Zipcode,Median Income ,Old Median Income,Growth,Population_size,Population_age,Num_White_People,Immigrant_pop,Num_Black_People,Percentage_Black,2012_pop_size,Pop_Growth
ZCTA5 00601,5397,5477,-80,17126,43.7,14463,2,243,0.014188952,18544,-1418
ZCTA5 00602,12858,13241,-383,37895,44.4,23237,46,688,0.018155429,41640,-3745
ZCTA5 00603,19295,17518,1777,49136,44.1,36497,38,1681,0.034211169,54540,-5404
ZCTA5 00606,1968,1754,214,5751,44.9,3319,0,27,0.004694836,6593,-842
ZCTA5 00610,8934,9181,-247,26153,43.5,15815,0,642,0.024547853,29141,-2988
ZCTA5 00611,514,23268,-22754,1283,47.2,641,0,13,0.010132502,69017,-67734
ZCTA5 00612,23319,3574,19745,64090,43.5,33184,542,1936,0.030207521,10750,53340
ZCTA5 00616,3342,8046,-4704,10186,45.3,5778,145,644,0.063224033,24733,-14547
ZCTA5 00617,7820,2027,5793,22803,42.4,11622,323,930,0.040784107,5923,16880
ZCTA5 00622,2789,13321,-10532,7751,48.3,2947,0,344,0.04438137,44943,-37192
ZCTA5 00623,13933,7935,5998,39652,44.5,13350,205,1482,0.037375164,26016,13636
ZCTA5 00624,7194,10987,-3793,21912,40.3,15829,22,607,0.027701716,35085,-13173
ZCTA5 00627,11367,556,10811,32885,43.8,29275,0,467,0.014201003,1800,31085
ZCTA5 00631,396,7500,-7104,1098,46.1,1075,0,0,0,25312,-24214
ZCTA5 00636,296,5668,-5372,1174,32.3,724,0,0,0,18997,-17823
ZCTA5 00637,7005,9641,-2636,23016,44.3,14689,10,354,0.015380605,30771,-7755
ZCTA5 00638,6032,12185,-6153,17689,44.5,12140,72,409,0.023121714,38179,-20490
ZCTA5 00641,8724,1807,6917,24915,46.1,12470,18,353,0.014168172,5869,19046
ZCTA5 00646,11863,4558,7305,36142,42.4,20141,0,3147,0.087073211,15120,21022
ZCTA5 00647,1927,1159,768,5198,44.9,2349,0,265,0.050981147,3244,1954
ZCTA5 00650,5157,4004,1153,14301,40.5,8280,143,234,0.016362492,13502,799
ZCTA5 00652,1250,6569,-5319,3193,47.2,1874,49,79,0.024741622,21438,-18245
ZCTA5 00653,3591,13109,-9518,9099,43.6,5332,0,432,0.047477745,41945,-32846
ZCTA5 00656,6513,6334,179,18633,44.3,14146,108,318,0.017066495,17217,1416
ZCTA5 00659,13214,14229,-1015,37525,43.7,32004,7,792,0.021105929,43598,-6073
ZCTA5 00660,6220,4840,1380,15630,48,2868,0,344,0.022008957,16665,-1035
ZCTA5 00662,13974,8345,5629,40503,43.6,23039,33,2774,0.068488754,26102,14401
ZCTA5 00664,5120,9541,-4421,15132,41.8,7993,0,449,0.029672218,29569,-14437
ZCTA5 00667,7849,3270,4579,23665,46.9,7886,0,358,0.015127826,9814,13851
ZCTA5 00669,9745,15558,-5813,27763,43.9,22905,0,503,0.018117639,44365,-16602
ZCTA5 00670,2639,11484,-8845,8744,43.2,4746,0,64,0.007319305,40145,-31401
ZCTA5 00674,14437,5491,8946,39569,43.1,22796,113,1296,0.032752913,15197,24372
ZCTA5 00676,13032,9048,3984,36849,41.5,28061,24,1554,0.042172108,27419,9430
ZCTA5 00677,5763,20354,-14591,15225,47.7,7853,0,213,0.013990148,57220,-41995
ZCTA5 00678,8985,11387,-2402,25763,42.3,19562,0,702,0.027248379,32899,-7136
ZCTA5 00680,17636,11396,6240,43070,46.1,8268,13,1178,0.027350824,33581,9489
ZCTA5 00682,11916,12166,-250,31816,37.1,6534,5,984,0.030927835,42552,-10736
ZCTA5 00683,10721,9138,1583,29664,45.7,18554,10,423,0.014259709,32617,-2953
ZCTA5 00685,14152,3876,10276,40169,45.6,25875,145,1283,0.031940053,13036,27133
ZCTA5 00687,9654,1929,7725,29069,39.9,18111,0,1177,0.040489869,6174,22895
ZCTA5 00688,4066,10896,-6830,11552,42.9,5044,106,204,0.01765928,37615,-26063
ZCTA5 00690,2187,17668,-15481,6217,38.1,4736,0,204,0.032813254,60873,-54656
ZCTA5 00692,11537,80,11457,33646,40.9,15393,0,2618,0.077810141,152,33494
ZCTA5 00693,20194,11997,8197,56146,42.8,31222,9,2823,0.050279628,41788,14358
ZCTA5 00694,28,8928,-8900,86,76,28,0,0,0,29175,-29089
ZCTA5 00698,11647,2873,8774,34016,44.8,24237,0,1281,0.037658749,7950,26066
ZCTA5 00703,9057,8486,571,25001,43.1,10515,0,1478,0.059117635,25575,-574
ZCTA5 00704,2543,4001,-1458,7179,30.7,2717,0,2012,0.280261875,12201,-5022
ZCTA5 00705,8683,6059,2624,24414,45,11974,0,3411,0.139714918,19542,4872
ZCTA5 00707,3845,1310,2535,10615,45.2,727,0,5579,0.525577014,4270,6345
ZCTA5 00714,6147,11651,-5504,16183,41.6,9284,0,4033,0.249212136,32840,-16657
ZCTA5 00715,801,7369,-6568,2012,55.8,883,0,224,0.111332008,18615,-16603
ZCTA5 00716,11125,8378,2747,27746,46,18924,18,1758,0.063360484,26604,1142
ZCTA5 00717,6398,8274,-1876,14568,43.7,8881,0,979,0.067202087,30992,-16424
ZCTA5 00718,8105,6858,1247,23412,39.4,10699,23,374,0.015974714,23259,153
ZCTA5 00719,8456,6173,2283,29555,42.3,17277,0,2131,0.072102859,19225,10330
ZCTA5 00720,6495,30765,-24270,20717,41.4,12748,0,957,0.046193947,91035,-70318
ZCTA5 00723,5882,19203,-13321,16265,46.4,1044,0,8866,0.545096834,56679,-40414
ZCTA5 00725,29994,13362,16632,79153,43.7,48539,191,6939,0.08766566,43260,35893
ZCTA5 00727,19267,16178,3089,52829,42.2,33232,228,5169,0.097843987,54914,-2085
ZCTA5 00728,13021,13254,-233,39669,39.4,27571,22,2583,0.065113817,39124,545
ZCTA5 00729,16529,4581,11948,48227,41.5,18774,305,6435,0.13343148,13869,34358
ZCTA5 00730,12806,4402,8404,33251,43.2,19201,0,1460,0.043908454,13803,19448
ZCTA5 00731,3933,16924,-12991,11131,46.3,6767,0,651,0.058485311,51689,-40558
ZCTA5 00735,4129,12439,-8310,11621,44.5,4050,80,756,0.065054642,35127,-23506
ZCTA5 00736,17400,12066,5334,46167,44,19857,83,4057,0.087876622,39171,6996
ZCTA5 00738,11564,566,10998,30468,43.5,12208,71,2543,0.083464619,1730,28738
ZCTA5 00739,11792,1633,10159,35105,41.8,17502,0,4170,0.118786498,5189,29916
ZCTA5 00740,643,17126,-16483,2020,33.4,683,0,150,0.074257426,54984,-52964
ZCTA5 00741,1394,7857,-6463,3899,47.9,957,0,1007,0.258271352,23203,-19304
ZCTA5 00745,15803,13052,2751,48282,43.2,17734,174,6180,0.127998012,40631,7651
ZCTA5 00751,7538,7646,-108,19768,44.5,7768,0,5388,0.272561716,23261,-3493
ZCTA5 00754,13248,2888,10360,37012,43.4,10727,102,11139,0.300956447,9236,27776
ZCTA5 00757,7203,7722,-519,20366,40.2,7537,0,5093,0.250073652,26315,-5949
ZCTA5 00765,2374,11671,-9297,8317,43.6,2592,14,629,0.075628231,37863,-29546
ZCTA5 00766,7873,12924,-5051,22416,42.1,10543,0,1784,0.07958601,40088,-17672
ZCTA5 00767,12011,11549,462,31450,44.6,3339,11,16174,0.51427663,38231,-6781
ZCTA5 00769,12975,6636,6339,35126,43.7,15517,0,6837,0.194642145,21883,13243
ZCTA5 00771,11857,6714,5143,34882,42.3,3891,28,17143,0.491456912,20050,14832
ZCTA5 00772,6580,463,6117,18148,41.6,2117,14,7958,0.43850562,1535,16613
ZCTA5 00773,6803,12597,-5794,17917,43.6,6987,40,1362,0.07601719,40945,-23028
ZCTA5 00775,489,13521,-13032,1293,45.1,453,11,31,0.023975251,45564,-44271
ZCTA5 00777,13352,4084,9268,38267,39.6,14066,88,7518,0.196461703,13340,24927
ZCTA5 00778,14448,5711,8737,41026,40.5,20656,99,4623,0.112684639,18989,22037
ZCTA5 00780,4443,10500,-6057,12975,38,6795,0,1249,0.096262042,36756,-23781
ZCTA5 00782,5130,14176,-9046,18664,39.9,11140,0,1734,0.092906129,44782,-26118
ZCTA5 00783,10531,152,10379,34329,41,20388,0,2100,0.061172769,386,33943
ZCTA5 00784,13947,16769,-2822,36965,40.3,23239,0,5465,0.147842554,53104,-16139
ZCTA5 00786,81,9037,-8956,151,61.1,63,0,65,0.430463576,30674,-30523
ZCTA5 00791,16356,15461,895,47335,44.8,15150,399,6919,0.146170909,48403,-1068
ZCTA5 00794,8731,2536,6195,28432,38.5,18181,0,2088,0.073438379,6257,22175
ZCTA5 00795,14486,22,14464,44055,41.6,13950,108,3209,0.072840767,36,44019
ZCTA5 00901,3133,8162,-5029,8098,48,4805,1,867,0.107063472,17049,-8951
ZCTA5 00906,91,2387,-2296,171,35.8,171,0,0,0,5394,-5223
ZCTA5 00907,8334,3790,4544,16620,51.3,9233,139,1302,0.07833935,7481,9139
ZCTA5 00909,2239,2501,-262,5007,39.5,1705,16,752,0.150189734,6353,-1346
ZCTA5 00911,3656,3466,190,7347,48.7,3761,184,511,0.069552198,8648,-1301
ZCTA5 00912,2691,11801,-9110,6233,48.5,2219,62,999,0.160275951,32368,-26135
ZCTA5 00913,3040,8457,-5417,7460,26.8,2087,62,308,0.041286863,21275,-13815
ZCTA5 00915,10602,7521,3081,25585,41.7,4415,52,3349,0.13089701,16890,8695
ZCTA5 00917,8100,7443,657,18504,47.9,8431,57,1860,0.100518807,19528,-1024
ZCTA5 00918,7633,14079,-6446,15393,42.5,8362,39,738,0.047943871,38800,-23407
ZCTA5 00920,6911,11130,-4219,17249,46,7875,0,3316,0.192243029,30072,-12823
ZCTA5 00921,13552,20118,-6566,32958,43.8,13410,10,5509,0.167152133,57860,-24902
ZCTA5 00923,10278,2856,7422,25915,41.4,11172,32,3801,0.146671812,6896,19019
ZCTA5 00924,19048,38084,-19036,48016,41.3,24624,8,8874,0.184813396,108427,-60411
ZCTA5 00925,2964,6280,-3316,6128,41.7,3204,24,1220,0.199086162,15769,-9641
ZCTA5 00926,35788,79,35709,94560,45.2,53554,140,9525,0.100729695,266,94294
ZCTA5 00927,5936,0,5936,13662,46.1,8175,52,967,0.070780266,1316,12346
ZCTA5 00934,27,27566,-27539,124,32.2,71,0,53,0.427419355,82068,-81944
ZCTA5 00949,25663,0,25663,69785,41.8,37394,0,5876,0.084201476,0,69785
ZCTA5 00950,0,16,-16,0,-,0,0,0,#DIV/0!,16,-16
ZCTA5 00951,149,3412,-3263,376,37.4,210,0,94,0.25,10099,-9723
ZCTA5 00952,2842,21765,-18923,7727,48.8,3403,0,1610,0.208360295,73159,-65432
ZCTA5 00953,21990,26689,-4699,67606,39.6,45542,26,4219,0.062405704,79371,-11765
ZCTA5 00956,23846,15415,8431,64939,43.9,31454,22,4130,0.063598146,46330,18609
ZCTA5 00957,14799,18145,-3346,41162,44.2,20004,155,2483,0.060322628,48030,-6868
ZCTA5 00959,17329,0,17329,47783,42.4,23350,77,4250,0.088943767,1585,46198
ZCTA5 00960,0,11434,-11434,3380,35.1,1560,0,506,0.149704142,33000,-29620
ZCTA5 00961,11292,7417,3875,30842,44.5,15784,72,2317,0.07512483,22200,8642
ZCTA5 00962,7567,3161,4406,20066,40.6,10796,0,1953,0.097328815,9256,10810
ZCTA5 00965,1888,6443,-4555,5392,43.3,2502,16,660,0.122403561,17445,-12053
ZCTA5 00966,5976,1952,4024,15737,49.3,8694,42,582,0.036982907,3986,11751
ZCTA5 00968,1775,15034,-13259,3683,55.9,2349,15,99,0.026880261,42731,-39048
ZCTA5 00969,14577,9963,4614,42144,43.8,22435,0,2586,0.061361048,30042,12102
ZCTA5 00971,9104,21554,-12450,27048,46.5,12739,0,1922,0.071058858,64104,-37056
ZCTA5 00976,22179,7374,14805,61869,42.7,39554,188,7555,0.122112851,16247,45622
ZCTA5 00979,8548,6029,2519,17313,49.8,8078,211,1883,0.108762202,16656,657
ZCTA5 00982,5804,14507,-8703,14151,44.7,6108,108,2573,0.181824606,42485,-28334
ZCTA5 00983,12664,12472,192,32747,41.7,13921,0,6537,0.199621339,37382,-4635
ZCTA5 00985,12105,19863,-7758,32261,46.3,12783,77,6135,0.190167695,59995,-27734
ZCTA5 00987,20202,7018,13184,54950,41.1,22978,79,8801,0.160163785,17380,37570
ZCTA5 01001,6791,9260,-2469,16088,45.4,14434,591,596,0.037046246,28718,-12630
ZCTA5 01002,9985,17,9968,27323,25.3,20141,2623,1643,0.060132489,11286,16037
ZCTA5 01003,15,1819,-1804,13711,19.8,9173,2570,766,0.055867552,5120,8591
ZCTA5 01005,1761,5624,-3863,4947,43.2,4768,0,22,0.00444714,14593,-9646
ZCTA5 01007,5917,461,5456,15304,42.8,14051,491,52,0.003397804,1160,14144
ZCTA5 01008,506,279,227,1171,52.5,1152,0,0,0,636,535
ZCTA5 01009,333,1422,-1089,800,30.6,800,0,0,0,3610,-2810
ZCTA5 01010,1503,520,983,3703,44.6,3058,25,151,0.040777748,1326,2377
ZCTA5 01011,498,237,261,1332,45.8,1302,3,5,0.003753754,506,826
ZCTA5 01012,227,8905,-8678,503,52.8,493,0,0,0,21822,-21319
ZCTA5 01013,9375,12922,-3547,22709,38.8,16916,507,1023,0.045048219,30893,-8184
ZCTA5 01020,13400,1130,12270,30704,44.2,25560,405,1684,0.054846274,2611,28093
ZCTA5 01022,1082,462,620,2235,34.5,1659,65,370,0.165548098,1066,1169
ZCTA5 01026,454,7967,-7513,1071,47.6,1039,1,0,0,17622,-16551
ZCTA5 01027,8451,5769,2682,17708,46.2,16033,307,71,0.004009487,15710,1998
ZCTA5 01028,6017,262,5755,16386,43,14792,645,165,0.010069572,601,15785
ZCTA5 01029,228,4452,-4224,511,53.1,504,0,0,0,11096,-10585
ZCTA5 01030,4994,577,4417,12627,47.6,11849,74,186,0.01473034,1547,11080
ZCTA5 01031,608,274,334,1577,36.8,1427,0,0,0,626,951
ZCTA5 01032,198,2603,-2405,430,55.7,426,0,0,0,6197,-5767
ZCTA5 01033,2530,733,1797,6110,46.4,5899,31,65,0.010638298,1952,4158
ZCTA5 01034,830,2101,-1271,1991,49.4,1848,10,22,0.011049724,5239,-3248
ZCTA5 01035,2254,1844,410,5293,49.7,4716,114,120,0.022671453,5096,197
ZCTA5 01036,2016,235,1781,4991,56.5,4579,13,5,0.001001803,716,4275
ZCTA5 01037,257,1166,-909,692,56.4,665,3,1,0.001445087,2676,-1984
ZCTA5 01038,1111,707,404,2601,48.6,2292,21,0,0,1532,1069
ZCTA5 01039,709,16032,-15323,1675,53.5,1577,0,29,0.017313433,39996,-38321
ZCTA5 01040,15062,1055,14007,38480,36.5,28031,373,1550,0.040280665,2670,35810
ZCTA5 01050,1072,576,496,2593,43.9,2432,0,28,0.010798303,1926,667
ZCTA5 01053,712,744,-32,2016,54.5,1809,2,173,0.085813492,1812,204
ZCTA5 01054,708,8029,-7321,1794,50.1,1653,71,9,0.005016722,21146,-19352
ZCTA5 01056,8567,3398,5169,21050,45.8,18767,233,411,0.019524941,8511,12539
ZCTA5 01057,3485,6553,-3068,8288,50.3,7905,129,60,0.007239382,15065,-6777
ZCTA5 01060,7060,4610,2450,14975,41.2,12852,420,276,0.018430718,10980,3995
ZCTA5 01062,4162,0,4162,9835,49.2,8844,139,200,0.020335536,671,9164
ZCTA5 01063,5,0,5,2532,20.2,1742,474,135,0.053317536,0,2532
ZCTA5 01066,34,650,-616,51,94,51,0,0,0,1796,-1745
ZCTA5 01068,625,3554,-2929,1621,49.8,1539,0,20,0.012338063,8881,-7260
ZCTA5 01069,3732,238,3494,8870,49.1,7627,175,316,0.035625705,529,8341
ZCTA5 01070,258,586,-328,621,49.4,556,9,1,0.001610306,1485,-864
ZCTA5 01071,518,628,-110,1280,46.5,1177,2,36,0.028125,1449,-169
ZCTA5 01072,609,2337,-1728,1374,52,1234,11,12,0.008733624,5828,-4454
ZCTA5 01073,2318,118,2200,6158,47,5494,195,49,0.007957129,271,5887
ZCTA5 01074,157,7100,-6943,584,33.9,556,0,0,0,17705,-17121
ZCTA5 01075,7328,3650,3678,18051,42.1,15999,943,280,0.015511606,9496,8555
ZCTA5 01077,3648,223,3425,9292,47.1,8836,73,1,0.000107619,492,8800
ZCTA5 01079,237,1036,-799,521,53.6,482,0,0,0,2329,-1808
ZCTA5 01080,895,720,175,2276,37.7,1892,36,14,0.006151142,1862,414
ZCTA5 01081,708,4487,-3779,1748,41.7,1670,0,9,0.005148741,10265,-8517
ZCTA5 01082,4689,1207,3482,10441,40.8,9858,1,160,0.015324203,2913,7528
ZCTA5 01083,934,104,830,2701,34.8,2522,35,25,0.009255831,239,2462
ZCTA5 01084,44,15507,-15463,101,49.2,86,0,0,0,40590,-40489
ZCTA5 01085,15608,0,15608,41715,38.7,36541,1677,728,0.017451756,1298,40417
ZCTA5 01088,345,360,-15,663,31.4,633,30,0,0,595,68
ZCTA5 01089,12734,11694,1040,28814,38.6,23299,1435,1092,0.037898244,28411,403
ZCTA5 01092,532,576,-44,1248,36.5,1217,0,31,0.024839744,1440,-192
ZCTA5 01093,70,119,-49,157,52.2,157,0,0,0,298,-141
ZCTA5 01094,31,149,-118,70,66.2,70,0,0,0,240,-170
ZCTA5 01095,5417,5345,72,14737,45.4,13657,100,461,0.031281808,14275,462
ZCTA5 01096,1058,907,151,2413,48.4,2379,1,0,0,2220,193
ZCTA5 01097,26,25,1,64,39.2,64,0,0,0,83,-19
ZCTA5 01098,510,539,-29,1042,59.1,1028,0,0,0,1138,-96
ZCTA5 01103,1434,1466,-32,2168,38.7,1028,42,511,0.235701107,2340,-172
ZCTA5 01104,9208,8905,303,23226,34.8,12538,113,3157,0.135925256,22833,393
ZCTA5 01105,5206,4901,305,12527,29.6,5254,23,2093,0.167079109,12664,-137
ZCTA5 01106,6015,5956,59,16150,44.6,14245,1010,242,0.01498452,16079,71
ZCTA5 01107,4234,3721,513,12387,28.5,6413,159,1577,0.12731089,11071,1316
ZCTA5 01108,10213,9128,1085,26257,33.7,13582,1765,5311,0.202269871,25551,706
ZCTA5 01109,9506,9553,-47,31242,28.9,13349,533,11059,0.353978619,31503,-261
ZCTA5 01118,5785,5567,218,15073,36.3,9898,702,2602,0.172626551,13762,1311
ZCTA5 01119,5230,5051,179,13803,37.7,8032,645,2893,0.209592118,14946,-1143
ZCTA5 01128,1136,938,198,3232,39.8,2518,106,233,0.072091584,2347,885
ZCTA5 01129,2523,2896,-373,5916,43.7,4116,174,892,0.150777552,7330,-1414
ZCTA5 01144,0,3316,-3316,0,-,0,0,0,#DIV/0!,8655,-8655
ZCTA5 01151,3664,0,3664,9640,34.8,5352,135,2001,0.207572614,0,9640
ZCTA5 01201,19952,20577,-625,45372,44.8,37953,607,2301,0.050714097,45975,-603
ZCTA5 01220,3948,3796,152,8161,47.5,7726,97,66,0.008087244,8657,-496
ZCTA5 01222,289,407,-118,754,42.6,745,0,0,0,875,-121
ZCTA5 01223,1223,1035,188,2658,48.6,2465,16,21,0.007900677,2399,259
ZCTA5 01224,80,80,0,186,57,186,0,0,0,291,-105
ZCTA5 01225,1509,1301,208,3243,52,3020,28,37,0.011409189,3036,207
ZCTA5 01226,2907,2692,215,6356,52.4,6140,48,42,0.00660793,7024,-668
ZCTA5 01229,88,60,28,142,69.4,142,0,0,0,170,-28
ZCTA5 01230,3793,3395,398,9139,46.7,8351,32,139,0.015209542,8486,653
ZCTA5 01235,1104,1151,-47,2610,49.4,2478,0,14,0.005363985,2867,-257
ZCTA5 01236,704,571,133,1632,57.7,1406,174,14,0.008578431,1396,236
ZCTA5 01237,1019,1048,-29,2332,53.9,2319,0,2,0.000857633,2599,-267
ZCTA5 01238,2292,2533,-241,5626,49.4,5112,101,17,0.003021685,6190,-564
ZCTA5 01240,2158,2096,62,4926,56.8,4537,0,105,0.021315469,4442,484
ZCTA5 01242,93,122,-29,279,53.4,279,0,0,0,569,-290
ZCTA5 01243,80,118,-38,163,56.7,145,0,0,0,267,-104
ZCTA5 01244,68,46,22,164,61.2,164,0,0,0,133,31
ZCTA5 01245,355,344,11,771,64.6,760,0,0,0,821,-50
ZCTA5 01247,6527,6891,-364,15405,44.6,13655,495,258,0.016747809,16160,-755
ZCTA5 01253,434,271,163,879,52.9,865,0,0,0,623,256
ZCTA5 01254,440,451,-11,995,58.7,913,25,51,0.051256281,1120,-125
ZCTA5 01255,309,356,-47,865,48.8,830,4,14,0.016184971,886,-21
ZCTA5 01256,330,286,44,708,50,666,0,26,0.036723164,663,45
ZCTA5 01257,1013,843,170,2034,58.6,1911,64,1,0.000491642,2072,-38
ZCTA5 01258,77,157,-80,161,56.8,158,0,0,0,321,-160
ZCTA5 01259,292,240,52,720,47.5,678,0,35,0.048611111,564,156
ZCTA5 01260,81,62,19,331,40,331,0,0,0,157,174
ZCTA5 01262,688,524,164,1627,57.7,1401,53,68,0.041794714,1171,456
ZCTA5 01264,100,74,26,252,60,227,0,5,0.01984127,143,109
ZCTA5 01266,421,717,-296,920,52.3,833,8,54,0.058695652,1600,-680
ZCTA5 01267,2541,2900,-359,8166,31.1,6783,500,267,0.032696547,7994,172
ZCTA5 01270,372,286,86,949,42.2,789,0,0,0,776,173
ZCTA5 01301,8190,7849,341,17901,44.6,15934,298,492,0.027484498,17843,58
ZCTA5 01330,704,640,64,1542,57.5,1374,15,0,0,1439,103
ZCTA5 01331,5450,5155,295,13870,45,13046,85,136,0.009805335,13520,350
ZCTA5 01337,1007,1115,-108,2492,49,2397,20,0,0,2528,-36
ZCTA5 01338,63,79,-16,97,61.6,82,0,0,0,231,-134
ZCTA5 01339,627,702,-75,1493,54.8,1418,15,0,0,1586,-93
ZCTA5 01340,797,703,94,1818,53.4,1732,6,15,0.008250825,1671,147
ZCTA5 01341,730,714,16,1658,54.2,1629,5,0,0,1776,-118
ZCTA5 01342,343,542,-199,1135,37.8,996,5,26,0.022907489,1481,-346
ZCTA5 01343,60,38,22,152,45.4,143,0,0,0,85,67
ZCTA5 01344,681,594,87,1697,43,1599,0,30,0.017678256,1471,226
ZCTA5 01346,180,181,-1,407,51.8,378,0,0,0,426,-19
ZCTA5 01347,96,45,51,207,27.7,137,32,0,0,102,105
ZCTA5 01349,327,360,-33,715,44.3,561,12,0,0,847,-132
ZCTA5 01350,52,61,-9,114,58.9,114,0,0,0,105,9
ZCTA5 01351,1046,1025,21,2725,41.9,2611,0,33,0.012110092,2367,358
ZCTA5 01354,602,593,9,1708,47.7,1584,55,35,0.020491803,1565,143
ZCTA5 01355,413,358,55,1010,56,782,5,0,0,895,115
ZCTA5 01360,1213,1229,-16,2899,47.6,2643,7,2,0.000689893,3043,-144
ZCTA5 01364,3021,3377,-356,7684,42.9,7227,81,73,0.00950026,7966,-282
ZCTA5 01366,458,477,-19,1141,51.9,1040,11,5,0.004382121,1301,-160
ZCTA5 01367,178,232,-54,473,43.3,415,1,9,0.019027484,530,-57
ZCTA5 01368,551,443,108,1461,48.2,1443,3,0,0,1051,410
ZCTA5 01370,1694,1732,-38,3690,51.8,3342,56,13,0.003523035,4127,-437
ZCTA5 01373,2355,2006,349,5076,52.3,4882,10,0,0,4631,445
ZCTA5 01375,1666,1488,178,3667,34.5,3024,463,28,0.007635669,3690,-23
ZCTA5 01376,2312,2376,-64,4968,48,4654,6,7,0.001409018,5432,-464
ZCTA5 01378,319,313,6,762,50.1,744,2,0,0,631,131
ZCTA5 01379,381,447,-66,819,51.2,682,12,73,0.089133089,1004,-185
ZCTA5 01380,14,14907,-14893,47,30.6,47,0,0,0,40327,-40280
ZCTA5 01420,16383,2278,14105,41766,37.1,30596,615,2705,0.064765599,6077,35689
ZCTA5 01430,2141,1066,1075,6316,40.4,5947,13,76,0.012032932,3066,3250
ZCTA5 01431,1297,3058,-1761,3189,50.8,3066,15,8,0.002508623,7105,-3916
ZCTA5 01432,3560,94,3466,7912,39.8,6568,261,208,0.026289181,1564,6348
ZCTA5 01434,315,1206,-891,2245,45.2,1350,260,555,0.247216036,3641,-1396
ZCTA5 01436,1262,159,1103,3673,32.6,3544,46,8,0.002178056,313,3360
ZCTA5 01438,124,7847,-7723,365,19.1,362,0,3,0.008219178,20393,-20028
ZCTA5 01440,8904,3778,5126,21310,44.5,18465,658,537,0.025199437,10687,10623
ZCTA5 01450,3820,1696,2124,11218,41.6,9891,471,63,0.005615974,4915,6303
ZCTA5 01451,1668,1513,155,5068,41.8,4569,125,0,0,4366,702
ZCTA5 01452,1586,16605,-15019,4338,42.6,3941,133,96,0.022130014,41113,-36775
ZCTA5 01453,17896,3287,14609,43478,41.6,33709,1529,2873,0.066079396,8934,34544
ZCTA5 01460,3504,4076,-572,10063,41.7,9023,587,15,0.001490609,10356,-293
ZCTA5 01462,4447,4202,245,11657,42.8,10545,126,139,0.011924166,11537,120
ZCTA5 01463,4370,2149,2221,11707,42.8,10513,553,125,0.010677373,7352,4355
ZCTA5 01464,2345,129,2216,7400,46.6,5987,213,582,0.078648649,401,6999
ZCTA5 01468,1622,1422,200,4058,46.6,3746,312,0,0,3880,178
ZCTA5 01469,2831,2495,336,7479,38.8,6725,342,151,0.020189865,6822,657
ZCTA5 01473,3122,2672,450,8148,47.4,8055,0,0,0,7282,866
ZCTA5 01474,680,779,-99,1665,54.8,1555,0,0,0,2159,-494
ZCTA5 01475,3726,3907,-181,10292,39.2,9277,387,88,0.00855033,10333,-41
ZCTA5 01501,6534,6040,494,16684,43.1,15533,486,80,0.004795013,16080,604
ZCTA5 01503,1311,1072,239,3326,50,3109,62,35,0.010523151,2856,470
ZCTA5 01504,3874,3367,507,9188,43.1,8080,143,437,0.047562037,9030,158
ZCTA5 01505,1834,1618,216,4810,45.5,4609,101,0,0,4341,469
ZCTA5 01506,1395,1342,53,3435,50.1,3279,12,9,0.002620087,3378,57
ZCTA5 01507,4776,4411,365,13312,41.1,12403,38,97,0.007286659,12947,365
ZCTA5 01510,6455,5478,977,15221,36.4,13250,427,323,0.021220682,13618,1603
ZCTA5 01515,835,760,75,2040,50.6,1916,19,26,0.012745098,2152,-112
ZCTA5 01516,3179,3138,41,9186,42.1,8728,79,28,0.003048117,8466,720
ZCTA5 01518,1280,1140,140,3299,37.1,3103,87,30,0.009093665,3089,210
ZCTA5 01519,2652,2293,359,7626,41.2,6308,578,163,0.021374246,6386,1240
ZCTA5 01520,6021,5139,882,16752,41.4,14790,393,533,0.031817096,14333,2419
ZCTA5 01521,1106,997,109,2591,49,2478,17,14,0.005403319,2477,114
ZCTA5 01522,1159,1160,-1,2907,44.4,2759,41,50,0.017199862,2994,-87
ZCTA5 01523,2801,2258,543,8359,40.1,7260,77,456,0.05455198,7395,964
ZCTA5 01524,2180,2492,-312,6296,42.3,5736,51,262,0.041613723,7029,-733
ZCTA5 01525,31,90,-59,31,-,31,0,0,0,136,-105
ZCTA5 01527,5165,5132,33,13827,43.9,12261,533,192,0.013885875,13257,570
ZCTA5 01529,1275,1004,271,3166,47.2,3037,1,25,0.007896399,3168,-2
ZCTA5 01531,430,374,56,1052,50.3,1020,2,15,0.014258555,1084,-32
ZCTA5 01532,5662,5195,467,15605,44.1,12404,1670,603,0.038641461,14407,1198
ZCTA5 01534,2367,1761,606,6169,44.4,5647,0,243,0.039390501,5168,1001
ZCTA5 01535,1883,1968,-85,4757,47.3,4599,10,62,0.013033424,4681,76
ZCTA5 01536,2914,2571,343,7141,41.9,5432,408,230,0.032208374,7156,-15
ZCTA5 01537,781,979,-198,1775,36.6,1653,1,76,0.042816901,2334,-559
ZCTA5 01540,3988,4162,-174,11529,39.7,10506,188,139,0.012056553,11237,292
ZCTA5 01541,1298,1206,92,3502,49.1,3228,0,18,0.00513992,3423,79
ZCTA5 01542,992,604,388,2667,44,2351,0,127,0.047619048,1655,1012
ZCTA5 01543,3052,2639,413,8988,42.4,8543,270,46,0.005117935,7967,1021
ZCTA5 01545,13808,13104,704,38291,39.6,26084,8856,867,0.022642396,35413,2878
ZCTA5 01550,7094,6396,698,17643,40.6,13477,154,781,0.044266848,16775,868
ZCTA5 01560,1902,1521,381,4773,38,3400,847,80,0.016760947,4290,483
ZCTA5 01561,17,112,-95,69,3.9,69,0,0,0,293,-224
ZCTA5 01562,5186,4678,508,11963,47.9,11158,81,171,0.014294073,11713,250
ZCTA5 01564,3248,2804,444,8015,49.9,7670,35,96,0.011977542,7808,207
ZCTA5 01566,2610,2454,156,6507,48.4,5962,280,63,0.009681881,6141,366
ZCTA5 01568,2651,2610,41,7826,45.1,6415,351,472,0.060311781,7367,459
ZCTA5 01569,5327,4931,396,13948,43.9,13247,65,101,0.007241182,13422,526
ZCTA5 01570,7414,7077,337,17664,42,14321,177,888,0.050271739,16760,904
ZCTA5 01571,4199,3951,248,11890,41.2,10678,412,386,0.032464256,11401,489
ZCTA5 01581,7980,6943,1037,21213,38.9,13400,5409,747,0.035214255,18345,2868
ZCTA5 01583,2784,2311,473,7607,46,6690,89,284,0.037334034,7627,-20
ZCTA5 01585,1968,1766,202,4864,51.1,4796,0,0,0,4481,383
ZCTA5 01588,4005,4029,-24,10206,38.1,8838,39,16,0.001567705,10411,-205
ZCTA5 01590,3332,2975,357,9219,42.2,8447,146,140,0.015186029,8836,383
ZCTA5 01602,10527,9089,1438,26711,39.8,20186,1423,2318,0.086780727,23185,3526
ZCTA5 01603,7496,7214,282,20184,35.7,12033,2552,2324,0.115140706,19123,1061
ZCTA5 01604,16869,14772,2097,40961,35.9,26840,3221,5905,0.144161519,35844,5117
ZCTA5 01605,11626,10705,921,30353,32.5,17481,1200,4897,0.161334959,26247,4106
ZCTA5 01606,9198,8318,880,22883,38.9,16030,1527,2851,0.124590307,19899,2984
ZCTA5 01607,3916,3651,265,8836,39.5,5608,221,1798,0.20348574,8265,571
ZCTA5 01608,1945,1465,480,4782,27.5,1973,424,497,0.103931409,3767,1015
ZCTA5 01609,8439,7423,1016,23509,32,17120,1500,1856,0.078948488,21571,1938
ZCTA5 01610,8866,7355,1511,26057,27.6,15050,1742,3447,0.132286909,23826,2231
ZCTA5 01611,783,960,-177,2209,44.9,1957,1,47,0.021276596,2446,-237
ZCTA5 01612,1588,1547,41,5005,36.7,4391,76,388,0.077522478,4846,159
ZCTA5 01701,13189,12228,961,33319,43.8,25216,3611,1506,0.045199436,31144,2175
ZCTA5 01702,14810,14343,467,38842,35.1,20657,2711,3177,0.081792905,37700,1142
ZCTA5 01718,228,174,54,767,38.8,312,309,0,0,367,400
ZCTA5 01719,2180,2028,152,5471,43.4,3862,1019,366,0.06689819,5017,454
ZCTA5 01720,8678,7975,703,23107,43.8,15345,5358,993,0.042973991,21382,1725
ZCTA5 01721,7587,6512,1075,18646,41.1,14135,2242,897,0.048106833,16587,2059
ZCTA5 01730,5540,4971,569,14233,43.3,10580,2619,436,0.030633036,13515,718
ZCTA5 01731,478,437,41,1917,22.3,1126,143,119,0.062076161,1865,52
ZCTA5 01740,1853,1635,218,5606,42.1,4856,238,11,0.001962183,4905,701
ZCTA5 01741,1800,1796,4,5215,45.7,4483,557,0,0,4870,345
ZCTA5 01742,6357,6520,-163,18393,46,15323,860,774,0.042081227,18309,84
ZCTA5 01745,215,140,75,538,35.4,441,92,0,0,365,173
ZCTA5 01746,5354,4868,486,14386,44.6,12808,823,173,0.01202558,13668,718
ZCTA5 01747,2116,2174,-58,6012,44.4,5704,28,35,0.00582169,5911,101
ZCTA5 01748,6556,4940,1616,18501,41.1,14343,2863,345,0.018647641,14982,3519
ZCTA5 01749,8035,7803,232,20032,43.8,17181,907,100,0.004992013,19077,955
ZCTA5 01752,17147,15918,1229,41505,39.2,28514,2168,1424,0.034309119,38491,3014
ZCTA5 01754,4269,4301,-32,10702,40.5,9135,448,119,0.011119417,10151,551
ZCTA5 01756,2076,2034,42,6212,45.6,5832,48,33,0.005312299,5827,385
ZCTA5 01757,11487,10568,919,30294,40.6,23324,688,1041,0.03436324,28120,2174
ZCTA5 01760,15153,13340,1813,36354,42.2,28724,5162,774,0.021290642,32821,3533
ZCTA5 01770,1515,1428,87,4406,45.3,3783,283,16,0.003631412,4128,278
ZCTA5 01772,3364,3212,152,9842,42.7,7823,1606,68,0.006909165,9380,462
ZCTA5 01773,2123,1808,315,5155,51,4498,360,12,0.002327837,4672,483
ZCTA5 01775,2646,2331,315,7130,40.9,6043,392,188,0.026367461,6618,512
ZCTA5 01776,6208,5646,562,18912,42.7,15784,1885,272,0.014382403,17712,1200
ZCTA5 01778,4838,5003,-165,14060,43.3,11398,1890,123,0.008748222,13136,924
ZCTA5 01801,16292,15507,785,40967,39.7,32074,3914,1967,0.048014255,38732,2235
ZCTA5 01803,10093,9183,910,26234,44,19979,4042,560,0.021346344,24372,1862
ZCTA5 01810,13235,12065,1170,35600,43.4,26841,5796,664,0.018651685,33385,2215
ZCTA5 01821,11664,10743,921,31499,42,25923,2580,1740,0.055239849,30569,930
ZCTA5 01824,9915,9593,322,26574,42.9,22141,2515,197,0.007413261,24603,1971
ZCTA5 01826,12350,10952,1398,32313,41.4,28121,1255,895,0.027697831,29555,2758
ZCTA5 01827,1136,1138,-2,3369,42.5,3202,129,0,0,3190,179
ZCTA5 01830,10759,10009,750,27403,37.9,19948,350,1253,0.045724921,25229,2174
ZCTA5 01832,9915,8778,1137,25526,37.2,18389,639,506,0.019822926,22324,3202
ZCTA5 01833,3185,2805,380,8384,42.5,8011,61,23,0.002743321,8203,181
ZCTA5 01834,2532,2371,161,6739,39.9,6530,57,0,0,6530,209
ZCTA5 01835,5434,5238,196,14164,41.5,11649,59,752,0.053092347,13400,764
ZCTA5 01840,3068,2099,969,6814,34.4,2182,0,244,0.035808629,4493,2321
ZCTA5 01841,17019,15561,1458,53180,31.2,19174,521,3040,0.057164347,47547,5633
ZCTA5 01843,10204,8949,1255,27804,33,11926,977,1330,0.047834844,24291,3513
ZCTA5 01844,18792,17598,1194,52502,40.4,34156,2348,3405,0.064854672,47238,5264
ZCTA5 01845,10971,10193,778,31394,37.6,26379,2194,699,0.022265401,28114,3280
ZCTA5 01850,5864,5634,230,16438,32.8,10328,1838,2558,0.155615038,15924,514
ZCTA5 01851,11376,10275,1101,32469,35.3,12832,14086,2475,0.076226555,29404,3065
ZCTA5 01852,14628,13570,1058,36740,36.8,25051,4720,2778,0.075612412,33316,3424
ZCTA5 01854,10417,9799,618,29157,31.4,18617,4888,2514,0.086222862,28113,1044
ZCTA5 01860,2589,2439,150,6698,48.2,6271,75,0,0,6368,330
ZCTA5 01862,3956,3470,486,10719,44.8,8339,467,882,0.082283795,10385,334
ZCTA5 01863,3713,3890,-177,9697,41.5,8228,811,280,0.02887491,9328,369
ZCTA5 01864,5848,5239,609,15549,42.2,14039,587,203,0.013055502,14919,630
ZCTA5 01867,9297,8867,430,25511,42.7,22618,1658,180,0.00705578,24252,1259
ZCTA5 01876,11903,10485,1418,30930,45.8,27906,1182,1071,0.034626576,28634,2296
ZCTA5 01879,4053,4055,-2,12454,41.4,10502,1174,210,0.016862052,11484,970
ZCTA5 01880,10905,9771,1134,27179,43.7,24984,1035,316,0.011626623,24906,2273
ZCTA5 01886,8515,7378,1137,24535,42.2,17972,5295,154,0.006276748,22107,2428
ZCTA5 01887,7756,7329,427,23311,41.2,20399,1244,497,0.021320407,22392,919
ZCTA5 01890,8149,7569,580,22875,42.4,17522,3474,408,0.017836066,21437,1438
ZCTA5 01901,1194,1126,68,2291,40.9,745,33,727,0.317328677,2147,144
ZCTA5 01902,18673,16899,1774,51008,35.5,21081,2174,8134,0.159465182,44654,6354
ZCTA5 01904,7044,6845,199,19912,40.2,14896,531,1075,0.053987545,18765,1147
ZCTA5 01905,9339,8762,577,26962,34.2,13083,2143,4648,0.172390772,24779,2183
ZCTA5 01906,10581,10093,488,28521,43.6,24729,1380,993,0.034816451,26761,1760
ZCTA5 01907,6169,5672,497,15183,44.9,13828,385,262,0.017256142,14011,1172
ZCTA5 01908,1678,1584,94,3354,58.4,3160,33,51,0.015205725,3438,-84
ZCTA5 01913,7326,6694,632,17286,44.1,15815,181,72,0.00416522,16344,942
ZCTA5 01915,16363,15406,957,41545,39.8,37116,1147,1129,0.027175352,39748,1797
ZCTA5 01921,2905,2735,170,8265,49.7,7786,167,0,0,7990,275
ZCTA5 01922,1196,988,208,3929,43.7,3718,81,0,0,3013,916
ZCTA5 01923,10964,10319,645,27789,44.4,25298,659,721,0.025945518,26507,1282
ZCTA5 01929,1335,1421,-86,3650,43.6,3608,0,0,0,3520,130
ZCTA5 01930,13168,12140,1028,29814,50.2,27337,477,631,0.021164554,28937,877
ZCTA5 01937,0,0,0,177,37.3,166,0,0,0,61,116
ZCTA5 01938,5573,5512,61,13740,48.5,12726,323,176,0.012809316,13271,469
ZCTA5 01940,4663,4325,338,13023,40.5,11574,662,276,0.021193273,12019,1004
ZCTA5 01944,2080,1997,83,5382,48,5011,58,0,0,5158,224
ZCTA5 01945,8075,7837,238,20397,48.1,19508,330,84,0.004118253,19879,518
ZCTA5 01949,3122,2623,499,9726,45.9,8855,132,191,0.019638083,8992,734
ZCTA5 01950,7537,7502,35,18282,46.4,17241,271,74,0.004047697,17460,822
ZCTA5 01951,1337,1577,-240,2816,57.3,2693,32,0,0,3673,-857
ZCTA5 01952,3885,3405,480,9152,48.2,8098,220,97,0.010598776,8289,863
ZCTA5 01960,22681,21032,1649,54051,46.5,46864,728,1841,0.034060424,51036,3015
ZCTA5 01965,354,3088,-2734,903,64.5,851,0,0,0,7018,-6115
ZCTA5 01966,3319,2241,1078,7014,57.8,6675,9,21,0.002994012,5857,1157
ZCTA5 01969,2326,17834,-15508,6135,49,5974,57,60,0.009779951,41500,-35365
ZCTA5 01970,19699,2614,17085,44372,37.6,35955,1355,2253,0.050775264,7942,36430
ZCTA5 01982,2575,2093,482,7641,41.5,6949,454,57,0.007459757,6127,1514
ZCTA5 01983,2202,1308,894,6530,42.4,5936,244,106,0.016232772,4892,1638
ZCTA5 01984,1291,1463,-172,5006,23.6,4618,164,134,0.026767879,4263,743
ZCTA5 01985,1591,6223,-4632,4500,48.1,4032,75,0,0,16304,-11804
ZCTA5 02019,6250,8439,-2189,16934,38.5,14378,148,327,0.019310263,21596,-4662
ZCTA5 02021,9305,2852,6453,24122,43.2,18618,1918,2215,0.09182489,7756,16366
ZCTA5 02025,3146,9609,-6463,8295,45.1,7810,33,86,0.010367691,24716,-16421
ZCTA5 02026,10458,1834,8624,25308,43.1,21137,683,1919,0.075825826,5608,19700
ZCTA5 02030,1916,1356,560,5894,45.2,4791,767,0,0,3536,2358
ZCTA5 02032,1522,6505,-4983,4878,39.2,3984,490,152,0.031160312,16864,-11986
ZCTA5 02035,7289,10968,-3679,18431,41.7,14875,1182,1032,0.055992621,31760,-13329
ZCTA5 02038,12118,8140,3978,33057,41,29104,2069,560,0.016940436,22136,10921
ZCTA5 02043,9252,4744,4508,24061,46.2,22952,583,160,0.006649765,10342,13719
ZCTA5 02045,4380,70,4310,10120,53.9,9711,137,35,0.003458498,136,9984
ZCTA5 02047,89,8247,-8158,187,45.8,187,0,0,0,23191,-23004
ZCTA5 02048,8707,9854,-1147,23768,42.1,20727,1469,498,0.020952541,25485,-1717
ZCTA5 02050,10142,4025,6117,25841,46.2,25085,193,202,0.007817035,12067,13774
ZCTA5 02052,4373,4445,-72,12775,40.8,12127,382,31,0.002426614,12742,33
ZCTA5 02053,4812,3020,1792,13610,39.5,12132,577,167,0.012270389,7905,5705
ZCTA5 02054,3078,3175,-97,8481,45.8,7579,265,145,0.01709704,11142,-2661
ZCTA5 02056,2967,3451,-484,11531,39.6,9628,165,934,0.080999046,10501,1030
ZCTA5 02061,3567,11623,-8056,11258,39,10471,460,23,0.002042992,28580,-17322
ZCTA5 02062,13002,6640,6362,31256,39,25032,1616,2465,0.078864858,17708,13548
ZCTA5 02066,7412,6157,1255,18781,49.5,17092,364,65,0.003460945,17399,1382
ZCTA5 02067,6395,289,6106,18477,42.6,13400,3360,318,0.017210586,1947,16530
ZCTA5 02071,383,10641,-10258,1248,40.7,1104,0,0,0,27359,-26111
ZCTA5 02072,11277,7008,4269,29028,45.7,19375,1804,4904,0.168940333,18899,10129
ZCTA5 02081,7251,5255,1996,20287,42.2,18556,550,579,0.028540445,14616,5671
ZCTA5 02090,5424,3831,1593,16066,44.4,12765,1899,471,0.029316569,10960,5106
ZCTA5 02093,4480,2337,2143,12077,46.7,11338,137,278,0.023018962,4155,7922
ZCTA5 02108,1905,2190,-285,4225,35.7,3477,219,229,0.054201183,4277,-52
ZCTA5 02109,1958,981,977,3627,35.6,3141,313,37,0.010201268,1486,2141
ZCTA5 02110,1282,3390,-2108,2307,54.6,2058,99,51,0.022106632,7616,-5309
ZCTA5 02111,3515,4329,-814,7841,31.2,3191,3785,167,0.021298304,7276,565
ZCTA5 02113,4025,6752,-2727,6726,29.8,5936,250,239,0.03553375,11933,-5207
ZCTA5 02114,7358,9958,-2600,13401,33.8,10485,1137,554,0.041340198,29178,-15777
ZCTA5 02115,9455,10938,-1483,28559,21.9,17227,5217,2272,0.079554606,21318,7241
ZCTA5 02116,11707,12512,-805,22587,33.7,15959,3135,1091,0.048302121,26779,-4192
ZCTA5 02118,13847,9769,4078,27718,36.7,13808,4469,4819,0.173858143,24237,3481
ZCTA5 02119,11953,4509,7444,28307,34.7,5214,554,14378,0.5079309,13217,15090
ZCTA5 02120,4701,9739,-5038,15082,23.7,6586,2378,3257,0.215952791,26801,-11719
ZCTA5 02121,10718,8216,2502,29888,33.3,3605,67,17298,0.578760707,25437,4451
ZCTA5 02122,9004,17275,-8271,23747,36.1,8846,3607,6801,0.286394071,49867,-26120
ZCTA5 02124,19395,11481,7914,56070,35.1,12212,4340,29937,0.533921883,31996,24074
ZCTA5 02125,12986,9510,3476,32614,33.8,11679,3725,10657,0.326761513,27335,5279
ZCTA5 02126,8785,14994,-6209,25572,36,1757,261,19990,0.781714375,32547,-6975
ZCTA5 02127,16799,14965,1834,35266,32.3,27983,2307,1759,0.04987807,41680,-6414
ZCTA5 02128,16925,8083,8842,45501,33.8,24968,2051,1341,0.02947188,17052,28449
ZCTA5 02129,9278,15306,-6028,20411,35.6,15118,2216,1577,0.077262261,36866,-16455
ZCTA5 02130,17609,11282,6327,41112,35.1,26269,2636,5780,0.140591555,30370,10742
ZCTA5 02131,12450,11013,1437,32609,38.5,18330,635,8146,0.249808335,27163,5446
ZCTA5 02132,10941,8916,2025,26437,44.7,20414,2117,1500,0.056738662,20478,5959
ZCTA5 02133,0,18336,-18336,0,-,0,0,0,#DIV/0!,38839,-38839
ZCTA5 02134,8082,10650,-2568,18437,27.4,10966,4443,1263,0.068503553,29219,-10782
ZCTA5 02135,20040,14315,5725,45024,30,29579,7298,2665,0.059190654,35661,9363
ZCTA5 02136,13929,14761,-832,40947,38.3,12382,911,19934,0.486824432,35945,5002
ZCTA5 02138,14377,8504,5873,39370,28.6,26224,6588,2339,0.059410719,17924,21446
ZCTA5 02139,15263,6158,9105,39707,29.9,23164,7056,5497,0.138439066,12703,27004
ZCTA5 02140,9437,1388,8049,20060,34.5,11903,3684,3173,0.158175474,2805,17255
ZCTA5 02141,6826,10994,-4168,13953,31.5,8832,2701,1231,0.088224755,24965,-11012
ZCTA5 02142,2077,10646,-8569,4172,32,2226,1356,351,0.084132311,24399,-20227
ZCTA5 02143,11623,9556,2067,25264,32.5,18637,2823,1101,0.043579797,24153,1111
ZCTA5 02144,11363,22850,-11487,25367,31,20746,2022,1038,0.040919305,59402,-34035
ZCTA5 02145,11349,15271,-3922,27359,33.7,18821,2228,1593,0.058225812,41607,-14248
ZCTA5 02148,25582,11586,13996,65386,34.9,31343,17735,10203,0.156042578,35527,29859
ZCTA5 02149,17091,19522,-2431,48584,35.7,23409,3949,6561,0.135044459,51729,-3145
ZCTA5 02150,13337,7630,5707,40009,33.6,15377,1541,3216,0.080381914,17584,22425
ZCTA5 02151,21663,22743,-1080,60736,39.4,40617,3142,2453,0.040387908,58567,2169
ZCTA5 02152,8242,562,7680,19088,45.9,16057,293,790,0.041387259,1842,17246
ZCTA5 02155,24771,24519,252,62996,34.7,44590,6878,5260,0.083497365,54043,8953
ZCTA5 02163,403,7787,-7384,2198,25.2,1266,466,219,0.099636033,19962,-17764
ZCTA5 02169,27629,7627,20002,60459,37.7,36546,15254,4654,0.076977787,18073,42386
ZCTA5 02170,8001,11221,-3220,20130,38.4,10997,7591,835,0.041480378,27043,-6913
ZCTA5 02171,8869,8951,-82,19923,40.7,10995,7255,682,0.034231792,21414,-1491
ZCTA5 02176,11926,13220,-1294,29401,42.1,24154,2448,1001,0.034046461,35731,-6330
ZCTA5 02180,9758,9038,720,23077,42.8,19978,1333,538,0.023313256,26954,-3877
ZCTA5 02184,14384,6166,8218,38712,40.5,28022,7624,1262,0.032599711,14206,24506
ZCTA5 02186,8797,6116,2681,28414,39.3,20361,1441,4750,0.167171113,14807,13607
ZCTA5 02188,7085,6591,494,16169,45.5,13204,758,1241,0.076751809,16176,-7
ZCTA5 02189,6194,3642,2552,15265,42.2,12405,649,1194,0.078218146,8744,6521
ZCTA5 02190,7677,823,6854,17927,43.6,14985,2031,107,0.005968651,1290,16637
ZCTA5 02191,3444,0,3444,7856,51,7058,607,104,0.013238289,0,7856
ZCTA5 02199,833,1088,-255,1232,37,766,375,0,0,1905,-673
ZCTA5 02203,0,7995,-7995,0,-,0,0,0,#DIV/0!,23719,-23719
ZCTA5 02205,0,21765,-21765,0,-,0,0,0,#DIV/0!,60265,-60265
ZCTA5 02210,3016,11423,-8407,4830,38.7,4082,464,148,0.030641822,33651,-28821
ZCTA5 02215,7931,1638,6293,25856,21.8,16548,5154,1620,0.062654703,4349,21507
ZCTA5 02301,22928,7961,14967,68571,34.7,21514,1484,29618,0.431931866,26687,41884
ZCTA5 02302,12164,4276,7888,35645,37.7,13614,514,13083,0.36703605,11497,24148
ZCTA5 02322,1653,5349,-3696,4740,36.9,3555,1,873,0.184177215,15040,-10300
ZCTA5 02324,8657,4705,3952,25245,40.2,22042,797,1180,0.046741929,13794,11451
ZCTA5 02325,30,2836,-2806,3082,19.8,2354,18,465,0.150876055,7524,-4442
ZCTA5 02330,4648,4683,-35,11641,45.8,10784,170,33,0.002834808,13902,-2261
ZCTA5 02332,6092,3341,2751,16004,47.6,15483,200,63,0.003936516,10209,5795
ZCTA5 02333,4952,4253,699,14403,40,12985,202,438,0.030410331,10595,3808
ZCTA5 02338,2930,8205,-5275,7737,40.9,7286,13,63,0.008142691,23037,-15300
ZCTA5 02339,4744,3658,1086,14742,40.9,14186,74,65,0.004409171,10674,4068
ZCTA5 02341,3850,5893,-2043,10419,42.7,9444,330,29,0.002783377,15930,-5511
ZCTA5 02343,4695,4029,666,11309,44.1,8476,142,1301,0.115041118,12730,-1421
ZCTA5 02346,9727,12,9715,24219,43.4,22468,324,307,0.012675998,1010,23209
ZCTA5 02347,4162,6235,-2073,11514,42.6,10809,136,207,0.017978114,17831,-6317
ZCTA5 02350,70,21600,-21530,182,47.7,166,0,0,0,56425,-56243
ZCTA5 02351,6083,4581,1502,16974,39.9,14488,557,268,0.015788854,12609,4365
ZCTA5 02356,4511,0,4511,11943,44.2,10249,298,654,0.054760111,149,11794
ZCTA5 02357,0,994,-994,1582,19.6,1363,41,83,0.052465234,2817,-1235
ZCTA5 02359,6861,11909,-5048,18329,44.3,17580,111,37,0.002018659,32577,-14248
ZCTA5 02360,24985,6756,18229,60793,47.9,56217,577,847,0.013932525,17518,43275
ZCTA5 02364,5321,3448,1873,13618,44.7,13016,168,67,0.004919959,9480,4138
ZCTA5 02366,0,2403,-2403,194,46,125,0,20,0.103092784,6907,-6713
ZCTA5 02367,989,5269,-4280,2934,45.5,2835,0,78,0.026584867,14493,-11559
ZCTA5 02368,12167,4999,7168,34696,41.3,10638,5031,14698,0.42362232,13927,20769
ZCTA5 02370,6654,6456,198,17774,39.5,16004,152,526,0.029593789,17600,174
ZCTA5 02375,4482,8645,-4163,11437,44,9516,409,539,0.047127743,20853,-9416
ZCTA5 02379,2726,13407,-10681,7622,39.8,7177,44,115,0.015087903,28807,-21185
ZCTA5 02382,5684,7285,-1601,15116,41,13893,204,267,0.017663403,16573,-1457
ZCTA5 02420,5374,4693,681,15451,45.8,9558,4946,174,0.011261407,14434,1017
ZCTA5 02421,6927,11455,-4528,18784,47.1,11266,5948,222,0.011818569,29829,-11045
ZCTA5 02445,9225,10,9215,21485,35.4,15181,3335,494,0.022992786,1343,20142
ZCTA5 02446,14278,4771,9507,31764,34.2,22390,5838,938,0.029530286,11362,20402
ZCTA5 02451,7586,6522,1064,17965,39.9,12635,2387,1021,0.05683273,18210,-245
ZCTA5 02452,5215,3473,1742,16193,29.4,10949,2165,1758,0.10856543,8639,7554
ZCTA5 02453,12115,2533,9582,30441,33.1,20727,3311,1586,0.052100785,6856,23585
ZCTA5 02457,18,594,-576,1848,20.1,1189,370,125,0.067640693,1292,556
ZCTA5 02458,4871,1321,3550,12428,40.7,9113,1603,395,0.03178307,3112,9316
ZCTA5 02459,6268,4300,1968,19081,43.5,14363,3022,560,0.029348567,11822,7259
ZCTA5 02460,3776,3022,754,9638,43.4,7359,873,467,0.048454036,8591,1047
ZCTA5 02461,2532,6351,-3819,6899,43.9,5082,1335,90,0.013045369,22796,-15897
ZCTA5 02462,532,1876,-1344,1381,50.4,1011,238,20,0.014482259,5251,-3870
ZCTA5 02464,1370,14081,-12711,3595,42.2,2171,1086,106,0.029485396,32274,-28679
ZCTA5 02465,4436,11746,-7310,11574,41.7,8416,1679,243,0.020995334,26079,-14505
ZCTA5 02466,2990,7341,-4351,9109,34.8,6746,1742,252,0.027664947,16873,-7764
ZCTA5 02467,6746,9501,-2755,23328,26.5,16490,3743,662,0.028377915,24691,-1363
ZCTA5 02468,1873,4757,-2884,5305,48.1,4292,634,56,0.010556079,16332,-11027
ZCTA5 02472,16067,3771,12296,35229,39,26959,4200,1304,0.037014959,10513,24716
ZCTA5 02474,11649,6930,4719,28028,37.5,21010,4223,730,0.026045383,19950,8078
ZCTA5 02476,7659,3724,3935,18017,44.3,13791,2078,811,0.045013043,11430,6587
ZCTA5 02478,10372,3439,6933,27016,41.5,20291,4919,278,0.010290198,9055,17961
ZCTA5 02481,4743,4863,-120,16997,33.2,13316,2093,573,0.033711831,11592,5405
ZCTA5 02482,3907,444,3463,10520,46.2,8134,1411,151,0.014353612,982,9538
ZCTA5 02492,7160,449,6711,20927,43.4,18116,1599,489,0.023366942,1240,19687
ZCTA5 02493,3731,8265,-4534,11806,45.6,9117,1672,374,0.031678807,19524,-7718
ZCTA5 02494,4100,2371,1729,10881,43.2,8402,1371,236,0.021689183,6256,4625
ZCTA5 02532,5688,1196,4492,12715,54.9,11278,488,136,0.010696028,3162,9553
ZCTA5 02534,379,1408,-1029,1127,52.3,1098,0,11,0.009760426,4086,-2959
ZCTA5 02535,742,4125,-3383,2151,53.2,1787,107,33,0.015341702,8521,-6370
ZCTA5 02536,8373,389,7984,20261,53.7,18019,293,269,0.013276739,1284,18977
ZCTA5 02537,2488,348,2140,7124,43.9,6468,279,288,0.040426727,684,6440
ZCTA5 02538,1748,142,1606,4663,39.3,4077,44,0,0,314,4349
ZCTA5 02539,1401,3807,-2406,5084,50.2,4186,24,335,0.065892998,9847,-4763
ZCTA5 02540,4171,1404,2767,8888,59.4,8026,185,121,0.013613861,2890,5998
ZCTA5 02542,244,1644,-1400,847,25.1,727,0,36,0.042502952,4513,-3666
ZCTA5 02543,485,815,-330,924,68.4,905,0,0,0,1791,-867
ZCTA5 02553,30,1755,-1725,30,-,30,0,0,0,3941,-3911
ZCTA5 02554,3973,204,3769,13585,41.8,10286,228,1818,0.133824071,471,13114
ZCTA5 02556,1018,1286,-268,2457,49.4,2365,32,37,0.015059015,3232,-775
ZCTA5 02557,685,3829,-3144,1762,47,1485,0,236,0.133938706,9746,-7984
ZCTA5 02558,993,135,858,1779,58.5,1282,0,119,0.066891512,347,1432
ZCTA5 02559,1593,1209,384,3307,60,3275,13,12,0.003628666,3967,-660
ZCTA5 02561,280,4653,-4373,1025,35.1,490,27,82,0.08,11255,-10230
ZCTA5 02562,1236,1000,236,3204,41.3,3022,152,0,0,2606,598
ZCTA5 02563,3983,1465,2518,9514,55.1,8853,234,15,0.001576624,3898,5616
ZCTA5 02564,33,0,33,180,37.5,137,1,42,0.233333333,0,180
ZCTA5 02568,3044,6080,-3036,8810,45.5,7380,6,325,0.036889898,13402,-4592
ZCTA5 02571,4824,983,3841,10738,54,8978,95,263,0.024492457,2129,8609
ZCTA5 02575,907,4193,-3286,2432,53.1,2016,51,0,0,9721,-7289
ZCTA5 02576,1767,5028,-3261,3985,53,3410,8,143,0.035884567,11466,-7481
ZCTA5 02584,25,1884,-1859,30,52.8,30,0,0,0,4057,-4027
ZCTA5 02601,6794,1522,5272,17175,39.3,11813,178,1998,0.116331878,3366,13809
ZCTA5 02630,744,44,700,1953,48.7,1857,40,4,0.002048131,82,1871
ZCTA5 02631,4519,1667,2852,10109,56.1,9679,60,17,0.00168167,3562,6547
ZCTA5 02632,4744,1363,3381,12038,48.8,10467,100,253,0.02101678,3240,8798
ZCTA5 02633,2269,240,2029,4649,64.5,4394,135,64,0.013766401,501,4148
ZCTA5 02635,1376,2305,-929,2902,57.3,2648,26,183,0.063059959,4963,-2061
ZCTA5 02637,129,17,112,292,69.2,292,0,0,0,17,275
ZCTA5 02638,1447,1286,161,3180,60.3,2919,34,36,0.011320755,4389,-1209
ZCTA5 02639,1712,4087,-2375,3439,50.6,2573,11,269,0.078220413,9417,-5978
ZCTA5 02641,91,919,-828,178,75.2,178,0,0,0,1878,-1700
ZCTA5 02642,2525,54,2471,5674,59,5105,164,161,0.028375044,123,5551
ZCTA5 02643,0,3014,-3014,0,-,0,0,0,#DIV/0!,7206,-7206
ZCTA5 02644,1447,5737,-4290,3713,51.4,3621,19,0,0,13950,-10237
ZCTA5 02645,4474,534,3940,10845,56,10252,16,188,0.017335178,1183,9662
ZCTA5 02646,896,10,886,1801,64.6,1717,5,22,0.012215436,20,1781
ZCTA5 02647,67,512,-445,166,46.6,166,0,0,0,1125,-959
ZCTA5 02648,3064,2813,251,7283,51.8,6968,31,199,0.027323905,5950,1333
ZCTA5 02649,6603,1699,4904,14996,51.9,12793,370,442,0.029474527,3846,11150
ZCTA5 02650,340,1687,-1347,764,66.6,759,0,5,0.006544503,2974,-2210
ZCTA5 02652,618,374,244,990,60.4,990,0,0,0,741,249
ZCTA5 02653,2989,2699,290,6276,64.7,6142,61,13,0.002071383,5881,395
ZCTA5 02655,1527,64,1463,3341,56.9,2934,38,63,0.01885663,96,3245
ZCTA5 02657,1968,4634,-2666,3582,56.2,3113,91,17,0.004745952,9562,-5980
ZCTA5 02659,555,259,296,1141,52.8,1115,0,26,0.022787029,528,613
ZCTA5 02660,2896,1671,1225,6480,57.8,6150,60,98,0.015123457,3002,3478
ZCTA5 02663,178,1307,-1129,398,60.2,398,0,0,0,3178,-2780
ZCTA5 02664,3989,87,3902,9010,58.7,7907,467,111,0.012319645,183,8827
ZCTA5 02666,295,598,-303,585,56.1,584,0,0,0,1087,-502
ZCTA5 02667,1558,542,1016,3907,54.1,3316,41,30,0.007678526,1011,2896
ZCTA5 02668,1004,49,955,2604,40.9,2492,0,61,0.023425499,91,2513
ZCTA5 02670,829,4045,-3216,1373,61.9,1332,0,12,0.008739985,8384,-7011
ZCTA5 02671,463,2996,-2533,870,66.5,823,17,14,0.016091954,6155,-5285
ZCTA5 02672,88,1459,-1371,153,83.2,153,0,0,0,4268,-4115
ZCTA5 02673,3839,16354,-12515,9351,46.1,6969,102,1355,0.144904288,43603,-34252
ZCTA5 02675,3087,44,3043,7178,57.8,6991,83,6,0.000835887,139,7039
ZCTA5 02702,1673,1026,647,4383,42.6,4309,11,1,0.000228154,3057,1326
ZCTA5 02703,17898,1586,16312,46126,39.7,39608,1238,1687,0.036573733,4599,41527
ZCTA5 02713,18,2452,-2434,34,61.7,34,0,0,0,6854,-6820
ZCTA5 02715,1383,6577,-5194,3531,44.9,3273,0,4,0.001132824,15893,-12362
ZCTA5 02717,1696,12852,-11156,4782,43.6,4603,86,77,0.016102049,30782,-26000
ZCTA5 02718,2444,10873,-8429,6867,43.3,5660,120,437,0.063637687,25566,-18699
ZCTA5 02719,6872,6276,596,15911,47.8,15000,190,96,0.006033562,14799,1112
ZCTA5 02720,13787,7526,6261,31210,40.5,24856,632,1863,0.059692406,17147,14063
ZCTA5 02721,11010,993,10017,26981,37.9,19522,1135,2044,0.075757014,2577,24404
ZCTA5 02723,7511,6055,1456,16577,36.1,11587,345,1227,0.074018218,15654,923
ZCTA5 02724,8389,1900,6489,18127,42,13837,419,1196,0.065978926,4913,13214
ZCTA5 02725,934,2375,-1441,2490,48.1,2346,0,40,0.016064257,6070,-3580
ZCTA5 02726,6314,17848,-11534,15781,45.7,15104,136,8,0.000506939,43863,-28082
ZCTA5 02738,1993,3800,-1807,5378,49,4553,78,71,0.013201934,10310,-4932
ZCTA5 02739,2926,4771,-1845,6478,56.6,6013,27,0,0,11551,-5073
ZCTA5 02740,19301,10393,8908,45990,37.1,25829,1015,3770,0.081974342,25005,20985
ZCTA5 02743,4060,6066,-2006,10443,46.4,9929,48,28,0.002681222,14345,-3902
ZCTA5 02744,5157,6723,-1566,12614,32.3,7332,105,756,0.059933407,21538,-8924
ZCTA5 02745,10154,5277,4877,24884,41.8,19414,236,592,0.023790387,12893,11991
ZCTA5 02746,6697,9797,-3100,16675,30.3,8051,59,1004,0.060209895,26997,-10322
ZCTA5 02747,7237,3276,3961,22872,37,20227,493,902,0.039436866,8278,14594
ZCTA5 02748,4779,510,4269,11496,49.5,10263,271,85,0.007393876,1676,9820
ZCTA5 02760,11550,1370,10180,28837,41.5,24926,1882,372,0.012900094,4006,24831
ZCTA5 02762,4144,6165,-2021,9760,44.3,8656,233,256,0.026229508,19123,-9363
ZCTA5 02763,723,4808,-4085,1720,36.5,1666,20,0,0,13461,-11741
ZCTA5 02764,1560,4008,-2448,4472,38.6,4167,0,27,0.006037567,11570,-7098
ZCTA5 02766,6489,1747,4742,19270,40.4,17482,333,646,0.033523612,5199,14071
ZCTA5 02767,5550,4710,840,15255,40.5,12937,354,948,0.062143559,13785,1470
ZCTA5 02769,4377,6170,-1793,12434,46.4,12052,84,11,0.000884671,15903,-3469
ZCTA5 02770,2032,1983,49,5702,42.6,5611,0,12,0.002104525,6411,-709
ZCTA5 02771,5969,19199,-13230,15339,46,14463,184,168,0.010952474,48972,-33633
ZCTA5 02777,6752,6145,607,17020,45.2,15930,255,116,0.006815511,16074,946
ZCTA5 02779,2294,24,2270,6724,42.4,6481,0,20,0.00297442,46,6678
ZCTA5 02780,20625,354,20271,51911,39.6,40678,942,3634,0.070004431,582,51329
ZCTA5 02790,6667,1077,5590,16237,50.7,15827,29,8,0.000492702,2657,13580
ZCTA5 02791,244,5894,-5650,361,68.2,361,0,0,0,16352,-15991
ZCTA5 02802,238,394,-156,501,44.8,411,0,0,0,863,-362
ZCTA5 02804,898,952,-54,2456,49,2398,0,0,0,2491,-35
ZCTA5 02806,6176,8921,-2745,17201,43.5,15604,762,53,0.003081216,22792,-5591
ZCTA5 02807,459,646,-187,1007,47,953,5,7,0.006951341,1901,-894
ZCTA5 02808,901,3049,-2148,2432,40,2432,0,0,0,7823,-5391
ZCTA5 02809,8065,2756,5309,22305,43.5,20833,446,306,0.013718897,7584,14721
ZCTA5 02812,438,79,359,1043,52.8,1043,0,0,0,256,787
ZCTA5 02813,3459,12648,-9189,8012,50.5,7759,0,2,0.000249626,32646,-24634
ZCTA5 02814,2902,2275,627,7638,46,7443,20,0,0,6081,1557
ZCTA5 02815,72,7260,-7188,155,53.6,126,0,0,0,18189,-18034
ZCTA5 02816,13371,2204,11167,32348,44.6,30456,361,54,0.001669346,6379,25969
ZCTA5 02817,2316,1795,521,6500,43.7,5807,136,152,0.023384615,5381,1119
ZCTA5 02818,8307,210,8097,19814,45.8,17556,1345,167,0.008428384,450,19364
ZCTA5 02822,2018,798,1220,6155,39.5,5757,55,44,0.00714866,2149,4006
ZCTA5 02823,13,2902,-2889,25,-,25,0,0,0,7590,-7565
ZCTA5 02824,85,2630,-2545,140,69,140,0,0,0,6788,-6648
ZCTA5 02825,1843,1238,605,5771,43.2,5064,17,19,0.003292324,3340,2431
ZCTA5 02826,282,2079,-1797,589,58.4,546,0,0,0,5222,-4633
ZCTA5 02827,844,279,565,2357,45.5,2198,26,13,0.005515486,495,1862
ZCTA5 02828,3183,2319,864,7331,51.6,6878,158,10,0.00136407,5420,1911
ZCTA5 02829,35,49,-14,152,27.1,152,0,0,0,119,33
ZCTA5 02830,2409,1479,930,6377,43.6,6018,198,2,0.000313627,3491,2886
ZCTA5 02831,1473,1521,-48,4201,38.3,4133,33,0,0,3780,421
ZCTA5 02832,1816,692,1124,4901,39.7,4486,91,59,0.01203836,1744,3157
ZCTA5 02833,352,10946,-10594,782,46.7,748,0,0,0,23438,-22656
ZCTA5 02835,2361,0,2361,5531,56.7,5281,14,3,0.000542397,967,4564
ZCTA5 02836,53,6467,-6414,95,55.6,95,0,0,0,16122,-16027
ZCTA5 02837,1592,9087,-7495,3600,58.1,3554,19,27,0.0075,22587,-18987
ZCTA5 02838,1310,3264,-1954,3645,31.1,2827,115,87,0.023868313,8479,-4834
ZCTA5 02839,589,216,373,1313,41.9,1257,23,0,0,554,759
ZCTA5 02840,10171,2322,7849,23460,37.7,18836,445,1767,0.075319693,6610,16850
ZCTA5 02841,6,18519,-18513,1862,24.3,1468,129,150,0.080558539,43960,-42098
ZCTA5 02842,7270,10633,-3363,16983,44.8,13528,369,1294,0.076193841,27434,-10451
ZCTA5 02852,9563,6615,2948,22979,45.9,20775,724,141,0.006136037,19374,3605
ZCTA5 02857,3155,12917,-9762,7992,50.1,7806,98,0,0,33340,-25348
ZCTA5 02858,214,6646,-6432,622,34.8,448,0,0,0,16878,-16256
ZCTA5 02859,2436,6853,-4417,7401,38.6,6961,135,19,0.002567221,17222,-9821
ZCTA5 02860,18949,53,18896,48092,35.3,23004,756,10254,0.213216335,105,47987
ZCTA5 02861,10737,64,10673,27128,38.5,19013,744,3009,0.110918608,172,26956
ZCTA5 02863,7074,2116,4958,22192,31.6,9404,74,1525,0.068718457,6132,16060
ZCTA5 02864,13620,180,13440,36053,44.9,31588,1116,847,0.023493191,375,35678
ZCTA5 02865,6756,180,6576,18269,44.5,15999,1143,214,0.011713832,281,17988
ZCTA5 02871,7196,6612,584,17674,48.4,16318,126,258,0.014597714,15738,1936
ZCTA5 02872,82,8513,-8431,128,58.5,128,0,0,0,20620,-20492
ZCTA5 02873,58,1225,-1167,72,67.2,72,0,0,0,7651,-7579
ZCTA5 02874,2395,6128,-3733,6615,43.5,6225,94,65,0.009826153,14013,-7398
ZCTA5 02875,138,4502,-4364,305,35.2,305,0,0,0,10652,-10347
ZCTA5 02876,520,12900,-12380,782,59.5,782,0,0,0,29080,-28298
ZCTA5 02878,6651,8557,-1906,16287,48.1,15826,88,138,0.008473015,19805,-3518
ZCTA5 02879,9148,11294,-2146,22325,47.4,20150,315,446,0.019977604,28409,-6084
ZCTA5 02881,793,9034,-8241,6844,19.6,5542,574,342,0.049970777,21078,-14234
ZCTA5 02882,5492,1617,3875,13574,45.9,12783,154,96,0.007072344,4200,9374
ZCTA5 02885,5032,12934,-7902,11166,47.6,10411,12,230,0.020598245,29487,-18321
ZCTA5 02886,12976,196,12780,29991,41.6,26386,1520,665,0.022173319,552,29439
ZCTA5 02888,8365,16518,-8153,18398,46,16063,230,960,0.052179585,41244,-22846
ZCTA5 02889,11354,4489,6865,28433,45.5,25397,540,591,0.020785707,11651,16782
ZCTA5 02891,9936,459,9477,21998,50.4,19979,566,208,0.009455405,1362,20636
ZCTA5 02892,2091,4434,-2343,6144,43,5811,35,4,0.000651042,10096,-3952
ZCTA5 02893,14030,12807,1223,30823,41.1,26253,996,776,0.025176005,28662,2161
ZCTA5 02894,255,8585,-8330,555,51,555,0,0,0,25936,-25381
ZCTA5 02895,16921,11248,5673,43177,35.6,28439,2594,3156,0.073094472,28039,15138
ZCTA5 02896,4455,8719,-4264,11499,45.7,11094,110,78,0.006783199,28015,-16516
ZCTA5 02898,575,12563,-11988,1441,45.6,1283,0,6,0.004163775,37533,-36092
ZCTA5 02903,5047,14305,-9258,12450,32.6,8333,1452,1191,0.095662651,43446,-30996
ZCTA5 02904,12951,8189,4762,31494,39.8,20043,1150,4200,0.133358735,20715,10779
ZCTA5 02905,9862,6651,3211,26569,33.8,13574,1193,4955,0.18649554,15939,10630
ZCTA5 02906,12185,9,12176,26299,34.7,20249,2632,937,0.035628731,1898,24401
ZCTA5 02907,10591,9061,1530,31705,32.8,9431,2106,4674,0.147421542,22291,9414
ZCTA5 02908,14380,7500,6880,38977,34.8,20874,1591,7426,0.190522616,16210,22767
ZCTA5 02909,14857,3612,11245,42021,30.8,19241,1387,7670,0.182527784,8644,33377
ZCTA5 02910,8624,4253,4371,22469,37.9,16607,1529,1044,0.046464017,13882,8587
ZCTA5 02911,6637,11581,-4944,16151,38.1,12433,544,1361,0.084267228,28887,-12736
ZCTA5 02912,13,14424,-14411,4247,19.7,2662,809,380,0.089474923,38276,-34029
ZCTA5 02914,9311,4142,5169,21966,41.3,16401,859,1763,0.080260402,11865,10101
ZCTA5 02915,7168,4031,3137,15912,45.2,13739,260,526,0.033056812,11201,4711
ZCTA5 02916,3791,1749,2042,9293,41.9,8563,82,265,0.028516087,4993,4300
ZCTA5 02917,4672,1643,3029,14595,37.7,13071,555,257,0.01760877,4979,9616
ZCTA5 02918,36,1472,-1436,2934,19.9,2402,135,171,0.058282209,3970,-1036
ZCTA5 02919,11405,1618,9787,29473,44.8,25181,327,1406,0.047704679,4759,24714
ZCTA5 02920,14326,1533,12793,37389,40.6,27516,2443,2421,0.064751665,4229,33160
ZCTA5 02921,4659,13046,-8387,12384,42.2,10269,1136,507,0.040939922,33495,-21111
ZCTA5 03031,4476,2512,1964,11744,46.9,11154,185,0,0,6352,5392
ZCTA5 03032,1989,601,1388,5852,45.7,5494,0,72,0.012303486,1603,4249
ZCTA5 03033,1728,1524,204,5591,38.8,5414,22,33,0.005902343,4260,1331
ZCTA5 03034,1603,5021,-3418,4166,48.3,4055,0,39,0.009361498,13614,-9448
ZCTA5 03036,1719,1043,676,5198,46.4,5107,59,9,0.001731435,2756,2442
ZCTA5 03037,1646,553,1093,4664,42.4,4474,24,33,0.007075472,1488,3176
ZCTA5 03038,13056,1391,11665,34371,39.2,31895,542,357,0.010386663,3696,30675
ZCTA5 03042,2681,2746,-65,7077,45.8,6750,55,25,0.00353257,7679,-602
ZCTA5 03043,571,8736,-8165,1542,48.7,1494,0,15,0.009727626,24484,-22942
ZCTA5 03044,1638,2667,-1029,4680,42.5,4432,68,14,0.002991453,8263,-3583
ZCTA5 03045,5172,8296,-3124,13824,43.8,12950,103,24,0.001736111,23967,-10143
ZCTA5 03046,1024,9763,-8739,3006,43.6,2930,29,16,0.005322688,25540,-22534
ZCTA5 03047,677,6015,-5338,1789,49.4,1750,8,6,0.003353829,15079,-13290
ZCTA5 03048,1418,828,590,3468,45.6,3109,25,112,0.032295271,2421,1047
ZCTA5 03049,3223,12101,-8878,8324,48.5,7288,217,128,0.015377222,28847,-20523
ZCTA5 03051,9542,10664,-1122,25314,45.2,23781,617,310,0.012246188,27476,-2162
ZCTA5 03052,2967,6647,-3680,8467,40.7,8319,27,0,0,15814,-7347
ZCTA5 03053,9269,5797,3472,25534,41.9,23854,466,347,0.013589724,14686,10848
ZCTA5 03054,9971,1840,8131,26730,42,23833,1167,366,0.01369248,5287,21443
ZCTA5 03055,6419,1814,4605,16041,40.1,14279,491,50,0.003117013,5100,10941
ZCTA5 03057,893,4288,-3395,2584,44.6,2502,0,15,0.005804954,12850,-10266
ZCTA5 03060,12194,3899,8295,31039,34.4,23749,1312,1816,0.05850704,10207,20832
ZCTA5 03062,11733,11219,514,28562,43.5,22449,4160,606,0.021217002,28824,-262
ZCTA5 03063,6823,577,6246,16289,40.2,12886,1222,558,0.034256247,1411,14878
ZCTA5 03064,6369,610,5759,14769,41.7,12752,524,262,0.017739861,1571,13198
ZCTA5 03070,2045,1477,568,6051,41,5935,13,0,0,3791,2260
ZCTA5 03071,1844,4717,-2873,5217,38.5,4855,105,0,0,13603,-8386
ZCTA5 03076,4884,1634,3250,14099,43.5,12941,309,191,0.01354706,3055,11044
ZCTA5 03077,4093,13001,-8908,10670,40.8,10071,31,266,0.024929709,31575,-20905
ZCTA5 03079,12138,13870,-1732,30158,44.4,26807,1226,298,0.009881292,36780,-6622
ZCTA5 03082,620,13309,-12689,1628,49.1,1452,0,16,0.00982801,32844,-31216
ZCTA5 03084,490,4900,-4410,1257,47,1226,0,1,0.000795545,13382,-12125
ZCTA5 03086,1739,3786,-2047,4096,46.8,3771,54,0,0,9673,-5577
ZCTA5 03087,5283,7040,-1757,15587,42.2,13851,814,91,0.005838198,21180,-5593
ZCTA5 03101,1895,161,1734,3114,36.6,2295,311,427,0.137122672,318,2796
ZCTA5 03102,14100,822,13278,33924,35.1,27347,1200,2566,0.075639665,2133,31791
ZCTA5 03103,15018,731,14287,37602,35.9,28450,2585,2173,0.057789479,1653,35949
ZCTA5 03104,14725,269,14456,34557,37.8,29493,1047,1561,0.045171745,805,33752
ZCTA5 03106,5185,2774,2411,14732,37.8,13163,507,285,0.019345642,7360,7372
ZCTA5 03109,3833,779,3054,10023,40.6,8649,494,208,0.02075227,1853,8170
ZCTA5 03110,8076,2363,5713,23157,44.8,20736,1404,181,0.007816211,5692,17465
ZCTA5 03215,99,1359,-1260,198,59.9,190,0,0,0,3389,-3191
ZCTA5 03216,818,932,-114,2420,36.2,2351,7,42,0.017355372,2419,1
ZCTA5 03217,992,1425,-433,2365,30.7,2065,0,0,0,3781,-1416
ZCTA5 03218,569,443,126,1411,42.4,1386,0,0,0,1034,377
ZCTA5 03220,3039,431,2608,7424,47.7,7144,100,0,0,867,6557
ZCTA5 03221,878,2169,-1291,2142,45.7,2080,34,2,0.000933707,5608,-3466
ZCTA5 03222,2286,538,1748,5992,48.5,5658,102,3,0.000500668,1290,4702
ZCTA5 03223,1174,168,1006,3382,44.3,3366,0,5,0.001478415,370,3012
ZCTA5 03224,900,49,851,2233,47.8,2034,16,15,0.006717421,170,2063
ZCTA5 03225,1299,1717,-418,3491,44.5,3219,80,0,0,4572,-1081
ZCTA5 03226,384,3409,-3025,825,63.5,817,0,0,0,8615,-7790
ZCTA5 03227,692,989,-297,1364,61.5,1347,0,0,0,2499,-1135
ZCTA5 03229,2227,25,2202,5941,47,5709,0,20,0.003366437,68,5873
ZCTA5 03230,616,576,40,1366,51.6,1344,5,5,0.003660322,1383,-17
ZCTA5 03231,77,339,-262,138,64.5,138,0,0,0,797,-659
ZCTA5 03233,100,1734,-1634,235,65.6,235,0,0,0,4839,-4604
ZCTA5 03234,1746,432,1314,4843,44,4645,57,0,0,1210,3633
ZCTA5 03235,3813,3038,775,8859,45.7,8557,105,14,0.001580314,8052,807
ZCTA5 03237,773,746,27,2100,43.4,2034,5,37,0.017619048,1671,429
ZCTA5 03238,43,7148,-7105,84,57.6,83,0,0,0,16067,-15983
ZCTA5 03240,461,2996,-2535,1125,50.5,1068,4,0,0,7140,-6015
ZCTA5 03241,377,559,-182,1010,53.2,981,1,5,0.004950495,1278,-268
ZCTA5 03242,2098,2954,-856,5671,33,5466,29,89,0.015693881,6265,-594
ZCTA5 03243,355,1793,-1438,881,52.5,865,0,0,0,4078,-3197
ZCTA5 03244,2967,837,2130,7632,45.6,7113,9,44,0.005765199,2110,5522
ZCTA5 03245,815,865,-50,2092,47.7,1940,48,11,0.005258126,2229,-137
ZCTA5 03246,6826,1640,5186,16847,43.3,15994,122,149,0.008844305,4411,12436
ZCTA5 03249,3086,973,2113,7642,47,7026,309,0,0,2532,5110
ZCTA5 03251,563,149,414,1401,46.2,1115,268,0,0,323,1078
ZCTA5 03253,3109,307,2802,6630,53.1,6303,124,20,0.003016591,762,5868
ZCTA5 03254,2007,1766,241,4876,55.2,4718,9,1,0.000205086,4244,632
ZCTA5 03255,746,477,269,1902,48.6,1886,11,0,0,1180,722
ZCTA5 03256,941,1572,-631,2572,46.8,2431,0,67,0.026049767,4104,-1532
ZCTA5 03257,1537,2404,-867,4261,46.9,4007,24,49,0.011499648,7543,-3282
ZCTA5 03258,984,950,34,2677,45.4,2494,59,4,0.00149421,2366,311
ZCTA5 03259,151,437,-286,250,66.3,250,0,0,0,1155,-905
ZCTA5 03260,377,1190,-813,1027,52.1,951,18,0,0,2958,-1931
ZCTA5 03261,1746,125,1621,4601,44.2,4284,47,87,0.018908933,302,4299
ZCTA5 03262,475,4587,-4112,1177,43.6,1005,43,0,0,11504,-10327
ZCTA5 03263,1823,3181,-1358,4129,48.7,4098,11,0,0,8414,-4285
ZCTA5 03264,2179,1120,1059,6916,32.8,6218,173,200,0.02891845,3029,3887
ZCTA5 03266,799,291,508,1963,51.4,1763,39,10,0.005094244,701,1262
ZCTA5 03268,599,465,134,1467,51.5,1431,0,0,0,1071,396
ZCTA5 03269,1080,2992,-1912,2935,46.9,2786,28,43,0.014650767,8779,-5844
ZCTA5 03273,115,346,-231,287,45.6,191,0,0,0,916,-629
ZCTA5 03275,4458,411,4047,12002,38.8,11053,83,325,0.02707882,1115,10887
ZCTA5 03276,3501,944,2557,8758,43.2,8343,64,49,0.005594885,2282,6476
ZCTA5 03278,1203,540,663,3004,43.9,2817,26,33,0.010985353,1318,1686
ZCTA5 03279,307,1757,-1450,783,54.8,751,0,0,0,4689,-3906
ZCTA5 03280,479,7,472,1157,55.3,1118,0,0,0,29,1128
ZCTA5 03281,3371,43,3328,9072,45,8919,12,0,0,77,8995
ZCTA5 03282,412,13626,-13214,1099,44.3,1065,18,6,0.005459509,32814,-31715
ZCTA5 03284,252,6385,-6133,863,51.5,858,0,0,0,15671,-14808
ZCTA5 03285,1060,2735,-1675,2704,45.3,2649,16,11,0.004068047,7571,-4867
ZCTA5 03287,655,1898,-1243,1512,50.2,1426,57,0,0,5307,-3795
ZCTA5 03290,1959,9839,-7880,5090,44.7,4836,56,16,0.003143418,25388,-20298
ZCTA5 03291,29,1048,-1019,111,6,111,0,0,0,2623,-2512
ZCTA5 03293,54,210,-156,215,27.4,215,0,0,0,566,-351
ZCTA5 03301,13351,557,12794,33289,42.1,28947,1452,1112,0.033404428,1384,31905
ZCTA5 03303,6466,345,6121,16240,41,15108,291,392,0.024137931,917,15323
ZCTA5 03304,2802,620,2182,8227,41.1,7925,61,0,0,1709,6518
ZCTA5 03307,2336,260,2076,5634,55.1,5472,27,0,0,700,4934
ZCTA5 03431,9964,2460,7504,25062,37.6,23429,130,357,0.014244673,6248,18814
ZCTA5 03440,1103,1116,-13,2943,40.6,2865,0,0,0,2567,376
ZCTA5 03441,86,247,-161,261,55.1,261,0,0,0,542,-281
ZCTA5 03442,647,726,-79,1508,34.3,1427,2,8,0.00530504,1722,-214
ZCTA5 03443,180,428,-248,276,66.4,276,0,0,0,923,-647
ZCTA5 03444,621,1837,-1216,1542,53.8,1487,3,6,0.003891051,4046,-2504
ZCTA5 03445,273,2209,-1936,655,45.5,615,21,0,0,5462,-4807
ZCTA5 03446,2823,837,1986,6415,53,5974,134,0,0,1997,4418
ZCTA5 03447,1010,338,672,2341,49.5,2256,14,0,0,890,1451
ZCTA5 03448,302,354,-52,826,47.1,810,0,0,0,776,50
ZCTA5 03449,802,2953,-2151,1737,55.6,1670,5,4,0.002302821,6641,-4904
ZCTA5 03450,427,1785,-1358,1017,56.2,956,12,16,0.015732547,6001,-4984
ZCTA5 03451,1550,776,774,3970,50.3,3827,0,0,0,1787,2183
ZCTA5 03452,2048,426,1622,5345,42.3,5013,45,41,0.00767072,998,4347
ZCTA5 03455,988,842,146,2528,42.3,2417,28,0,0,2121,407
ZCTA5 03456,315,355,-40,791,49.2,769,7,0,0,946,-155
ZCTA5 03457,299,667,-368,784,51.2,746,0,0,0,2150,-1366
ZCTA5 03458,3011,1954,1057,6869,51.7,6700,30,12,0.001746979,4758,2111
ZCTA5 03461,1859,2616,-757,6383,34.6,5748,67,54,0.008459972,5958,425
ZCTA5 03462,625,4478,-3853,1468,43,1381,0,13,0.008855586,10009,-8541
ZCTA5 03464,346,1110,-764,863,51,839,4,0,0,2515,-1652
ZCTA5 03465,737,26,711,1768,39.6,1682,0,0,0,87,1681
ZCTA5 03466,599,1557,-958,1818,45.4,1736,82,0,0,3206,-1388
ZCTA5 03467,822,249,573,1944,54.9,1905,4,0,0,447,1497
ZCTA5 03470,1888,606,1282,5066,40,4976,13,20,0.003947888,1494,3572
ZCTA5 03561,2873,1453,1420,6015,49.8,5885,40,0,0,3211,2804
ZCTA5 03570,3759,1140,2619,9710,43.9,8832,13,658,0.067765191,2715,6995
ZCTA5 03574,1013,367,646,2534,53.3,2458,18,11,0.004340963,812,1722
ZCTA5 03575,3,1500,-1497,5,-,5,0,0,0,3618,-3613
ZCTA5 03576,1397,1100,297,2752,55.8,2656,1,6,0.002180233,2671,81
ZCTA5 03579,182,285,-103,353,63.3,353,0,0,0,596,-243
ZCTA5 03580,527,763,-236,1308,58.4,1275,6,2,0.001529052,1766,-458
ZCTA5 03581,1583,488,1095,3139,54.3,3093,1,4,0.001274291,1067,2072
ZCTA5 03582,913,662,251,2143,48.6,2088,5,2,0.000933271,1334,809
ZCTA5 03583,473,197,276,905,59.3,892,3,0,0,419,486
ZCTA5 03584,1395,286,1109,3417,38.9,3265,1,2,0.000585309,726,2691
ZCTA5 03585,1014,184,830,2599,48.4,2500,7,9,0.00346287,458,2141
ZCTA5 03586,252,1390,-1138,652,60.1,607,5,0,0,3065,-2413
ZCTA5 03588,655,175,480,1538,50.6,1499,0,0,0,497,1041
ZCTA5 03590,418,1011,-593,1118,49,1108,0,1,0.000894454,2604,-1486
ZCTA5 03592,544,2425,-1881,1064,58.4,1045,0,0,0,5364,-4300
ZCTA5 03593,173,109,64,386,56,378,1,0,0,249,137
ZCTA5 03595,386,427,-41,706,57.5,697,0,0,0,1212,-506
ZCTA5 03597,233,124,109,628,44.6,594,0,7,0.011146497,250,378
ZCTA5 03598,1494,908,586,3522,48.4,3462,3,7,0.001987507,2167,1355
ZCTA5 03601,125,498,-373,502,38.3,473,0,0,0,1315,-813
ZCTA5 03602,983,314,669,2352,48.3,2202,12,6,0.00255102,761,1591
ZCTA5 03603,2036,1689,347,5194,50.3,4896,76,4,0.000770119,4231,963
ZCTA5 03604,0,5949,-5949,0,-,0,0,0,#DIV/0!,14036,-14036
ZCTA5 03605,283,589,-306,792,44.4,774,0,0,0,1511,-719
ZCTA5 03607,99,68,31,323,57.2,304,6,0,0,154,169
ZCTA5 03608,1201,2096,-895,3100,40.8,2981,0,91,0.029354839,4657,-1557
ZCTA5 03609,248,313,-65,555,46.5,527,0,0,0,1048,-493
ZCTA5 03740,433,215,218,1063,49.8,1037,0,0,0,485,578
ZCTA5 03741,1567,331,1236,4157,45.6,3829,78,31,0.007457301,767,3390
ZCTA5 03743,5346,1117,4229,13612,44.2,13020,72,214,0.015721422,2928,10684
ZCTA5 03745,735,0,735,1700,55.8,1540,10,0,0,0,1700
ZCTA5 03748,2056,2524,-468,4550,52.6,4461,0,28,0.006153846,10268,-5718
ZCTA5 03750,259,244,15,889,39.2,805,68,0,0,593,296
ZCTA5 03751,203,4175,-3972,444,63.8,444,0,0,0,9379,-8935
ZCTA5 03752,301,740,-439,1010,49,993,0,0,0,1857,-847
ZCTA5 03753,1235,166,1069,3380,50.1,3380,0,0,0,550,2830
ZCTA5 03755,2668,337,2331,10723,22.6,7965,1235,462,0.043084958,882,9841
ZCTA5 03765,158,3239,-3081,505,49.4,499,0,0,0,7729,-7224
ZCTA5 03766,4184,606,3578,10055,38.9,9110,283,198,0.019691696,1726,8329
ZCTA5 03768,609,544,65,1658,47.8,1551,42,8,0.00482509,1451,207
ZCTA5 03770,147,329,-182,606,27.2,535,13,8,0.01320132,827,-221
ZCTA5 03771,323,129,194,837,50.6,832,0,0,0,283,554
ZCTA5 03773,3031,754,2277,7624,44.4,7226,31,43,0.005640084,2020,5604
ZCTA5 03774,691,1300,-609,1774,50.3,1609,0,6,0.003382187,3033,-1259
ZCTA5 03777,538,1759,-1221,1449,45.7,1178,216,47,0.032436163,3859,-2410
ZCTA5 03779,269,1022,-753,714,45.6,670,26,11,0.015406162,2706,-1992
ZCTA5 03780,198,10336,-10138,544,58.1,488,42,7,0.012867647,21799,-21255
ZCTA5 03781,778,1483,-705,2088,46.1,1969,79,0,0,3503,-1415
ZCTA5 03782,983,699,284,3065,48.9,3008,19,5,0.001631321,1737,1328
ZCTA5 03784,1802,2568,-766,4261,36.4,3471,454,138,0.032386764,6756,-2495
ZCTA5 03785,831,330,501,2240,41.6,2163,0,17,0.007589286,649,1591
ZCTA5 03801,10851,1511,9340,22904,43.1,20349,1103,299,0.013054488,3916,18988
ZCTA5 03809,1325,991,334,3818,45.5,3804,0,0,0,2316,1502
ZCTA5 03810,809,515,294,2008,56.5,1931,0,15,0.00747012,1352,656
ZCTA5 03811,2821,451,2370,7086,52.4,6836,123,0,0,802,6284
ZCTA5 03812,448,1579,-1131,652,60.5,646,2,4,0.006134969,3599,-2947
ZCTA5 03813,1573,1537,36,3273,52.4,3159,9,0,0,4410,-1137
ZCTA5 03814,933,12520,-11587,2349,45.4,2177,125,0,0,30041,-27692
ZCTA5 03816,567,648,-81,1509,42.6,1497,0,0,0,1997,-488
ZCTA5 03817,295,3327,-3032,891,35.7,671,12,42,0.047138047,14695,-13804
ZCTA5 03818,1664,2957,-1293,4098,41.2,3866,113,1,0.000244021,8517,-4419
ZCTA5 03819,1649,1045,604,4224,44.2,4077,12,8,0.001893939,2629,1595
ZCTA5 03820,14724,1177,13547,32676,36.2,29445,1446,387,0.011843555,3155,29521
ZCTA5 03823,711,667,44,2166,38.6,1957,65,6,0.002770083,1468,698
ZCTA5 03824,2904,176,2728,15410,20.6,13929,584,93,0.006035042,393,15017
ZCTA5 03825,3333,8159,-4826,9270,38.6,8470,43,121,0.013052859,20993,-11723
ZCTA5 03826,1122,2646,-1524,2904,37.4,2574,15,49,0.016873278,6768,-3864
ZCTA5 03827,1169,554,615,3216,49.8,3115,24,0,0,1197,2019
ZCTA5 03830,634,444,190,1329,56.3,1301,0,0,0,1262,67
ZCTA5 03832,155,662,-507,346,60.8,338,2,0,0,1337,-991
ZCTA5 03833,8953,1554,7399,22334,46.1,20601,711,211,0.009447479,3959,18375
ZCTA5 03835,2785,1409,1376,6771,42.9,6274,95,143,0.02111948,3571,3200
ZCTA5 03836,579,2496,-1917,1305,58.5,1272,6,0,0,6272,-4967
ZCTA5 03837,720,6685,-5965,1829,45.3,1783,0,40,0.021869874,14983,-13154
ZCTA5 03838,579,862,-283,1303,56.9,1282,0,0,0,2287,-984
ZCTA5 03839,1577,431,1146,3818,40.7,3529,81,0,0,869,2949
ZCTA5 03840,1566,405,1161,4006,47.1,3700,76,125,0.031203195,986,3020
ZCTA5 03841,2623,139,2484,6255,47.1,5987,83,34,0.005435651,258,5997
ZCTA5 03842,7139,2321,4818,15979,51.5,15430,110,26,0.001627136,6047,9932
ZCTA5 03844,861,628,233,2305,47.8,2256,0,7,0.003036876,1440,865
ZCTA5 03845,705,124,581,1199,62.3,1199,0,0,0,254,945
ZCTA5 03846,488,1470,-982,988,56.2,971,0,0,0,3987,-2999
ZCTA5 03847,249,190,59,439,67.4,391,48,0,0,579,-140
ZCTA5 03848,2687,402,2285,6177,49,5942,32,1,0.000161891,907,5270
ZCTA5 03849,459,469,-10,1377,48.8,1336,17,3,0.002178649,990,387
ZCTA5 03850,69,955,-886,85,73.8,85,0,0,0,2627,-2542
ZCTA5 03851,1512,561,951,4121,37.9,4015,18,0,0,1671,2450
ZCTA5 03852,140,3713,-3573,382,55.1,382,0,0,0,9002,-8620
ZCTA5 03853,363,1664,-1301,819,66.8,819,0,0,0,4642,-3823
ZCTA5 03854,395,1794,-1399,817,57.4,798,0,0,0,3815,-2998
ZCTA5 03855,1005,1773,-768,2698,45.9,2560,3,0,0,4334,-1636
ZCTA5 03856,637,1801,-1164,2022,45.8,1924,16,3,0.00148368,4323,-2301
ZCTA5 03857,4322,592,3730,9365,40.1,8808,211,108,0.011532301,1747,7618
ZCTA5 03858,1769,2878,-1109,4801,45.3,4562,10,0,0,7630,-2829
ZCTA5 03860,1818,8747,-6929,3817,48.5,3634,15,0,0,20066,-16249
ZCTA5 03861,1865,2491,-626,4524,47.7,3460,564,5,0.001105217,5879,-1355
ZCTA5 03862,1924,1004,920,4507,49.9,4095,142,139,0.030840914,2506,2001
ZCTA5 03864,730,2270,-1540,1998,58.6,1726,6,186,0.093093093,5299,-3301
ZCTA5 03865,3242,11,3231,7812,44.3,6937,0,16,0.002048131,11,7801
ZCTA5 03867,9366,1575,7791,22240,42.7,20756,244,199,0.008947842,3703,18537
ZCTA5 03868,2528,1833,695,6259,45.4,5679,250,127,0.020290781,5634,625
ZCTA5 03869,1025,3915,-2890,2421,42.6,2312,0,30,0.012391574,8909,-6488
ZCTA5 03870,2206,407,1799,5180,55,5074,35,0,0,968,4212
ZCTA5 03871,201,4568,-4367,331,63.9,331,0,0,0,11816,-11485
ZCTA5 03872,1674,495,1179,4109,49.6,4099,9,0,0,1344,2765
ZCTA5 03873,2211,38,2173,6498,38.9,6318,0,38,0.005847953,86,6412
ZCTA5 03874,3837,1378,2459,8627,51.2,8028,46,184,0.021328388,3992,4635
ZCTA5 03875,406,2727,-2321,1137,47.3,1098,4,0,0,7238,-6101
ZCTA5 03878,5185,858,4327,12061,39.9,10468,576,208,0.017245668,1969,10092
ZCTA5 03882,513,824,-311,1721,37.6,1596,7,6,0.003486345,2086,-365
ZCTA5 03883,164,114,50,548,37.7,528,13,0,0,278,270
ZCTA5 03884,1379,2590,-1211,4231,49.3,3810,224,35,0.008272276,6286,-2055
ZCTA5 03885,3046,2598,448,7662,46.5,7198,330,0,0,7291,371
ZCTA5 03886,457,901,-444,1256,40.3,1215,14,0,0,2042,-786
ZCTA5 03887,699,2567,-1868,1947,39.1,1796,11,28,0.014381099,6224,-4277
ZCTA5 03890,19,3828,-3809,79,65.1,79,0,0,0,8114,-8035
ZCTA5 03894,3005,722,2283,6414,57.4,6253,0,0,0,1424,4990
ZCTA5 03897,17,1768,-1751,33,67.6,33,0,0,0,4588,-4555
ZCTA5 03901,3398,587,2811,7891,40.1,7661,28,0,0,1183,6708
ZCTA5 03902,941,2680,-1739,2262,51,2262,0,0,0,7230,-4968
ZCTA5 03903,2680,4327,-1647,6725,50.6,5911,47,108,0.01605948,10369,-3644
ZCTA5 03904,4084,70,4014,8108,49.7,7356,120,230,0.028367045,113,7995
ZCTA5 03905,878,62,816,1898,52.6,1795,0,0,0,101,1797
ZCTA5 03906,1954,1023,931,4950,46.9,4695,16,30,0.006060606,2445,2505
ZCTA5 03907,595,2776,-2181,1207,65.7,1140,8,0,0,7362,-6155
ZCTA5 03908,2772,258,2514,7443,40.1,6896,113,106,0.014241569,674,6769
ZCTA5 03909,4539,9913,-5374,10982,48.8,10701,61,0,0,23516,-12534
ZCTA5 03910,14,22,-8,43,65.2,43,0,0,0,34,9
ZCTA5 03911,77,1156,-1079,294,66.2,294,0,0,0,2754,-2460
ZCTA5 04001,1129,2316,-1187,2599,53.6,2475,0,0,0,5212,-2613
ZCTA5 04002,2979,525,2454,7582,50.6,7484,24,28,0.003692957,1317,6265
ZCTA5 04003,107,8458,-8351,199,69.9,199,0,0,0,20376,-20177
ZCTA5 04005,9987,1632,8355,24462,36.5,22588,592,282,0.011528084,3825,20637
ZCTA5 04006,27,148,-121,54,70.3,54,0,0,0,285,-231
ZCTA5 04008,1196,13,1183,3042,47.6,2943,6,31,0.010190664,69,2973
ZCTA5 04009,2245,590,1655,5118,48.5,4973,0,19,0.003712388,1482,3636
ZCTA5 04010,613,2154,-1541,1658,41.1,1573,16,0,0,5847,-4189
ZCTA5 04011,8716,421,8295,21589,42.8,19809,361,423,0.019593311,1013,20576
ZCTA5 04015,1700,220,1480,3643,48.6,3254,20,10,0.00274499,596,3047
ZCTA5 04017,302,2363,-2061,566,55,495,51,0,0,6024,-5458
ZCTA5 04019,39,758,-719,47,55.6,47,0,0,0,1605,-1558
ZCTA5 04020,704,716,-12,1758,41.4,1434,2,0,0,2053,-295
ZCTA5 04021,2339,3454,-1115,6555,39.5,6162,91,40,0.006102212,7946,-1391
ZCTA5 04022,431,1335,-904,1135,50.4,1096,11,0,0,3838,-2703
ZCTA5 04024,193,5606,-5413,544,51.3,526,0,0,0,16395,-15851
ZCTA5 04027,2277,2769,-492,6437,39.2,6114,38,0,0,7287,-850
ZCTA5 04029,836,1312,-476,1930,39.7,1875,0,3,0.001554404,3064,-1134
ZCTA5 04030,735,592,143,2247,34.6,2129,3,52,0.023141967,1808,439
ZCTA5 04032,3427,1633,1794,8622,47.7,7927,248,8,0.000927859,4299,4323
ZCTA5 04037,1458,4620,-3162,3827,45.3,3577,49,16,0.00418082,10869,-7042
ZCTA5 04038,6092,3096,2996,18114,36.1,16316,266,193,0.010654742,7554,10560
ZCTA5 04039,3434,626,2808,7773,43,7113,89,42,0.005403319,1494,6279
ZCTA5 04040,1390,976,414,2952,53.6,2777,46,0,0,2937,15
ZCTA5 04041,617,1334,-717,1674,38.3,1441,0,0,0,3649,-1975
ZCTA5 04042,1882,153,1729,4707,50.4,4566,11,1,0.00021245,310,4397
ZCTA5 04043,4858,442,4416,11466,54.1,10706,309,2,0.000174429,1054,10412
ZCTA5 04046,3201,1512,1689,7860,50.9,7620,8,0,0,3761,4099
ZCTA5 04047,711,65,646,1686,46.3,1678,0,0,0,167,1519
ZCTA5 04048,1171,0,1171,3169,38.7,2930,14,92,0.02903124,17,3152
ZCTA5 04049,1496,1241,255,3883,48.2,3597,0,22,0.005665722,3707,176
ZCTA5 04050,117,6518,-6401,271,46.8,259,3,0,0,17026,-16755
ZCTA5 04051,530,181,349,1321,52.6,1283,13,0,0,278,1043
ZCTA5 04055,2006,3891,-1885,3911,48.2,3633,0,1,0.000255689,8392,-4481
ZCTA5 04056,39,201,-162,96,61.1,96,0,0,0,393,-297
ZCTA5 04057,116,626,-510,289,67.6,205,7,17,0.058823529,1692,-1403
ZCTA5 04061,976,581,395,3120,34.8,3000,1,25,0.008012821,1439,1681
ZCTA5 04062,7064,2059,5005,18438,40.9,16639,245,232,0.01258271,5025,13413
ZCTA5 04063,389,7643,-7254,621,69.2,596,1,0,0,18561,-17940
ZCTA5 04064,4751,6713,-1962,8333,54.8,7669,67,21,0.002520101,16348,-8015
ZCTA5 04066,357,7524,-7167,640,62,627,7,0,0,18809,-18169
ZCTA5 04068,556,1068,-512,1469,50.1,1296,30,2,0.00136147,2672,-1203
ZCTA5 04069,570,1573,-1003,1565,43.2,1406,0,26,0.016613419,3721,-2156
ZCTA5 04071,2173,1878,295,4990,48.2,4726,27,13,0.00260521,4537,453
ZCTA5 04072,8631,3018,5613,20203,43.1,18364,260,241,0.011928921,8359,11844
ZCTA5 04073,6997,627,6370,17114,39.4,15840,323,368,0.021502863,1523,15591
ZCTA5 04074,8811,3537,5274,21639,47.4,20029,622,54,0.002495494,8819,12820
ZCTA5 04076,1144,667,477,2930,44.1,2827,5,8,0.002730375,1901,1029
ZCTA5 04079,1967,664,1303,4146,58.7,4083,11,14,0.003376749,1964,2182
ZCTA5 04083,2037,4045,-2008,4698,44.6,4535,62,8,0.001702852,9662,-4964
ZCTA5 04084,2656,376,2280,7396,39.5,6842,34,54,0.007301244,989,6407
ZCTA5 04085,992,7498,-6506,2787,41,2700,0,0,0,17501,-14714
ZCTA5 04086,4135,3215,920,9431,47.9,8787,158,102,0.010815396,8052,1379
ZCTA5 04087,924,503,421,2553,48.8,2473,0,0,0,1187,1366
ZCTA5 04088,532,3287,-2755,1259,48.6,1231,5,5,0.003971406,8390,-7131
ZCTA5 04090,4904,1352,3552,11156,50.1,10428,175,294,0.026353532,3578,7578
ZCTA5 04091,320,9147,-8827,769,50.3,699,0,0,0,17844,-17075
ZCTA5 04092,8838,7702,1136,20074,37.7,17677,446,885,0.044086879,16610,3464
ZCTA5 04093,3325,13487,-10162,8332,44.7,7227,26,51,0.006120979,30639,-22307
ZCTA5 04095,708,4485,-3777,1617,46.3,1534,15,0,0,11191,-9574
ZCTA5 04096,3463,11017,-7554,8903,44.8,8308,244,48,0.005391441,25194,-16291
ZCTA5 04097,1497,3551,-2054,4037,48.1,3839,66,0,0,8990,-4953
ZCTA5 04101,9684,469,9215,17816,36.3,13999,426,2494,0.139986529,1000,16816
ZCTA5 04102,7820,22,7798,17174,36.3,14799,740,846,0.04926051,73,17101
ZCTA5 04103,13183,513,12670,32011,37.1,26642,1566,2783,0.086938865,1389,30622
ZCTA5 04105,4825,10071,-5246,12221,46.2,11300,253,0,0,23104,-10883
ZCTA5 04106,11774,207,11567,26646,43.7,23556,546,1371,0.051452376,487,26159
ZCTA5 04107,3893,1174,2719,9448,48.8,9120,161,0,0,3112,6336
ZCTA5 04108,434,572,-138,885,59,869,0,0,0,1511,-626
ZCTA5 04109,77,1161,-1084,130,71.1,121,0,0,0,2923,-2793
ZCTA5 04110,611,445,166,1777,47,1670,0,0,0,1176,601
ZCTA5 04210,10249,1492,8757,23790,39.4,21544,172,349,0.014670029,3853,19937
ZCTA5 04216,280,1218,-938,657,55.8,630,19,0,0,3061,-2404
ZCTA5 04217,1540,65,1475,3280,48,2991,3,6,0.001829268,157,3123
ZCTA5 04219,559,19,540,1298,50.5,1274,0,0,0,48,1250
ZCTA5 04220,1238,13,1225,3486,39.6,3272,0,55,0.015777395,26,3460
ZCTA5 04221,335,106,229,1059,41.7,946,58,0,0,195,864
ZCTA5 04222,1699,55,1644,4170,42.8,3945,65,0,0,242,3928
ZCTA5 04224,1072,1746,-674,2675,44.4,2615,10,0,0,4348,-1673
ZCTA5 04226,33,65,-32,80,55.7,80,0,0,0,135,-55
ZCTA5 04227,17,439,-422,32,58.4,21,0,0,0,1334,-1302
ZCTA5 04231,94,1939,-1845,257,54.9,251,0,0,0,4859,-4602
ZCTA5 04234,0,14990,-14990,0,-,0,0,0,#DIV/0!,36588,-36588
ZCTA5 04236,1661,1717,-56,4403,40.5,4190,11,7,0.001589825,4111,292
ZCTA5 04237,105,2068,-1963,219,50.8,186,0,0,0,4912,-4693
ZCTA5 04238,443,876,-433,1324,41.6,1269,9,7,0.005287009,2145,-821
ZCTA5 04239,1928,1340,588,4661,41,4429,41,0,0,3161,1500
ZCTA5 04240,15588,315,15273,36615,40.5,30538,731,2656,0.072538577,915,35700
ZCTA5 04250,1782,1164,618,4532,36.6,4307,0,12,0.002647838,3038,1494
ZCTA5 04252,1928,1176,752,5056,37.7,4759,17,1,0.000197785,2701,2355
ZCTA5 04253,761,916,-155,1873,47.5,1788,0,0,0,2601,-728
ZCTA5 04254,1412,1213,199,3089,37.6,2957,0,7,0.002266106,3299,-210
ZCTA5 04255,302,2001,-1699,618,51.5,560,0,50,0.080906149,5533,-4915
ZCTA5 04256,1152,176,976,3109,37.9,2702,28,40,0.012865873,369,2740
ZCTA5 04257,1136,749,387,2739,48.6,2739,0,0,0,1972,767
ZCTA5 04258,1063,281,782,2766,46.9,2664,10,2,0.000723066,829,1937
ZCTA5 04259,1412,30,1382,3279,46.7,3126,15,12,0.003659652,84,3195
ZCTA5 04260,2093,2106,-13,5668,43.3,5473,81,14,0.002470007,5023,645
ZCTA5 04261,158,2297,-2139,282,60.9,278,0,0,0,5929,-5647
ZCTA5 04263,777,0,777,2427,37.5,2385,4,7,0.002884219,0,2427
ZCTA5 04265,332,2218,-1886,790,44.5,760,0,0,0,5368,-4578
ZCTA5 04267,15,170,-155,27,60.1,14,0,0,0,389,-362
ZCTA5 04268,1915,2703,-788,5075,48.2,4762,0,35,0.006896552,5873,-798
ZCTA5 04270,2320,2558,-238,6248,44.7,6144,0,3,0.000480154,6827,-579
ZCTA5 04271,0,2310,-2310,0,-,0,0,0,#DIV/0!,5174,-5174
ZCTA5 04274,2348,2236,112,5880,41.9,5820,0,0,0,5712,168
ZCTA5 04275,268,468,-200,584,59.3,532,0,0,0,1002,-418
ZCTA5 04276,2416,178,2238,5846,51.7,5686,38,11,0.001881628,414,5432
ZCTA5 04280,2989,50,2939,6804,46.8,6449,13,27,0.003968254,103,6701
ZCTA5 04281,2063,1172,891,5180,44.8,4949,0,0,0,3203,1977
ZCTA5 04282,2361,697,1664,5864,50,5517,48,0,0,1972,3892
ZCTA5 04284,465,624,-159,1006,54.3,990,3,0,0,1545,-539
ZCTA5 04285,189,415,-226,393,64.6,393,0,0,0,1059,-666
ZCTA5 04286,0,1556,-1556,0,-,0,0,0,#DIV/0!,4049,-4049
ZCTA5 04287,1356,11597,-10241,3147,50.4,3025,0,0,0,26092,-22945
ZCTA5 04289,689,829,-140,2017,44.4,1935,8,4,0.001983143,1759,258
ZCTA5 04290,669,31,638,1590,50.3,1552,13,0,0,82,1508
ZCTA5 04292,373,1291,-918,1024,44.5,980,0,0,0,2921,-1897
ZCTA5 04294,1422,4930,-3508,3954,42.1,3870,0,35,0.008851796,11663,-7709
ZCTA5 04330,12227,777,11450,26271,44.2,24720,176,265,0.010087168,1726,24545
ZCTA5 04341,0,1181,-1181,30,83.5,30,0,0,0,2538,-2508
ZCTA5 04342,717,1279,-562,1883,46.9,1872,3,0,0,3059,-1176
ZCTA5 04344,1381,521,860,2987,40.3,2866,0,0,0,1224,1763
ZCTA5 04345,4760,1411,3349,12163,42.7,11533,86,23,0.001890981,3596,8567
ZCTA5 04346,792,1033,-241,1595,49.6,1576,0,4,0.002507837,2573,-978
ZCTA5 04347,1289,673,616,2542,42,2489,38,0,0,1548,994
ZCTA5 04348,1169,875,294,3417,41.2,3124,20,60,0.017559263,2357,1060
ZCTA5 04349,581,618,-37,1274,59.4,1219,6,6,0.004709576,1533,-259
ZCTA5 04350,1482,972,510,3587,49.1,3452,81,1,0.000278784,2581,1006
ZCTA5 04351,974,1469,-495,2412,44.6,2366,10,0,0,3413,-1001
ZCTA5 04352,665,1730,-1065,1613,48.7,1555,0,0,0,4261,-2648
ZCTA5 04353,895,159,736,2251,44.8,2181,5,21,0.009329187,356,1895
ZCTA5 04354,618,280,338,1408,45.3,1379,6,0,0,560,848
ZCTA5 04355,959,1110,-151,2587,45.5,2514,0,5,0.001932741,2564,23
ZCTA5 04357,1484,2557,-1073,3503,35.8,3387,0,0,0,6025,-2522
ZCTA5 04358,1845,18853,-17008,4351,40.1,4270,23,35,0.008044128,45087,-40736
ZCTA5 04359,127,334,-207,282,56.2,270,0,0,0,692,-410
ZCTA5 04360,229,51,178,602,38.3,571,7,0,0,156,446
ZCTA5 04363,1051,435,616,2627,47.2,2514,0,37,0.014084507,1158,1469
ZCTA5 04364,2533,622,1911,6103,41.8,5555,13,297,0.048664591,1553,4550
ZCTA5 04401,18773,4254,14519,44184,39.8,40034,572,843,0.019079305,9452,34732
ZCTA5 04406,328,72,256,722,52.4,707,0,2,0.002770083,164,558
ZCTA5 04408,100,634,-534,181,54.1,167,1,0,0,1442,-1261
ZCTA5 04410,430,110,320,1074,49.6,1044,0,0,0,226,848
ZCTA5 04411,620,2189,-1569,1657,42,1443,8,0,0,5493,-3836
ZCTA5 04412,4074,147,3927,9606,39,9190,2,61,0.006350198,366,9240
ZCTA5 04413,75,603,-528,137,62.4,101,0,0,0,1519,-1382
ZCTA5 04414,667,1104,-437,1456,57.6,1429,0,0,0,2775,-1319
ZCTA5 04415,116,394,-278,302,50.3,259,0,0,0,1673,-1371
ZCTA5 04416,2327,468,1859,5585,41.8,5380,53,79,0.014145031,1494,4091
ZCTA5 04417,203,330,-127,390,63.3,388,0,0,0,801,-411
ZCTA5 04418,633,1953,-1320,1745,40.9,1620,5,0,0,4600,-2855
ZCTA5 04419,1204,1125,79,2838,40.1,2759,3,0,0,2807,31
ZCTA5 04421,256,1326,-1070,1162,20.8,1083,2,19,0.016351119,3296,-2134
ZCTA5 04422,400,2015,-1615,1176,44.1,1096,8,23,0.019557823,4890,-3714
ZCTA5 04424,378,822,-444,872,51.8,861,0,0,0,1839,-967
ZCTA5 04426,1969,52,1917,4733,45.7,4299,68,10,0.002112825,91,4642
ZCTA5 04427,1088,494,594,2878,41.7,2670,0,4,0.001389854,1352,1526
ZCTA5 04428,1267,399,868,3496,44.6,3221,6,22,0.006292906,1053,2443
ZCTA5 04429,2102,542,1560,4875,46.7,4717,19,0,0,1346,3529
ZCTA5 04430,721,882,-161,1581,47.9,1560,0,0,0,2020,-439
ZCTA5 04431,21,35,-14,33,76.7,33,0,0,0,63,-30
ZCTA5 04434,418,1097,-679,1124,42,1119,0,0,0,2422,-1298
ZCTA5 04435,438,3351,-2913,1111,52.4,1103,0,0,0,8699,-7588
ZCTA5 04438,525,590,-65,1244,43.6,1165,2,0,0,1462,-218
ZCTA5 04441,757,570,187,1689,60.4,1635,0,1,0.000592066,1338,351
ZCTA5 04442,37,568,-531,103,45.9,103,0,0,0,1198,-1095
ZCTA5 04443,916,124,792,2080,54,1933,42,0,0,251,1829
ZCTA5 04444,3541,304,3237,9189,42.2,8534,10,76,0.008270759,800,8389
ZCTA5 04448,561,37,524,1418,44.2,1385,0,0,0,86,1332
ZCTA5 04449,490,390,100,1138,46.4,1089,8,0,0,1231,-93
ZCTA5 04450,553,1110,-557,1441,48.4,1407,2,0,0,2835,-1394
ZCTA5 04451,119,2447,-2328,211,61.3,207,2,0,0,5738,-5527
ZCTA5 04453,287,481,-194,733,42,716,0,0,0,990,-257
ZCTA5 04454,13,611,-598,26,68.7,26,0,0,0,1413,-1387
ZCTA5 04455,260,1320,-1060,755,42.6,731,0,6,0.00794702,3056,-2301
ZCTA5 04456,1164,2252,-1088,2909,39.6,2817,14,0,0,4835,-1926
ZCTA5 04457,2700,1272,1428,5709,51.9,5571,0,1,0.000175162,2700,3009
ZCTA5 04459,323,279,44,735,51.4,649,0,39,0.053061224,622,113
ZCTA5 04460,598,4108,-3510,1340,49.3,1303,0,5,0.003731343,9626,-8286
ZCTA5 04461,1197,0,1197,3052,39.3,2775,218,0,0,2637,415
ZCTA5 04462,2349,245,2104,4517,57.5,4503,0,0,0,485,4032
ZCTA5 04463,1153,865,288,2830,44.3,2667,21,86,0.030388693,2040,790
ZCTA5 04464,213,2808,-2595,501,55.1,484,0,0,0,7741,-7240
ZCTA5 04468,3881,1557,2324,9245,39,8198,26,13,0.001406165,3737,5508
ZCTA5 04469,0,207,-207,3078,19.3,2655,166,147,0.047758285,493,2585
ZCTA5 04471,240,482,-242,532,56.1,486,8,4,0.007518797,1086,-554
ZCTA5 04472,862,140,722,1935,51,1870,0,32,0.016537468,333,1602
ZCTA5 04473,3465,648,2817,8403,29.9,7569,217,123,0.014637629,1460,6943
ZCTA5 04474,1551,207,1344,3775,46.2,3719,6,9,0.002384106,492,3283
ZCTA5 04475,221,130,91,515,49.4,499,0,0,0,320,195
ZCTA5 04476,524,323,201,1144,52.7,1088,10,0,0,835,309
ZCTA5 04478,186,503,-317,367,64.7,367,0,0,0,1239,-872
ZCTA5 04479,585,96,489,1323,50.1,1288,0,0,0,213,1110
ZCTA5 04481,230,89,141,521,50,484,12,0,0,220,301
ZCTA5 04485,66,51,15,174,48.4,140,3,0,0,120,54
ZCTA5 04487,376,86,290,819,53,802,0,1,0.001221001,169,650
ZCTA5 04488,463,747,-284,1271,40.2,1226,0,9,0.007081039,1927,-656
ZCTA5 04489,111,186,-75,296,24.5,281,0,0,0,364,-68
ZCTA5 04490,105,1483,-1378,244,55,235,0,0,0,3766,-3522
ZCTA5 04491,86,169,-83,162,58.4,145,3,10,0.061728395,407,-245
ZCTA5 04492,34,4949,-4915,88,44.7,88,0,0,0,10968,-10880
ZCTA5 04493,764,281,483,1848,49.3,1794,8,0,0,616,1232
ZCTA5 04495,187,932,-745,392,52.3,350,4,5,0.012755102,2058,-1666
ZCTA5 04496,1587,1020,567,3845,44.8,3783,7,7,0.001820546,2041,1804
ZCTA5 04497,173,533,-360,354,58.2,327,0,0,0,1054,-700
ZCTA5 04530,5008,44,4964,11344,43.3,10940,60,87,0.007669252,138,11206
ZCTA5 04535,278,871,-593,743,44.8,643,19,0,0,2170,-1427
ZCTA5 04537,660,374,286,1464,42.7,1462,0,2,0.00136612,706,758
ZCTA5 04538,836,504,332,1772,61.2,1661,43,28,0.015801354,1199,573
ZCTA5 04539,654,406,248,1450,60.9,1223,0,0,0,935,515
ZCTA5 04541,29,339,-310,50,68.4,50,0,0,0,784,-734
ZCTA5 04543,917,774,143,2221,41.6,2055,16,0,0,1814,407
ZCTA5 04544,467,445,22,936,59.3,880,0,0,0,727,209
ZCTA5 04547,499,750,-251,1197,48.6,1183,0,0,0,1699,-502
ZCTA5 04548,458,475,-17,937,61.1,905,1,0,0,1082,-145
ZCTA5 04551,279,161,118,704,54.2,686,0,0,0,305,399
ZCTA5 04553,778,915,-137,1804,48.8,1702,71,0,0,2228,-424
ZCTA5 04554,326,518,-192,634,65.2,624,0,0,0,1343,-709
ZCTA5 04555,697,248,449,1541,50.9,1490,28,0,0,524,1017
ZCTA5 04556,557,255,302,1252,51.6,1242,10,0,0,531,721
ZCTA5 04558,102,0,102,190,61.1,187,0,1,0.005263158,0,190
ZCTA5 04562,1040,156,884,2038,54.2,1954,0,0,0,352,1686
ZCTA5 04563,645,1962,-1317,1395,57.6,1305,0,1,0.000716846,5062,-3667
ZCTA5 04564,207,186,21,495,50.4,495,0,0,0,433,62
ZCTA5 04568,257,581,-324,486,45.5,485,0,0,0,1468,-982
ZCTA5 04570,0,50,-50,0,-,0,0,0,#DIV/0!,109,-109
ZCTA5 04571,309,303,6,621,66.3,621,0,0,0,539,82
ZCTA5 04572,2639,1887,752,5135,55.8,5006,0,0,0,4487,648
ZCTA5 04573,178,1196,-1018,453,48.7,419,0,0,0,3074,-2621
ZCTA5 04574,691,5792,-5101,1653,47.2,1612,8,0,0,12651,-10998
ZCTA5 04575,106,513,-407,301,41.2,300,0,1,0.003322259,1252,-951
ZCTA5 04576,278,482,-204,512,66.7,497,4,0,0,1115,-603
ZCTA5 04578,1994,2277,-283,4596,47.7,4390,49,13,0.002828547,5062,-466
ZCTA5 04579,1202,230,972,3088,52.3,2848,34,12,0.00388601,453,2635
ZCTA5 04605,6244,301,5943,14201,47.2,13373,187,63,0.004436307,674,13527
ZCTA5 04606,518,79,439,1204,54.9,1136,2,0,0,187,1017
ZCTA5 04607,566,1109,-543,1222,53.8,1201,0,0,0,2527,-1305
ZCTA5 04609,2208,438,1770,5098,48.3,4651,153,193,0.037857984,981,4117
ZCTA5 04611,190,394,-204,467,41.8,417,1,12,0.025695931,904,-437
ZCTA5 04612,222,1566,-1344,545,51.7,545,0,0,0,3132,-2587
ZCTA5 04613,42,592,-550,105,64.2,105,0,0,0,1391,-1286
ZCTA5 04614,1228,442,786,2796,43.9,2598,0,0,0,1271,1525
ZCTA5 04616,349,95,254,753,54.5,711,18,0,0,201,552
ZCTA5 04617,348,14,334,741,57.2,725,7,2,0.002699055,19,722
ZCTA5 04619,1664,214,1450,3010,51.2,2901,14,13,0.004318937,560,2450
ZCTA5 04622,397,669,-272,867,53.5,807,3,0,0,1478,-611
ZCTA5 04623,366,293,73,1040,40.3,1001,0,0,0,705,335
ZCTA5 04624,103,83,20,231,71.2,231,0,0,0,154,77
ZCTA5 04625,32,532,-500,54,70.8,54,0,0,0,1267,-1213
ZCTA5 04626,240,716,-476,583,39.7,549,0,0,0,1458,-875
ZCTA5 04627,807,827,-20,1861,53.8,1811,4,14,0.007522837,1873,-12
ZCTA5 04628,241,25,216,557,49.4,551,0,0,0,73,484
ZCTA5 04630,529,82,447,1307,43.4,1258,11,8,0.006120888,142,1165
ZCTA5 04631,599,935,-336,1226,62.4,1113,0,16,0.013050571,1973,-747
ZCTA5 04634,846,44,802,2115,53.4,1944,0,22,0.010401891,79,2036
ZCTA5 04635,6,415,-409,16,27,16,0,0,0,1060,-1044
ZCTA5 04640,1059,62,997,2472,48.8,2358,0,0,0,168,2304
ZCTA5 04642,78,43,35,138,65.8,138,0,0,0,93,45
ZCTA5 04643,320,34,286,861,40.6,853,1,0,0,79,782
ZCTA5 04645,22,235,-213,30,70.3,30,0,0,0,511,-481
ZCTA5 04646,41,560,-519,66,61.4,66,0,0,0,1308,-1242
ZCTA5 04648,263,100,163,682,37.9,626,0,8,0.011730205,187,495
ZCTA5 04649,541,802,-261,1195,50.1,1137,12,11,0.009205021,1815,-620
ZCTA5 04650,133,227,-94,277,49.1,261,0,0,0,439,-162
ZCTA5 04652,727,1389,-662,1421,61.7,1388,2,21,0.014778325,3422,-2001
ZCTA5 04653,318,400,-82,662,48.4,641,0,0,0,1161,-499
ZCTA5 04654,1282,164,1118,3355,42.7,3132,30,17,0.005067064,337,3018
ZCTA5 04655,396,606,-210,1010,45.3,956,2,5,0.004950495,1373,-363
ZCTA5 04657,144,653,-509,310,60,305,0,0,0,1349,-1039
ZCTA5 04658,536,279,257,1323,48.5,1210,2,90,0.068027211,442,881
ZCTA5 04660,502,525,-23,1118,54.6,1069,7,25,0.02236136,1210,-92
ZCTA5 04662,238,543,-305,520,53.8,520,0,0,0,1215,-695
ZCTA5 04664,482,615,-133,1431,41.9,1379,0,0,0,1546,-115
ZCTA5 04666,517,650,-133,1316,46.6,1195,4,0,0,1727,-411
ZCTA5 04667,536,83,453,1406,40.6,710,6,0,0,167,1239
ZCTA5 04668,760,251,509,1861,39.9,1034,1,0,0,579,1282
ZCTA5 04669,56,61,-5,124,52.9,124,0,0,0,150,-26
ZCTA5 04671,217,286,-69,595,51.2,582,0,0,0,662,-67
ZCTA5 04673,68,120,-52,164,52.5,153,0,0,0,295,-131
ZCTA5 04674,111,421,-310,255,45.3,243,0,0,0,1076,-821
ZCTA5 04675,80,103,-23,133,55,133,0,0,0,206,-73
ZCTA5 04676,575,893,-318,1186,49,1099,56,0,0,1848,-662
ZCTA5 04677,131,443,-312,271,42.8,254,5,0,0,1031,-760
ZCTA5 04679,708,561,147,1535,55.5,1516,0,11,0.007166124,1192,343
ZCTA5 04680,514,26,488,1297,46.1,1171,11,5,0.00385505,61,1236
ZCTA5 04681,477,734,-257,887,56.1,869,0,9,0.010146561,1736,-849
ZCTA5 04683,0,161,-161,0,-,0,0,0,#DIV/0!,386,-386
ZCTA5 04684,858,52,806,1831,52.6,1798,0,0,0,90,1741
ZCTA5 04685,195,194,1,436,57,389,37,0,0,493,-57
ZCTA5 04686,66,253,-187,158,52.5,145,0,0,0,450,-292
ZCTA5 04691,188,1031,-843,456,44.8,390,0,0,0,2207,-1751
ZCTA5 04693,230,4131,-3901,474,64.5,459,0,6,0.012658228,10210,-9736
ZCTA5 04694,944,746,198,2256,42.2,2071,9,6,0.002659574,1804,452
ZCTA5 04730,4032,103,3929,10086,42.9,9434,22,168,0.016656752,259,9827
ZCTA5 04732,731,320,411,1534,46.9,1456,0,0,0,751,783
ZCTA5 04733,156,250,-94,291,56.6,286,0,5,0.017182131,622,-331
ZCTA5 04734,339,4154,-3815,913,44.9,886,0,10,0.010952903,9813,-8900
ZCTA5 04735,203,391,-188,473,48.8,467,2,0,0,937,-464
ZCTA5 04736,4139,513,3626,9021,50.5,8357,21,6,0.000665115,1249,7772
ZCTA5 04737,0,0,0,0,-,0,0,0,#DIV/0!,0,0
ZCTA5 04739,331,1432,-1101,819,58.4,811,0,0,0,3478,-2659
ZCTA5 04740,594,2060,-1466,1454,54.7,1380,0,17,0.011691884,4608,-3154
ZCTA5 04742,1303,428,875,3302,47.6,3125,7,0,0,1057,2245
ZCTA5 04743,1939,204,1735,4724,42.7,4216,12,116,0.024555461,481,4243
ZCTA5 04745,376,638,-262,789,54.1,789,0,0,0,1534,-745
ZCTA5 04746,201,1021,-820,419,52.3,410,0,0,0,2508,-2089
ZCTA5 04747,562,1643,-1081,1372,50.1,1291,1,10,0.00728863,3563,-2191
ZCTA5 04750,777,1119,-342,2110,36.8,1971,24,21,0.009952607,2775,-665
ZCTA5 04756,1510,652,858,3240,53.4,3181,8,0,0,1617,1623
ZCTA5 04757,1089,313,776,2607,43.3,2502,0,2,0.000767165,725,1882
ZCTA5 04758,532,217,315,1374,38.6,1337,1,1,0.000727802,441,933
ZCTA5 04760,317,261,56,679,54.1,635,11,0,0,576,103
ZCTA5 04761,172,306,-134,467,41,402,0,10,0.021413276,748,-281
ZCTA5 04762,200,26,174,466,54.1,418,0,0,0,41,425
ZCTA5 04763,304,637,-333,679,52.7,653,6,0,0,1407,-728
ZCTA5 04764,13,141,-128,21,61.8,21,0,0,0,366,-345
ZCTA5 04765,461,196,265,1047,56.1,1006,0,0,0,384,663
ZCTA5 04766,157,4131,-3974,366,54.9,350,0,0,0,9638,-9272
ZCTA5 04768,178,357,-179,364,63.2,354,0,3,0.008241758,771,-407
ZCTA5 04769,4157,243,3914,8859,43,8105,90,111,0.012529631,505,8354
ZCTA5 04772,396,330,66,896,59.3,884,0,0,0,664,232
ZCTA5 04773,295,386,-91,639,52.2,639,0,0,0,844,-205
ZCTA5 04774,312,149,163,608,51.8,579,0,0,0,420,188
ZCTA5 04776,325,128,197,966,40.4,929,0,0,0,297,669
ZCTA5 04777,152,319,-167,426,44.3,412,0,0,0,856,-430
ZCTA5 04779,171,225,-54,341,68.1,339,0,0,0,509,-168
ZCTA5 04780,335,153,182,935,35.3,887,0,0,0,326,609
ZCTA5 04781,213,1286,-1073,523,43.9,484,0,20,0.038240918,2994,-2471
ZCTA5 04783,199,828,-629,456,56.4,431,0,0,0,1980,-1524
ZCTA5 04785,857,213,644,1936,58.8,1862,31,31,0.016012397,621,1315
ZCTA5 04786,743,3340,-2597,1718,50.3,1669,0,0,0,7314,-5596
ZCTA5 04787,179,2325,-2146,560,60,533,0,0,0,4883,-4323
ZCTA5 04841,3367,616,2751,6977,45.4,6699,60,2,0.000286656,1635,5342
ZCTA5 04843,2373,305,2068,5175,51.4,4917,0,31,0.005990338,626,4549
ZCTA5 04847,665,1651,-986,1730,44.7,1679,9,0,0,3621,-1891
ZCTA5 04848,329,18,311,600,62.3,598,0,2,0.003333333,41,559
ZCTA5 04849,1672,21,1651,3827,51.1,3666,55,27,0.007055135,34,3793
ZCTA5 04851,34,197,-163,69,66.2,67,0,0,0,456,-387
ZCTA5 04852,43,716,-673,124,43.1,80,0,0,0,1667,-1543
ZCTA5 04853,198,172,26,476,41.2,475,0,0,0,355,121
ZCTA5 04854,696,1307,-611,1450,50.2,1387,7,11,0.007586207,3344,-1894
ZCTA5 04855,159,610,-451,262,69.3,262,0,0,0,1390,-1128
ZCTA5 04856,1364,216,1148,3615,46.1,3507,43,7,0.001936376,476,3139
ZCTA5 04858,558,760,-202,1347,48.8,1318,0,0,0,1788,-441
ZCTA5 04859,371,1221,-850,781,64,767,0,0,0,2820,-2039
ZCTA5 04860,825,1472,-647,1588,56.4,1567,0,0,0,3732,-2144
ZCTA5 04861,1308,518,790,2753,55.1,2435,0,31,0.011260443,1126,1627
ZCTA5 04862,1718,1723,-5,4218,44.4,4006,5,21,0.004978663,4718,-500
ZCTA5 04863,479,10764,-10285,991,63.1,980,0,3,0.003027245,26281,-25290
ZCTA5 04864,1557,750,807,4812,43.5,4430,11,71,0.01475478,1926,2886
ZCTA5 04901,10942,834,10108,26467,39,24697,562,165,0.006234178,1988,24479
ZCTA5 04910,862,418,444,2331,46.6,2231,0,0,0,1131,1200
ZCTA5 04911,806,3900,-3094,1783,47.3,1760,0,0,0,8780,-6997
ZCTA5 04912,282,1195,-913,778,44.8,740,3,1,0.001285347,2908,-2130
ZCTA5 04915,4174,171,4003,8979,53.4,8290,38,85,0.009466533,270,8709
ZCTA5 04917,1308,832,476,3218,47.1,3117,0,2,0.000621504,1730,1488
ZCTA5 04918,0,666,-666,0,-,0,0,0,#DIV/0!,1546,-1546
ZCTA5 04920,840,473,367,1630,52.8,1572,7,0,0,1118,512
ZCTA5 04921,664,228,436,1587,44,1486,7,8,0.005040958,554,1033
ZCTA5 04922,412,826,-414,909,50.5,880,0,0,0,2169,-1260
ZCTA5 04923,232,47,185,559,38.9,519,1,3,0.005366726,81,478
ZCTA5 04924,920,39,881,2374,38.7,2323,0,0,0,69,2305
ZCTA5 04925,11,1398,-1387,31,42.9,31,0,0,0,3470,-3439
ZCTA5 04926,10,870,-860,43,15,43,0,0,0,2138,-2095
ZCTA5 04927,1462,377,1085,3368,52.3,3279,0,0,0,863,2505
ZCTA5 04928,868,1861,-993,1990,45.5,1932,0,33,0.016582915,4433,-2443
ZCTA5 04929,322,480,-158,757,49.3,735,0,0,0,1185,-428
ZCTA5 04930,1954,17,1937,4186,52.8,3957,0,1,0.000238892,70,4116
ZCTA5 04932,514,137,377,1210,48.1,1190,0,5,0.004132231,251,959
ZCTA5 04936,112,2903,-2791,179,42.8,172,0,0,0,6527,-6348
ZCTA5 04937,2891,3832,-941,6381,47.9,6037,0,36,0.005641749,9831,-3450
ZCTA5 04938,3771,414,3357,9728,41.6,9250,23,46,0.004728618,985,8743
ZCTA5 04939,394,39,355,809,55.3,797,3,3,0.003708282,39,770
ZCTA5 04940,0,681,-681,0,-,0,0,0,#DIV/0!,1657,-1657
ZCTA5 04941,732,523,209,1740,43.4,1656,7,0,0,1178,562
ZCTA5 04942,528,731,-203,1052,56,1033,5,0,0,1688,-636
ZCTA5 04943,756,14,742,1649,50.7,1633,0,10,0.006064281,30,1619
ZCTA5 04944,32,516,-484,60,-,60,0,0,0,1184,-1124
ZCTA5 04945,580,722,-142,1188,52.1,1104,4,11,0.009259259,1799,-611
ZCTA5 04947,790,317,473,1559,56.2,1544,6,2,0.001282874,747,812
ZCTA5 04949,335,1924,-1589,733,54.2,717,0,1,0.001364256,4818,-4085
ZCTA5 04950,1995,437,1558,4711,50.1,4682,6,13,0.002759499,950,3761
ZCTA5 04951,475,774,-299,1090,43.3,1045,5,0,0,1869,-779
ZCTA5 04952,796,1441,-645,1839,44.6,1765,1,3,0.001631321,3205,-1366
ZCTA5 04953,1425,542,883,3129,48.6,3069,0,25,0.007989773,1399,1730
ZCTA5 04955,571,295,276,1393,50.3,1276,9,0,0,676,717
ZCTA5 04956,275,1782,-1507,745,44,713,2,3,0.004026846,4161,-3416
ZCTA5 04957,1642,867,775,4109,41.1,3869,44,51,0.012411779,1933,2176
ZCTA5 04958,832,525,307,1988,51.9,1862,0,0,0,964,1024
ZCTA5 04961,397,55,342,789,53.5,686,45,0,0,119,670
ZCTA5 04963,3086,2995,91,7274,46.4,6845,27,7,0.000962332,7224,50
ZCTA5 04964,84,96,-12,140,69.5,140,0,0,0,158,-18
ZCTA5 04965,817,826,-9,2226,36.3,2167,0,0,0,2099,127
ZCTA5 04966,703,726,-23,1629,46.6,1579,0,6,0.003683241,1864,-235
ZCTA5 04967,1503,1580,-77,3916,39.6,3662,0,57,0.014555669,4235,-319
ZCTA5 04969,462,455,7,1164,43.3,1093,0,14,0.012027491,1155,9
ZCTA5 04970,733,730,3,1510,57,1497,0,0,0,1608,-98
ZCTA5 04971,767,745,22,1863,42.6,1810,37,0,0,1922,-59
ZCTA5 04973,546,641,-95,1350,46.6,1322,5,10,0.007407407,1529,-179
ZCTA5 04974,1386,1171,215,2650,47.5,2587,0,0,0,2634,16
ZCTA5 04975,33,49,-16,49,68.5,49,0,0,0,151,-102
ZCTA5 04976,4301,4235,66,10129,44.6,9746,48,19,0.001875802,9993,136
ZCTA5 04978,427,369,58,934,55,899,0,0,0,936,-2
ZCTA5 04979,354,463,-109,775,54.6,745,25,0,0,1105,-330
ZCTA5 04981,1223,1010,213,2590,51.7,2514,9,12,0.004633205,2293,297
ZCTA5 04982,227,233,-6,487,40.6,485,0,0,0,629,-142
ZCTA5 04983,602,663,-61,1454,47.3,1272,2,0,0,1605,-151
ZCTA5 04984,269,231,38,782,40,689,0,0,0,568,214
ZCTA5 04985,52,39,13,104,37.8,98,0,0,0,72,32
ZCTA5 04986,642,655,-13,2209,29.9,2172,0,0,0,1667,542
ZCTA5 04987,404,365,39,975,44.6,910,0,2,0.002051282,848,127
ZCTA5 04988,708,829,-121,2089,30.2,1953,22,20,0.009573959,2311,-222
ZCTA5 04989,1963,1669,294,4475,51.7,4274,10,0,0,4235,240
ZCTA5 04992,112,55,57,191,64.3,191,0,0,0,156,35
ZCTA5 05001,4128,4329,-201,9332,45,8417,275,110,0.011787398,9301,31
ZCTA5 05009,0,75,-75,0,-,0,0,0,#DIV/0!,130,-130
ZCTA5 05030,111,1348,-1237,256,37.4,256,0,0,0,3068,-2812
ZCTA5 05031,10,1108,-1098,19,-,19,0,0,0,2742,-2723
ZCTA5 05032,1062,98,964,2655,37.5,2536,13,6,0.002259887,184,2471
ZCTA5 05033,1272,226,1046,2978,43.9,2865,4,7,0.002350571,512,2466
ZCTA5 05034,98,389,-291,186,61.3,173,0,13,0.069892473,906,-720
ZCTA5 05035,321,220,101,698,55.9,664,6,11,0.015759312,561,137
ZCTA5 05036,485,619,-134,1058,54.1,1018,0,0,0,1412,-354
ZCTA5 05037,375,397,-22,986,50.4,961,0,0,0,917,69
ZCTA5 05038,593,192,401,1451,45.9,1399,2,5,0.003445899,505,946
ZCTA5 05039,472,142,330,1019,48.5,975,0,5,0.004906771,720,299
ZCTA5 05040,281,252,29,687,41.9,657,0,30,0.043668122,622,65
ZCTA5 05041,67,373,-306,216,30,211,0,0,0,888,-672
ZCTA5 05042,277,844,-567,586,60.3,544,25,0,0,2065,-1479
ZCTA5 05043,537,443,94,1173,47.2,1131,3,0,0,1088,85
ZCTA5 05045,776,1107,-331,1646,55.2,1522,62,0,0,2644,-998
ZCTA5 05046,512,69,443,1322,44,1272,0,0,0,202,1120
ZCTA5 05048,1176,745,431,2885,41.7,2777,21,6,0.002079723,1629,1256
ZCTA5 05050,55,92,-37,113,29.5,113,0,0,0,187,-74
ZCTA5 05051,521,161,360,1217,41.4,1170,0,11,0.00903862,378,839
ZCTA5 05052,75,1468,-1393,184,31.1,184,0,0,0,3423,-3239
ZCTA5 05053,110,213,-103,322,43,315,0,0,0,445,-123
ZCTA5 05055,1220,95,1125,3374,40.9,3175,57,0,0,249,3125
ZCTA5 05056,145,329,-184,330,50.8,325,0,0,0,773,-443
ZCTA5 05058,72,1863,-1791,172,47.9,172,0,0,0,4223,-4051
ZCTA5 05059,278,431,-153,544,64.4,544,0,0,0,1416,-872
ZCTA5 05060,2035,267,1768,4515,49.6,4307,1,20,0.004429679,671,3844
ZCTA5 05061,580,462,118,1754,27.7,1709,0,0,0,1173,581
ZCTA5 05062,190,110,80,449,49.3,439,0,0,0,244,205
ZCTA5 05065,441,1436,-995,1198,43,1152,10,18,0.015025042,3093,-1895
ZCTA5 05067,71,205,-134,155,64.3,139,10,0,0,541,-386
ZCTA5 05068,1309,219,1090,3158,48.9,2994,0,40,0.012666244,512,2646
ZCTA5 05069,271,175,96,651,58.2,646,0,0,0,455,196
ZCTA5 05070,181,216,-35,442,49.7,437,0,0,0,520,-78
ZCTA5 05071,71,458,-387,123,68.3,108,0,15,0.12195122,1072,-949
ZCTA5 05072,260,178,82,574,52.5,539,0,0,0,515,59
ZCTA5 05073,0,491,-491,0,-,0,0,0,#DIV/0!,1151,-1151
ZCTA5 05075,480,295,185,1128,49.7,1028,8,0,0,673,455
ZCTA5 05076,200,221,-21,501,45.9,472,7,5,0.00998004,497,4
ZCTA5 05077,486,56,430,1208,42.2,1178,0,1,0.000827815,114,1094
ZCTA5 05079,384,12,372,839,49.2,736,3,12,0.014302741,17,822
ZCTA5 05081,254,323,-69,610,44.5,503,4,0,0,819,-209
ZCTA5 05083,83,2167,-2084,220,54.6,215,4,0,0,4953,-4733
ZCTA5 05084,28,1471,-1443,88,64.3,88,0,0,0,3257,-3169
ZCTA5 05086,223,2056,-1833,567,35.7,559,0,0,0,4666,-4099
ZCTA5 05088,465,41,424,1038,42.1,1038,0,0,0,61,977
ZCTA5 05089,2014,297,1717,4245,46.3,4042,7,0,0,797,3448
ZCTA5 05091,1594,1981,-387,3720,53.6,3648,3,31,0.008333333,4186,-466
ZCTA5 05101,1799,303,1496,4206,42.7,3603,108,187,0.044460295,663,3543
ZCTA5 05141,80,524,-444,164,68.6,164,0,0,0,1125,-961
ZCTA5 05142,260,939,-679,789,41.6,784,0,0,0,2145,-1356
ZCTA5 05143,1891,400,1491,4689,49.8,4557,0,90,0.019193858,864,3825
ZCTA5 05146,224,553,-329,543,57.1,516,10,0,0,1332,-789
ZCTA5 05148,577,202,375,1393,54.7,1348,8,12,0.008614501,457,936
ZCTA5 05149,964,320,644,2223,46.7,2084,3,1,0.000449843,706,1517
ZCTA5 05150,257,252,5,416,63.9,416,0,0,0,757,-341
ZCTA5 05151,609,298,311,1717,48.3,1464,0,19,0.011065812,605,1112
ZCTA5 05152,172,3813,-3641,457,50,439,14,0,0,9324,-8867
ZCTA5 05153,271,534,-263,783,47.4,707,2,4,0.005108557,1331,-548
ZCTA5 05154,243,281,-38,533,46.2,524,0,0,0,588,-55
ZCTA5 05155,330,5951,-5621,705,54.6,657,0,16,0.022695035,14524,-13819
ZCTA5 05156,3924,1592,2332,9251,47.8,8763,71,28,0.0030267,3497,5754
ZCTA5 05158,429,680,-251,1112,45.6,1075,0,9,0.008093525,1439,-327
ZCTA5 05161,288,116,172,796,55,709,19,0,0,248,548
ZCTA5 05201,5984,287,5697,14831,45.8,14030,183,123,0.008293439,596,14235
ZCTA5 05250,1327,164,1163,3462,45,3091,47,148,0.042749856,420,3042
ZCTA5 05251,626,1853,-1227,1572,48.4,1460,49,0,0,3944,-2372
ZCTA5 05252,171,874,-703,579,37.7,576,0,0,0,2796,-2217
ZCTA5 05253,257,118,139,509,50.8,471,0,0,0,279,230
ZCTA5 05254,149,1191,-1042,420,60.4,354,0,7,0.016666667,2911,-2491
ZCTA5 05255,1815,1149,666,4085,52.6,3969,0,24,0.005875153,2663,1422
ZCTA5 05257,946,7388,-6442,3225,35.9,2895,95,14,0.004341085,16793,-13568
ZCTA5 05260,167,311,-144,400,65.5,386,0,0,0,659,-259
ZCTA5 05261,820,222,598,2294,40.9,2245,0,0,0,471,1823
ZCTA5 05262,755,238,517,2196,42.3,2176,0,0,0,537,1659
ZCTA5 05301,7388,323,7065,16560,47.7,15527,327,82,0.004951691,774,15786
ZCTA5 05340,272,991,-719,648,41.6,588,26,0,0,2256,-1608
ZCTA5 05341,247,1850,-1603,601,45,592,9,0,0,4783,-4182
ZCTA5 05342,232,329,-97,609,48,593,10,0,0,799,-190
ZCTA5 05343,430,362,68,926,50.3,884,0,17,0.018358531,819,107
ZCTA5 05344,0,443,-443,460,20.7,359,9,86,0.186956522,973,-513
ZCTA5 05345,790,869,-79,1846,47.9,1798,6,0,0,2138,-292
ZCTA5 05346,1998,282,1716,5283,47.1,4879,21,136,0.025742949,599,4684
ZCTA5 05350,314,431,-117,755,43.4,749,0,0,0,893,-138
ZCTA5 05351,149,111,38,266,53.7,266,0,0,0,225,41
ZCTA5 05352,351,294,57,882,52.4,838,22,0,0,569,313
ZCTA5 05353,569,101,468,1471,58.1,1336,0,0,0,238,1233
ZCTA5 05354,876,384,492,2587,37.6,2422,21,4,0.001546193,946,1641
ZCTA5 05355,307,50,257,787,56.5,787,0,0,0,132,655
ZCTA5 05356,323,1136,-813,529,54.2,492,12,10,0.018903592,2518,-1989
ZCTA5 05358,141,12419,-12278,396,35.3,395,1,0,0,27970,-27574
ZCTA5 05359,232,7968,-7736,622,41,577,0,1,0.001607717,17751,-17129
ZCTA5 05360,119,3175,-3056,379,32.7,379,0,0,0,7035,-6656
ZCTA5 05361,371,0,371,1114,37.6,1065,0,3,0.002692998,4136,-3022
ZCTA5 05362,130,4278,-4148,263,56.7,261,0,0,0,10302,-10039
ZCTA5 05363,930,17,913,1994,54.8,1887,34,0,0,1649,345
ZCTA5 05401,13031,783,12248,32724,25.1,27764,1518,1570,0.04797702,1785,30939
ZCTA5 05403,8651,364,8287,19877,38.6,16827,1628,283,0.014237561,1076,18801
ZCTA5 05404,3628,130,3498,8224,32.7,6722,1033,259,0.031493191,327,7897
ZCTA5 05405,0,2581,-2581,2015,19.5,1939,38,12,0.005955335,6503,-4488
ZCTA5 05408,4219,712,3507,10097,45.5,8704,505,368,0.036446469,1790,8307
ZCTA5 05439,0,1403,-1403,1347,19.5,1293,0,15,0.011135857,3756,-2409
ZCTA5 05440,764,6174,-5410,1783,50.1,1697,20,18,0.010095345,15743,-13960
ZCTA5 05441,238,35,203,576,51.2,512,0,0,0,94,482
ZCTA5 05442,179,448,-269,400,47.4,381,0,0,0,1090,-690
ZCTA5 05443,2691,1886,805,6410,46.8,6187,27,76,0.011856474,4808,1602
ZCTA5 05444,590,7732,-7142,1518,40.6,1430,5,0,0,19810,-18292
ZCTA5 05445,1717,1846,-129,3900,51.7,3754,11,38,0.00974359,4845,-945
ZCTA5 05446,6733,395,6338,16001,38.4,14274,483,366,0.02287357,1143,14858
ZCTA5 05447,39,581,-542,103,32.2,103,0,0,0,1467,-1364
ZCTA5 05448,344,645,-301,795,49.4,719,14,0,0,1433,-638
ZCTA5 05450,1864,977,887,5221,41.3,4797,26,71,0.013598927,2221,3000
ZCTA5 05452,9365,855,8510,22154,41.6,19428,764,816,0.036833078,2269,19885
ZCTA5 05454,2100,1981,119,5343,36.8,5179,32,0,0,4505,838
ZCTA5 05455,458,796,-338,1371,41.4,1297,0,0,0,1935,-564
ZCTA5 05456,402,207,195,954,46.1,950,0,0,0,510,444
ZCTA5 05457,567,1085,-518,1508,38.9,1431,37,0,0,2747,-1239
ZCTA5 05458,873,1943,-1070,2268,42.1,2079,2,18,0.007936508,5279,-3011
ZCTA5 05459,609,4828,-4219,1544,39.5,1350,0,0,0,13065,-11521
ZCTA5 05461,2079,298,1781,4813,45.6,4661,0,0,0,658,4155
ZCTA5 05462,718,649,69,1634,45.5,1524,58,12,0.007343941,1623,11
ZCTA5 05463,213,577,-364,541,43.3,525,0,0,0,1474,-933
ZCTA5 05464,1131,427,704,3173,34.7,2932,0,0,0,871,2302
ZCTA5 05465,2236,1318,918,5540,46.7,5286,13,45,0.008122744,3401,2139
ZCTA5 05468,4814,1812,3002,13055,42.9,12385,12,272,0.020834929,4486,8569
ZCTA5 05471,407,5638,-5231,741,45.3,740,1,0,0,13870,-13129
ZCTA5 05472,811,0,811,2025,48.6,1968,45,0,0,0,2025
ZCTA5 05473,580,2904,-2324,1398,48.3,1313,4,0,0,7315,-5917
ZCTA5 05474,528,493,35,1211,59,1081,9,1,0.000825764,1455,-244
ZCTA5 05476,1219,33,1186,3248,37.9,2971,2,2,0.000615764,62,3186
ZCTA5 05477,1943,736,1207,4374,43.7,4044,51,31,0.007087334,1645,2729
ZCTA5 05478,6395,570,5825,16003,40.4,14937,197,85,0.005311504,1539,14464
ZCTA5 05481,0,3058,-3058,0,-,0,0,0,#DIV/0!,8003,-8003
ZCTA5 05482,3180,1173,2007,7714,47.6,7184,284,12,0.001555613,3102,4612
ZCTA5 05483,545,2294,-1749,1357,44.2,1329,0,7,0.005158438,5854,-4497
ZCTA5 05485,0,309,-309,0,-,0,0,0,#DIV/0!,795,-795
ZCTA5 05486,581,680,-99,1593,47.1,1488,4,45,0.028248588,1853,-260
ZCTA5 05487,596,3830,-3234,1697,38.4,1644,14,3,0.001767826,9351,-7654
ZCTA5 05488,2960,5206,-2246,8269,41.4,7848,97,41,0.004958278,11767,-3498
ZCTA5 05489,1408,111,1297,3561,41,3465,26,36,0.01010952,268,3293
ZCTA5 05491,2456,7467,-5011,6049,47,5796,4,21,0.003471648,17622,-11573
ZCTA5 05492,384,468,-84,856,47.1,848,0,0,0,1189,-333
ZCTA5 05494,568,191,377,1525,42.8,1388,0,1,0.000655738,425,1100
ZCTA5 05495,4368,285,4083,10628,41.6,9639,213,232,0.021829131,845,9783
ZCTA5 05602,5734,439,5295,12495,45.7,11747,191,47,0.003761505,1048,11447
ZCTA5 05640,75,656,-581,242,16.8,242,0,0,0,1655,-1413
ZCTA5 05641,7371,320,7051,16521,45.9,15721,80,142,0.008595121,854,15667
ZCTA5 05647,462,177,285,1202,42.6,1168,0,0,0,438,764
ZCTA5 05648,211,367,-156,589,41.8,564,0,13,0.022071307,577,12
ZCTA5 05649,192,1245,-1053,532,45,515,0,0,0,2880,-2348
ZCTA5 05650,421,1276,-855,954,48.1,946,0,0,0,3512,-2558
ZCTA5 05651,551,19,532,1380,39.6,1342,3,0,0,41,1339
ZCTA5 05652,326,604,-278,735,46.4,724,0,0,0,1557,-822
ZCTA5 05653,245,698,-453,617,42.1,591,0,0,0,1607,-990
ZCTA5 05654,607,2356,-1749,1310,32.4,1178,0,132,0.100763359,5653,-4343
ZCTA5 05655,1241,2061,-820,3009,43.9,2912,35,0,0,6771,-3762
ZCTA5 05656,1284,0,1284,3552,28.7,3345,13,50,0.014076577,0,3552
ZCTA5 05658,609,885,-276,1720,38,1539,6,0,0,2287,-567
ZCTA5 05660,733,262,471,1719,49.5,1673,10,0,0,537,1182
ZCTA5 05661,2699,1823,876,6052,38.5,5550,11,238,0.039325843,4319,1733
ZCTA5 05663,2211,1094,1117,7083,29.4,6588,116,49,0.006917973,2443,4640
ZCTA5 05664,0,648,-648,0,-,0,0,0,#DIV/0!,1494,-1494
ZCTA5 05666,18,426,-408,49,56.5,40,0,0,0,987,-938
ZCTA5 05667,962,2182,-1220,2184,43.8,2081,42,21,0.009615385,5091,-2907
ZCTA5 05669,319,945,-626,868,35.9,864,0,0,0,2060,-1192
ZCTA5 05670,39,54,-15,110,44.5,39,0,0,0,99,11
ZCTA5 05672,2497,1356,1141,5315,49.4,5089,0,1,0.000188147,3367,1948
ZCTA5 05673,1129,875,254,2363,47,2244,4,8,0.003385527,2074,289
ZCTA5 05674,702,156,546,1632,52.2,1572,2,39,0.023897059,402,1230
ZCTA5 05675,418,507,-89,930,51.1,900,0,4,0.004301075,1270,-340
ZCTA5 05676,2026,9101,-7075,4747,39.2,4530,75,4,0.000842637,20404,-15657
ZCTA5 05677,865,120,745,2303,43.3,2297,0,0,0,240,2063
ZCTA5 05678,34,357,-323,81,39.4,81,0,0,0,802,-721
ZCTA5 05679,1195,2558,-1363,3076,43.5,2927,2,0,0,5894,-2818
ZCTA5 05680,888,561,327,2190,41.8,2153,0,16,0.007305936,1322,868
ZCTA5 05681,59,1417,-1358,139,49.7,134,0,0,0,4049,-3910
ZCTA5 05682,517,366,151,1305,44.6,1229,0,22,0.016858238,892,413
ZCTA5 05701,9378,362,9016,20523,49.3,19529,208,225,0.010963309,814,19709
ZCTA5 05730,153,456,-303,359,60.4,359,0,0,0,1136,-777
ZCTA5 05731,0,569,-569,0,-,0,0,0,#DIV/0!,1508,-1508
ZCTA5 05732,496,0,496,1083,47.7,1032,0,0,0,0,1083
ZCTA5 05733,2505,263,2242,6039,49.8,5704,132,5,0.000827952,693,5346
ZCTA5 05734,526,1797,-1271,1244,49.8,1190,2,0,0,4314,-3070
ZCTA5 05735,1349,221,1128,3947,33.7,3734,20,69,0.017481632,568,3379
ZCTA5 05736,239,138,101,588,41.6,588,0,0,0,304,284
ZCTA5 05737,242,175,67,619,38.1,594,1,0,0,403,216
ZCTA5 05738,468,377,91,1279,47.7,1200,28,13,0.010164191,798,481
ZCTA5 05739,521,3658,-3137,1214,48.1,1191,4,0,0,10484,-9270
ZCTA5 05742,230,351,-121,589,47.2,589,0,0,0,770,-181
ZCTA5 05743,1549,330,1219,4234,41.5,4073,6,3,0.00070855,736,3498
ZCTA5 05744,183,790,-607,393,49.7,388,0,5,0.012722646,1617,-1224
ZCTA5 05746,0,421,-421,0,-,0,0,0,#DIV/0!,1037,-1037
ZCTA5 05747,139,421,-282,300,42,290,1,0,0,1108,-808
ZCTA5 05748,234,228,6,479,32.5,449,4,0,0,580,-101
ZCTA5 05751,311,1095,-784,697,48,554,46,1,0.00143472,2651,-1954
ZCTA5 05753,3610,1279,2331,10806,34.5,9246,567,322,0.02979826,3448,7358
ZCTA5 05757,318,791,-473,805,53.4,793,4,0,0,1788,-983
ZCTA5 05758,243,212,31,631,43.7,561,0,0,0,544,87
ZCTA5 05759,719,466,253,1833,45.3,1780,0,0,0,959,874
ZCTA5 05760,355,486,-131,807,52.4,766,8,0,0,1230,-423
ZCTA5 05761,420,424,-4,926,51.8,874,0,0,0,1059,-133
ZCTA5 05762,193,280,-87,372,50.4,356,2,6,0.016129032,640,-268
ZCTA5 05763,1225,937,288,3030,49.8,2748,40,32,0.010561056,2215,815
ZCTA5 05764,1060,593,467,3117,35.5,2904,20,67,0.021495027,1449,1668
ZCTA5 05765,668,278,390,1838,43.2,1810,0,0,0,633,1205
ZCTA5 05766,243,333,-90,549,47.1,549,0,0,0,729,-180
ZCTA5 05767,684,1476,-792,1250,57.2,1232,5,0,0,3666,-2416
ZCTA5 05768,14,289,-275,39,44.6,39,0,0,0,728,-689
ZCTA5 05769,479,4125,-3646,1225,50.9,1166,11,0,0,9639,-8414
ZCTA5 05770,442,271,171,1092,50.8,1017,3,4,0.003663004,651,441
ZCTA5 05772,368,439,-71,788,47.2,752,20,0,0,1252,-464
ZCTA5 05773,887,743,144,2493,37.3,2410,26,19,0.00762134,1750,743
ZCTA5 05774,388,469,-81,964,42.8,904,6,0,0,1080,-116
ZCTA5 05775,237,116,121,642,49.3,575,0,0,0,292,350
ZCTA5 05776,146,368,-222,387,50.4,387,0,0,0,998,-611
ZCTA5 05777,1400,133,1267,3315,48.3,3254,6,13,0.003921569,286,3029
ZCTA5 05778,327,899,-572,826,39.3,715,8,8,0.00968523,2049,-1223
ZCTA5 05819,3868,775,3093,9304,45.2,8682,69,92,0.00988822,1763,7541
ZCTA5 05820,156,743,-587,397,42.4,389,0,0,0,1836,-1439
ZCTA5 05821,363,368,-5,965,47.2,905,0,12,0.012435233,836,129
ZCTA5 05822,810,83,727,1735,55.4,1614,12,35,0.020172911,193,1542
ZCTA5 05824,512,401,111,1128,48.7,1076,2,0,0,1184,-56
ZCTA5 05825,31,173,-142,62,52.8,62,0,0,0,394,-332
ZCTA5 05826,311,268,43,668,47.3,655,0,0,0,757,-89
ZCTA5 05827,159,192,-33,513,46.1,450,1,8,0.015594542,376,137
ZCTA5 05828,847,217,630,1900,51.3,1815,11,0,0,592,1308
ZCTA5 05829,745,932,-187,1503,62,1499,0,0,0,2570,-1067
ZCTA5 05830,635,414,221,1327,49.1,1263,0,0,0,1024,303
ZCTA5 05832,403,469,-66,1115,38.5,1108,0,0,0,954,161
ZCTA5 05833,18,332,-314,42,67.3,42,0,0,0,915,-873
ZCTA5 05836,543,19,524,1372,38.9,1343,12,7,0.005102041,157,1215
ZCTA5 05837,160,2520,-2360,364,48,313,0,9,0.024725275,6505,-6141
ZCTA5 05839,242,303,-61,733,39.2,682,1,1,0.001364256,798,-65
ZCTA5 05840,19,2863,-2844,44,62.3,44,0,0,0,7204,-7160
ZCTA5 05841,180,617,-437,373,59,335,0,0,0,1463,-1090
ZCTA5 05842,223,195,28,566,39.9,559,0,2,0.003533569,472,94
ZCTA5 05843,1005,783,222,2394,48.5,2184,7,37,0.015455305,1954,440
ZCTA5 05845,528,977,-449,1318,38.2,1283,0,0,0,2518,-1200
ZCTA5 05846,625,175,450,1247,54.5,1214,2,0,0,347,900
ZCTA5 05847,326,230,96,945,33.8,866,0,7,0.007407407,545,400
ZCTA5 05850,56,384,-328,304,30.2,282,0,0,0,921,-617
ZCTA5 05851,2495,142,2353,6075,40.2,5780,0,104,0.017119342,319,5756
ZCTA5 05853,323,636,-313,720,53.1,699,0,0,0,1625,-905
ZCTA5 05855,3279,293,2986,7900,45.3,7578,10,88,0.011139241,664,7236
ZCTA5 05857,572,239,333,1345,46.2,1298,0,19,0.014126394,569,776
ZCTA5 05858,138,221,-83,320,39.3,316,0,0,0,581,-261
ZCTA5 05859,877,202,675,2241,41.6,2176,0,10,0.004462294,479,1762
ZCTA5 05860,1140,3,1137,2996,38.8,2811,0,2,0.000667557,5,2991
ZCTA5 05862,160,86,74,336,56.9,304,0,5,0.014880952,163,173
ZCTA5 05866,301,442,-141,752,49.7,677,15,0,0,1070,-318
ZCTA5 05867,271,124,147,746,40.4,717,0,9,0.012064343,253,493
ZCTA5 05868,35,351,-316,96,51.7,96,0,0,0,721,-625
ZCTA5 05871,556,554,2,1381,47.6,1323,0,2,0.001448226,1335,46
ZCTA5 05872,411,89,322,926,44.6,896,0,0,0,174,752
ZCTA5 05873,344,7305,-6961,645,54.2,629,0,16,0.024806202,18410,-17765
ZCTA5 05874,215,8505,-8290,633,44.4,594,0,0,0,20470,-19837
ZCTA5 05875,199,25207,-25008,430,51.1,331,0,0,0,60478,-60048
ZCTA5 05901,9,3520,-3511,16,-,16,0,0,0,9317,-9301
ZCTA5 05902,57,2530,-2473,112,57.5,108,0,0,0,6332,-6220
ZCTA5 05903,351,1133,-782,739,52,735,0,0,0,2690,-1951
ZCTA5 05904,95,3946,-3851,194,55.5,187,0,0,0,10149,-9955
ZCTA5 05905,414,0,414,858,56.6,834,0,0,0,0,858
ZCTA5 05906,527,134,393,1370,47.2,1267,39,0,0,345,1025
ZCTA5 05907,56,60,-4,103,53.9,96,1,0,0,94,9
ZCTA5 06001,7570,409,7161,19132,45.3,15151,2686,233,0.012178549,1004,18128
ZCTA5 06002,8802,340,8462,21399,48.3,7140,898,12194,0.569839712,768,20631
ZCTA5 06010,24557,2042,22515,60745,40.1,48004,928,3667,0.060367108,4929,55816
ZCTA5 06013,3318,498,2820,9511,41.7,8642,269,44,0.004626222,1481,8030
ZCTA5 06016,2730,6077,-3347,6940,36.9,5200,440,746,0.107492795,15466,-8526
ZCTA5 06018,1055,608,447,2607,46.4,2476,0,60,0.02301496,1273,1334
ZCTA5 06019,4173,7311,-3138,9989,49.3,9043,136,387,0.038742617,17880,-7891
ZCTA5 06020,19,10836,-10817,37,-,37,0,0,0,28563,-28526
ZCTA5 06021,598,3149,-2551,1422,50.3,1350,12,19,0.013361463,7697,-6275
ZCTA5 06022,23,7210,-7187,67,40.5,67,0,0,0,18970,-18903
ZCTA5 06023,693,797,-104,1601,50.5,1405,127,0,0,1970,-369
ZCTA5 06024,189,14488,-14299,602,56.5,470,0,0,0,35974,-35372
ZCTA5 06026,1879,9965,-8086,5093,40.3,4048,146,276,0.054192028,22104,-17011
ZCTA5 06027,601,1996,-1395,1431,55.4,1323,0,1,0.000698812,4990,-3559
ZCTA5 06029,6714,11923,-5209,16339,39.3,13892,1030,466,0.028520717,30568,-14229
ZCTA5 06031,630,3037,-2407,1421,55.7,1358,19,17,0.011963406,7661,-6240
ZCTA5 06032,7790,13143,-5353,18430,44.5,13461,3120,799,0.043353228,34893,-16463
ZCTA5 06033,11930,2572,9358,29385,44.9,23938,2942,540,0.018376723,6704,22681
ZCTA5 06035,3158,646,2512,8030,46.1,7531,34,75,0.009339975,1554,6476
ZCTA5 06037,7412,0,7412,18506,47.5,16451,951,73,0.003944667,0,18506
ZCTA5 06039,729,972,-243,1837,48.9,1715,40,11,0.005988024,2532,-695
ZCTA5 06040,14830,108,14722,36298,36.7,21721,3048,6439,0.177392694,220,36078
ZCTA5 06042,10122,7591,2531,23154,37,14176,3706,2705,0.116826466,17726,5428
ZCTA5 06043,1868,1229,639,4839,45.2,4407,167,36,0.007439554,3185,1654
ZCTA5 06051,12204,346,11858,31737,32,16789,468,5326,0.167816744,1015,30722
ZCTA5 06052,3329,13271,-9942,8344,39.1,5360,58,1137,0.13626558,29188,-20844
ZCTA5 06053,12782,8109,4673,34049,33.1,21440,1452,4058,0.11918118,19631,14418
ZCTA5 06057,2510,601,1909,6380,47.4,6079,106,2,0.00031348,1582,4798
ZCTA5 06058,700,1149,-449,1750,50.8,1586,12,7,0.004,2478,-728
ZCTA5 06059,17,5439,-5422,38,-,17,0,0,0,15116,-15078
ZCTA5 06060,772,3360,-2588,2311,44.1,2234,48,1,0.000432713,11598,-9287
ZCTA5 06061,110,2030,-1920,305,32.4,305,0,0,0,5838,-5533
ZCTA5 06062,8004,9384,-1380,17543,43.7,14680,826,437,0.024910221,25684,-8141
ZCTA5 06063,1220,4970,-3750,3359,48,3249,12,2,0.000595415,12771,-9412
ZCTA5 06065,237,3767,-3530,629,56.9,580,0,0,0,12395,-11766
ZCTA5 06066,13695,718,12977,30002,37.8,23252,1576,2108,0.070261983,1415,28587
ZCTA5 06067,8894,16400,-7506,20682,44.2,14422,3732,790,0.038197466,44699,-24017
ZCTA5 06068,674,5476,-4802,2004,48.8,1947,0,16,0.007984032,15063,-13059
ZCTA5 06069,1171,2821,-1650,2443,51.8,2181,44,6,0.002455997,7020,-4577
ZCTA5 06070,5813,2004,3809,15333,45.3,13058,578,746,0.048653232,4864,10469
ZCTA5 06071,3400,1072,2328,10771,45.5,9233,25,597,0.055426608,2733,8038
ZCTA5 06072,0,431,-431,0,-,0,0,0,#DIV/0!,1212,-1212
ZCTA5 06073,2148,70,2078,5676,44.1,5085,255,66,0.011627907,178,5498
ZCTA5 06074,9926,1434,8492,26719,41.4,19213,4622,1071,0.040083835,4271,22448
ZCTA5 06076,5053,1217,3836,11954,45,11236,85,38,0.003178852,3297,8657
ZCTA5 06078,3853,10707,-6854,10107,46,8971,365,438,0.043336302,29088,-18981
ZCTA5 06079,21,5298,-5277,43,-,43,0,0,0,12500,-12457
ZCTA5 06080,0,5023,-5023,2079,39,505,0,1010,0.485810486,12255,-10176
ZCTA5 06081,600,876,-276,1684,38.4,1471,83,0,0,1325,359
ZCTA5 06082,16588,9974,6614,42480,40.6,33064,1172,2946,0.069350282,20759,21721
ZCTA5 06084,5411,13836,-8425,14546,41.5,13002,501,47,0.003231129,37516,-22970
ZCTA5 06085,2898,7594,-4696,7499,40.9,6090,1162,11,0.001466862,18551,-11052
ZCTA5 06088,2186,9435,-7249,4251,51.7,3446,380,100,0.023523877,24173,-19922
ZCTA5 06089,1285,11123,-9838,2838,40.7,2422,110,30,0.010570825,26670,-23832
ZCTA5 06090,334,4977,-4643,685,56.9,623,62,0,0,12690,-12005
ZCTA5 06091,93,12699,-12606,203,46.5,153,0,0,0,30520,-30317
ZCTA5 06092,1412,7346,-5934,4612,39.7,4316,93,0,0,22578,-17966
ZCTA5 06093,1356,9918,-8562,3677,43.3,3406,0,53,0.014413924,28656,-24979
ZCTA5 06095,11278,5597,5681,29424,44.2,13956,1238,10851,0.368780587,17951,11473
ZCTA5 06096,5357,10904,-5547,12559,43.4,9964,897,982,0.078190939,26998,-14439
ZCTA5 06098,4708,6631,-1923,10316,50.6,9576,1,116,0.011244668,14965,-4649
ZCTA5 06103,1424,4270,-2846,2137,32.2,1132,516,324,0.151614413,13092,-10955
ZCTA5 06105,9685,0,9685,19769,33.2,6688,760,6802,0.344074055,0,19769
ZCTA5 06106,14176,6789,7387,38410,33.6,13252,1047,8038,0.20926842,19578,18832
ZCTA5 06107,7912,1332,6580,20460,40.3,17572,1362,375,0.018328446,4054,16406
ZCTA5 06108,9137,1135,8002,23784,34.3,10941,559,7174,0.301631349,3185,20599
ZCTA5 06109,11411,2765,8646,27162,44.4,22852,846,1255,0.046204256,8194,18968
ZCTA5 06110,5375,852,4523,12979,39.2,8370,1304,1629,0.12551044,2324,10655
ZCTA5 06111,12575,2083,10492,30493,46.1,24642,2043,1115,0.036565769,5464,25029
ZCTA5 06112,7533,4653,2880,21891,31.8,3760,85,15191,0.693938148,12445,9446
ZCTA5 06114,9649,4273,5376,26537,33.9,6901,711,6689,0.252063157,10941,15596
ZCTA5 06117,5759,2557,3202,15496,45.9,11563,1562,1308,0.08440888,6861,8635
ZCTA5 06118,10510,540,9970,27187,39,15110,1113,6676,0.245558539,1448,25739
ZCTA5 06119,6482,0,6482,14729,35,11185,694,1308,0.088804399,0,14729
ZCTA5 06120,4761,1074,3687,13399,30.9,2565,32,7196,0.537055004,2732,10667
ZCTA5 06226,6752,1950,4802,19365,30.6,12727,464,1226,0.063310096,5595,13770
ZCTA5 06231,1384,2849,-1465,3463,47.8,3311,14,0,0,7289,-3826
ZCTA5 06232,1178,2198,-1020,2998,50,2750,47,49,0.016344229,5908,-2910
ZCTA5 06234,2833,746,2087,8476,42.9,7470,366,175,0.020646531,1984,6492
ZCTA5 06235,878,1896,-1018,2185,43.9,1918,9,8,0.003661327,4852,-2667
ZCTA5 06237,2216,1249,967,5269,53.2,4946,0,72,0.013664832,2523,2746
ZCTA5 06238,4780,1648,3132,12186,44.4,11164,327,98,0.008042015,4473,7713
ZCTA5 06239,4483,3714,769,10832,43.5,9652,116,155,0.014309453,9516,1316
ZCTA5 06241,2684,310,2374,6883,39.4,6369,24,56,0.008135987,567,6316
ZCTA5 06242,517,112,405,1280,47.7,1231,3,3,0.00234375,202,1078
ZCTA5 06243,57,56,1,261,33.8,261,0,0,0,154,107
ZCTA5 06247,966,189,777,2382,48.1,2298,1,1,0.000419815,693,1689
ZCTA5 06248,2219,3401,-1182,5659,45.6,5451,87,5,0.000883548,11044,-5385
ZCTA5 06249,2847,5,2842,7140,47.8,6553,57,0,0,9009,-1869
ZCTA5 06250,2168,1372,796,5446,34.6,4641,390,42,0.007712082,3913,1533
ZCTA5 06254,705,1675,-970,1835,41.9,1538,3,36,0.019618529,4386,-2551
ZCTA5 06255,1887,2337,-450,4427,46.8,4234,0,9,0.002032979,6042,-1615
ZCTA5 06256,919,1079,-160,2096,45.4,1993,0,0,0,2899,-803
ZCTA5 06258,0,2678,-2678,83,18.8,58,0,13,0.156626506,7092,-7009
ZCTA5 06259,1762,452,1310,4406,46.9,4114,86,72,0.016341353,985,3421
ZCTA5 06260,3756,10385,-6629,9250,44.3,8145,104,124,0.013405405,27675,-18425
ZCTA5 06262,414,1441,-1027,731,57.2,731,0,0,0,3395,-2664
ZCTA5 06263,83,2122,-2039,202,37,155,0,0,0,5111,-4909
ZCTA5 06264,70,83,-13,150,48.3,118,0,0,0,260,-110
ZCTA5 06266,115,2217,-2102,295,37.4,263,3,27,0.091525424,6485,-6190
ZCTA5 06268,3977,1000,2977,12094,21.6,9460,1583,556,0.04597321,2592,9502
ZCTA5 06269,147,2543,-2396,8680,19.8,6922,966,492,0.056682028,6608,2072
ZCTA5 06277,1480,24,1456,4008,49.9,3567,84,3,0.000748503,32,3976
ZCTA5 06278,1824,3061,-1237,4349,37.6,4001,25,0,0,8373,-4024
ZCTA5 06279,2542,12024,-9482,5586,33.8,4786,399,40,0.007160759,31594,-26008
ZCTA5 06280,1374,9,1365,3173,31.9,2715,2,64,0.020170186,19,3154
ZCTA5 06281,2939,6388,-3449,7206,43.4,6543,22,9,0.001248959,16262,-9056
ZCTA5 06282,487,116,371,1028,57.9,1028,0,0,0,252,776
ZCTA5 06320,11138,2370,8768,27585,32.8,14783,786,4431,0.160630778,5973,21612
ZCTA5 06330,1251,5416,-4165,3384,39.7,2766,61,121,0.035756501,12499,-9115
ZCTA5 06331,2144,4742,-2598,5080,46,4681,61,46,0.009055118,12683,-7603
ZCTA5 06332,448,2104,-1656,882,52.9,687,62,76,0.0861678,5309,-4427
ZCTA5 06333,2723,15489,-12766,6953,45.1,5234,830,205,0.029483676,37295,-30342
ZCTA5 06334,902,1854,-952,2308,46.5,2137,11,2,0.000866551,4736,-2428
ZCTA5 06335,2197,2691,-494,6014,36,5530,149,137,0.02278018,7306,-1292
ZCTA5 06336,19,4129,-4110,81,40.2,67,0,14,0.172839506,9843,-9762
ZCTA5 06338,31,94,-63,76,47.6,9,2,2,0.026315789,290,-214
ZCTA5 06339,3497,2934,563,9283,39.6,7508,495,128,0.013788646,8497,786
ZCTA5 06340,12660,1551,11109,30565,31.6,21485,2390,2308,0.075511206,4276,26289
ZCTA5 06350,58,67,-9,121,62.1,120,0,0,0,116,5
ZCTA5 06351,6557,988,5569,15665,45,14151,72,18,0.001149058,2878,12787
ZCTA5 06353,140,2316,-2176,200,31.3,145,0,55,0.275,5366,-5166
ZCTA5 06354,2211,3591,-1380,5522,39.5,5275,79,63,0.01140891,9196,-3674
ZCTA5 06355,5192,1112,4080,12108,51.6,10051,490,280,0.023125206,2909,9199
ZCTA5 06357,4847,4122,725,11845,53.1,9670,610,439,0.037062051,11795,50
ZCTA5 06359,2106,1040,1066,5151,49.7,4809,182,2,0.000388274,2777,2374
ZCTA5 06360,15611,6487,9124,37371,38.6,25034,2745,4558,0.12196623,15395,21976
ZCTA5 06365,1806,112,1694,4718,44.5,4389,94,44,0.009325986,387,4331
ZCTA5 06370,2757,35,2722,7578,37.9,6699,74,490,0.06466086,99,7479
ZCTA5 06371,4016,145,3871,9946,50.6,9180,166,77,0.007741806,307,9639
ZCTA5 06373,60,7380,-7320,159,51.2,148,0,0,0,19188,-19029
ZCTA5 06374,3172,2227,945,8141,42.1,7333,138,460,0.056504115,5946,2195
ZCTA5 06375,1457,12355,-10898,3810,46.7,3244,140,100,0.026246719,27952,-24142
ZCTA5 06376,20,332,-312,51,44.4,51,0,0,0,728,-677
ZCTA5 06377,1001,9481,-8480,2938,39.6,2710,16,13,0.004424779,29132,-26194
ZCTA5 06378,2665,1697,968,5670,55,5273,106,137,0.024162257,4090,1580
ZCTA5 06379,3850,5407,-1557,8697,43.2,7329,118,346,0.039783834,13207,-4510
ZCTA5 06380,1264,93,1171,2554,48.2,2115,0,318,0.124510572,431,2123
ZCTA5 06382,3702,6143,-2441,10786,43.9,7757,571,864,0.080103838,16532,-5746
ZCTA5 06384,1086,5544,-4458,2639,47.4,2268,0,139,0.052671466,14059,-11420
ZCTA5 06385,6748,1881,4867,15791,46.8,13744,660,422,0.026724083,4636,11155
ZCTA5 06387,163,5195,-5032,359,38,263,3,0,0,12858,-12499
ZCTA5 06389,48,2518,-2470,95,54.1,95,0,0,0,6512,-6417
ZCTA5 06390,22,1536,-1514,58,37.3,46,0,0,0,4161,-4103
ZCTA5 06401,8032,2589,5443,18927,42.2,12756,293,2567,0.135626354,7368,11559
ZCTA5 06403,2631,1944,687,6027,50.6,5743,34,44,0.007300481,5087,940
ZCTA5 06405,12686,4853,7833,28102,51.3,24686,998,818,0.029108249,12456,15646
ZCTA5 06409,363,1507,-1144,682,48.3,546,136,0,0,3228,-2546
ZCTA5 06410,9900,8843,1057,28748,45.4,23100,1796,1183,0.041150689,22353,6395
ZCTA5 06412,1548,1034,514,3787,49.5,3462,33,66,0.017428043,2764,1023
ZCTA5 06413,5400,2025,3375,13269,47.6,12589,183,7,0.000527545,5330,7939
ZCTA5 06414,30,1037,-1007,112,65,112,0,0,0,2726,-2614
ZCTA5 06415,6333,6738,-405,16111,43,14501,192,453,0.028117435,18264,-2153
ZCTA5 06416,5742,48,5694,14252,42.3,11828,618,857,0.060131911,191,14061
ZCTA5 06417,2061,2229,-168,4473,48.3,4300,32,71,0.015873016,6382,-1909
ZCTA5 06418,5613,14642,-9029,12405,46.8,9530,219,1398,0.112696493,36756,-24351
ZCTA5 06419,2276,9145,-6869,6276,50.6,5794,92,0,0,23918,-17642
ZCTA5 06420,1695,1241,454,4261,38.5,3830,54,56,0.013142455,3480,781
ZCTA5 06422,3019,120,2899,7242,46.1,6745,76,7,0.000966584,280,6962
ZCTA5 06423,2223,19792,-17569,5337,53,5115,6,19,0.003560052,47530,-42193
ZCTA5 06424,4731,15682,-10951,12725,43.2,11549,389,114,0.008958743,37953,-25228
ZCTA5 06426,1621,5389,-3768,3563,57.4,3176,89,31,0.008700533,14873,-11310
ZCTA5 06437,8665,21,8644,22113,48.9,19960,930,541,0.024465247,45,22068
ZCTA5 06438,986,6530,-5544,2922,46.1,2805,12,2,0.000684463,19529,-16607
ZCTA5 06439,15,1406,-1391,15,-,15,0,0,0,3535,-3520
ZCTA5 06441,1995,5339,-3344,5394,42.5,4767,448,104,0.019280682,16237,-10843
ZCTA5 06442,980,3194,-2214,2480,40.3,2415,11,0,0,7663,-5183
ZCTA5 06443,6719,2420,4299,17742,50.8,16306,531,88,0.004959982,6816,10926
ZCTA5 06444,72,8966,-8894,178,37.8,178,0,0,0,24200,-24022
ZCTA5 06447,2142,4400,-2258,6155,43.2,5752,97,165,0.026807474,10268,-4113
ZCTA5 06450,15112,4844,10268,36367,40.2,26218,1027,3168,0.087111942,13919,22448
ZCTA5 06451,10079,4420,5659,24423,40.1,15027,548,2615,0.107071203,12602,11821
ZCTA5 06455,1187,4277,-3090,2935,50.2,2780,42,19,0.006473595,10585,-7650
ZCTA5 06456,122,3731,-3609,199,65.8,199,0,0,0,9500,-9301
ZCTA5 06457,20084,436,19648,46000,40.6,32472,2568,7270,0.158043478,946,45054
ZCTA5 06459,5,3768,-3763,1164,20.2,857,100,128,0.109965636,11306,-10142
ZCTA5 06460,15863,6313,9550,37309,46.4,31733,1906,906,0.024283685,16487,20822
ZCTA5 06461,5447,15019,-9572,14999,45.5,12697,1309,285,0.019001267,39641,-24642
ZCTA5 06467,208,8022,-7814,403,35.3,401,0,1,0.00248139,19841,-19438
ZCTA5 06468,6274,12680,-6406,18927,41.4,15664,1035,640,0.033814128,32217,-13290
ZCTA5 06469,1298,17160,-15862,3002,47.4,2938,0,0,0,45168,-42166
ZCTA5 06470,5587,2911,2676,15894,45,14102,267,297,0.018686297,6980,8914
ZCTA5 06471,2977,1451,1526,7332,51.6,7027,84,2,0.000272777,2496,4836
ZCTA5 06472,2203,21027,-18824,6439,42.7,5913,83,61,0.009473521,54837,-48398
ZCTA5 06473,9642,11639,-1997,24614,46.2,20354,1596,1172,0.047615178,29016,-4402
ZCTA5 06475,4584,14707,-10123,10506,56.1,10115,162,57,0.005425471,38749,-28243
ZCTA5 06477,5169,10033,-4864,14225,44.9,11177,1683,887,0.062355009,26917,-12692
ZCTA5 06478,4781,6475,-1694,12744,46.9,11523,391,138,0.010828625,17780,-5036
ZCTA5 06479,4136,21878,-17742,9587,48.7,8834,115,284,0.029623448,55386,-45799
ZCTA5 06480,3564,6283,-2719,9459,41.3,8693,210,84,0.008880431,14683,-5224
ZCTA5 06481,608,6718,-6110,1341,46.7,1180,105,0,0,19135,-17794
ZCTA5 06482,4068,5307,-1239,11494,45.7,10129,349,198,0.017226379,16045,-4551
ZCTA5 06483,6432,1915,4517,16731,41.6,14436,258,461,0.027553643,5524,11207
ZCTA5 06484,16204,3364,12840,40944,47.9,34815,2018,1153,0.028160414,8990,31954
ZCTA5 06488,8029,10219,-2190,19866,50.8,17825,626,455,0.022903453,28764,-8898
ZCTA5 06489,12722,8473,4249,33265,44.2,29489,1143,737,0.022155419,23603,9662
ZCTA5 06492,18289,16674,1615,44446,44.3,37576,2106,551,0.012397066,48725,-4279
ZCTA5 06498,3494,2617,877,6814,54.5,5527,65,76,0.011153507,7533,-719
ZCTA5 06510,2233,4279,-2046,3942,28.1,2071,659,759,0.192541857,13772,-9830
ZCTA5 06511,20507,8562,11945,54856,29.1,19733,4391,22467,0.40956322,22049,32807
ZCTA5 06512,11316,12140,-824,28711,43.2,21139,1205,2005,0.069833862,36008,-7297
ZCTA5 06513,15064,2527,12537,38790,36.3,17693,778,9440,0.243361691,7501,31289
ZCTA5 06514,10170,12995,-2825,26710,38.3,12294,1024,10185,0.381317858,33295,-6585
ZCTA5 06515,6524,7174,-650,18937,30.5,8396,562,7443,0.39304008,18145,792
ZCTA5 06516,20341,1757,18584,55518,35.9,31653,2819,10819,0.194873735,3431,52087
ZCTA5 06517,5922,9225,-3303,14445,41.9,8249,292,3875,0.268258913,24832,-10387
ZCTA5 06518,6304,10829,-4525,20210,29.9,14011,1706,3080,0.152399802,26838,-6628
ZCTA5 06519,5252,5245,7,16090,31.5,5478,292,4945,0.307333748,14738,1352
ZCTA5 06524,1768,11655,-9887,5331,42.8,4862,282,76,0.014256237,29875,-24544
ZCTA5 06525,3057,3511,-454,9073,46.3,7516,674,213,0.023476248,10371,-1298
ZCTA5 06604,10183,3280,6903,27322,35.1,11066,1379,8730,0.319522729,9450,17872
ZCTA5 06605,9233,5947,3286,24776,32.3,9325,1124,7950,0.32087504,16638,8138
ZCTA5 06606,17125,559,16566,50041,38.2,18220,2889,17577,0.351251973,1251,48790
ZCTA5 06607,2685,1388,1297,9048,27.5,952,423,4139,0.45744916,3528,5520
ZCTA5 06608,4750,746,4004,14162,32.2,3532,374,4378,0.309137128,1704,12458
ZCTA5 06610,8938,684,8254,23180,38.7,7352,461,8789,0.379163072,1846,21334
ZCTA5 06611,12282,378,11904,36830,42.3,29175,2477,1331,0.036139017,1133,35697
ZCTA5 06612,2719,1228,1491,7602,47.9,6735,90,244,0.032096817,2803,4799
ZCTA5 06614,12842,880,11962,33791,44.6,24035,602,5119,0.151490042,2162,31629
ZCTA5 06615,7345,167,7178,18569,41.2,9928,138,5649,0.304216705,435,18134
ZCTA5 06702,1791,2417,-626,2782,56.6,1414,5,659,0.236879942,6081,-3299
ZCTA5 06704,10726,2797,7929,28226,35.1,13361,235,8229,0.291539715,7522,20704
ZCTA5 06705,11200,795,10405,25976,41.3,15564,1407,3740,0.143979058,2029,23947
ZCTA5 06706,5423,12507,-7084,15060,40.1,8002,351,2331,0.154780876,31907,-16847
ZCTA5 06708,12642,10229,2413,31469,36,21408,463,5311,0.168769265,26750,4719
ZCTA5 06710,3362,674,2688,10285,31.2,5310,45,3380,0.328633933,1616,8669
ZCTA5 06712,3238,470,2768,9361,47.4,8617,26,306,0.032688815,1363,7998
ZCTA5 06716,6173,3349,2824,16104,45.5,14774,300,352,0.021857923,8377,7727
ZCTA5 06750,532,928,-396,1112,55.5,1083,14,15,0.013489209,2379,-1267
ZCTA5 06751,1340,990,350,3408,50.3,3151,75,30,0.008802817,2313,1095
ZCTA5 06752,728,1434,-706,1833,54.8,1775,10,11,0.006001091,3803,-1970
ZCTA5 06753,28,299,-271,54,64.5,54,0,0,0,809,-755
ZCTA5 06754,675,3811,-3136,1649,50.3,1323,133,35,0.021224985,9814,-8165
ZCTA5 06755,337,3192,-2855,1009,42,972,0,0,0,7865,-6856
ZCTA5 06756,1117,15332,-14215,3049,48.1,2724,149,3,0.000983929,36152,-33103
ZCTA5 06757,929,2164,-1235,2152,55.4,1903,94,9,0.004182156,5752,-3600
ZCTA5 06758,21,433,-412,32,70.5,32,0,0,0,1111,-1079
ZCTA5 06759,2380,571,1809,5727,53.8,5122,160,153,0.026715558,1188,4539
ZCTA5 06762,2906,5240,-2334,7617,46.2,6826,356,30,0.003938558,14084,-6467
ZCTA5 06763,825,412,413,2117,47,2004,0,59,0.027869627,984,1133
ZCTA5 06770,12212,4208,8004,31699,40.8,25481,1028,2499,0.078835294,9934,21765
ZCTA5 06776,10297,6816,3481,27043,42.7,23194,826,706,0.026106571,18673,8370
ZCTA5 06777,664,5846,-5182,1548,56,1400,29,16,0.010335917,16515,-14967
ZCTA5 06778,493,2492,-1999,1452,51,1271,21,2,0.00137741,6854,-5402
ZCTA5 06779,3405,17820,-14415,7849,45.9,7313,12,68,0.008663524,49146,-41297
ZCTA5 06782,807,11533,-10726,2111,50.6,1991,28,81,0.038370441,31914,-29803
ZCTA5 06783,939,4781,-3842,2095,53.2,1980,73,4,0.001909308,13932,-11837
ZCTA5 06784,1566,6627,-5061,3545,58.2,3162,53,20,0.005641749,20758,-17213
ZCTA5 06785,314,11229,-10915,801,57.7,764,0,19,0.02372035,34374,-33573
ZCTA5 06786,3927,7372,-3445,9594,43.6,8805,7,48,0.005003127,20648,-11054
ZCTA5 06787,3076,9332,-6256,7515,42.7,6975,193,82,0.01091151,24315,-16800
ZCTA5 06790,14344,5234,9110,35360,45.5,30845,834,1282,0.036255656,14526,20834
ZCTA5 06791,2070,6770,-4700,5535,49.5,5355,11,59,0.01065944,19794,-14259
ZCTA5 06793,532,8139,-7607,1423,54.4,1381,3,0,0,20120,-18697
ZCTA5 06794,387,11815,-11428,963,33.4,683,35,34,0.035306334,28616,-27653
ZCTA5 06795,5330,1725,3605,14261,47.1,12673,384,230,0.016127901,3975,10286
ZCTA5 06796,431,11505,-11074,940,62.1,929,3,5,0.005319149,25788,-24848
ZCTA5 06798,4501,3373,1128,9762,54.7,9088,186,89,0.009116984,7047,2715
ZCTA5 06801,7207,0,7207,20287,40.4,15405,1281,1097,0.054074038,2,20285
ZCTA5 06804,6392,2444,3948,17652,45.8,15114,728,540,0.030591434,7268,10384
ZCTA5 06807,2713,8680,-5967,7504,41.3,5854,520,20,0.002665245,24747,-17243
ZCTA5 06810,20216,2734,17482,53931,37.7,27764,3418,5650,0.104763494,8571,45360
ZCTA5 06811,11910,9556,2354,32042,43.6,22287,2194,2807,0.08760377,26790,5252
ZCTA5 06812,4503,3213,1290,13640,41.9,12174,215,79,0.005791789,10203,3437
ZCTA5 06820,6978,1581,5397,21485,39.9,18785,1313,178,0.00828485,4429,17056
ZCTA5 06824,11950,3480,8470,36028,38.3,32387,1252,437,0.012129455,9049,26979
ZCTA5 06825,7416,6036,1380,20992,43.7,17264,1050,740,0.035251524,18343,2649
ZCTA5 06830,9447,3828,5619,24788,43.4,19457,1408,976,0.039373891,7435,17353
ZCTA5 06831,5247,22722,-17475,15172,47.1,13453,593,421,0.027748484,65817,-50645
ZCTA5 06840,6937,4881,2056,20672,42.4,18260,1348,143,0.00691757,14480,6192
ZCTA5 06850,8013,7178,835,19158,40.9,12092,1430,2183,0.113947176,18356,802
ZCTA5 06851,11440,3334,8106,28756,42.6,20274,1530,3162,0.109959661,8499,20257
ZCTA5 06853,1468,3226,-1758,4004,41.9,3698,101,34,0.008491508,8185,-4181
ZCTA5 06854,11076,4857,6219,30352,36.6,16978,1440,5353,0.176363996,16598,13754
ZCTA5 06855,3548,25802,-22254,8449,45,6433,131,734,0.086874186,63164,-54715
ZCTA5 06870,2673,18090,-15417,7907,40.1,6532,606,154,0.019476413,47309,-39402
ZCTA5 06877,9159,2572,6587,25148,45.3,22796,826,380,0.015110546,7347,17801
ZCTA5 06878,2634,5557,-2923,8387,42.1,6191,1377,110,0.013115536,15353,-6966
ZCTA5 06880,9522,9424,98,27242,46.2,23456,1558,263,0.00965421,24976,2266
ZCTA5 06883,3525,7599,-4074,10339,46.9,8623,537,288,0.027855692,23135,-12796
ZCTA5 06890,1680,4346,-2666,4647,42.2,4110,298,101,0.021734452,12432,-7785
ZCTA5 06896,3307,10128,-6821,8736,48.7,7665,299,15,0.001717033,23618,-14882
ZCTA5 06897,6198,12586,-6388,18486,44.1,15420,1499,194,0.010494428,39904,-21418
ZCTA5 06901,5053,4873,180,8878,33.6,4995,1653,1505,0.169520162,12588,-3710
ZCTA5 06902,26869,10015,16854,69523,36.1,34991,5314,11347,0.163212174,25317,44206
ZCTA5 06903,5218,1844,3374,14816,49.8,12206,1008,550,0.03712203,4816,10000
ZCTA5 06905,8365,8350,15,21604,39.8,14653,2236,1922,0.088965006,22659,-1055
ZCTA5 06906,3619,13626,-10007,10847,37.1,6853,829,888,0.081865954,34983,-24136
ZCTA5 06907,3359,11324,-7965,8849,37.9,5983,472,1183,0.133687422,29536,-20687
ZCTA5 07001,5055,5770,-715,17132,39.9,7277,3515,4374,0.255311697,11425,5707
ZCTA5 07002,27036,706,26330,70553,38.4,41210,7233,6741,0.095545193,2129,68424
ZCTA5 07003,19959,4849,15110,52323,37.2,28382,4627,10643,0.20340959,13888,38435
ZCTA5 07004,2946,2447,499,7751,48.5,7463,235,0,0,7313,438
ZCTA5 07005,5606,16548,-10942,14912,43.2,11649,1396,792,0.053111588,35431,-20519
ZCTA5 07006,9816,11071,-1255,26403,44.1,21601,2306,696,0.026360641,30570,-4167
ZCTA5 07008,8231,1645,6586,25085,37.5,10055,5905,3185,0.126968308,4295,20790
ZCTA5 07009,4791,2511,2280,13073,45.6,10985,916,395,0.030214947,7607,5466
ZCTA5 07010,10296,5591,4705,25515,40.5,15855,3867,757,0.029668822,15980,9535
ZCTA5 07011,13357,23958,-10601,40680,38.2,23051,1508,2482,0.061012783,49898,-9218
ZCTA5 07012,5215,5972,-757,14711,38.4,9637,2270,750,0.050982258,15407,-696
ZCTA5 07013,11341,13643,-2302,29322,44.4,20040,3613,651,0.02220176,40744,-11422
ZCTA5 07014,1716,2736,-1020,4029,43.6,2566,956,50,0.012410027,7907,-3878
ZCTA5 07016,9029,3538,5491,23823,42.7,21678,669,379,0.015908996,9773,14050
ZCTA5 07017,14597,4025,10572,38771,36,1401,813,31065,0.801243197,10598,28173
ZCTA5 07018,11407,15449,-4042,30047,35.4,932,410,25739,0.856624621,41851,-11804
ZCTA5 07020,6788,9654,-2866,14234,36.5,5823,6155,718,0.050442602,29269,-15035
ZCTA5 07021,714,7869,-7155,2270,43.5,1916,59,9,0.003964758,23897,-21627
ZCTA5 07022,6127,2530,3597,14918,41.5,9615,1169,267,0.017897842,7090,7828
ZCTA5 07023,2670,10097,-7427,7727,42.5,6057,510,372,0.048142876,25661,-17934
ZCTA5 07024,18189,4300,13889,39701,46.2,18758,16412,933,0.023500667,12918,26783
ZCTA5 07026,11762,5355,6407,32481,38.3,24671,905,1862,0.057325821,13626,18855
ZCTA5 07027,1814,3626,-1812,4425,41.4,3521,141,0,0,10066,-5641
ZCTA5 07028,2539,1298,1241,7970,41,6387,499,228,0.028607277,4206,3764
ZCTA5 07029,8771,21282,-12511,21845,34.2,8250,3935,1127,0.051590753,60772,-38927
ZCTA5 07030,27932,11071,16861,59369,32,43501,7229,2313,0.038959726,30002,29367
ZCTA5 07031,6660,15879,-9219,16339,41,12158,1086,420,0.025705368,46153,-29814
ZCTA5 07032,14294,11046,3248,41790,38.2,22482,1730,1827,0.043718593,28729,13061
ZCTA5 07033,2755,20083,-17328,8377,38.5,5790,269,504,0.060164737,69727,-61350
ZCTA5 07034,4064,4845,-781,9987,39.1,5292,3445,449,0.044958446,11410,-1423
ZCTA5 07035,4079,1927,2152,10898,47.6,8836,430,323,0.029638466,6091,4807
ZCTA5 07036,16300,4820,11480,44931,40.6,21584,1549,12884,0.286750796,15412,29519
ZCTA5 07039,10452,13962,-3510,31103,44.4,19093,8724,983,0.031604668,44219,-13116
ZCTA5 07040,8264,4454,3810,25420,39.2,13609,855,8520,0.335169158,12712,12708
ZCTA5 07041,2668,3994,-1326,7352,40.9,4650,1889,118,0.016050054,14606,-7254
ZCTA5 07042,10454,1228,9226,28049,38.8,14246,1657,8788,0.313308852,3571,24478
ZCTA5 07043,4148,10273,-6125,13051,41.8,10733,609,643,0.049268255,27369,-14318
ZCTA5 07044,5714,5391,323,14479,44.7,13222,447,190,0.013122453,14768,-289
ZCTA5 07045,3629,6156,-2527,10133,51.4,6819,2704,99,0.009770058,17794,-7661
ZCTA5 07046,1413,2441,-1028,4464,43.4,3782,667,0,0,5812,-1348
ZCTA5 07047,23315,2279,21036,62686,40.9,33559,4309,1657,0.026433334,6015,56671
ZCTA5 07050,12420,6895,5525,33505,35.3,4400,524,20181,0.602328011,18084,15421
ZCTA5 07052,16977,7999,8978,48480,43.9,24648,3211,12991,0.267966172,20621,27859
ZCTA5 07054,11845,2125,9720,30692,39.8,15010,12838,1053,0.034308615,6161,24531
ZCTA5 07055,20217,3969,16248,70308,30,34461,2563,5330,0.075809296,8909,61399
ZCTA5 07057,4917,1122,3795,11833,40.4,9607,696,503,0.04250824,2711,9122
ZCTA5 07058,2123,2961,-838,5974,42.3,4205,1288,47,0.007867426,7892,-1918
ZCTA5 07059,5500,8456,-2956,16198,45.6,12257,2734,336,0.020743302,23370,-7172
ZCTA5 07060,15777,947,14830,47683,34.7,13556,1073,12438,0.260847682,2662,45021
ZCTA5 07062,4540,3942,598,14357,36.7,2981,48,7193,0.50100996,12966,1391
ZCTA5 07063,4366,5052,-686,14764,35.1,2817,399,6425,0.435180168,16472,-1708
ZCTA5 07064,1286,7972,-6686,3920,40.8,1887,491,679,0.173214286,23397,-19477
ZCTA5 07065,12158,6890,5268,29582,39.5,13168,1922,9491,0.320836995,16030,13552
ZCTA5 07066,5902,1650,4252,15445,42.5,13710,574,345,0.022337326,4783,10662
ZCTA5 07067,6249,18408,-12159,18776,42.9,12902,2662,1213,0.064603749,52899,-34123
ZCTA5 07068,2429,5602,-3173,6240,44.8,5159,533,13,0.002083333,12764,-6524
ZCTA5 07069,2327,22963,-20636,6696,45.4,5508,925,16,0.002389486,66924,-60228
ZCTA5 07070,6720,1265,5455,18781,39.8,13079,2953,372,0.019807252,3581,15200
ZCTA5 07071,9083,10263,-1180,22315,41.8,17130,1315,557,0.024960789,30382,-8067
ZCTA5 07072,2411,2386,25,6358,40.6,5400,561,64,0.010066059,6714,-356
ZCTA5 07073,4356,22715,-18359,9918,37.6,6901,1510,658,0.066344021,60982,-51064
ZCTA5 07074,970,6214,-5244,3079,36.4,2300,174,51,0.016563819,16809,-13730
ZCTA5 07075,3735,7400,-3665,9865,38,6963,1592,367,0.03720223,20596,-10731
ZCTA5 07076,8903,4558,4345,24737,42.4,17142,2889,2216,0.089582407,12777,11960
ZCTA5 07077,1187,10133,-8946,3342,43.8,1915,205,363,0.108617594,30773,-27431
ZCTA5 07078,4464,17193,-12729,14285,41.5,7933,5081,187,0.013090655,50519,-36234
ZCTA5 07079,5680,15451,-9771,18450,35.3,11637,772,4567,0.247533875,49344,-30894
ZCTA5 07080,8144,10871,-2727,24251,41.2,14483,3291,3052,0.12585048,31643,-7392
ZCTA5 07081,6534,12408,-5874,17004,43.8,12229,1728,1518,0.089273112,37269,-20265
ZCTA5 07082,1980,8158,-6178,5867,42.9,5094,519,0,0,24235,-18368
ZCTA5 07083,19667,12888,6779,56903,42.4,22171,6397,19089,0.335465617,35778,21125
ZCTA5 07086,7565,11237,-3672,16215,37,9854,2142,738,0.045513414,28311,-12096
ZCTA5 07087,25292,20299,4993,67903,36.7,34319,2076,3710,0.054636761,54205,13698
ZCTA5 07088,1108,9528,-8420,2922,42.6,264,55,2038,0.697467488,25543,-22621
ZCTA5 07090,10531,4117,6414,30967,40.9,24850,2331,986,0.031840346,14517,16450
ZCTA5 07092,2546,7644,-5098,7047,50.8,5456,710,161,0.022846601,24704,-17657
ZCTA5 07093,24973,13350,11623,64318,37,32803,4252,1835,0.028530116,41910,22408
ZCTA5 07094,8000,7944,56,21439,39.7,10683,7162,984,0.045897663,21103,336
ZCTA5 07095,7748,5188,2560,21314,37.2,12234,4510,2367,0.111053767,13310,8004
ZCTA5 07102,5835,7230,-1395,13585,34.1,3074,640,6704,0.493485462,21413,-7828
ZCTA5 07103,12484,7103,5381,36025,31.2,3710,1439,26456,0.734378904,26005,10020
ZCTA5 07104,19433,10960,8473,54736,34.2,18954,547,13244,0.241961415,32176,22560
ZCTA5 07105,18883,17548,1335,55781,35.3,28174,454,3839,0.068822717,37055,18726
ZCTA5 07106,12625,14649,-2024,35724,36.2,845,1763,28918,0.80948382,39886,-4162
ZCTA5 07107,14693,21706,-7013,41999,34.9,9700,408,14801,0.352413153,62432,-20433
ZCTA5 07108,11094,20071,-8977,28267,32.4,1083,64,22868,0.808999894,52437,-24170
ZCTA5 07109,13536,15645,-2109,37963,41.4,20873,4118,3234,0.08518821,43626,-5663
ZCTA5 07110,11711,5582,6129,29811,41.3,22097,3108,1026,0.034416826,12397,17414
ZCTA5 07111,22208,185,22023,60224,35.4,3545,343,51190,0.849993358,324,59900
ZCTA5 07112,10549,2005,8544,26684,36.3,1071,234,23606,0.884649978,6549,20135
ZCTA5 07114,4268,2830,1438,13617,39.7,2803,137,7302,0.536241463,7654,5963
ZCTA5 07201,9394,6443,2951,28207,35.5,11825,324,6616,0.234551707,17778,10429
ZCTA5 07202,14261,7231,7030,43795,36.4,11854,773,6433,0.146888914,19461,24334
ZCTA5 07203,7915,11834,-3919,22511,37.9,5203,264,9908,0.440140376,32479,-9968
ZCTA5 07204,5204,2220,2984,13973,37.8,6751,1712,1430,0.102340228,5778,8195
ZCTA5 07205,7191,3425,3766,22319,36.9,5531,437,11148,0.499484744,10596,11723
ZCTA5 07206,8504,720,7784,29387,32.4,5625,410,6010,0.204512199,2022,27365
ZCTA5 07208,12195,3869,8326,34383,35.9,15649,1128,6263,0.182153971,9422,24961
ZCTA5 07302,25272,1423,23849,51452,34.7,23917,17075,3879,0.075390655,4591,46861
ZCTA5 07304,18673,2532,16141,50444,34.8,12631,7392,16234,0.321822219,6935,43509
ZCTA5 07305,25335,2305,23030,71911,35.5,14140,11608,32429,0.450960215,6276,65635
ZCTA5 07306,21825,1375,20450,55053,34.7,18862,18337,7485,0.135959893,4085,50968
ZCTA5 07307,17009,9517,7492,43151,34.8,17843,10325,3698,0.085699057,26236,16915
ZCTA5 07310,6624,9693,-3069,13641,30.9,4259,7433,761,0.055787699,25840,-12199
ZCTA5 07311,916,2719,-1803,1494,35.1,396,843,57,0.03815261,7131,-5637
ZCTA5 07401,2213,807,1406,6820,43.6,5202,1267,58,0.008504399,2177,4643
ZCTA5 07403,2896,4234,-1338,7759,43.7,6292,369,379,0.048846501,12763,-5004
ZCTA5 07405,6729,4134,2595,17992,41.9,15871,1006,89,0.004946643,11720,6272
ZCTA5 07407,7121,907,6214,21239,39.2,14383,2380,1491,0.070201045,2407,18832
ZCTA5 07410,11892,1797,10095,34820,40.5,26949,4173,866,0.024870764,5043,29777
ZCTA5 07416,2530,4031,-1501,5544,50.4,4741,9,129,0.023268398,11074,-5530
ZCTA5 07417,3847,4361,-514,11037,48.1,8943,1039,179,0.016218175,10426,611
ZCTA5 07418,995,5342,-4347,2843,37.6,2468,0,267,0.093914879,14528,-11685
ZCTA5 07419,3949,8274,-4325,9720,46.2,8061,175,605,0.062242798,25063,-15343
ZCTA5 07420,1877,3677,-1800,5395,41.4,4125,289,118,0.021872104,11631,-6236
ZCTA5 07421,2819,3931,-1112,7371,45.4,6825,86,25,0.00339167,12234,-4863
ZCTA5 07422,2178,1621,557,5666,46,5301,15,79,0.013942817,3659,2007
ZCTA5 07423,1444,3602,-2158,4248,43.2,3231,618,43,0.010122411,11351,-7103
ZCTA5 07424,10669,1252,9417,26893,46.2,20999,1568,1435,0.05335961,3338,23555
ZCTA5 07430,9430,6834,2596,25530,44,20030,3188,621,0.024324324,19774,5756
ZCTA5 07432,2796,2688,108,7033,42.3,6528,139,83,0.011801507,7111,-78
ZCTA5 07435,1035,3343,-2308,2510,49.7,2281,117,18,0.007171315,9678,-7168
ZCTA5 07436,4223,2512,1711,12770,42.7,10719,729,301,0.023570869,6471,6299
ZCTA5 07438,4482,18272,-13790,11219,45.9,10242,243,21,0.001871825,54641,-43422
ZCTA5 07439,828,5684,-4856,2192,42.2,1993,47,6,0.002737226,16667,-14475
ZCTA5 07440,1531,5660,-4129,4793,37.5,4288,146,0,0,16729,-11936
ZCTA5 07442,4224,0,4224,11113,40,9451,701,192,0.017277063,0,11113
ZCTA5 07444,4736,9791,-5055,10784,53.5,9820,370,137,0.012704006,31448,-20664
ZCTA5 07446,5300,4235,1065,14801,42.1,12064,1108,87,0.005877981,14229,572
ZCTA5 07450,8659,5719,2940,25999,41.5,19837,3869,314,0.012077388,20027,5972
ZCTA5 07452,3630,3592,38,12098,38.2,9676,1498,255,0.021077864,12866,-768
ZCTA5 07456,4200,855,3345,11778,43.1,10372,263,183,0.015537443,1750,10028
ZCTA5 07457,1839,6928,-5089,4049,46.1,3717,135,68,0.01679427,18753,-14704
ZCTA5 07458,4000,6801,-2801,11714,44.4,9094,1468,250,0.021341984,22595,-10881
ZCTA5 07460,1192,3674,-2482,3046,43.1,2838,0,70,0.022980959,10784,-7738
ZCTA5 07461,6728,3235,3493,17994,44.7,16498,216,236,0.013115483,11601,6393
ZCTA5 07462,2871,6307,-3436,6674,45.3,6177,14,93,0.013934672,19321,-12647
ZCTA5 07463,3354,6333,-2979,10086,38.9,8575,779,168,0.016656752,21910,-11824
ZCTA5 07465,2374,3552,-1178,5890,47.8,5600,140,54,0.009168081,12503,-6613
ZCTA5 07470,19147,18410,737,55280,42.3,44476,5288,1525,0.027586831,43126,12154
ZCTA5 07480,5975,2780,3195,14991,47.8,13646,331,267,0.017810686,8200,6791
ZCTA5 07481,5749,4325,1424,16746,46.7,15089,864,160,0.00955452,11830,4916
ZCTA5 07501,12269,3452,8817,36019,31.5,6285,946,9492,0.263527583,8998,27021
ZCTA5 07502,4794,891,3903,18113,33.6,4986,3961,2740,0.151272567,2282,15831
ZCTA5 07503,6086,3709,2377,19365,35.7,7534,176,1430,0.073844565,9547,9818
ZCTA5 07504,3984,25,3959,12198,38.1,2991,358,5029,0.412280702,80,12118
ZCTA5 07505,1332,668,664,4122,36.1,1024,50,993,0.240902475,2006,2116
ZCTA5 07506,7463,9087,-1624,19507,41.6,14956,170,1173,0.06013226,26606,-7099
ZCTA5 07508,8045,2808,5237,23730,40.8,15926,600,2692,0.113442899,8397,15333
ZCTA5 07512,3803,3096,707,11013,43,8651,242,531,0.048215745,8393,2620
ZCTA5 07513,3182,1649,1533,11600,33.5,1720,64,1892,0.163103448,4909,6691
ZCTA5 07514,6582,6333,249,19254,34.6,2227,247,6653,0.345538589,17505,1749
ZCTA5 07522,7013,2501,4512,22645,30.8,5820,1126,7003,0.30925149,7471,15174
ZCTA5 07524,4459,10461,-6002,14611,29.8,3571,38,3823,0.26165218,27153,-12542
ZCTA5 07601,19995,1859,18136,45723,39.7,19943,6029,11352,0.248277672,5349,40374
ZCTA5 07603,3102,1624,1478,8830,42.3,5263,713,1156,0.130917327,4715,4115
ZCTA5 07604,4226,1130,3096,12120,44.7,9096,1286,830,0.068481848,3382,8738
ZCTA5 07605,3470,3491,-21,9283,46.1,3885,3581,335,0.036087472,10230,-947
ZCTA5 07606,869,3947,-3078,2865,35.3,1950,45,71,0.02478185,10635,-7770
ZCTA5 07607,3755,9115,-5360,10049,44.1,6197,1964,638,0.063488904,24176,-14127
ZCTA5 07608,26,2761,-2735,92,30.3,73,1,4,0.043478261,7809,-7717
ZCTA5 07620,485,5947,-5462,1336,48.7,773,479,0,0,16362,-15026
ZCTA5 07621,9146,1540,7606,28282,39.2,14816,7454,2408,0.085142493,5151,23131
ZCTA5 07624,2791,1810,981,8573,41.9,4461,3091,288,0.033593841,5729,2844
ZCTA5 07626,3036,2672,364,9096,44.6,5583,3109,13,0.0014292,7997,1099
ZCTA5 07627,1656,7302,-5646,4977,45,3498,1356,2,0.000401849,19500,-14523
ZCTA5 07628,6626,8481,-1855,17965,42.8,11587,3228,589,0.032785973,26301,-8336
ZCTA5 07630,2537,3178,-641,7317,47.5,5964,972,86,0.011753451,8737,-1420
ZCTA5 07631,11320,4155,7165,29129,42.4,14089,3244,7573,0.259981462,11081,18048
ZCTA5 07632,1905,4601,-2696,5358,47.7,2669,2113,110,0.020530049,12761,-7403
ZCTA5 07640,1737,4052,-2315,4801,46.1,3500,1008,1,0.00020829,11340,-6539
ZCTA5 07641,1059,2106,-1047,3341,46.2,2509,457,108,0.032325651,5534,-2193
ZCTA5 07642,3457,5112,-1655,10166,42.2,8480,705,237,0.023313004,13734,-3568
ZCTA5 07643,4353,13238,-8885,10973,44.5,5972,2551,328,0.029891552,39781,-28808
ZCTA5 07644,9235,4907,4328,25983,38.3,16773,1985,2648,0.101912789,14789,11194
ZCTA5 07645,2920,9373,-6453,8413,43.1,6355,1276,214,0.025436824,26368,-17955
ZCTA5 07646,6167,3266,2901,16912,40.3,10449,3387,579,0.034236045,9056,7856
ZCTA5 07647,1693,1997,-304,5394,44.7,3143,1763,109,0.020207638,5750,-356
ZCTA5 07648,1921,9995,-8074,5666,45.8,3635,1746,10,0.001764914,23669,-18003
ZCTA5 07649,2702,1367,1335,8236,45.6,6796,862,36,0.004371054,3822,4414
ZCTA5 07650,7142,98,7044,20291,40.9,5625,11916,375,0.0184811,436,19855
ZCTA5 07652,8354,2108,6246,26650,50,17109,6643,875,0.032833021,6102,20548
ZCTA5 07656,3246,564,2682,8987,47.7,7839,475,57,0.006342495,1489,7498
ZCTA5 07657,4032,16246,-12214,11477,41.8,6562,3332,21,0.001829746,39365,-27888
ZCTA5 07660,4971,3317,1654,13202,37.4,8581,825,499,0.037797303,8664,4538
ZCTA5 07661,4352,943,3409,12024,40.1,7571,3618,250,0.02079175,1972,10052
ZCTA5 07662,2248,2094,154,5805,46.4,4096,617,260,0.044788975,5947,-142
ZCTA5 07663,5245,8773,-3528,14313,38.9,11486,883,642,0.044854328,22437,-8124
ZCTA5 07666,13122,2343,10779,41335,38,21087,3913,9204,0.222668441,4335,37000
ZCTA5 07670,4981,971,4010,15307,41.9,9393,4911,207,0.013523225,2942,12365
ZCTA5 07675,9689,3247,6442,27025,43.4,19772,4399,237,0.008769658,10173,16852
ZCTA5 07676,3410,476,2934,9293,47.1,8263,474,134,0.014419456,1245,8048
ZCTA5 07677,2021,8891,-6870,6112,45.1,5231,275,91,0.014888743,21720,-15608
ZCTA5 07701,11023,14386,-3363,25010,42.7,20810,511,1249,0.049940024,41943,-16933
ZCTA5 07702,1361,2388,-1027,4129,42.3,3690,211,24,0.005812545,6450,-2321
ZCTA5 07703,0,19909,-19909,0,-,0,0,0,#DIV/0!,56369,-56369
ZCTA5 07704,2038,6059,-4021,6235,40,5949,70,176,0.028227747,17365,-11130
ZCTA5 07711,595,12531,-11936,1749,39.2,1515,11,6,0.003430532,38140,-36391
ZCTA5 07712,17010,2399,14611,39491,41.4,25120,1503,8789,0.222557038,5163,34328
ZCTA5 07716,3638,5459,-1821,8173,50.1,7589,51,231,0.028263795,16530,-8357
ZCTA5 07717,868,5269,-4401,1760,55.7,1632,27,8,0.004545455,13310,-11550
ZCTA5 07718,2393,7601,-5208,6901,36.9,6081,170,13,0.001883785,20289,-13388
ZCTA5 07719,9064,1478,7586,21857,47.9,20013,343,513,0.023470742,4071,17786
ZCTA5 07720,1956,2162,-206,4170,41.2,3581,176,75,0.017985612,6299,-2129
ZCTA5 07721,1439,2078,-639,3770,31.1,2187,612,738,0.195755968,5970,-2200
ZCTA5 07722,3510,12063,-8553,10123,47.6,9255,328,32,0.003161118,31012,-20889
ZCTA5 07723,259,6146,-5887,603,43.7,499,0,14,0.023217247,19616,-19013
ZCTA5 07724,9575,11707,-2132,23332,42.6,17122,1380,2251,0.096476942,30444,-7112
ZCTA5 07726,16214,9743,6471,44954,44.1,38388,2852,1463,0.032544379,28158,16796
ZCTA5 07727,2366,1603,763,6394,47.2,5474,197,473,0.073975602,3298,3096
ZCTA5 07728,20651,5817,14834,57245,41.5,43510,4303,2911,0.050851603,18883,38362
ZCTA5 07730,6300,15343,-9043,16845,45.9,14884,488,166,0.009854556,36740,-19895
ZCTA5 07731,12958,2217,10741,39457,38.6,32959,1393,1430,0.036241985,6650,32807
ZCTA5 07732,2559,1771,788,4744,45.3,4021,356,43,0.009064081,3235,1509
ZCTA5 07733,6084,2051,4033,17135,48.3,12845,3026,182,0.010621535,5519,11616
ZCTA5 07734,4952,1808,3144,13323,42.2,10646,300,1042,0.078210613,5404,7919
ZCTA5 07735,7954,3440,4514,19661,44.7,16013,659,784,0.039875896,9318,10343
ZCTA5 07737,1508,3815,-2307,4353,37.3,3513,238,222,0.050999311,8525,-4172
ZCTA5 07738,2321,2479,-158,6812,44.4,6088,509,4,0.000587199,8238,-1426
ZCTA5 07739,2224,8065,-5841,6103,47,5990,52,0,0,25878,-19775
ZCTA5 07740,12817,1234,11583,31863,37.5,21090,585,4372,0.137212441,3669,28194
ZCTA5 07746,5944,0,5944,18437,45.1,13848,3695,249,0.013505451,0,18437
ZCTA5 07747,12839,3314,9525,32462,42.6,24486,2850,2231,0.068726511,9420,23042
ZCTA5 07748,10067,304,9763,28295,45,25705,768,166,0.005866761,857,27438
ZCTA5 07750,1479,3495,-2016,3197,56.9,2980,14,28,0.008758211,7813,-4616
ZCTA5 07751,7018,3417,3601,20782,40.8,14335,5030,528,0.025406602,9720,11062
ZCTA5 07753,15843,2427,13416,37370,44.7,21515,1276,10837,0.289991972,6143,31227
ZCTA5 07755,2037,1763,274,6651,33.7,5161,66,250,0.037588333,4343,2308
ZCTA5 07756,1773,5696,-3923,3076,60.3,2789,50,35,0.011378414,14078,-11002
ZCTA5 07757,2384,2313,71,6115,48.9,5553,215,37,0.006050695,6916,-801
ZCTA5 07758,1589,1282,307,4345,45.3,3833,170,242,0.055696203,3510,835
ZCTA5 07760,3365,36,3329,9451,44.6,9026,140,33,0.003491694,108,9343
ZCTA5 07762,4133,6726,-2593,8442,52.7,7995,169,120,0.014214641,17630,-9188
ZCTA5 07764,2858,4653,-1795,8470,34.3,7282,45,432,0.051003542,12882,-4412
ZCTA5 07801,8299,1297,7002,26036,38.9,13324,1010,2274,0.087340605,3741,22295
ZCTA5 07803,1387,11748,-10361,3976,41.8,2832,206,82,0.020623742,29658,-25682
ZCTA5 07820,0,52,-52,8,-,8,0,0,0,134,-126
ZCTA5 07821,3438,4767,-1329,9277,42.5,8307,152,128,0.013797564,12326,-3049
ZCTA5 07822,352,43,309,1084,39.9,986,69,7,0.006457565,95,989
ZCTA5 07823,3640,510,3130,7814,54.7,7384,55,164,0.02098797,1186,6628
ZCTA5 07825,3459,1606,1853,9738,47.8,9198,67,85,0.008728692,4926,4812
ZCTA5 07826,2181,3370,-1189,5548,47.7,5060,66,27,0.004866619,8926,-3378
ZCTA5 07827,1613,2535,-922,4068,44.4,3670,185,15,0.003687316,7293,-3225
ZCTA5 07828,5699,38,5661,14602,38.1,10887,899,1424,0.097520888,132,14470
ZCTA5 07830,2777,1455,1322,7389,50.9,6938,203,168,0.0227365,4257,3132
ZCTA5 07831,0,4401,-4401,0,-,0,0,0,#DIV/0!,12952,-12952
ZCTA5 07832,1209,1871,-662,3123,49.5,2783,37,69,0.02209414,3542,-419
ZCTA5 07833,48,1471,-1423,91,47.4,91,0,0,0,3319,-3228
ZCTA5 07834,6880,10151,-3271,18207,44.3,14837,1580,492,0.027022574,26585,-8378
ZCTA5 07836,4458,1595,2863,12262,42,10227,348,331,0.026993965,4260,8002
ZCTA5 07838,1274,855,419,3083,49,2999,47,13,0.004216672,2316,767
ZCTA5 07840,12148,7927,4221,31581,42.4,25664,1929,1466,0.046420316,21859,9722
ZCTA5 07842,10,9192,-9182,38,17.9,38,0,0,0,25403,-25365
ZCTA5 07843,4391,31,4360,11267,41.1,9554,403,213,0.018904766,89,11178
ZCTA5 07844,54,7233,-7179,121,24.9,68,53,0,0,21013,-20892
ZCTA5 07846,6,3191,-3185,18,52.3,18,0,0,0,8550,-8532
ZCTA5 07847,791,3468,-2677,1940,42.5,1358,0,151,0.077835052,10322,-8382
ZCTA5 07848,1662,420,1242,4822,53.5,4276,181,88,0.018249689,1232,3590
ZCTA5 07849,3422,18,3404,8916,46.7,7187,717,603,0.067631225,70,8846
ZCTA5 07850,2494,2,2492,7498,39.7,5485,121,659,0.087890104,5,7493
ZCTA5 07851,153,5428,-5275,342,38,295,0,0,0,14201,-13859
ZCTA5 07852,1480,3506,-2026,3817,48.4,3001,244,219,0.057374902,9883,-6066
ZCTA5 07853,4306,8111,-3805,12821,43.3,11315,585,78,0.006083769,22712,-9891
ZCTA5 07856,1709,9841,-8132,4033,45.7,3622,36,213,0.052814282,26310,-22277
ZCTA5 07857,1793,3812,-2019,3418,45.8,2922,22,256,0.074897601,7855,-4437
ZCTA5 07860,10152,4082,6070,26151,47.9,23466,376,987,0.037742343,12126,14025
ZCTA5 07863,1510,2516,-1006,3711,48.3,3317,38,79,0.021288063,7572,-3861
ZCTA5 07865,895,50,845,2942,37.4,2620,16,60,0.02039429,102,2840
ZCTA5 07866,8274,1347,6927,22689,44.3,19631,1242,534,0.023535634,3599,19090
ZCTA5 07869,9118,6828,2290,26170,40.2,19564,3488,971,0.037103554,19137,7033
ZCTA5 07870,21,2662,-2641,50,63.7,50,0,0,0,8320,-8270
ZCTA5 07871,7538,1135,6403,20908,42.7,18886,763,112,0.005356801,3593,17315
ZCTA5 07874,3091,3887,-796,8504,41.6,7399,177,243,0.028574788,10459,-1955
ZCTA5 07876,3179,1247,1932,9279,47.5,8094,659,147,0.015842224,3563,5716
ZCTA5 07878,246,571,-325,531,51.6,434,33,0,0,1493,-962
ZCTA5 07880,102,191,-89,347,42.2,347,0,0,0,399,-52
ZCTA5 07881,5,3821,-3816,9,-,9,0,0,0,11222,-11213
ZCTA5 07882,5836,0,5836,14521,43.7,12373,450,518,0.035672474,294,14227
ZCTA5 07885,4237,5584,-1347,11329,41,8431,447,156,0.013769971,16779,-5450
ZCTA5 07901,8555,3149,5406,24218,40,17005,2551,1582,0.065323313,9722,14496
ZCTA5 07920,10227,1087,9140,28451,45.7,20314,6486,479,0.016835964,3300,25151
ZCTA5 07921,3921,7227,-3306,7596,48.1,6134,610,121,0.015929437,19129,-11533
ZCTA5 07922,4089,17215,-13126,12059,46.3,9372,1569,376,0.031180032,43712,-31653
ZCTA5 07924,2668,0,2668,7754,41.8,6973,415,47,0.006061388,0,7754
ZCTA5 07926,19,77,-58,65,28.2,8,0,0,0,240,-175
ZCTA5 07927,1812,4095,-2283,4286,42.6,3080,1100,53,0.012365842,12085,-7799
ZCTA5 07928,6614,266,6348,19553,40.9,15979,2214,352,0.018002353,752,18801
ZCTA5 07930,2955,219,2736,8485,49.1,7708,259,128,0.015085445,627,7858
ZCTA5 07931,1185,225,960,3432,47.2,3116,121,27,0.007867133,611,2821
ZCTA5 07932,4351,747,3604,10915,44.8,8674,1320,406,0.037196519,1877,9038
ZCTA5 07933,952,3314,-2362,2648,50.2,2420,80,0,0,9045,-6397
ZCTA5 07934,498,293,205,1357,44.7,1288,54,0,0,864,493
ZCTA5 07935,135,8559,-8424,389,49.6,363,0,0,0,22250,-21861
ZCTA5 07936,3797,10704,-6907,11128,44.1,9541,1025,105,0.009435658,30888,-19760
ZCTA5 07939,26,4059,-4033,212,54.8,88,0,124,0.58490566,12339,-12127
ZCTA5 07940,5710,8711,-3001,18054,36.1,14576,1018,573,0.031738119,22118,-4064
ZCTA5 07945,3377,246,3131,9518,47.5,8469,371,89,0.009350704,526,8992
ZCTA5 07946,1038,2338,-1300,3090,46.6,2626,195,1,0.000323625,5413,-2323
ZCTA5 07950,7938,3551,4387,21068,45.7,14764,4502,522,0.024776913,7134,13934
ZCTA5 07960,18312,4578,13734,46463,39.6,35887,2254,2582,0.0555711,12581,33882
ZCTA5 07961,0,4589,-4589,337,20.7,147,26,109,0.323442136,11517,-11180
ZCTA5 07970,75,27,48,232,47.1,180,52,0,0,71,161
ZCTA5 07974,4588,14617,-10029,13038,42.8,9961,1806,118,0.009050468,39281,-26243
ZCTA5 07976,129,158,-29,288,54.2,288,0,0,0,414,-126
ZCTA5 07977,212,7859,-7647,885,22.8,693,29,116,0.131073446,20820,-19935
ZCTA5 07979,57,11999,-11942,212,40.2,184,0,15,0.070754717,33089,-32877
ZCTA5 07980,913,313,600,2911,41.1,2438,240,0,0,891,2020
ZCTA5 07981,3809,818,2991,9116,49.6,7312,1142,112,0.01228609,2465,6651
ZCTA5 08001,284,18407,-18123,814,50.9,742,0,55,0.067567568,45041,-44227
ZCTA5 08002,9052,3177,5875,23613,39.3,16866,2804,1968,0.083343921,8780,14833
ZCTA5 08003,11143,180,10963,31082,46.2,23557,4930,968,0.031143427,483,30599
ZCTA5 08004,3838,796,3042,10884,42.4,8991,315,1034,0.095001838,2309,8575
ZCTA5 08005,10093,1931,8162,25319,51.1,23121,292,983,0.038824598,4881,20438
ZCTA5 08006,214,6200,-5986,427,61.6,356,53,0,0,20145,-19718
ZCTA5 08007,2390,1921,469,5521,45.5,4944,281,70,0.012678863,4970,551
ZCTA5 08008,3355,4972,-1617,6882,62.7,6618,54,11,0.001598373,13279,-6397
ZCTA5 08009,5391,4433,958,13995,44.2,10154,335,1723,0.123115398,11585,2410
ZCTA5 08010,4202,6299,-2097,11042,41.1,6849,83,3100,0.280746242,15978,-4936
ZCTA5 08011,0,6707,-6707,0,-,0,0,0,#DIV/0!,17725,-17725
ZCTA5 08012,15076,3011,12065,38901,41.1,30257,2260,3730,0.095884425,7584,31317
ZCTA5 08014,124,2028,-1904,395,44.6,395,0,0,0,5519,-5124
ZCTA5 08015,7243,8263,-1020,19060,42.3,12571,573,3472,0.182161595,24173,-5113
ZCTA5 08016,12594,54,12540,34433,40.4,17119,2602,11246,0.326605291,140,34293
ZCTA5 08019,375,21,354,998,43.6,781,60,0,0,58,940
ZCTA5 08020,968,394,574,2607,50.4,2253,11,119,0.045646337,1235,1372
ZCTA5 08021,21033,49,20984,48202,37.4,25502,1574,13702,0.284262064,151,48051
ZCTA5 08022,3815,11239,-7424,9511,50.7,7039,470,1461,0.153611608,29225,-19714
ZCTA5 08023,119,1005,-886,313,41.4,313,0,0,0,2928,-2615
ZCTA5 08026,758,10739,-9981,2303,41.5,1809,135,57,0.024750326,31760,-29457
ZCTA5 08027,1978,4468,-2490,4954,48,4361,108,228,0.046023415,12471,-7517
ZCTA5 08028,7080,2208,4872,21809,30.5,13941,1112,4480,0.205419781,5381,16428
ZCTA5 08029,2253,9162,-6909,5561,39.7,4872,20,437,0.078582989,24374,-18813
ZCTA5 08030,5129,4661,468,13222,36,10374,602,1110,0.083950991,10917,2305
ZCTA5 08031,4696,8460,-3764,11631,40.3,8887,1250,361,0.031037744,19273,-7642
ZCTA5 08032,96,17422,-17326,397,45.2,397,0,0,0,45555,-45158
ZCTA5 08033,6308,17431,-11123,16565,40.5,15448,218,160,0.009658919,41865,-25300
ZCTA5 08034,7689,9576,-1887,19522,43.2,14403,1579,1425,0.07299457,27253,-7731
ZCTA5 08035,3194,1425,1769,7615,40.7,7267,107,148,0.019435325,4372,3243
ZCTA5 08036,2474,7422,-4948,6026,50.9,5053,289,381,0.063226021,20819,-14793
ZCTA5 08037,8907,2245,6662,23729,46.1,18889,259,716,0.030174049,5679,18050
ZCTA5 08038,163,9024,-8861,410,36.7,366,0,5,0.012195122,24955,-24545
ZCTA5 08039,6,929,-923,19,73.6,19,0,0,0,2733,-2714
ZCTA5 08041,402,4945,-4543,930,50.5,868,26,28,0.030107527,15645,-14715
ZCTA5 08042,31,1094,-1063,125,16.4,125,0,0,0,3151,-3026
ZCTA5 08043,11683,15,11668,30864,42.5,19854,6493,2453,0.079477709,200,30664
ZCTA5 08045,1198,3030,-1832,2966,49.1,219,35,2289,0.77174646,7411,-4445
ZCTA5 08046,10701,3601,7100,31747,40.8,5137,477,22014,0.693419851,8612,23135
ZCTA5 08048,4793,702,4091,12752,42.9,8600,942,2187,0.171502509,1916,10836
ZCTA5 08049,2058,2772,-714,5238,36.1,3586,336,919,0.175448645,7031,-1793
ZCTA5 08050,10646,5161,5485,26673,46.1,24559,193,98,0.003674127,13064,13609
ZCTA5 08051,4298,5399,-1101,11722,38.9,10808,133,462,0.039413069,12955,-1233
ZCTA5 08052,8767,3830,4937,19818,36.9,13367,1558,2304,0.116257947,9595,10223
ZCTA5 08053,18653,58,18595,46775,42.4,38804,2822,2683,0.057359701,152,46623
ZCTA5 08054,18545,100,18445,44473,42.6,31678,4033,5357,0.120455108,252,44221
ZCTA5 08055,10332,0,10332,28519,46.8,26325,687,274,0.00960763,11,28508
ZCTA5 08056,1729,10602,-8873,5656,41.5,4802,672,91,0.016089109,29156,-23500
ZCTA5 08057,7490,6869,621,20892,45.8,17103,1449,837,0.040063182,18505,2387
ZCTA5 08059,2249,3176,-927,5667,36.6,5074,18,40,0.007058408,8437,-2770
ZCTA5 08060,9312,4273,5039,25333,37.2,13937,1307,6696,0.264319267,10918,14415
ZCTA5 08061,1265,12819,-11554,3414,38.3,3051,127,127,0.037199766,36201,-32787
ZCTA5 08062,5701,17097,-11396,17669,41,15827,591,589,0.03333522,50544,-32875
ZCTA5 08063,1125,3549,-2424,3111,40.3,2887,52,11,0.003535841,9521,-6410
ZCTA5 08064,37,2658,-2621,53,70.8,53,0,0,0,7048,-6995
ZCTA5 08065,3078,6372,-3294,7429,40.9,5213,126,1376,0.185220083,18855,-11426
ZCTA5 08066,3761,3201,560,8242,45.1,4657,178,2202,0.267168163,7425,817
ZCTA5 08067,569,9757,-9188,1675,39.5,1475,0,58,0.034626866,24029,-22354
ZCTA5 08068,2832,9528,-6696,7135,43.3,4044,250,1862,0.260967064,24402,-17267
ZCTA5 08069,4995,1602,3393,13412,38.9,8148,36,3221,0.240158067,4408,9004
ZCTA5 08070,5127,3152,1975,12365,44.6,11088,163,407,0.032915487,8746,3619
ZCTA5 08071,3742,1912,1830,9363,42.7,8787,86,160,0.01708854,5371,3992
ZCTA5 08072,133,1397,-1264,351,28.7,326,0,0,0,3491,-3140
ZCTA5 08073,0,4245,-4245,0,-,0,0,0,#DIV/0!,10432,-10432
ZCTA5 08074,32,13874,-13842,146,40,146,0,0,0,39604,-39458
ZCTA5 08075,11748,83,11665,30186,40.3,22657,1078,3150,0.104353011,117,30069
ZCTA5 08077,7200,13712,-6512,20298,43,17764,509,873,0.043009163,35155,-14857
ZCTA5 08078,3053,1172,1881,8020,36.8,6576,236,621,0.077431421,3154,4866
ZCTA5 08079,4112,3265,847,10200,40.8,6041,118,3753,0.367941176,8963,1237
ZCTA5 08080,14080,2310,11770,39122,42.7,33733,1577,1797,0.045933234,7380,31742
ZCTA5 08081,17337,4700,12637,51518,36.2,26882,1669,17849,0.346461431,15029,36489
ZCTA5 08083,3691,8495,-4804,9704,42.7,6911,204,1555,0.160243199,24420,-14716
ZCTA5 08084,2598,8836,-6238,6967,39.2,5433,274,551,0.079087125,29577,-22610
ZCTA5 08085,7080,4138,2942,21142,37.8,16468,712,2898,0.137073125,9925,11217
ZCTA5 08086,3468,5710,-2242,7697,43.3,6161,339,592,0.076913083,13955,-6258
ZCTA5 08087,10601,7637,2964,24951,50.6,22422,495,539,0.021602341,17664,7287
ZCTA5 08088,9189,8472,717,24203,51,22387,159,381,0.01574185,22720,1483
ZCTA5 08089,1363,5947,-4584,4213,44.8,3107,56,734,0.174222644,18322,-14109
ZCTA5 08090,3061,3887,-826,9408,34.8,7544,391,1138,0.120960884,10172,-764
ZCTA5 08091,2105,1091,1014,5823,41.7,4082,276,369,0.063369397,2166,3657
ZCTA5 08092,1141,4359,-3218,3044,45.1,2908,15,0,0,9622,-6578
ZCTA5 08093,4218,8191,-3973,9812,39.4,7222,225,1691,0.172339992,18296,-8484
ZCTA5 08094,14952,9436,5516,40845,39.5,33010,641,4734,0.115901579,26823,14022
ZCTA5 08095,0,6880,-6880,0,-,0,0,0,#DIV/0!,17188,-17188
ZCTA5 08096,13643,103,13540,36038,41.7,25160,1534,4716,0.130861868,161,35877
ZCTA5 08097,1200,5005,-3805,3337,46.9,2820,60,204,0.061132754,13857,-10520
ZCTA5 08098,3493,0,3493,9444,46.6,8230,68,586,0.062049979,14,9430
ZCTA5 08102,3095,2597,498,8603,30.4,2390,88,2226,0.258746949,7109,1494
ZCTA5 08103,4355,1818,2537,12984,35.5,1892,74,8411,0.647797289,3996,8988
ZCTA5 08104,8537,225,8312,21530,33.2,2572,199,12398,0.575847654,689,20841
ZCTA5 08105,8411,3271,5140,26968,31.1,4348,633,7572,0.280777217,8670,18298
ZCTA5 08106,3835,5809,-1974,9727,39.3,9144,9,290,0.02981392,11790,-2063
ZCTA5 08107,5710,2349,3361,13798,38.5,8992,322,2680,0.194231048,5739,8059
ZCTA5 08108,8385,5925,2460,18827,40.7,16848,265,687,0.036490147,19015,-188
ZCTA5 08109,8635,14674,-6039,23273,40.7,10604,2067,5088,0.218622438,42343,-19070
ZCTA5 08110,6098,0,6098,19658,33.3,5096,1642,6538,0.332587242,3737,15921
ZCTA5 08201,4075,360,3715,10220,38.4,6468,394,1348,0.131898239,980,9240
ZCTA5 08202,789,1309,-520,1584,64.7,1567,0,3,0.001893939,2913,-1329
ZCTA5 08203,3769,1087,2682,7890,57.3,6860,470,43,0.005449937,1994,5896
ZCTA5 08204,7614,4642,2972,17565,49.3,15594,214,346,0.019698264,10898,6667
ZCTA5 08205,11031,76,10955,28051,45.1,18806,2833,2300,0.081993512,198,27853
ZCTA5 08210,7039,480,6559,17385,44.5,14756,177,1723,0.099108427,819,16566
ZCTA5 08212,79,65,14,150,73.3,146,2,2,0.013333333,118,32
ZCTA5 08215,5594,4592,1002,14230,45.3,10450,187,2474,0.173858046,10234,3996
ZCTA5 08217,0,6991,-6991,0,-,0,0,0,#DIV/0!,13770,-13770
ZCTA5 08221,2621,2940,-319,6957,48.8,5955,318,171,0.02457956,8329,-1372
ZCTA5 08223,1868,13918,-12050,4207,49.3,4181,1,25,0.005942477,48348,-44141
ZCTA5 08224,62,884,-822,211,34.2,211,0,0,0,1970,-1759
ZCTA5 08225,3084,757,2327,8419,44.7,7004,662,207,0.024587243,2217,6202
ZCTA5 08226,5353,2941,2412,11211,56.3,9974,46,346,0.030862546,8003,3208
ZCTA5 08230,2099,150,1949,5718,45.5,5328,171,9,0.001573977,2807,2911
ZCTA5 08232,6359,156,6203,20107,35.1,4783,366,7693,0.382603074,430,19677
ZCTA5 08234,15773,486,15287,45998,39.3,29458,5614,3462,0.075264142,1480,44518
ZCTA5 08240,5,4197,-4192,2690,20.3,2035,140,379,0.140892193,12050,-9360
ZCTA5 08241,450,473,-23,1058,54.3,1005,11,7,0.006616257,1333,-275
ZCTA5 08242,1782,0,1782,3812,51.2,2844,25,260,0.068205666,0,3812
ZCTA5 08243,1083,71,1012,2068,64.7,2024,13,0,0,148,1920
ZCTA5 08244,4635,3534,1101,10620,43.7,7403,620,1646,0.154990584,10049,571
ZCTA5 08245,0,382,-382,0,-,0,0,0,#DIV/0!,924,-924
ZCTA5 08246,26,277,-251,53,-,53,0,0,0,830,-777
ZCTA5 08247,553,610,-57,1051,63.6,1045,1,0,0,1728,-677
ZCTA5 08248,76,242,-166,161,53.2,161,0,0,0,2328,-2167
ZCTA5 08251,4658,554,4104,10631,40.1,9751,16,30,0.002821936,1753,8878
ZCTA5 08260,6145,119,6026,12509,57.1,11078,28,476,0.038052602,213,12296
ZCTA5 08270,3101,9962,-6861,8278,41.1,7190,65,490,0.059193042,28046,-19768
ZCTA5 08302,13716,13125,591,47358,33,23984,780,12936,0.273153427,36316,11042
ZCTA5 08310,567,317,250,1245,59.3,1128,30,64,0.051405622,818,427
ZCTA5 08311,544,783,-239,1830,39.7,1448,24,112,0.061202186,2114,-284
ZCTA5 08312,2921,1701,1220,8310,40.9,5155,17,2206,0.265463297,5507,2803
ZCTA5 08314,180,1943,-1763,489,45.5,489,0,0,0,5600,-5111
ZCTA5 08316,85,283,-198,125,68.1,82,0,0,0,734,-609
ZCTA5 08317,571,319,252,1388,46.9,1033,0,170,0.122478386,929,459
ZCTA5 08318,4482,153,4329,12046,41.8,10381,128,1020,0.084675411,378,11668
ZCTA5 08319,451,879,-428,1304,44.1,1264,0,8,0.006134969,2501,-1197
ZCTA5 08320,0,285,-285,1097,40.6,478,38,441,0.402005469,651,446
ZCTA5 08321,70,185,-115,118,63.9,118,0,0,0,567,-449
ZCTA5 08322,3418,228,3190,10208,41.4,8637,115,1076,0.105407524,629,9579
ZCTA5 08323,223,14889,-14666,515,49.4,450,3,13,0.025242718,43373,-42858
ZCTA5 08324,100,6248,-6148,308,27.7,167,0,124,0.402597403,18053,-17745
ZCTA5 08326,443,16101,-15658,1259,32.9,1049,88,32,0.025416998,39680,-38421
ZCTA5 08327,192,3094,-2902,4981,38.1,1448,34,2495,0.500903433,6459,-1478
ZCTA5 08328,634,566,68,1773,35,1589,0,110,0.062041737,1060,713
ZCTA5 08329,103,4500,-4397,265,64.1,180,19,0,0,10785,-10520
ZCTA5 08330,11503,2313,9190,29580,40.9,20051,1450,3761,0.127146721,6366,23214
ZCTA5 08332,14571,3389,11182,35532,42.8,25574,680,5808,0.163458291,11057,24475
ZCTA5 08340,386,6774,-6388,978,37.5,901,27,50,0.051124744,17087,-16109
ZCTA5 08341,846,1713,-867,2200,32.2,1388,325,135,0.061363636,5056,-2856
ZCTA5 08343,1572,380,1192,4835,45,4473,17,57,0.011789038,1188,3647
ZCTA5 08344,1930,3962,-2032,4657,48.1,4126,11,201,0.043160833,10139,-5482
ZCTA5 08345,292,1640,-1348,649,55.1,640,3,4,0.006163328,4406,-3757
ZCTA5 08346,194,1482,-1288,484,45.4,290,15,141,0.291322314,6907,-6423
ZCTA5 08348,22,2068,-2046,50,48.4,50,0,0,0,5204,-5154
ZCTA5 08349,837,9593,-8756,2457,34.3,1755,0,448,0.182336182,27486,-25029
ZCTA5 08350,150,1744,-1594,475,56,360,0,52,0.109473684,4403,-3928
ZCTA5 08352,115,19342,-19227,441,16.8,73,0,212,0.480725624,54268,-53827
ZCTA5 08353,120,125,-5,323,47.1,270,18,2,0.00619195,234,89
ZCTA5 08360,15543,3438,12105,44080,36.4,26756,410,6693,0.151837568,8293,35787
ZCTA5 08361,6520,2429,4091,18953,44.9,14553,499,1940,0.102358466,6983,11970
ZCTA5 08401,16176,4770,11406,38496,37.5,8257,6461,12593,0.327124896,13037,25459
ZCTA5 08402,2651,1627,1024,5388,58.1,5163,67,1,0.000185598,5411,-23
ZCTA5 08403,482,8106,-7624,906,65.8,855,25,0,0,19968,-19062
ZCTA5 08406,4243,16216,-11973,9332,53.8,7018,943,427,0.045756537,47204,-37872
ZCTA5 08501,2476,1529,947,6395,50,5577,406,258,0.040344019,4755,1640
ZCTA5 08502,3717,6420,-2703,11467,41.2,5514,5172,227,0.019795936,19258,-7791
ZCTA5 08505,6831,1981,4850,17549,41.6,13313,1203,1538,0.087640321,5756,11793
ZCTA5 08510,1738,231,1507,5207,49.4,4251,313,37,0.007105819,546,4661
ZCTA5 08511,339,1589,-1250,838,35.7,506,15,92,0.109785203,4087,-3249
ZCTA5 08512,4406,273,4133,11540,44.1,6976,3185,594,0.051473137,828,10712
ZCTA5 08514,1976,2157,-181,5151,43.7,4779,225,66,0.012813046,6629,-1478
ZCTA5 08515,2272,2085,187,7884,36.4,4752,2185,591,0.074961948,5323,2561
ZCTA5 08518,2214,1150,1064,5632,40.9,4404,467,387,0.068714489,2969,2663
ZCTA5 08520,10362,0,10362,29799,39.2,19427,5618,1636,0.054901171,0,29799
ZCTA5 08525,1828,2066,-238,4611,45.9,4277,85,47,0.010193017,5924,-1313
ZCTA5 08527,20567,335,20232,57357,41,48283,2076,2285,0.039838206,637,56720
ZCTA5 08528,187,4384,-4197,219,68.2,219,0,0,0,13908,-13689
ZCTA5 08530,3291,11440,-8149,8075,49.3,6941,227,508,0.062910217,30255,-22180
ZCTA5 08533,2431,8236,-5805,6384,40.6,5993,42,97,0.015194236,27125,-20741
ZCTA5 08534,4574,13343,-8769,12672,43.1,9856,2068,151,0.011916035,37681,-25009
ZCTA5 08535,1669,9212,-7543,5189,43.5,4339,593,22,0.004239738,22363,-17174
ZCTA5 08536,8168,4456,3712,20523,36.3,5644,12472,1388,0.067631438,12832,7691
ZCTA5 08540,17695,3814,13881,48700,40.5,27956,14598,2915,0.059856263,9441,39259
ZCTA5 08542,1007,4088,-3081,2542,33.2,1272,389,361,0.142014162,12634,-10092
ZCTA5 08544,0,8055,-8055,4251,20.4,2621,889,409,0.096212656,23258,-19007
ZCTA5 08550,7310,769,6541,20546,44.5,8762,9971,487,0.023702911,6581,13965
ZCTA5 08551,1975,953,1022,5567,49.2,5198,228,66,0.011855578,4114,1453
ZCTA5 08553,280,11806,-11526,752,47,685,17,16,0.021276596,32168,-31416
ZCTA5 08554,1646,7236,-5590,4236,39,3586,154,339,0.080028329,19514,-15278
ZCTA5 08555,339,5831,-5492,1006,39.6,885,19,13,0.012922465,15283,-14277
ZCTA5 08558,2610,24847,-22237,7810,45.4,4918,1926,443,0.056722151,91423,-83613
ZCTA5 08559,2253,259,1994,5295,54.6,4955,20,10,0.001888574,926,4369
ZCTA5 08560,1483,7556,-6073,3904,52.7,3303,239,22,0.005635246,20377,-16473
ZCTA5 08561,144,3679,-3535,433,38.9,304,129,0,0,11067,-10634
ZCTA5 08562,1476,12702,-11226,3924,41.4,2988,34,191,0.048674822,31603,-27679
ZCTA5 08608,505,17098,-16593,982,32,55,2,841,0.856415479,43005,-42023
ZCTA5 08609,4364,1957,2407,13298,34.9,3431,75,6638,0.499172808,4787,8511
ZCTA5 08610,11675,7457,4218,32159,38.2,20456,1654,4666,0.145091576,19460,12699
ZCTA5 08611,10269,605,9664,31283,34,15120,435,8128,0.259821628,1426,29857
ZCTA5 08618,13691,986,12705,39148,33.7,10464,1099,24379,0.622739348,2802,36346
ZCTA5 08619,9103,2862,6241,23438,41.3,18030,1338,2147,0.091603379,8188,15250
ZCTA5 08620,4152,1829,2323,12587,41.5,10400,407,1500,0.119170573,3563,9024
ZCTA5 08628,4092,4830,-738,9646,48.1,6737,625,1863,0.193137052,12024,-2378
ZCTA5 08629,4208,517,3691,12722,39.7,3254,378,5969,0.469187235,980,11742
ZCTA5 08638,8723,764,7959,23960,38,9914,381,11215,0.468071786,1908,22052
ZCTA5 08640,866,956,-90,7904,34.4,4341,132,2662,0.336791498,2569,5335
ZCTA5 08641,1432,9868,-8436,5216,23.8,3973,116,575,0.11023773,24429,-19213
ZCTA5 08648,11480,1460,10020,32508,39,20622,4860,3845,0.118278578,3541,28967
ZCTA5 08690,7857,2230,5627,20445,47.5,17784,1233,595,0.02910247,4417,16028
ZCTA5 08691,6635,1303,5332,16730,44.5,11234,4422,629,0.037597131,2238,14492
ZCTA5 08701,30408,23584,6824,130352,18.4,117433,1103,3466,0.026589542,63218,67134
ZCTA5 08720,215,9975,-9760,687,52.4,660,18,9,0.013100437,25987,-25300
ZCTA5 08721,7862,16967,-9105,21725,41.1,17750,1319,595,0.027387802,32955,-11230
ZCTA5 08722,3916,2968,948,10863,41.3,9378,58,535,0.049249747,7339,3524
ZCTA5 08723,12649,19120,-6471,32686,43.4,28615,327,732,0.022394909,33064,-378
ZCTA5 08724,15927,2846,13081,39809,44.5,34279,541,1742,0.043758949,8597,31212
ZCTA5 08730,1805,1295,510,4955,46.3,4730,0,31,0.006256307,3819,1136
ZCTA5 08731,8504,962,7542,21037,45.8,19504,150,347,0.016494747,2622,18415
ZCTA5 08732,664,3991,-3327,1447,53.6,1354,3,4,0.00276434,12193,-10746
ZCTA5 08733,1037,13432,-12395,2693,40.7,1882,244,256,0.09506127,38236,-35543
ZCTA5 08734,2532,43,2489,7536,44.3,7491,0,24,0.003184713,148,7388
ZCTA5 08735,2156,2081,75,3982,61.8,3591,7,8,0.002009041,6630,-2648
ZCTA5 08736,5297,2742,2555,13366,46.7,12595,89,15,0.00112225,9108,4258
ZCTA5 08738,634,4849,-4215,1422,58.1,1347,55,6,0.004219409,14327,-12905
ZCTA5 08740,757,16349,-15592,1629,48.4,1600,0,19,0.011663597,46298,-44669
ZCTA5 08741,1051,15367,-14316,2754,54,2580,37,40,0.014524328,45510,-42756
ZCTA5 08742,10376,12795,-2419,24902,46.7,22861,181,133,0.005340936,38759,-13857
ZCTA5 08750,1475,110,1365,3576,54.8,3368,40,96,0.026845638,424,3152
ZCTA5 08751,1928,11468,-9540,3671,54.6,3494,1,1,0.000272405,30228,-26557
ZCTA5 08752,1335,3549,-2214,2364,62.6,2307,0,37,0.015651438,8649,-6285
ZCTA5 08753,24947,3753,21194,64708,42.5,55537,2207,1913,0.029563578,11778,52930
ZCTA5 08755,10299,1711,8588,27164,43.1,22223,1118,2023,0.074473568,4591,22573
ZCTA5 08757,17702,2000,15702,34957,63.4,30015,631,2259,0.06462225,5664,29293
ZCTA5 08758,3303,1675,1628,7783,54.1,7297,0,88,0.011306694,4468,3315
ZCTA5 08759,19912,887,19025,34007,68.6,31004,987,993,0.029199871,2235,31772
ZCTA5 08801,2530,1490,1040,8296,34.8,5955,396,1350,0.162729026,3684,4612
ZCTA5 08802,1461,6186,-4725,4301,47.4,4067,37,21,0.004882585,18584,-14283
ZCTA5 08804,1138,19080,-17942,2948,47.7,2568,18,246,0.083446404,45793,-42845
ZCTA5 08805,5128,1055,4073,13730,35.5,8473,550,698,0.050837582,2793,10937
ZCTA5 08807,13740,3374,10366,38916,44.1,24469,10708,872,0.022407236,8844,30072
ZCTA5 08809,2231,3826,-1595,6948,35.3,5222,612,602,0.086643638,10358,-3410
ZCTA5 08810,2761,1399,1362,8185,39.9,2380,4492,789,0.096395846,3685,4500
ZCTA5 08812,4544,5862,-1318,14074,40.5,7977,1898,660,0.046894984,15880,-1806
ZCTA5 08816,16472,6218,10254,48950,42.8,27390,13991,1863,0.038059244,16391,32559
ZCTA5 08817,16234,13159,3075,47590,37.5,18063,18010,4785,0.100546333,38425,9165
ZCTA5 08820,13310,4919,8391,40083,42.7,8965,27479,2045,0.051019135,13661,26422
ZCTA5 08821,165,3299,-3134,548,39,495,44,9,0.016423358,8536,-7988
ZCTA5 08822,11462,3060,8402,30717,42.9,25612,2284,574,0.018686721,8289,22428
ZCTA5 08823,3476,6140,-2664,9071,35.4,2715,3451,1771,0.19523757,17217,-8146
ZCTA5 08824,4503,1811,2692,13511,46,6862,5074,444,0.032862112,5522,7989
ZCTA5 08825,1917,17217,-15300,4611,48.5,4143,113,17,0.003686836,56202,-51591
ZCTA5 08826,2181,14329,-12148,5429,47.1,5062,10,62,0.011420151,39970,-34541
ZCTA5 08827,1561,77,1484,3824,48.2,3543,72,39,0.010198745,133,3691
ZCTA5 08828,991,7773,-6782,2365,39.7,1905,96,86,0.036363636,21646,-19281
ZCTA5 08829,1427,17249,-15822,3547,42.6,2915,325,146,0.041161545,53143,-49596
ZCTA5 08830,6410,4422,1988,17684,42.8,5597,9247,1314,0.074304456,12129,5555
ZCTA5 08831,22751,11554,11197,53894,53.3,40119,9906,1520,0.028203511,29922,23972
ZCTA5 08832,976,1722,-746,2937,29,1651,189,325,0.110657133,4939,-2002
ZCTA5 08833,3516,2696,820,9062,49.5,8565,177,13,0.001434562,6968,2094
ZCTA5 08835,4380,7012,-2632,10861,43.2,8228,295,1269,0.11684007,19723,-8862
ZCTA5 08836,1336,18688,-17352,4220,38.5,3210,486,2,0.000473934,50554,-46334
ZCTA5 08837,6874,8197,-1323,19371,36.2,6838,8069,2108,0.108822467,22026,-2655
ZCTA5 08840,6083,8967,-2884,17757,39.4,11389,2901,1108,0.062397928,22279,-4522
ZCTA5 08844,15293,1693,13600,42818,42.1,28410,9050,1876,0.04381335,4653,38165
ZCTA5 08846,5459,5248,211,14513,42.3,9611,1058,840,0.057879143,15992,-1479
ZCTA5 08848,2993,3187,-194,8463,44.8,8186,28,112,0.013234078,8283,180
ZCTA5 08850,3043,2400,643,8364,42.7,7130,465,199,0.023792444,7042,1322
ZCTA5 08852,7141,502,6639,18480,39.3,6001,9209,1729,0.093560606,957,17523
ZCTA5 08853,1913,3629,-1716,5260,47.2,4244,414,349,0.06634981,10055,-4795
ZCTA5 08854,16954,0,16954,60467,33.7,19001,22288,11898,0.196768485,0,60467
ZCTA5 08857,15753,14558,1195,40725,43.1,28983,5901,1968,0.048324125,55189,-14464
ZCTA5 08858,0,14389,-14389,0,-,0,0,0,#DIV/0!,41153,-41153
ZCTA5 08859,8837,5728,3109,24408,38.6,13290,5606,2763,0.11320059,14074,10334
ZCTA5 08861,19135,10728,8407,57515,36.6,32452,463,4570,0.079457533,20579,36936
ZCTA5 08863,4349,32238,-27889,12897,39.2,6750,2213,1806,0.140032566,80323,-67426
ZCTA5 08865,12885,27618,-14733,30179,42.3,23658,645,2360,0.078200073,56614,-26435
ZCTA5 08867,1892,1469,423,5436,46.9,5172,172,67,0.012325239,2780,2656
ZCTA5 08869,3119,3323,-204,7993,43.3,5167,1281,125,0.015638684,5724,2269
ZCTA5 08872,7501,1659,5842,19711,39.1,11428,3099,3827,0.194155548,2696,17015
ZCTA5 08873,20794,2459,18335,55115,40.9,21473,10773,16339,0.296452871,6188,48927
ZCTA5 08876,8926,29892,-20966,22691,41.1,16864,2489,1761,0.077607862,62397,-39706
ZCTA5 08879,9004,15818,-6814,21940,42.4,14219,1758,2427,0.110619872,29396,-7456
ZCTA5 08880,1778,29668,-27890,4818,35.7,2502,280,746,0.154836032,51853,-47035
ZCTA5 08882,5658,12847,-7189,16087,37.1,11867,420,1339,0.08323491,24703,-8616
ZCTA5 08884,3143,10690,-7547,8175,44.8,6717,577,259,0.031681957,26090,-17915
ZCTA5 08886,2519,18496,-15977,7225,42.6,5678,605,436,0.060346021,30893,-23668
ZCTA5 08887,584,28711,-28127,1294,40.6,829,45,30,0.023183926,52624,-51330
ZCTA5 08889,4242,10111,-5869,10269,52.7,8968,648,68,0.006621872,16137,-5868
ZCTA5 08890,7,3102,-3095,94,20.2,15,39,40,0.425531915,6147,-6053
ZCTA5 08901,15464,24056,-8592,57257,23.2,30083,6099,8522,0.148837697,40351,16906
ZCTA5 08902,15488,0,15488,42570,37.9,16717,10384,8906,0.209208363,0,42570
ZCTA5 08904,6502,23377,-16875,14947,35.8,9308,2499,1739,0.116344417,42646,-27699
ZCTA5 10001,14273,17504,-3231,26966,35.8,16963,4527,2117,0.078506267,29317,-2351
ZCTA5 10002,34737,32610,2127,76807,43.7,24687,30288,6453,0.08401578,60447,16360
ZCTA5 10003,25181,29381,-4200,54447,32,38481,9110,2823,0.051848587,58991,-4544
ZCTA5 10004,2113,43571,-41458,4795,33.9,2758,1593,162,0.033785193,96449,-91654
ZCTA5 10005,4782,14112,-9330,8637,30.3,6496,1180,147,0.017019799,36797,-28160
ZCTA5 10006,1991,23052,-21061,3894,31.9,2526,895,255,0.065485362,61018,-57124
ZCTA5 10007,3246,24739,-21493,8194,34,6173,1064,736,0.089821821,45799,-37605
ZCTA5 10009,29407,29165,242,60000,37,34924,7995,4577,0.076283333,79031,-19031
ZCTA5 10010,16207,12272,3935,33193,36,22952,4955,2952,0.088934414,29364,3829
ZCTA5 10011,29222,20919,8303,51867,42.8,38919,4854,2322,0.04476835,59708,-7841
ZCTA5 10012,11964,20079,-8115,22269,35.2,15836,4131,806,0.036193812,61650,-39381
ZCTA5 10013,12334,19400,-7066,29563,39.6,17204,9160,1000,0.033826066,57073,-27510
ZCTA5 10014,17685,15058,2627,29815,39.2,25507,1377,539,0.018078149,41200,-11385
ZCTA5 10016,30115,12339,17776,56758,32.7,38463,10060,2474,0.043588569,34709,22049
ZCTA5 10017,9471,13908,-4437,15514,40.7,11545,2762,426,0.027459069,22413,-6899
ZCTA5 10018,4535,8407,-3872,8063,34.2,4514,2433,409,0.050725536,17099,-9036
ZCTA5 10019,26403,8875,17528,43989,40.4,28545,8249,2664,0.060560595,20042,23947
ZCTA5 10020,0,10063,-10063,0,-,0,0,0,#DIV/0!,25372,-25372
ZCTA5 10021,21312,15846,5466,42484,44.5,36010,3936,129,0.003036437,43650,-1166
ZCTA5 10022,18294,4231,14063,33303,49.3,27702,3433,450,0.013512296,12311,20992
ZCTA5 10023,35480,18066,17414,65891,43.2,48380,8331,3108,0.047168809,32807,33084
ZCTA5 10024,29475,2828,26647,63916,41.5,52190,3588,1834,0.028693911,5359,58557
ZCTA5 10025,41418,13599,27819,96918,40,59414,9793,11148,0.115025073,24148,72770
ZCTA5 10026,15034,0,15034,39401,35.7,10096,2360,20286,0.514860029,0,39401
ZCTA5 10027,23638,0,23638,65840,31,19727,5701,24465,0.371582625,3,65837
ZCTA5 10028,24790,0,24790,47793,40.4,41401,3632,636,0.013307388,0,47793
ZCTA5 10029,33024,0,33024,77661,38.4,21361,8336,23610,0.304013598,0,77661
ZCTA5 10030,13111,0,13111,31611,37.6,5266,1107,18308,0.57916548,0,31611
ZCTA5 10031,21473,0,21473,61801,35.4,16316,2708,17443,0.282244624,0,61801
ZCTA5 10032,21959,31579,-9620,60529,37.1,14137,2939,10784,0.178162534,59443,1086
ZCTA5 10033,20079,0,20079,60739,36.9,22094,1787,5005,0.082401752,0,60739
ZCTA5 10034,15763,0,15763,43365,37.3,13880,1196,5539,0.127729736,0,43365
ZCTA5 10035,14350,0,14350,37042,36.3,7749,1375,14979,0.404378813,0,37042
ZCTA5 10036,18598,775,17823,30437,39.7,18141,5116,2288,0.075171666,1590,28847
ZCTA5 10037,9922,0,9922,19374,39.1,2228,702,13342,0.688654898,0,19374
ZCTA5 10038,10494,0,10494,23356,35.1,11554,6638,2495,0.106824799,0,23356
ZCTA5 10039,11550,0,11550,27234,35.8,4217,627,15394,0.565249321,0,27234
ZCTA5 10040,16502,0,16502,45771,39.6,13785,1061,3044,0.066504992,0,45771
ZCTA5 10044,4914,0,4914,12155,41.4,5268,3994,1581,0.13006993,0,12155
ZCTA5 10065,16112,0,16112,31270,37.7,24949,4304,647,0.020690758,0,31270
ZCTA5 10069,2651,0,2651,5774,38.6,2872,1866,179,0.031001039,0,5774
ZCTA5 10075,12227,0,12227,23391,43,20121,1659,423,0.018083878,0,23391
ZCTA5 10103,0,0,0,0,-,0,0,0,#DIV/0!,0,0
ZCTA5 10110,0,0,0,0,-,0,0,0,#DIV/0!,0,0
ZCTA5 10111,0,0,0,0,-,0,0,0,#DIV/0!,0,0
ZCTA5 10112,0,0,0,0,-,0,0,0,#DIV/0!,0,0
ZCTA5 10115,0,0,0,0,-,0,0,0,#DIV/0!,0,0
ZCTA5 10119,0,0,0,0,-,0,0,0,#DIV/0!,0,0
ZCTA5 10128,29351,3847,25504,58147,42.1,42660,5736,2985,0.051335409,7610,50537
ZCTA5 10152,0,2278,-2278,0,-,0,0,0,#DIV/0!,5507,-5507
ZCTA5 10153,0,14221,-14221,0,-,0,0,0,#DIV/0!,38851,-38851
ZCTA5 10154,0,5719,-5719,0,-,0,0,0,#DIV/0!,17090,-17090
ZCTA5 10162,1208,8180,-6972,2268,40.4,2203,65,0,0,24933,-22665
ZCTA5 10165,0,14432,-14432,0,-,0,0,0,#DIV/0!,41845,-41845
ZCTA5 10167,0,14799,-14799,0,-,0,0,0,#DIV/0!,41309,-41309
ZCTA5 10168,0,20365,-20365,0,-,0,0,0,#DIV/0!,55692,-55692
ZCTA5 10169,0,4814,-4814,0,-,0,0,0,#DIV/0!,14418,-14418
ZCTA5 10170,0,10195,-10195,0,-,0,0,0,#DIV/0!,28782,-28782
ZCTA5 10171,0,10433,-10433,0,-,0,0,0,#DIV/0!,31943,-31943
ZCTA5 10172,0,8498,-8498,0,-,0,0,0,#DIV/0!,24454,-24454
ZCTA5 10173,0,0,0,0,-,0,0,0,#DIV/0!,0,0
ZCTA5 10174,0,21306,-21306,0,-,0,0,0,#DIV/0!,61136,-61136
ZCTA5 10177,0,30713,-30713,0,-,0,0,0,#DIV/0!,87921,-87921
ZCTA5 10199,0,17178,-17178,0,-,0,0,0,#DIV/0!,45931,-45931
ZCTA5 10271,0,24638,-24638,0,-,0,0,0,#DIV/0!,74520,-74520
ZCTA5 10278,0,25142,-25142,0,-,0,0,0,#DIV/0!,79143,-79143
ZCTA5 10279,56,12392,-12336,131,48.1,131,0,0,0,37850,-37719
ZCTA5 10280,4208,12803,-8595,8582,45,6199,1810,138,0.016080168,38114,-29532
ZCTA5 10282,2581,28200,-25619,6419,38.8,4774,993,124,0.019317651,87796,-81377
ZCTA5 10301,14308,22066,-7758,38736,39,22839,2899,7772,0.200640231,69411,-30675
ZCTA5 10302,5597,25305,-19708,18144,35.4,8182,1069,4449,0.245205026,74911,-56767
ZCTA5 10303,8387,15382,-6995,27469,34.6,10012,2678,9205,0.335105027,47000,-19531
ZCTA5 10304,15160,19359,-4199,43849,38.8,21430,4912,12254,0.279459053,56011,-12162
ZCTA5 10305,15969,19421,-3452,44531,41.1,29984,8661,2799,0.06285509,51599,-7068
ZCTA5 10306,19820,28498,-8678,55805,42.5,42275,5757,2465,0.044171669,75709,-19904
ZCTA5 10307,5146,27386,-22240,14828,42.6,13484,481,21,0.00141624,69371,-54543
ZCTA5 10308,10488,2033,8455,30353,42.8,27124,1171,430,0.014166639,3974,26379
ZCTA5 10309,12114,15800,-3686,35832,40.5,32925,1088,225,0.006279303,43897,-8065
ZCTA5 10310,9070,22682,-13612,25976,38.4,14269,1410,5892,0.226824761,71631,-45655
ZCTA5 10311,0,34577,-34577,0,-,0,0,0,#DIV/0!,96319,-96319
ZCTA5 10312,21708,24363,-2655,63935,40.6,54984,4500,524,0.008195824,73205,-9270
ZCTA5 10314,31761,22144,9617,93736,42.1,64563,16710,3716,0.039643253,71580,22156
ZCTA5 10451,20434,5892,14542,50118,34.3,7686,611,21816,0.435292709,15647,34471
ZCTA5 10452,27940,8758,19182,79838,32.2,11730,1046,26950,0.337558556,21792,58046
ZCTA5 10453,27864,20987,6877,80393,33.2,9043,1586,25969,0.323025637,67915,12478
ZCTA5 10454,14259,20297,-6038,38908,32.3,6089,66,12532,0.322093143,58403,-19495
ZCTA5 10455,15673,3769,11904,42781,31.6,6098,587,13906,0.32505084,12723,30058
ZCTA5 10456,31718,17575,14143,90314,32.5,11085,638,43434,0.480922116,41625,48689
ZCTA5 10457,25682,395,25287,79443,30.6,14120,498,36024,0.453457196,1207,78236
ZCTA5 10458,29090,1794,27296,86757,29.7,10878,2904,15587,0.179662736,5361,81396
ZCTA5 10459,17453,123,17330,51303,33.2,6164,158,17878,0.348478646,263,51040
ZCTA5 10460,21480,2440,19040,59979,33.9,9533,827,20511,0.341969689,8215,51764
ZCTA5 10461,19084,168,18916,52756,38.9,23826,5979,5098,0.096633558,694,52062
ZCTA5 10462,29843,1819,28024,78470,35.5,15172,11680,20127,0.256492927,5158,73312
ZCTA5 10463,30201,2002,28199,73256,41.9,32415,2740,11915,0.162648793,7006,66250
ZCTA5 10464,1958,7129,-5171,4417,47.4,3399,87,31,0.007018338,20148,-15731
ZCTA5 10465,16211,3553,12658,46205,39.5,24703,2717,6303,0.136413808,10671,35534
ZCTA5 10466,25014,898,24116,75767,37.2,6861,1857,51654,0.681747991,2354,73413
ZCTA5 10467,38175,9219,28956,102209,34.4,21729,6508,33228,0.325098573,24960,77249
ZCTA5 10468,27795,4067,23728,82480,33.3,11015,2165,18434,0.223496605,12604,69876
ZCTA5 10469,23517,2207,21310,75290,40.3,11838,4136,42738,0.567645106,5205,70085
ZCTA5 10470,6412,205,6207,16446,39.3,7214,559,6143,0.373525477,679,15767
ZCTA5 10471,9015,536,8479,23387,46,14686,1029,2456,0.105015607,1561,21826
ZCTA5 10472,21876,67,21809,66720,32.9,6131,5847,18570,0.278327338,126,66594
ZCTA5 10473,22362,5245,17117,60296,38,14576,984,22610,0.374983415,13159,47137
ZCTA5 10474,3649,3816,-167,11312,30.6,1305,40,4099,0.362358557,10889,423
ZCTA5 10475,18608,2674,15934,44509,46.7,5230,1000,28070,0.630658968,7789,36720
ZCTA5 10501,495,1526,-1031,1452,51.8,1437,0,8,0.005509642,4482,-3030
ZCTA5 10502,1882,660,1222,5853,43.1,4253,672,240,0.041004613,1738,4115
ZCTA5 10503,50,378,-328,71,66.5,57,14,0,0,1221,-1150
ZCTA5 10504,2753,4802,-2049,8363,44.3,6989,363,93,0.011120411,13209,-4846
ZCTA5 10505,411,5731,-5320,1249,44.1,893,180,9,0.007205765,11947,-10698
ZCTA5 10506,2033,1670,363,5980,42.6,5363,126,87,0.014548495,5071,909
ZCTA5 10507,1984,2876,-892,6706,38.8,3896,749,583,0.086937071,7406,-700
ZCTA5 10509,7126,239,6887,20265,41.2,15416,629,438,0.02161362,800,19465
ZCTA5 10510,3776,3444,332,10592,47.8,8767,520,81,0.007647281,10840,-248
ZCTA5 10511,742,786,-44,2245,41.2,1636,108,186,0.08285078,2239,6
ZCTA5 10512,9213,5992,3221,24340,45.7,19549,454,1204,0.0494659,16699,7641
ZCTA5 10514,4327,8928,-4601,13267,41.9,10724,1202,726,0.054722243,26647,-13380
ZCTA5 10516,2283,7547,-5264,5639,46,5151,66,191,0.033871254,20040,-14401
ZCTA5 10517,162,0,162,485,42.5,380,32,8,0.016494845,114,371
ZCTA5 10518,376,439,-63,938,53.8,731,67,0,0,1275,-337
ZCTA5 10519,59,2759,-2700,157,34.1,0,157,0,0,7937,-7780
ZCTA5 10520,5110,1097,4013,13071,47.1,10815,474,663,0.050722975,2910,10161
ZCTA5 10522,3812,5727,-1915,11622,38.8,8720,1117,455,0.039149888,15560,-3938
ZCTA5 10523,3235,13596,-10361,9717,34.4,3963,838,2385,0.245446125,36938,-27221
ZCTA5 10524,1478,8817,-7339,4251,49,3796,70,90,0.021171489,20259,-16008
ZCTA5 10526,662,3456,-2794,1813,38.8,1456,150,9,0.004964148,10141,-8328
ZCTA5 10527,185,1563,-1378,594,45.8,479,0,20,0.033670034,4812,-4218
ZCTA5 10528,4622,10393,-5771,13546,40.3,10892,1367,501,0.036985088,31239,-17693
ZCTA5 10530,6395,8768,-2373,13807,50.1,9951,1230,1136,0.082277106,23568,-9761
ZCTA5 10532,1782,6520,-4738,5103,48.6,4544,253,135,0.026455026,20083,-14980
ZCTA5 10533,2362,4160,-1798,7608,38.6,6356,701,50,0.006572029,12623,-5015
ZCTA5 10535,136,13058,-12922,339,47.9,194,0,0,0,38237,-37898
ZCTA5 10536,3542,1882,1660,11124,44.9,9737,397,191,0.017170083,4996,6128
ZCTA5 10537,875,852,23,2572,40.4,1677,338,358,0.139191291,5391,-2819
ZCTA5 10538,5995,184,5811,17424,38.8,14257,925,644,0.036960514,665,16759
ZCTA5 10540,0,3187,-3187,206,16.6,105,2,55,0.266990291,9071,-8865
ZCTA5 10541,8869,6066,2803,26317,41.8,23706,260,205,0.007789642,17342,8975
ZCTA5 10542,0,13584,-13584,0,-,0,0,0,#DIV/0!,39210,-39210
ZCTA5 10543,7155,867,6288,21563,39.7,15471,1036,704,0.032648518,2090,19473
ZCTA5 10545,0,3908,-3908,149,61.6,114,9,5,0.033557047,8403,-8254
ZCTA5 10546,411,2364,-1953,1068,48.5,831,169,1,0.00093633,6632,-5564
ZCTA5 10547,2682,8654,-5972,7400,38.1,5482,271,1011,0.136621622,22722,-15322
ZCTA5 10548,1219,1562,-343,4078,43.8,3208,25,283,0.069396763,5114,-1036
ZCTA5 10549,5930,2248,3682,15587,43.4,11641,505,923,0.059216013,8016,7571
ZCTA5 10550,15504,526,14978,39360,40,3901,782,28407,0.721722561,1152,38208
ZCTA5 10552,9841,344,9497,23067,43.9,9212,893,8766,0.38002341,1138,21929
ZCTA5 10553,3632,10173,-6541,10259,43.4,1248,25,7654,0.746076616,28624,-18365
ZCTA5 10560,1761,5434,-3673,5001,46.1,4572,95,152,0.030393921,10113,-5112
ZCTA5 10562,12342,6593,5749,33850,43.7,18849,1853,3343,0.098759232,17914,15936
ZCTA5 10566,10404,3984,6420,25304,40.8,10681,486,5467,0.216052798,11607,13697
ZCTA5 10567,6623,7082,-459,20901,41.5,14919,617,1688,0.080761686,18368,2533
ZCTA5 10570,4072,5824,-1752,12821,41,10480,669,802,0.062553623,16410,-3589
ZCTA5 10573,13197,2235,10962,41181,39.6,22280,1403,1984,0.048177558,6854,34327
ZCTA5 10576,1740,22644,-20904,4959,52.4,4371,124,209,0.042145594,62396,-57437
ZCTA5 10577,731,6801,-6070,6059,20.8,4228,391,788,0.130054464,20261,-14202
ZCTA5 10578,498,12453,-11955,1502,43.2,508,137,0,0,30432,-28930
ZCTA5 10579,2976,13222,-10246,8279,49.1,7246,144,152,0.018359705,38654,-30375
ZCTA5 10580,6246,3234,3012,17901,42.5,14521,1163,391,0.021842355,8549,9352
ZCTA5 10583,14143,4006,10137,41532,42.4,29420,7502,994,0.023933353,10461,31071
ZCTA5 10588,1248,9291,-8043,3184,37.5,2554,278,94,0.029522613,21464,-18280
ZCTA5 10589,3502,3651,-149,7042,62.1,6665,149,44,0.006248225,9605,-2563
ZCTA5 10590,2542,10167,-7625,7132,47.4,6391,239,106,0.014862591,25811,-18679
ZCTA5 10591,9397,14083,-4686,23392,42.7,14260,1555,981,0.041937415,40674,-17282
ZCTA5 10594,1632,4098,-2466,5309,40.4,4864,187,21,0.003955547,12470,-7161
ZCTA5 10595,2360,5277,-2917,8019,36.1,5558,417,1008,0.125701459,15069,-7050
ZCTA5 10596,399,7624,-7225,951,46.4,698,0,57,0.059936909,17758,-16807
ZCTA5 10597,242,8793,-8551,755,44.9,666,10,0,0,23337,-22582
ZCTA5 10598,10362,0,10362,29195,46,23867,1333,1750,0.059941771,0,29195
ZCTA5 10601,5353,0,5353,10929,40,5891,1228,1664,0.152255467,0,10929
ZCTA5 10603,7307,1606,5701,19443,39,8873,1417,4804,0.247081212,5277,14166
ZCTA5 10604,3893,79,3814,11740,39.1,8036,223,1008,0.085860307,310,11430
ZCTA5 10605,7834,71,7763,20481,45.7,14716,1325,1835,0.089595235,158,20323
ZCTA5 10606,5712,1274,4438,15795,37.8,6549,1455,2509,0.158847737,4468,11327
ZCTA5 10607,2207,621,1586,6642,41.9,2918,814,1571,0.236525143,1790,4852
ZCTA5 10701,25954,4111,21843,66002,35.2,24294,2368,16632,0.251992364,11766,54236
ZCTA5 10703,7995,501,7494,23355,40.5,10743,798,5768,0.24697067,1312,22043
ZCTA5 10704,12533,2984,9549,32767,41.3,20674,2665,2776,0.084719382,8648,24119
ZCTA5 10705,15161,1569,13592,39846,38.4,13839,2152,7397,0.185639713,4094,35752
ZCTA5 10706,3265,473,2792,9050,44.8,7550,719,94,0.01038674,1165,7885
ZCTA5 10707,3996,2671,1325,10239,42.4,7285,859,425,0.04150796,8736,1503
ZCTA5 10708,9564,4452,5112,23014,43.3,17800,1033,1535,0.066698531,12913,10101
ZCTA5 10709,3735,1635,2100,10222,43.7,8799,875,140,0.01369595,4302,5920
ZCTA5 10710,10077,1245,8832,26319,43.3,12242,3182,4698,0.178502223,2958,23361
ZCTA5 10801,15122,3605,11517,41205,37.8,17521,2596,10832,0.262880718,11843,29362
ZCTA5 10803,4235,1645,2590,12953,40.1,9821,899,826,0.063769011,4035,8918
ZCTA5 10804,5173,2952,2221,15127,46.4,11489,782,1653,0.109274807,9029,6098
ZCTA5 10805,8075,337,7738,21260,42.4,10837,1322,3523,0.165710254,988,20272
ZCTA5 10901,9093,40,9053,25214,42.7,19187,1212,2331,0.09244864,142,25072
ZCTA5 10910,0,178,-178,0,-,0,0,0,#DIV/0!,553,-553
ZCTA5 10911,6,16695,-16689,12,-,6,0,6,0.5,48209,-48197
ZCTA5 10913,1484,4713,-3229,5370,39.9,4219,475,98,0.018249534,14006,-8636
ZCTA5 10914,106,12706,-12600,452,34.9,378,0,0,0,47742,-47290
ZCTA5 10915,32,9265,-9233,68,-,68,0,0,0,39271,-39203
ZCTA5 10916,1376,80,1296,4384,43.8,3518,114,38,0.008667883,133,4251
ZCTA5 10917,455,8479,-8024,1534,39.4,990,238,60,0.039113429,22908,-21374
ZCTA5 10918,4389,10237,-5848,12753,39.1,9749,287,640,0.05018427,31426,-18673
ZCTA5 10919,462,1064,-602,1226,54.4,680,11,21,0.017128874,3187,-1961
ZCTA5 10920,2868,6449,-3581,8776,44.3,6446,938,249,0.028372835,15545,-6769
ZCTA5 10921,1368,1666,-298,3992,39.9,2954,88,214,0.053607214,5995,-2003
ZCTA5 10922,407,777,-370,901,47.3,663,28,77,0.085460599,3889,-2988
ZCTA5 10923,2714,592,2122,8477,38,4492,591,1107,0.130588652,1598,6879
ZCTA5 10924,4442,5140,-698,13859,42.2,10924,569,593,0.04278808,14799,-940
ZCTA5 10925,1597,1196,401,4157,43.3,3862,158,47,0.01130623,2194,1963
ZCTA5 10926,1478,465,1013,3902,39.4,2079,422,726,0.186058432,1534,2368
ZCTA5 10927,3714,3349,365,12598,36.3,4856,454,1110,0.088109224,9164,3434
ZCTA5 10928,1984,794,1190,4900,42.2,2745,365,858,0.175102041,2462,2438
ZCTA5 10930,3418,1030,2388,10536,41.6,7697,473,1144,0.108580106,3141,7395
ZCTA5 10931,324,215,109,1110,33.3,476,67,161,0.145045045,305,805
ZCTA5 10932,14,602,-588,27,-,27,0,0,0,2179,-2152
ZCTA5 10933,87,15007,-14920,279,34.3,279,0,0,0,59133,-58854
ZCTA5 10940,18576,109,18467,50932,39.6,27432,2138,10520,0.20654991,137,50795
ZCTA5 10941,5324,4606,718,14415,37.6,8106,893,2988,0.207284079,13620,795
ZCTA5 10950,14828,1958,12870,61452,21.2,53864,546,1903,0.030967259,5522,55930
ZCTA5 10952,10556,999,9557,46448,19.5,41076,591,3010,0.064803651,3485,42963
ZCTA5 10953,0,20,-20,0,-,0,0,0,#DIV/0!,90,-90
ZCTA5 10954,9266,601,8665,26391,44.6,16779,3587,3155,0.119548331,1923,24468
ZCTA5 10956,9646,1377,8269,30664,44.9,21115,3280,2702,0.088116358,3320,27344
ZCTA5 10958,990,320,670,3286,43.1,2390,16,507,0.154290931,983,2303
ZCTA5 10960,5853,3537,2316,15145,39.7,10164,699,2841,0.187586662,9757,5388
ZCTA5 10962,1684,7456,-5772,5345,44.5,3422,1088,418,0.078203929,20526,-15181
ZCTA5 10963,1229,3302,-2073,4652,42.9,3067,221,762,0.163800516,9716,-5064
ZCTA5 10964,533,1512,-979,1419,52.3,1136,210,60,0.042283298,4559,-3140
ZCTA5 10965,5506,2180,3326,15527,40.2,12785,613,128,0.008243705,6963,8564
ZCTA5 10968,1231,648,583,2525,52.1,2049,191,159,0.062970297,7286,-4761
ZCTA5 10969,381,968,-587,1061,37.9,953,42,0,0,2818,-1757
ZCTA5 10970,3948,9138,-5190,11449,38.2,6097,1084,2317,0.202375753,27104,-15655
ZCTA5 10973,774,12020,-11246,2432,40,1887,57,107,0.043996711,44016,-41584
ZCTA5 10974,1252,5159,-3907,3181,46.3,2482,132,200,0.06287331,14178,-10997
ZCTA5 10975,44,1495,-1451,62,56.7,53,0,0,0,1963,-1901
ZCTA5 10976,602,7978,-7376,2051,35.9,1452,226,109,0.053144807,23800,-21749
ZCTA5 10977,16454,1866,14588,70743,24.9,42975,1775,14713,0.207978175,6139,64604
ZCTA5 10979,0,7562,-7562,0,-,0,0,0,#DIV/0!,17449,-17449
ZCTA5 10980,4701,3100,1601,13579,45,10559,354,1537,0.113189484,9400,4179
ZCTA5 10983,1890,2280,-390,5839,45,4782,516,103,0.017640007,7784,-1945
ZCTA5 10984,891,5900,-5009,2620,42.2,1994,86,236,0.090076336,17854,-15234
ZCTA5 10985,82,13211,-13129,207,44.4,207,0,0,0,40005,-39798
ZCTA5 10986,539,0,539,1736,42.7,1392,45,11,0.006336406,541,1195
ZCTA5 10987,1471,11009,-9538,3753,49.4,2839,57,377,0.100452971,30397,-26644
ZCTA5 10988,237,2443,-2206,722,33.9,628,0,34,0.047091413,8091,-7369
ZCTA5 10989,3437,10542,-7105,8339,51.7,6048,896,661,0.079266099,24405,-16066
ZCTA5 10990,7958,13876,-5918,21024,47.7,18972,245,819,0.038955479,33742,-12718
ZCTA5 10992,3070,16209,-13139,9591,38.5,7087,131,807,0.084141383,36724,-27133
ZCTA5 10993,1562,11718,-10156,5019,44.5,2510,201,931,0.185495119,26321,-21302
ZCTA5 10994,2416,16297,-13881,6937,49.5,5058,714,489,0.070491567,37438,-30501
ZCTA5 10996,860,16739,-15879,6386,21,4904,284,345,0.054024428,36958,-30572
ZCTA5 10998,1158,1711,-553,3602,40.5,3184,13,132,0.036646308,3272,330
ZCTA5 11001,8688,23739,-15051,26818,43.9,15995,6369,1477,0.05507495,52242,-25424
ZCTA5 11003,12279,27143,-14864,46200,39.5,9627,7425,20420,0.441991342,80202,-34002
ZCTA5 11004,5302,25084,-19782,16426,42.6,4553,8299,1067,0.064957993,80341,-63915
ZCTA5 11005,1452,14397,-12945,2075,86,2003,72,0,0,40125,-38050
ZCTA5 11010,8247,27918,-19671,25637,41,18742,2404,795,0.031009869,80086,-54449
ZCTA5 11020,1795,31008,-29213,6097,45,2476,2283,1055,0.173035919,92054,-85957
ZCTA5 11021,8071,28787,-20716,19265,45.7,12603,5033,320,0.016610433,93998,-74733
ZCTA5 11023,3018,30994,-27976,10169,37.5,8297,1302,80,0.007867047,72434,-62265
ZCTA5 11024,2093,21690,-19597,8394,29.7,7003,304,71,0.008458423,64041,-55647
ZCTA5 11030,5788,34079,-28291,17589,44.8,13254,3251,149,0.008471204,90510,-72921
ZCTA5 11040,13387,29857,-16470,42634,43,19373,18033,320,0.007505747,81267,-38633
ZCTA5 11042,0,23229,-23229,443,86.5,285,20,127,0.286681716,61495,-61052
ZCTA5 11050,11584,30214,-18630,31586,43.2,24548,3431,467,0.014785031,81428,-49842
ZCTA5 11096,2464,28558,-26094,9084,31.4,3761,332,1633,0.179766623,67195,-58111
ZCTA5 11101,15764,22780,-7016,33789,34,14126,9413,4214,0.124715144,53662,-19873
ZCTA5 11102,12265,16624,-4359,27876,35,15836,4292,1947,0.069845028,38398,-10522
ZCTA5 11103,15515,24853,-9338,35912,35.2,22907,5159,1046,0.029126754,74571,-38659
ZCTA5 11104,11864,26693,-14829,27575,38.7,15049,7076,587,0.021287398,95069,-67494
ZCTA5 11105,15352,30235,-14883,38311,36.2,27476,3444,1233,0.032183968,100476,-62165
ZCTA5 11106,18225,27635,-9410,40472,35.9,20997,7340,2647,0.065403242,80254,-39782
ZCTA5 11109,3109,16156,-13047,6712,34.5,3809,2334,90,0.01340882,33718,-27006
ZCTA5 11201,31084,26973,4111,68777,35.3,42126,9532,8999,0.13084316,74700,-5923
ZCTA5 11203,29002,18475,10527,79499,41.1,3511,1545,67600,0.850325161,44047,35452
ZCTA5 11204,25207,23106,2101,82140,34.9,45476,24962,801,0.009751644,60179,21961
ZCTA5 11205,16926,36134,-19208,50681,29.5,27765,3114,13159,0.259643653,99285,-48604
ZCTA5 11206,31256,14935,16321,90903,29.7,41946,5475,20937,0.230322432,43396,47507
ZCTA5 11207,33996,30668,3328,97690,35,13135,1525,59403,0.608076569,79268,18422
ZCTA5 11208,33551,29783,3768,107724,33.2,24195,7481,54516,0.506071071,84707,23017
ZCTA5 11209,30150,15336,14814,72938,40.5,50162,9901,2942,0.040335628,34393,38545
ZCTA5 11210,21720,8882,12838,65854,37.7,21344,3177,35066,0.532480943,28703,37151
ZCTA5 11211,26082,25943,139,65925,31.5,44335,4024,3742,0.056761471,67661,-1736
ZCTA5 11212,31594,32004,-410,78296,38.4,6299,828,59784,0.763563911,95390,-17094
ZCTA5 11213,26098,31057,-4959,69392,34.5,16573,1251,44558,0.642120129,72447,-3055
ZCTA5 11214,31716,31463,253,95361,40.5,43089,34873,1910,0.020029152,97084,-1723
ZCTA5 11215,29395,16277,13118,73419,37,53594,6665,2734,0.037238317,53031,20388
ZCTA5 11216,26106,22896,3210,62210,34.2,21074,2873,30187,0.48524353,52033,10177
ZCTA5 11217,18052,6390,11662,42107,35.5,24293,3678,7966,0.189184696,12850,29257
ZCTA5 11218,26140,0,26140,76370,36.4,44799,14820,6250,0.081838418,0,76370
ZCTA5 11219,24000,19620,4380,93119,26.2,59564,21873,1376,0.014776791,55543,37576
ZCTA5 11220,27487,28672,-1185,93584,35.9,26467,39288,2515,0.026874252,83938,9646
ZCTA5 11221,33851,7516,26335,89728,32.1,21971,3972,38446,0.428472718,22947,66781
ZCTA5 11222,18636,15078,3558,39669,34.9,31132,1595,1416,0.035695379,40705,-1036
ZCTA5 11223,27484,13599,13885,83565,37.9,44906,21598,5013,0.05998923,39143,44422
ZCTA5 11224,19218,0,19218,48110,48.2,26012,4126,9680,0.201205571,0,48110
ZCTA5 11225,24609,8816,15793,59465,36.1,18424,1630,33595,0.564954175,20688,38777
ZCTA5 11226,37128,10547,26581,99776,35.4,15562,2883,65416,0.655628608,29197,70579
ZCTA5 11228,15485,6998,8487,45267,42.4,25185,15319,502,0.011089756,18220,27047
ZCTA5 11229,31057,2679,28378,85538,41,53999,20037,5020,0.058687367,7442,78096
ZCTA5 11230,31670,13495,18175,91789,35.2,60925,14024,7397,0.080586998,35106,56683
ZCTA5 11231,16738,15241,1497,40311,36.7,26885,2029,5324,0.132073131,41520,-1209
ZCTA5 11232,9207,4372,4835,28501,34.9,11831,4604,2299,0.080663836,13593,14908
ZCTA5 11233,32147,14353,17794,85633,34.1,11760,1193,61404,0.717060012,39424,46209
ZCTA5 11234,32645,27854,4791,94254,41.7,34714,7641,43094,0.457211365,104486,-10232
ZCTA5 11235,34712,11230,23482,84859,45.9,62076,10849,1914,0.022555062,40160,44699
ZCTA5 11236,33728,8746,24982,102238,39.1,5470,2515,85092,0.832293276,37755,64483
ZCTA5 11237,17515,0,17515,50590,31.7,16855,3290,5681,0.11229492,0,50590
ZCTA5 11238,26009,24051,1958,58597,35.3,30572,3658,17431,0.297472567,62857,-4260
ZCTA5 11239,7845,31661,-23816,15917,45.8,2946,438,10578,0.66457247,97430,-81513
ZCTA5 11249,15811,19255,-3444,42421,30.7,30914,2264,2452,0.057801561,42484,-63
ZCTA5 11354,20400,32043,-11643,53375,46.6,10317,34227,1851,0.034679157,69745,-16370
ZCTA5 11355,29217,32069,-2852,80918,44.9,9380,59640,1878,0.02320868,87284,-6366
ZCTA5 11356,8104,12405,-4301,27295,38.6,7885,8479,450,0.016486536,32187,-4892
ZCTA5 11357,15456,13579,1877,44030,46.6,27975,10850,327,0.007426754,35680,8350
ZCTA5 11358,13190,34525,-21335,38103,42.8,14682,17443,406,0.010655329,99508,-61405
ZCTA5 11359,0,6189,-6189,0,-,0,0,0,#DIV/0!,19357,-19357
ZCTA5 11360,8822,11036,-2214,20076,50.5,12002,5968,282,0.014046623,36660,-16584
ZCTA5 11361,10842,11984,-1142,30006,44.4,13784,11817,1436,0.047857095,39291,-9285
ZCTA5 11362,7279,11261,-3982,19217,50.2,8345,9143,521,0.027111412,28769,-9552
ZCTA5 11363,2908,8433,-5525,7424,49.6,4025,2569,62,0.008351293,19464,-12040
ZCTA5 11364,13797,6920,6877,39015,45.6,14086,18895,1228,0.031475074,24977,14038
ZCTA5 11365,16167,9180,6987,45439,42.1,13825,19683,4693,0.103281322,30325,15114
ZCTA5 11366,4619,11020,-6401,13922,41.4,5062,6193,919,0.066010631,36821,-22899
ZCTA5 11367,14568,12405,2163,42362,37.1,21738,12050,3120,0.073650914,48119,-5757
ZCTA5 11368,29550,13508,16042,116469,34.3,31219,14504,10511,0.09024719,48226,68243
ZCTA5 11369,9551,12135,-2584,31550,40.7,7895,5067,5823,0.184564184,41872,-10322
ZCTA5 11370,7823,9738,-1915,29780,38.5,12282,6612,4084,0.137139019,33116,-3336
ZCTA5 11371,0,9792,-9792,0,-,0,0,0,#DIV/0!,31425,-31425
ZCTA5 11372,25164,0,25164,67252,40.7,28687,14582,2437,0.036236841,0,67252
ZCTA5 11373,31438,0,31438,102104,37.4,13738,49729,1608,0.015748648,0,102104
ZCTA5 11374,19938,5936,14002,47019,41.2,21895,14648,2274,0.048363428,18847,28172
ZCTA5 11375,33099,7920,25179,76091,44.1,42804,21718,2417,0.031764598,24601,51490
ZCTA5 11377,32419,5817,26602,85255,40.4,32761,31479,1964,0.023036772,19784,65471
ZCTA5 11378,12885,7568,5317,39994,39.5,25182,4939,659,0.016477472,28571,11423
ZCTA5 11379,13887,0,13887,39805,43.3,28852,4542,440,0.011053888,101,39704
ZCTA5 11385,37050,18706,18344,109111,36.2,73355,7557,3620,0.033177223,58705,50406
ZCTA5 11411,6509,9772,-3263,21605,46.3,1076,54,19257,0.891321453,30851,-9246
ZCTA5 11412,11500,19845,-8345,41782,40.2,981,1390,35455,0.848571155,61853,-20071
ZCTA5 11413,12983,18023,-5040,45661,40.1,870,738,40594,0.889030026,52288,-6627
ZCTA5 11414,11516,5206,6310,30915,46.2,22738,1630,1298,0.041986091,17316,13599
ZCTA5 11415,8546,0,8546,20351,41.4,11173,4126,1621,0.079652106,0,20351
ZCTA5 11416,7372,7404,-32,27098,36.2,6557,9002,1483,0.054727286,18982,8116
ZCTA5 11417,9347,2340,7007,33236,35.6,9559,10099,2835,0.085299073,7215,26021
ZCTA5 11418,11609,887,10722,38938,39.2,12659,9523,3592,0.092249217,2159,36779
ZCTA5 11419,12856,10554,2302,50107,41,3827,17836,6906,0.137825054,33152,16955
ZCTA5 11420,13555,1785,11770,51831,39.9,5817,17403,12787,0.246705639,5332,46499
ZCTA5 11421,11676,2416,9260,42704,39,13784,7688,2615,0.061235481,7486,35218
ZCTA5 11422,10191,3890,6301,34063,40,2764,1463,27242,0.799753398,10307,23756
ZCTA5 11423,10007,13804,-3797,30983,41.7,4339,8809,10633,0.3431882,43246,-12263
ZCTA5 11424,0,9260,-9260,0,-,0,0,0,#DIV/0!,27982,-27982
ZCTA5 11426,6256,9713,-3457,20959,44.1,6114,9104,1489,0.071043466,27530,-6571
ZCTA5 11427,7970,4405,3565,25890,43.5,5328,8742,5785,0.223445346,13070,12820
ZCTA5 11428,6298,226,6072,21184,43.6,2900,6274,4056,0.191465257,655,20529
ZCTA5 11429,7974,324,7650,28643,42,1295,1565,19598,0.684216039,2347,26296
ZCTA5 11430,0,0,0,222,47.9,45,8,154,0.693693694,2567,-2345
ZCTA5 11432,19783,17025,2758,64858,38.4,10416,28371,10635,0.163973604,56347,8511
ZCTA5 11433,10822,7179,3643,41396,34.4,1655,6844,24000,0.579766161,22872,18524
ZCTA5 11434,22264,6151,16113,66424,40.3,2700,2157,53061,0.798822715,26430,39994
ZCTA5 11435,19075,12288,6787,60842,36.2,10036,13064,15241,0.250501298,38126,22716
ZCTA5 11436,5852,0,5852,21248,37.1,685,1666,12907,0.607445407,0,21248
ZCTA5 11439,0,2465,-2465,2154,19.2,1109,205,476,0.220984215,7214,-5060
ZCTA5 11451,0,2864,-2864,0,-,0,0,0,#DIV/0!,8456,-8456
ZCTA5 11501,8361,2416,5945,21353,42,14847,2985,292,0.013674893,8020,13333
ZCTA5 11507,2277,2393,-116,6826,47.8,3844,2653,21,0.003076472,6628,198
ZCTA5 11509,730,16403,-15673,1691,54.3,1592,27,7,0.004139562,37881,-36190
ZCTA5 11510,10901,8395,2506,34713,42.1,15649,1247,13192,0.380030536,22953,11760
ZCTA5 11514,1682,3147,-1465,4725,40.8,3686,557,96,0.02031746,8779,-4054
ZCTA5 11516,2725,11157,-8432,8244,35.8,7111,75,145,0.017588549,33980,-25736
ZCTA5 11518,4050,900,3150,10248,40.5,8047,399,829,0.080893833,3858,6390
ZCTA5 11520,14611,583,14028,44788,39.8,15834,843,13934,0.311110119,1225,43563
ZCTA5 11530,9521,9920,-399,28550,41.8,24615,1742,288,0.010087566,26870,1680
ZCTA5 11542,10877,10411,466,29384,42,19501,1319,1963,0.066805064,29540,-156
ZCTA5 11545,4325,4266,59,11841,48,10116,909,52,0.004391521,16408,-4567
ZCTA5 11547,202,4413,-4211,488,46.3,361,127,0,0,12060,-11572
ZCTA5 11548,340,4253,-3913,2068,21.7,1349,459,147,0.071083172,12511,-10443
ZCTA5 11549,0,2059,-2059,2692,20.1,1861,231,318,0.118127786,5265,-2573
ZCTA5 11550,17544,12506,5038,60673,35.6,8818,1042,28936,0.476917245,40500,20173
ZCTA5 11552,7304,6578,726,26207,37.3,14523,1261,5718,0.218185981,20553,5654
ZCTA5 11553,6850,13659,-6809,27150,35.7,7878,366,11111,0.409244936,44977,-17827
ZCTA5 11554,11808,3678,8130,38078,42.3,25850,6655,1812,0.047586533,10517,27561
ZCTA5 11556,0,4002,-4002,0,-,0,0,0,#DIV/0!,12972,-12972
ZCTA5 11557,2701,19221,-16520,8234,41.4,6224,738,465,0.05647316,61442,-53208
ZCTA5 11558,2917,5728,-2811,8758,41.6,7085,194,143,0.016327929,16870,-8112
ZCTA5 11559,2389,4529,-2140,8427,29.9,7505,215,17,0.002017325,11415,-2988
ZCTA5 11560,2384,8328,-5944,7025,45.6,6261,185,60,0.008540925,21281,-14256
ZCTA5 11561,15771,1742,14029,39140,45.5,32143,1719,2055,0.052503832,4344,34796
ZCTA5 11563,7765,8942,-1177,22152,44.4,16302,1605,1008,0.045503792,26349,-4197
ZCTA5 11565,3209,5392,-2183,9077,43.3,7198,304,371,0.040872535,15255,-6178
ZCTA5 11566,11534,5582,5952,34393,42.7,30804,900,885,0.02573198,16075,18318
ZCTA5 11568,1022,13355,-12333,4428,25.5,3062,594,377,0.085140018,40968,-36540
ZCTA5 11569,577,2725,-2148,1168,57.5,1138,0,0,0,7859,-6691
ZCTA5 11570,10740,19676,-8936,28462,42.7,22336,1435,2294,0.080598693,66314,-37852
ZCTA5 11572,10306,2489,7817,29791,45.3,25359,1052,683,0.022926387,6690,23101
ZCTA5 11575,4334,11390,-7056,18143,34.3,3026,355,9129,0.503169266,34467,-16324
ZCTA5 11576,4526,3483,1043,12828,48.6,9756,2240,136,0.010601809,9648,3180
ZCTA5 11577,4136,7792,-3656,12125,43.9,8783,2115,376,0.031010309,23447,-11322
ZCTA5 11579,1834,1612,222,5084,42.1,4663,64,60,0.011801731,4417,667
ZCTA5 11580,13353,3729,9624,43414,43.3,13341,6130,14152,0.325977795,10953,32461
ZCTA5 11581,7021,13839,-6818,22919,38.8,10614,3269,4324,0.188664427,57011,-34092
ZCTA5 11590,14677,1047,13630,48436,40.4,21534,4614,9773,0.20177141,3122,45314
ZCTA5 11596,3474,951,2523,10431,42.5,7512,1872,118,0.011312434,2940,7491
ZCTA5 11598,3933,9047,-5114,14058,32,12302,289,532,0.037843221,29603,-15545
ZCTA5 11691,21572,2359,19213,70797,32.1,23157,3048,31387,0.443337995,6503,64294
ZCTA5 11692,8035,10104,-2069,24639,36.9,4882,1407,13798,0.560006494,38140,-13501
ZCTA5 11693,5257,893,4364,14147,40,8512,415,3105,0.219481162,2616,11531
ZCTA5 11694,8392,9492,-1100,22432,46.2,18238,534,1339,0.059691512,29199,-6767
ZCTA5 11697,1403,5953,-4550,3782,50,3713,20,9,0.002379693,19600,-15818
ZCTA5 11701,9162,11070,-1908,27831,44.1,12637,164,9738,0.349897596,28126,-295
ZCTA5 11702,5494,9508,-4014,14121,45.5,13333,160,61,0.004319807,28149,-14028
ZCTA5 11703,5518,4613,905,17754,39.7,12739,585,2030,0.11434043,14126,3628
ZCTA5 11704,12972,9960,3012,40344,43.4,29572,996,5180,0.128395796,29959,10385
ZCTA5 11705,3027,1400,1627,8241,42.5,7370,123,229,0.02778789,3443,4798
ZCTA5 11706,18882,5945,12937,66668,37.3,39483,4206,8434,0.12650747,18236,48432
ZCTA5 11709,2732,11085,-8353,6780,53,6417,13,23,0.00339233,32221,-25441
ZCTA5 11710,11362,5536,5826,36171,42.3,30907,1630,893,0.024688286,18559,17612
ZCTA5 11713,3256,483,2773,9128,39.2,6112,149,1676,0.183610868,1473,7655
ZCTA5 11714,7926,3393,4533,23262,44.7,18112,2791,58,0.002493337,9478,13784
ZCTA5 11715,1595,9488,-7893,4092,44.4,3998,27,0,0,27747,-23655
ZCTA5 11716,3545,4420,-875,9919,41.6,8740,371,189,0.01905434,12979,-3060
ZCTA5 11717,14754,15133,-379,65992,35.3,30324,1295,9321,0.141244393,42887,23105
ZCTA5 11718,1023,21327,-20304,3169,39.2,2822,13,109,0.034395708,67290,-64121
ZCTA5 11719,1149,7254,-6105,3508,48,2981,13,222,0.063283922,19806,-16298
ZCTA5 11720,8948,1059,7889,29213,37.7,22950,2240,1512,0.051757779,3406,25807
ZCTA5 11721,2315,5116,-2801,6409,49.4,5683,243,117,0.018255578,14152,-7743
ZCTA5 11722,9436,2923,6513,36756,34.6,13972,743,8320,0.226357601,9184,27572
ZCTA5 11724,946,4063,-3117,2916,39.6,2473,106,0,0,11786,-8870
ZCTA5 11725,9220,6528,2692,28896,44.7,25975,1478,412,0.014258029,19368,9528
ZCTA5 11726,6034,4053,1981,21674,40.1,10352,372,3359,0.154978315,12263,9411
ZCTA5 11727,10906,13913,-3007,29374,43.5,20935,1763,3553,0.120957309,43510,-14136
ZCTA5 11729,8562,14966,-6404,26306,43.1,17674,2945,2754,0.104690945,45623,-19317
ZCTA5 11730,4854,18209,-13355,13099,43.5,11710,203,500,0.038170853,54795,-41696
ZCTA5 11731,10667,7375,3292,31115,46.2,27723,1383,530,0.017033585,22326,8789
ZCTA5 11732,1547,9451,-7904,3705,50.8,3199,67,154,0.041565452,30422,-26717
ZCTA5 11733,5911,4279,1632,17177,45.4,14144,1544,278,0.016184433,13280,3897
ZCTA5 11735,11175,228,10947,33123,42.7,26040,2383,1348,0.040696797,586,32537
ZCTA5 11738,5346,4159,1187,19401,34.7,15053,839,1691,0.087160456,11976,7425
ZCTA5 11739,572,4650,-4078,1685,47.1,1562,1,0,0,15081,-13396
ZCTA5 11740,3353,7736,-4383,10469,42.8,8524,468,956,0.091317222,21808,-11339
ZCTA5 11741,9023,3399,5624,27172,40.1,23489,1056,1301,0.047880171,8673,18499
ZCTA5 11742,4514,89,4425,12946,39.7,11207,462,915,0.070678202,235,12711
ZCTA5 11743,15300,3466,11834,42406,47.1,34517,1516,2253,0.053129274,9449,32957
ZCTA5 11746,21544,16258,5286,67873,42.3,48358,5912,3858,0.056841454,45435,22438
ZCTA5 11747,7425,8324,-899,19232,50.6,17035,959,400,0.020798669,26308,-7076
ZCTA5 11749,1151,3587,-2436,3541,38.8,1744,385,218,0.06156453,9453,-5912
ZCTA5 11751,5212,4221,991,13746,45.1,11518,530,259,0.018841845,12354,1392
ZCTA5 11752,3029,13111,-10082,9146,45.6,7826,319,121,0.013229827,39176,-30030
ZCTA5 11753,4155,5079,-924,13361,43.5,6909,5760,191,0.014295337,14733,-1372
ZCTA5 11754,6691,5433,1258,17884,43.6,16432,654,110,0.006150749,15200,2684
ZCTA5 11755,4052,7166,-3114,12352,40.8,10027,1060,239,0.019349093,21131,-8779
ZCTA5 11756,14088,8027,6061,43571,42.3,33719,3796,845,0.019393633,25611,17960
ZCTA5 11757,14401,1948,12453,45091,41,36245,1083,1943,0.043090639,6273,38818
ZCTA5 11758,19159,11948,7211,54135,45.7,47880,501,2708,0.05002309,35969,18166
ZCTA5 11762,7737,5556,2181,22704,43.5,20828,532,122,0.005373502,16333,6371
ZCTA5 11763,9540,2562,6978,29808,41.5,20862,523,3304,0.110842727,7506,22302
ZCTA5 11764,4240,4550,-310,13157,40.8,11798,295,79,0.006004408,17672,-4515
ZCTA5 11765,244,8044,-7800,783,49.2,651,111,0,0,25240,-24457
ZCTA5 11766,3888,3129,759,11271,48.6,10422,371,112,0.009937006,9309,1962
ZCTA5 11767,4729,10628,-5899,14190,44.7,12425,726,259,0.01825229,31898,-17708
ZCTA5 11768,7882,0,7882,21139,50.2,19867,344,62,0.002932968,3150,17989
ZCTA5 11769,3210,8242,-5032,8855,48.6,7877,49,469,0.052964427,25709,-16854
ZCTA5 11770,52,1202,-1150,139,43.6,110,0,0,0,3758,-3619
ZCTA5 11771,3699,3134,565,10032,41.5,8459,665,243,0.024222488,8789,1243
ZCTA5 11772,16989,3988,13001,46181,39.7,36927,1791,2363,0.051168229,15025,31156
ZCTA5 11776,7830,12811,-4981,23292,40.7,19756,424,633,0.027176713,38777,-15485
ZCTA5 11777,3456,9609,-6153,9136,46.2,7774,626,119,0.013025394,28133,-18997
ZCTA5 11778,4449,1668,2781,12092,40.1,11282,54,93,0.007691035,4973,7119
ZCTA5 11779,12882,9840,3042,38713,38.1,31280,2363,1667,0.043060471,27934,10779
ZCTA5 11780,5602,566,5036,16114,46.1,14480,653,331,0.020541144,1255,14859
ZCTA5 11782,5422,21,5401,15388,42.9,14414,226,159,0.010332727,21,15367
ZCTA5 11783,7094,437,6657,21830,42.1,20155,910,312,0.014292258,895,20935
ZCTA5 11784,8209,3006,5203,25251,39.5,19648,1421,1290,0.051087086,7530,17721
ZCTA5 11786,1977,2510,-533,6670,38.9,5754,157,253,0.037931034,7751,-1081
ZCTA5 11787,11920,1338,10582,34815,46.8,31118,1642,258,0.007410599,3332,31483
ZCTA5 11788,5443,6347,-904,16578,44,13965,1237,169,0.010194233,15511,1067
ZCTA5 11789,2655,524,2131,7610,43.3,6659,152,107,0.014060447,1197,6413
ZCTA5 11790,4391,1882,2509,19319,22.7,12494,4966,1019,0.052746001,4933,14386
ZCTA5 11791,8170,745,7425,26075,43.3,16528,7950,307,0.01177373,1822,24253
ZCTA5 11792,3156,1756,1400,8879,41.5,8277,80,185,0.02083568,4597,4282
ZCTA5 11793,10407,1800,8607,31350,41.1,28728,676,281,0.008963317,4286,27064
ZCTA5 11794,0,5376,-5376,1279,19.5,411,537,185,0.144644253,13997,-12718
ZCTA5 11795,8107,83,8024,25839,40.6,23281,523,179,0.006927513,150,25689
ZCTA5 11796,1351,399,952,3911,44.9,3734,72,44,0.01125032,995,2916
ZCTA5 11797,3030,4834,-1804,9137,54.4,7219,1458,161,0.017620663,13539,-4402
ZCTA5 11798,4871,5088,-217,18134,37.1,2294,365,11097,0.611944414,16394,1740
ZCTA5 11801,12915,4372,8543,41099,41.9,22194,12886,846,0.020584442,13110,27989
ZCTA5 11803,10344,1753,8591,30067,45.4,24148,4897,80,0.002660724,4411,25656
ZCTA5 11804,1464,4993,-3529,4594,42.2,3587,849,15,0.003265128,12258,-7664
ZCTA5 11901,11065,1667,9398,32534,43.1,21875,878,4522,0.138993053,3559,28975
ZCTA5 11930,366,1445,-1079,780,59.5,736,0,2,0.002564103,2814,-2034
ZCTA5 11931,0,170,-170,0,-,0,0,0,#DIV/0!,313,-313
ZCTA5 11932,431,313,118,1066,50.7,811,51,171,0.160412758,661,405
ZCTA5 11933,3038,172,2866,6781,51.5,6069,76,478,0.070491078,441,6340
ZCTA5 11934,2721,301,2420,7889,42.5,7256,153,144,0.018253264,677,7212
ZCTA5 11935,1224,414,810,3114,54,3009,0,16,0.005138086,878,2236
ZCTA5 11937,8328,5325,3003,20819,45.9,15384,431,653,0.03136558,11811,9008
ZCTA5 11939,629,172,457,1331,61.3,1293,0,13,0.009767092,447,884
ZCTA5 11940,1850,3041,-1191,5005,47.3,4620,105,51,0.01018981,6737,-1732
ZCTA5 11941,820,797,23,2426,46.3,2230,0,30,0.012366035,1960,466
ZCTA5 11942,2183,298,1885,5428,52.4,5205,90,30,0.005526898,664,4764
ZCTA5 11944,2207,7929,-5722,4696,54.1,3810,37,225,0.047913118,26818,-22122
ZCTA5 11946,6312,4548,1764,17027,43.1,13467,183,153,0.008985729,11658,5369
ZCTA5 11947,0,311,-311,0,-,0,0,0,#DIV/0!,600,-600
ZCTA5 11948,255,2506,-2251,526,37.3,526,0,0,0,6057,-5531
ZCTA5 11949,4799,318,4481,12744,46.9,10954,232,532,0.041745135,900,11844
ZCTA5 11950,4759,0,4759,17264,31.9,13286,159,1354,0.078429101,26,17238
ZCTA5 11951,4718,133,4585,14686,36.3,12273,185,1151,0.078373962,330,14356
ZCTA5 11952,2201,861,1340,4949,58.5,4940,0,8,0.001616488,1870,3079
ZCTA5 11953,5708,1025,4683,14300,43.3,11065,219,2166,0.151468531,2568,11732
ZCTA5 11954,1571,1403,168,4272,51.8,3920,2,47,0.011001873,3150,1122
ZCTA5 11955,1470,1493,-23,2863,56.2,2657,38,65,0.022703458,4878,-2015
ZCTA5 11956,148,31,117,319,58.8,284,0,3,0.009404389,88,231
ZCTA5 11957,521,175,346,1037,62.3,992,5,7,0.006750241,544,493
ZCTA5 11958,310,2931,-2621,802,48.3,802,0,0,0,7469,-6667
ZCTA5 11959,235,12062,-11827,542,65.8,482,33,15,0.027675277,28711,-28169
ZCTA5 11960,445,1200,-755,990,53.5,990,0,0,0,3062,-2072
ZCTA5 11961,5676,116,5560,12878,48.7,11139,303,827,0.064218046,310,12568
ZCTA5 11962,127,2858,-2731,253,63.6,253,0,0,0,7353,-7100
ZCTA5 11963,3318,5605,-2287,8438,48.5,6943,526,164,0.019435885,15125,-6687
ZCTA5 11964,1366,12329,-10963,3101,49.7,2711,238,31,0.009996775,30796,-27695
ZCTA5 11965,417,403,14,560,64.5,560,0,0,0,964,-404
ZCTA5 11967,8195,926,7269,27621,40.2,22403,953,2079,0.075268817,2262,25359
ZCTA5 11968,5193,31,5162,13481,50.9,10550,321,1278,0.094800089,103,13378
ZCTA5 11970,282,2371,-2089,523,68.3,495,28,0,0,5635,-5112
ZCTA5 11971,2745,1353,1392,6769,53.4,6079,233,0,0,3610,3159
ZCTA5 11972,272,452,-180,570,45.8,568,0,1,0.001754386,1437,-867
ZCTA5 11973,0,398,-398,35,22.6,10,25,0,0,1196,-1161
ZCTA5 11975,189,51,138,391,52.5,308,7,15,0.038363171,139,252
ZCTA5 11976,938,352,586,2093,49.3,1833,22,10,0.004777831,811,1282
ZCTA5 11977,1049,3251,-2202,3219,47.7,2978,99,4,0.001242622,8226,-5007
ZCTA5 11978,1442,297,1145,3636,45.8,2921,74,86,0.023652365,732,2904
ZCTA5 11980,2060,66,1994,4804,39,4472,38,203,0.042256453,164,4640
ZCTA5 12007,127,1729,-1602,304,46.5,304,0,0,0,4344,-4040
ZCTA5 12008,181,34,147,539,27.9,536,0,0,0,81,458
ZCTA5 12009,3154,161,2993,8394,42.7,7365,417,201,0.023945675,359,8035
ZCTA5 12010,11049,153,10896,27324,40.5,21203,394,1239,0.045344752,370,26954
ZCTA5 12015,1282,3031,-1749,3580,50.8,3066,94,176,0.049162011,8443,-4863
ZCTA5 12017,218,203,15,400,63.3,399,1,0,0,539,-139
ZCTA5 12018,3014,373,2641,7470,47.6,7379,25,15,0.002008032,891,6579
ZCTA5 12019,6275,8566,-2291,14681,45.9,13445,629,139,0.00946802,19590,-4909
ZCTA5 12020,14242,1730,12512,33896,43,31553,801,389,0.01147628,7291,26605
ZCTA5 12022,340,582,-242,931,41.4,901,0,14,0.015037594,1297,-366
ZCTA5 12023,805,1463,-658,2098,49.6,2026,15,7,0.003336511,3825,-1727
ZCTA5 12024,38,6703,-6665,59,56.1,59,0,0,0,16934,-16875
ZCTA5 12025,2165,929,1236,5221,47.7,5024,90,5,0.000957671,2538,2683
ZCTA5 12027,1675,833,842,4423,44.1,4174,10,24,0.005426181,2059,2364
ZCTA5 12028,323,652,-329,819,51.5,819,0,0,0,1218,-399
ZCTA5 12029,496,623,-127,1045,56.2,924,1,100,0.09569378,1495,-450
ZCTA5 12031,83,563,-480,196,51.1,196,0,0,0,1372,-1176
ZCTA5 12032,282,3852,-3570,635,51.8,587,47,0,0,9774,-9139
ZCTA5 12033,3457,667,2790,8079,46.6,7699,81,15,0.001856665,1555,6524
ZCTA5 12035,191,181,10,417,56.9,412,0,0,0,441,-24
ZCTA5 12036,90,237,-147,226,32.6,215,2,0,0,481,-255
ZCTA5 12037,1808,16891,-15083,4501,46.5,4037,13,154,0.034214619,41720,-37219
ZCTA5 12040,11,986,-975,25,61.4,25,0,0,0,2795,-2770
ZCTA5 12041,188,547,-359,599,32.4,560,0,0,0,1514,-915
ZCTA5 12042,115,1239,-1124,283,52.4,276,0,0,0,3229,-2946
ZCTA5 12043,2709,91,2618,7872,35.6,6882,98,293,0.037220528,284,7588
ZCTA5 12045,233,587,-354,571,34,565,0,6,0.010507881,1619,-1048
ZCTA5 12046,271,90,181,536,51.8,517,0,0,0,230,306
ZCTA5 12047,9863,898,8965,23236,39.9,18804,1248,1467,0.063134791,2778,20458
ZCTA5 12051,1513,1135,378,6405,38.6,4571,45,1547,0.241530055,2896,3509
ZCTA5 12052,768,1170,-402,2149,45.9,2117,0,0,0,2862,-713
ZCTA5 12053,1476,653,823,4133,44.4,3670,5,45,0.010887975,1458,2675
ZCTA5 12054,6816,2378,4438,16578,42.6,15545,309,253,0.01526119,6148,10430
ZCTA5 12056,765,9580,-8815,2277,35.7,2181,0,1,0.000439174,23634,-21357
ZCTA5 12057,813,1613,-800,2232,42.1,2069,61,0,0,3670,-1438
ZCTA5 12058,427,2003,-1576,974,50.9,916,17,41,0.042094456,4361,-3387
ZCTA5 12059,621,205,416,1491,48.9,1476,7,4,0.002682763,492,999
ZCTA5 12060,783,677,106,1826,56.9,1748,23,0,0,1560,266
ZCTA5 12061,4098,426,3672,10072,40.2,8731,533,185,0.018367752,1037,9035
ZCTA5 12062,638,45,593,1561,42.1,1518,26,0,0,78,1483
ZCTA5 12063,310,2267,-1957,685,59.1,685,0,0,0,5894,-5209
ZCTA5 12064,177,450,-273,357,57.5,353,0,0,0,896,-539
ZCTA5 12065,17855,698,17157,44139,40.3,36791,2869,1454,0.03294139,1755,42384
ZCTA5 12066,710,714,-4,1628,48.8,1527,3,13,0.007985258,1841,-213
ZCTA5 12067,589,5037,-4448,1518,41,1498,0,4,0.002635046,12504,-10986
ZCTA5 12068,973,957,16,2839,48.6,2706,0,16,0.005635787,2321,518
ZCTA5 12069,119,127,-8,391,42.2,330,0,61,0.15601023,290,101
ZCTA5 12070,755,7474,-6719,2220,43.9,2178,18,24,0.010810811,21331,-19111
ZCTA5 12071,99,92,7,204,46,204,0,0,0,242,-38
ZCTA5 12072,970,759,211,3027,33.4,2826,8,45,0.014866204,1765,1262
ZCTA5 12074,1179,1405,-226,2844,48.8,2765,37,8,0.00281294,3405,-561
ZCTA5 12075,1010,5670,-4660,2816,51.5,2389,0,26,0.009232955,14632,-11816
ZCTA5 12076,572,309,263,1208,54.6,1066,21,17,0.014072848,813,395
ZCTA5 12077,2675,694,1981,6917,42.5,5765,411,432,0.062454821,1976,4941
ZCTA5 12078,9418,1855,7563,23048,43.3,20429,168,375,0.016270392,4491,18557
ZCTA5 12082,2,2241,-2239,2,-,0,0,0,0,5103,-5101
ZCTA5 12083,1328,227,1101,3905,46.2,3707,0,16,0.004097311,627,3278
ZCTA5 12084,2085,638,1447,4863,34.7,2706,1665,350,0.071972034,1427,3436
ZCTA5 12085,130,426,-296,318,56.3,221,0,29,0.091194969,1254,-936
ZCTA5 12086,704,33,671,1712,54.8,1647,8,0,0,89,1623
ZCTA5 12087,413,120,293,1108,50.9,962,8,0,0,196,912
ZCTA5 12090,2309,1523,786,5701,46.5,5341,9,16,0.002806525,3631,2070
ZCTA5 12092,601,325,276,1415,43,1378,0,21,0.014840989,663,752
ZCTA5 12093,654,630,24,1488,49.1,1369,33,0,0,1549,-61
ZCTA5 12094,902,1288,-386,2525,46.4,2451,0,24,0.00950495,3286,-761
ZCTA5 12095,5131,71,5060,12472,43.7,11733,15,329,0.026379089,151,12321
ZCTA5 12106,1017,673,344,2229,52,2152,6,0,0,1777,452
ZCTA5 12108,119,2034,-1915,510,50,422,0,22,0.043137255,5067,-4557
ZCTA5 12110,7749,8549,-800,19825,41.4,15846,1908,928,0.046809584,19941,-116
ZCTA5 12115,34,184,-150,61,69.4,61,0,0,0,472,-411
ZCTA5 12116,618,1584,-966,1570,43.4,1570,0,0,0,4384,-2814
ZCTA5 12117,1267,954,313,2994,48.6,2889,0,7,0.002338009,2480,514
ZCTA5 12118,7343,315,7028,16897,43.7,15894,323,93,0.005503936,736,16161
ZCTA5 12120,290,274,16,709,41.7,701,0,8,0.011283498,559,150
ZCTA5 12121,724,375,349,2262,46,2237,0,18,0.00795756,1189,1073
ZCTA5 12122,1896,999,897,3797,53.2,3631,46,18,0.004740585,2658,1139
ZCTA5 12123,1998,794,1204,4753,42.8,4484,0,0,0,2150,2603
ZCTA5 12124,97,314,-217,228,46.8,228,0,0,0,796,-568
ZCTA5 12125,512,1812,-1300,1280,40.7,1224,19,0,0,4638,-3358
ZCTA5 12130,161,2291,-2130,560,35.8,560,0,0,0,6354,-5794
ZCTA5 12131,69,3248,-3179,140,56.3,133,0,0,0,7882,-7742
ZCTA5 12132,98,339,-241,203,42.7,148,0,0,0,953,-750
ZCTA5 12134,1702,110,1592,4730,51.9,4483,9,6,0.001268499,302,4428
ZCTA5 12136,304,131,173,765,57.2,750,0,7,0.009150327,313,452
ZCTA5 12137,759,82,677,2146,35.9,2067,0,77,0.035880708,160,1986
ZCTA5 12138,1296,512,784,2923,49.9,2759,12,17,0.005815943,1353,1570
ZCTA5 12139,89,1007,-918,261,61.3,251,0,0,0,2580,-2319
ZCTA5 12140,595,730,-135,1504,54.5,1420,32,15,0.009973404,1929,-425
ZCTA5 12143,2179,129,2050,5301,40.8,4888,62,214,0.040369742,246,5055
ZCTA5 12144,9380,1860,7520,21623,41,18261,1030,938,0.043379735,5073,16550
ZCTA5 12147,219,116,103,418,63.4,412,0,6,0.014354067,249,169
ZCTA5 12148,1928,713,1215,4549,49.7,4114,258,115,0.025280281,1710,2839
ZCTA5 12149,955,97,858,2246,45.4,2152,0,33,0.014692787,255,1991
ZCTA5 12150,273,287,-14,613,54.1,588,0,12,0.019575856,895,-282
ZCTA5 12151,370,130,240,863,49.6,813,8,24,0.027809965,419,444
ZCTA5 12153,314,272,42,799,45,698,45,0,0,505,294
ZCTA5 12154,1311,21607,-20296,3157,40.7,3028,5,13,0.004117833,54011,-50854
ZCTA5 12155,681,6040,-5359,1540,52.6,1478,0,2,0.001298701,14534,-12994
ZCTA5 12156,342,1064,-722,912,45.3,902,0,0,0,2603,-1691
ZCTA5 12157,1761,2753,-992,4718,45.5,4298,68,67,0.014200933,6897,-2179
ZCTA5 12158,2706,963,1743,6421,46,5721,204,112,0.017442766,2485,3936
ZCTA5 12159,3714,2471,1243,8381,51.7,7461,533,190,0.022670326,6331,2050
ZCTA5 12160,333,174,159,775,51.6,717,6,20,0.025806452,420,355
ZCTA5 12161,8,4472,-4464,8,-,8,0,0,0,11126,-11118
ZCTA5 12164,123,8037,-7914,454,62.3,453,0,1,0.002202643,17365,-16911
ZCTA5 12165,89,315,-226,168,58.2,168,0,0,0,663,-495
ZCTA5 12166,541,678,-137,1507,40.2,1478,1,0,0,1875,-368
ZCTA5 12167,1050,775,275,2441,50.3,2317,37,27,0.011061041,1753,688
ZCTA5 12168,771,90,681,1794,49.1,1772,0,0,0,147,1647
ZCTA5 12169,187,104,83,380,52.5,370,0,0,0,194,186
ZCTA5 12170,2018,1393,625,5156,43.1,4793,12,60,0.011636928,3373,1783
ZCTA5 12172,77,1010,-933,224,22.7,224,0,0,0,2431,-2207
ZCTA5 12173,727,2822,-2095,2202,34.7,1952,0,21,0.009536785,7700,-5498
ZCTA5 12174,208,4086,-3878,608,52.7,575,0,0,0,9079,-8471
ZCTA5 12175,281,12474,-12193,717,46,636,10,3,0.0041841,30078,-29361
ZCTA5 12176,186,3073,-2887,393,51.6,315,15,0,0,7205,-6812
ZCTA5 12177,233,11456,-11223,511,51.6,404,12,0,0,27575,-27064
ZCTA5 12180,21958,6545,15413,53729,34.5,38675,2703,7373,0.137225707,17170,36559
ZCTA5 12182,6634,998,5636,14643,40.1,11111,129,1852,0.126476815,1792,12851
ZCTA5 12183,1282,9440,-8158,2957,37.1,2245,0,208,0.070341562,21398,-18441
ZCTA5 12184,2804,4374,-1570,7105,48.2,6405,58,87,0.012244898,10830,-3725
ZCTA5 12185,741,4477,-3736,1795,40.7,1772,4,0,0,8992,-7197
ZCTA5 12186,2546,4199,-1653,6307,48.3,5965,75,32,0.005073728,11840,-5533
ZCTA5 12187,225,0,225,536,39.4,520,0,10,0.018656716,5995,-5459
ZCTA5 12188,4977,10609,-5632,11653,42.6,10868,235,133,0.01141337,27672,-16019
ZCTA5 12189,8694,11404,-2710,18277,37.6,13140,1755,1480,0.08097609,30294,-12017
ZCTA5 12190,170,8223,-8053,655,38.5,651,0,4,0.00610687,21600,-20945
ZCTA5 12192,651,2185,-1534,2135,47.1,2090,0,5,0.00234192,5090,-2955
ZCTA5 12193,787,9916,-9129,1912,44.5,1881,8,23,0.012029289,26371,-24459
ZCTA5 12194,56,2310,-2254,163,45.5,162,0,0,0,7018,-6855
ZCTA5 12195,108,5427,-5319,190,28.7,190,0,0,0,14749,-14559
ZCTA5 12196,1302,11406,-10104,3940,40.7,3659,0,24,0.006091371,29656,-25716
ZCTA5 12197,745,14443,-13698,2119,46.5,2024,0,16,0.007550731,35043,-32924
ZCTA5 12198,2767,1175,1592,7109,46.6,6791,64,7,0.000984667,3127,3982
ZCTA5 12202,4203,218,3985,8716,35.9,2526,520,4305,0.493919229,451,8265
ZCTA5 12203,13755,321,13434,30470,35.4,22684,2490,2837,0.093107975,635,29835
ZCTA5 12204,3819,117,3702,8216,31.8,3483,879,2775,0.337755599,165,8051
ZCTA5 12205,11324,294,11030,26255,43.2,21727,1885,1333,0.050771282,500,25755
ZCTA5 12206,6443,263,6180,15693,30.3,4477,1546,7262,0.462754094,558,15135
ZCTA5 12207,1225,182,1043,2157,33.7,998,20,995,0.461288827,436,1721
ZCTA5 12208,9876,301,9575,22143,33.2,15200,1917,3156,0.142528113,522,21621
ZCTA5 12209,4247,1299,2948,10055,35.1,5914,898,1913,0.190253605,2912,7143
ZCTA5 12210,5475,3834,1641,10807,32.6,5046,331,4791,0.443323772,10498,309
ZCTA5 12211,4431,216,4215,14094,36.7,11388,1440,493,0.034979424,339,13755
ZCTA5 12222,0,223,-223,6767,19.8,4099,362,1529,0.225949461,652,6115
ZCTA5 12226,0,154,-154,0,-,0,0,0,#DIV/0!,319,-319
ZCTA5 12302,10951,191,10760,27701,42.2,25809,325,314,0.011335331,451,27250
ZCTA5 12303,11346,199,11147,29725,39.9,21533,1349,3105,0.104457527,506,29219
ZCTA5 12304,8200,207,7993,20531,43.2,12505,1482,3109,0.151429546,528,20003
ZCTA5 12305,3393,85,3308,6947,35.6,4373,301,1439,0.207139773,276,6671
ZCTA5 12306,10556,415,10141,27352,41.3,22420,619,2066,0.075533782,1224,26128
ZCTA5 12307,2774,133,2641,7769,30.1,2164,602,2585,0.332732655,295,7474
ZCTA5 12308,5693,73,5620,14122,35,8845,764,2417,0.171151395,531,13591
ZCTA5 12309,12167,2395,9772,33172,41.9,26988,2900,1079,0.032527433,6541,26631
ZCTA5 12401,14536,126,14410,35225,40,25716,723,4034,0.114520937,360,34865
ZCTA5 12404,1419,408,1011,3686,44.2,3214,56,17,0.004612046,1110,2576
ZCTA5 12405,218,598,-380,603,45.4,484,19,0,0,1466,-863
ZCTA5 12406,298,192,106,571,49.8,556,3,0,0,491,80
ZCTA5 12407,40,172,-132,120,42.9,113,0,7,0.058333333,441,-321
ZCTA5 12409,442,302,140,955,61.4,870,46,0,0,595,360
ZCTA5 12410,215,122,93,365,57.3,357,0,0,0,280,85
ZCTA5 12411,157,230,-73,353,52.5,271,4,0,0,491,-138
ZCTA5 12412,253,21,232,575,68.3,546,15,0,0,34,541
ZCTA5 12413,1147,70,1077,3150,40.6,2767,0,29,0.009206349,154,2996
ZCTA5 12414,4363,952,3411,10211,46.7,8858,162,641,0.062775438,2157,8054
ZCTA5 12416,137,35,102,216,67.5,155,0,0,0,76,140
ZCTA5 12417,408,414,-6,941,51.4,765,0,0,0,801,140
ZCTA5 12418,108,1484,-1376,264,41.9,216,0,7,0.026515152,3643,-3379
ZCTA5 12419,272,231,41,648,52.1,553,0,0,0,523,125
ZCTA5 12420,88,1953,-1865,350,29.4,350,0,0,0,5004,-4654
ZCTA5 12421,140,230,-90,240,69.8,240,0,0,0,488,-248
ZCTA5 12422,138,1285,-1147,360,49.7,339,21,0,0,3262,-2902
ZCTA5 12423,412,137,275,1207,37.4,788,0,125,0.103562552,347,860
ZCTA5 12424,144,737,-593,263,64.1,263,0,0,0,1960,-1697
ZCTA5 12427,143,106,37,876,36,853,5,9,0.010273973,291,585
ZCTA5 12428,2594,124,2470,6866,40.3,4609,93,426,0.062044859,390,6476
ZCTA5 12429,19,91,-72,35,-,35,0,0,0,202,-167
ZCTA5 12430,607,874,-267,1449,51.1,1158,50,0,0,2077,-628
ZCTA5 12431,611,264,347,1544,48.9,1398,1,0,0,797,747
ZCTA5 12432,310,485,-175,675,32.8,442,0,0,0,1000,-325
ZCTA5 12433,229,908,-679,486,46.5,486,0,0,0,3400,-2914
ZCTA5 12434,384,92,292,723,45.7,709,0,14,0.019363762,136,587
ZCTA5 12435,85,88,-3,210,43.1,194,0,0,0,278,-68
ZCTA5 12436,160,907,-747,224,65.6,224,0,0,0,1949,-1725
ZCTA5 12438,8,498,-490,29,43.6,29,0,0,0,1049,-1020
ZCTA5 12439,155,446,-291,336,53.5,309,0,0,0,808,-472
ZCTA5 12440,627,114,513,1561,53.5,1296,43,124,0.079436259,154,1407
ZCTA5 12441,62,1035,-973,98,78.1,98,0,0,0,2365,-2267
ZCTA5 12442,390,417,-27,686,59,663,0,0,0,1018,-332
ZCTA5 12443,1570,322,1248,3919,49.1,3495,45,138,0.035213065,683,3236
ZCTA5 12444,147,338,-191,432,50.7,293,1,0,0,826,-394
ZCTA5 12446,2023,188,1835,5077,45.5,4122,60,4,0.000787867,694,4383
ZCTA5 12448,99,705,-606,160,77.2,160,0,0,0,1645,-1485
ZCTA5 12449,1198,352,846,3333,49.4,2363,24,238,0.071407141,959,2374
ZCTA5 12450,99,567,-468,208,50.4,208,0,0,0,1464,-1256
ZCTA5 12451,449,168,281,1379,44,1227,33,0,0,424,955
ZCTA5 12452,13,7669,-7656,16,73.8,16,0,0,0,18695,-18679
ZCTA5 12453,100,275,-175,232,82.5,216,0,0,0,580,-348
ZCTA5 12454,155,545,-390,432,35.7,432,0,0,0,1058,-626
ZCTA5 12455,796,261,535,1733,49.8,1463,5,26,0.015002885,702,1031
ZCTA5 12456,238,127,111,796,34.1,755,0,31,0.038944724,405,391
ZCTA5 12457,595,1209,-614,1419,41,1356,7,0,0,3203,-1784
ZCTA5 12458,856,340,516,3762,46.2,2021,27,870,0.231259968,731,3031
ZCTA5 12459,63,593,-530,112,63.5,112,0,0,0,1595,-1483
ZCTA5 12460,108,1145,-1037,262,46.3,262,0,0,0,3153,-2891
ZCTA5 12461,610,204,406,1346,47,1223,75,0,0,877,469
ZCTA5 12463,613,18,595,1205,47.9,1182,0,4,0.003319502,58,1147
ZCTA5 12464,545,863,-318,989,56.5,859,52,11,0.011122346,1937,-948
ZCTA5 12465,151,143,8,343,61.7,222,117,0,0,336,7
ZCTA5 12466,896,138,758,2077,48.3,1668,0,10,0.004814636,263,1814
ZCTA5 12468,573,355,218,1372,53.7,1290,0,17,0.012390671,942,430
ZCTA5 12469,329,100,229,736,57.8,702,0,31,0.042119565,158,578
ZCTA5 12470,193,700,-507,667,44.2,667,0,0,0,1765,-1098
ZCTA5 12471,288,2242,-1954,288,58.6,288,0,0,0,5197,-4909
ZCTA5 12472,608,824,-216,1304,48.7,1158,16,28,0.021472393,2476,-1172
ZCTA5 12473,236,428,-192,657,60,657,0,0,0,1005,-348
ZCTA5 12474,400,339,61,943,54.5,872,0,33,0.034994698,781,162
ZCTA5 12475,176,5,171,463,45.3,336,11,0,0,1224,-761
ZCTA5 12477,7790,15,7775,18196,48.1,16084,122,247,0.013574412,153,18043
ZCTA5 12480,169,7631,-7462,369,54.8,311,10,0,0,20459,-20090
ZCTA5 12481,555,100,455,1569,48.2,1481,30,0,0,186,1383
ZCTA5 12482,128,274,-146,494,51.8,494,0,0,0,561,-67
ZCTA5 12483,22,1002,-980,54,48.5,49,0,0,0,2690,-2636
ZCTA5 12484,1486,526,960,3325,49.5,2556,283,227,0.068270677,1209,2116
ZCTA5 12485,370,669,-299,1220,48.1,1220,0,0,0,2023,-803
ZCTA5 12486,605,233,372,1784,52.2,1128,17,105,0.058856502,691,1093
ZCTA5 12487,1499,2164,-665,3930,48.8,3167,8,448,0.113994911,5856,-1926
ZCTA5 12489,96,1171,-1075,112,59.9,112,0,0,0,3110,-2998
ZCTA5 12490,0,607,-607,0,-,0,0,0,#DIV/0!,1525,-1525
ZCTA5 12491,715,2150,-1435,1858,41.5,1522,17,10,0.005382131,5081,-3223
ZCTA5 12492,92,762,-670,197,59,194,0,0,0,1751,-1554
ZCTA5 12493,57,5783,-5726,83,72.3,66,0,7,0.084337349,14758,-14675
ZCTA5 12494,342,1284,-942,774,49.5,739,0,35,0.045219638,2967,-2193
ZCTA5 12495,92,1479,-1387,98,71.6,98,0,0,0,3579,-3481
ZCTA5 12496,496,108,388,1292,53.5,1153,22,42,0.03250774,337,955
ZCTA5 12498,2405,5268,-2863,4657,60.5,4188,115,82,0.017607902,12875,-8218
ZCTA5 12501,875,1052,-177,2007,45,1434,81,62,0.030891878,2714,-707
ZCTA5 12502,454,5,449,1265,47.5,1106,15,26,0.02055336,10,1255
ZCTA5 12503,225,1056,-831,661,47.5,515,4,13,0.019667171,3217,-2556
ZCTA5 12504,9,8485,-8476,1299,19.8,929,145,113,0.086989992,26083,-24784
ZCTA5 12507,92,7597,-7505,299,21.2,259,17,7,0.023411371,18560,-18261
ZCTA5 12508,7588,5313,2275,19697,39.8,13061,540,3518,0.178605879,13885,5812
ZCTA5 12512,76,2700,-2624,239,56.2,231,0,0,0,8221,-7982
ZCTA5 12513,117,2293,-2176,178,65.3,178,0,0,0,6234,-6056
ZCTA5 12514,1327,1077,250,3213,57.9,2929,106,36,0.011204482,2974,239
ZCTA5 12515,545,1947,-1402,1735,42.8,1293,0,38,0.021902017,4640,-2905
ZCTA5 12516,780,1115,-335,1862,55.4,1737,22,11,0.005907626,2992,-1130
ZCTA5 12517,164,964,-800,397,44.6,338,0,0,0,2698,-2301
ZCTA5 12518,2318,605,1713,5934,44.9,4935,213,159,0.026794742,1601,4333
ZCTA5 12520,1203,3448,-2245,3111,45.3,2863,78,82,0.026358084,10113,-7002
ZCTA5 12521,700,19013,-18313,1529,56.7,1342,7,20,0.013080445,55405,-53876
ZCTA5 12522,1862,9528,-7666,4834,41.5,4401,91,22,0.004551096,25156,-20322
ZCTA5 12523,846,6225,-5379,2028,45.3,1956,12,13,0.006410256,18087,-16059
ZCTA5 12524,6233,2369,3864,15633,45.3,12134,609,1317,0.084244867,7748,7885
ZCTA5 12525,752,2739,-1987,1817,48.1,1268,0,0,0,7567,-5750
ZCTA5 12526,1444,551,893,3310,54.6,3082,30,44,0.013293051,1338,1972
ZCTA5 12527,6,3864,-3858,12,-,6,0,6,0.5,11004,-10992
ZCTA5 12528,5425,1055,4370,13675,45.1,11517,348,645,0.047166362,2667,11008
ZCTA5 12529,865,3640,-2775,1901,56.3,1856,0,0,0,9526,-7625
ZCTA5 12530,54,2416,-2362,354,56.3,354,0,0,0,7375,-7021
ZCTA5 12531,872,4043,-3171,2295,49.5,2083,13,35,0.015250545,10486,-8191
ZCTA5 12533,8556,3586,4970,26101,41.9,20107,1391,1139,0.043638175,9085,17016
ZCTA5 12534,7568,189,7379,18194,45.2,13689,983,1913,0.105144553,365,17829
ZCTA5 12538,5347,585,4762,14311,40.4,11889,406,1100,0.076863951,2127,12184
ZCTA5 12540,3009,474,2535,9107,38.1,7535,191,399,0.043812452,1364,7743
ZCTA5 12542,2407,964,1443,5825,46.8,5073,45,184,0.031587983,2737,3088
ZCTA5 12543,1286,1773,-487,3146,40.8,2434,46,384,0.122059758,4872,-1726
ZCTA5 12544,59,958,-899,59,-,59,0,0,0,2325,-2266
ZCTA5 12545,2009,1480,529,4321,54.8,3900,105,178,0.041194168,6201,-1880
ZCTA5 12546,1215,877,338,2766,50.1,2231,72,251,0.090744758,2471,295
ZCTA5 12547,1229,247,982,2786,49,2553,49,83,0.029791816,686,2100
ZCTA5 12548,446,4396,-3950,1011,53,911,0,22,0.021760633,12520,-11509
ZCTA5 12549,3469,4907,-1438,10750,38.7,8621,43,913,0.084930233,17873,-7123
ZCTA5 12550,19586,12882,6704,55564,37.8,27980,1032,11030,0.198509827,34368,21196
ZCTA5 12553,9718,633,9085,26806,37.8,17048,1183,4237,0.158061628,1524,25282
ZCTA5 12561,6429,1465,4964,18058,34,14808,558,1122,0.062133127,4287,13771
ZCTA5 12563,2196,16060,-13864,7316,41.3,5833,90,794,0.108529251,43400,-36084
ZCTA5 12564,2855,15562,-12707,7945,47.2,6649,136,314,0.039521712,43043,-35098
ZCTA5 12565,548,0,548,1403,50.9,1296,1,56,0.039914469,746,657
ZCTA5 12566,4224,4294,-70,13028,38.3,11011,22,509,0.039069696,10740,2288
ZCTA5 12567,1021,477,544,2411,53,2261,2,5,0.002073828,1275,1136
ZCTA5 12569,4002,45,3957,10174,41.2,8756,83,101,0.009927266,77,10097
ZCTA5 12570,2291,2387,-96,6792,41.7,5639,241,465,0.068462898,5973,819
ZCTA5 12571,3616,61,3555,9167,46,8216,170,348,0.037962256,113,9054
ZCTA5 12572,3904,835,3069,8762,55.6,7955,155,181,0.020657384,2195,6567
ZCTA5 12574,195,144,51,525,41.3,483,25,0,0,264,261
ZCTA5 12575,623,108,515,1944,40.9,1652,0,144,0.074074074,237,1707
ZCTA5 12577,514,386,128,1520,40.1,1297,0,65,0.042763158,986,534
ZCTA5 12578,871,815,56,2152,47.4,2000,21,19,0.008828996,1863,289
ZCTA5 12580,1655,258,1397,4389,47.3,3963,116,123,0.028024607,551,3838
ZCTA5 12581,844,157,687,2048,47.8,1657,33,1,0.000488281,1335,713
ZCTA5 12582,1454,383,1071,6205,45.6,3908,92,1340,0.215954875,840,5365
ZCTA5 12583,734,83,651,1837,42.2,1745,35,6,0.003266195,170,1667
ZCTA5 12585,378,822,-444,1000,46.6,729,62,153,0.153,2181,-1181
ZCTA5 12586,4476,172,4304,12147,38.1,9616,108,1329,0.109409731,515,11632
ZCTA5 12589,5431,770,4661,19255,38.9,13912,295,1595,0.082835627,1719,17536
ZCTA5 12590,14041,160,13881,36849,45.1,27706,1751,3401,0.092295585,352,36497
ZCTA5 12592,533,143,390,1507,40.2,1284,26,118,0.078301261,430,1077
ZCTA5 12594,1581,114,1467,3930,43.7,3274,10,393,0.1,296,3634
ZCTA5 12601,16972,90,16882,42737,35.3,23237,1049,11455,0.268034724,161,42576
ZCTA5 12603,16534,372,16162,41610,44.8,30949,2247,4590,0.110310022,1101,40509
ZCTA5 12604,0,473,-473,1993,20,1276,338,177,0.088810838,1633,360
ZCTA5 12701,4713,887,3826,12559,41.4,7294,417,2089,0.166334899,1964,10595
ZCTA5 12719,503,130,373,1093,44,1046,9,19,0.017383349,206,887
ZCTA5 12720,34,49,-15,67,57.4,67,0,0,0,109,-42
ZCTA5 12721,2241,309,1932,7209,34.4,5472,83,355,0.049244001,932,6277
ZCTA5 12722,25,102,-77,25,-,25,0,0,0,228,-203
ZCTA5 12723,767,2844,-2077,1596,52.3,1223,6,231,0.144736842,7672,-6076
ZCTA5 12724,28,1694,-1666,65,64.3,57,0,0,0,4074,-4009
ZCTA5 12725,74,600,-526,191,50.2,184,3,0,0,2016,-1825
ZCTA5 12726,601,252,349,1450,53.1,1384,2,1,0.000689655,645,805
ZCTA5 12729,530,233,297,1316,46.1,978,47,237,0.180091185,503,813
ZCTA5 12732,446,340,106,819,62.4,727,0,0,0,785,34
ZCTA5 12733,139,739,-600,2771,39.3,1396,4,954,0.344280043,1722,1049
ZCTA5 12734,393,291,102,1146,36.2,789,0,0,0,777,369
ZCTA5 12736,70,185,-115,108,80.4,94,0,0,0,436,-328
ZCTA5 12737,634,45,589,1743,42.6,1531,27,30,0.017211704,126,1617
ZCTA5 12738,105,399,-294,255,40.4,212,0,0,0,971,-716
ZCTA5 12740,727,62,665,1810,46.2,1479,0,49,0.027071823,123,1687
ZCTA5 12741,91,106,-15,189,35.8,146,0,17,0.08994709,300,-111
ZCTA5 12742,61,5444,-5383,87,63.1,82,0,5,0.057471264,14639,-14552
ZCTA5 12743,136,849,-713,384,58.1,377,0,2,0.005208333,2434,-2050
ZCTA5 12745,15,878,-863,15,-,15,0,0,0,2105,-2090
ZCTA5 12746,301,390,-89,785,35.6,645,54,0,0,876,-91
ZCTA5 12747,782,202,580,2046,46.8,1622,276,56,0.027370479,612,1434
ZCTA5 12748,835,824,11,1971,50.2,1736,28,51,0.02587519,2310,-339
ZCTA5 12749,148,891,-743,537,35,537,0,0,0,2217,-1680
ZCTA5 12750,12,140,-128,22,35.6,22,0,0,0,366,-344
ZCTA5 12751,443,621,-178,1397,21.6,1141,0,150,0.107372942,1825,-428
ZCTA5 12752,170,43,127,315,48,301,0,10,0.031746032,68,247
ZCTA5 12754,2661,378,2283,7688,33.6,5272,80,799,0.1039282,933,6755
ZCTA5 12758,1893,287,1606,3941,50.3,3451,107,51,0.012940878,611,3330
ZCTA5 12759,586,207,379,2398,20,1464,13,545,0.227272727,429,1969
ZCTA5 12760,217,860,-643,479,56.9,469,10,0,0,3285,-2806
ZCTA5 12762,158,717,-559,484,37,466,0,0,0,1745,-1261
ZCTA5 12763,291,1851,-1560,565,50.3,485,0,20,0.03539823,4601,-4036
ZCTA5 12764,799,372,427,1694,49.2,1490,53,44,0.025974026,750,944
ZCTA5 12765,397,166,231,910,52,910,0,0,0,392,518
ZCTA5 12766,267,6889,-6622,651,58.6,644,7,0,0,14696,-14045
ZCTA5 12767,54,3204,-3150,201,29.4,201,0,0,0,7852,-7651
ZCTA5 12768,212,11209,-10997,626,51.8,575,0,20,0.031948882,26265,-25639
ZCTA5 12769,145,173,-28,291,68.1,199,32,50,0.171821306,298,-7
ZCTA5 12770,83,1426,-1343,254,47.7,240,0,0,0,3576,-3322
ZCTA5 12771,5597,258,5339,14840,41.3,11272,526,815,0.054919137,584,14256
ZCTA5 12775,862,92,770,2061,52.7,1456,24,274,0.132945172,236,1825
ZCTA5 12776,723,79,644,2003,51.6,1870,6,14,0.006989516,152,1851
ZCTA5 12777,340,880,-540,856,50.2,779,5,19,0.022196262,1846,-990
ZCTA5 12778,149,434,-285,384,54.1,384,0,0,0,976,-592
ZCTA5 12779,639,1902,-1263,1380,43.9,801,0,191,0.138405797,4522,-3142
ZCTA5 12780,909,888,21,2153,47.2,1897,11,47,0.021830005,1984,169
ZCTA5 12781,49,180,-131,104,47.9,104,0,0,0,463,-359
ZCTA5 12783,550,151,399,1378,42.4,1250,0,80,0.058055152,2250,-872
ZCTA5 12784,1,2320,-2319,3,14.5,0,0,3,1,6139,-6136
ZCTA5 12785,407,103,304,1219,42.3,706,33,168,0.137817884,160,1059
ZCTA5 12786,271,329,-58,482,69.3,447,0,0,0,819,-337
ZCTA5 12787,38,1444,-1406,89,38.9,76,0,0,0,3951,-3862
ZCTA5 12788,714,3931,-3217,2596,47.2,1821,12,394,0.151771957,9817,-7221
ZCTA5 12789,785,6416,-5631,1961,31.2,1341,110,121,0.061703213,17212,-15251
ZCTA5 12790,1766,2595,-829,4542,46,3956,170,42,0.009247028,6716,-2174
ZCTA5 12791,245,1721,-1476,741,38.4,741,0,0,0,4160,-3419
ZCTA5 12792,69,2677,-2608,132,53.6,132,0,0,0,6527,-6395
ZCTA5 12801,6718,1075,5643,14838,36.7,13708,71,359,0.024194635,2446,12392
ZCTA5 12803,3689,281,3408,8349,40.1,8009,30,29,0.00347347,574,7775
ZCTA5 12804,11851,364,11487,27486,47.7,25905,207,242,0.008804482,979,26507
ZCTA5 12808,109,201,-92,202,62.5,192,4,0,0,450,-248
ZCTA5 12809,1493,5615,-4122,3679,49,3529,54,5,0.001359065,13299,-9620
ZCTA5 12810,259,70,189,586,54.9,565,0,3,0.005119454,128,458
ZCTA5 12811,63,520,-457,175,59.4,173,0,0,0,1235,-1060
ZCTA5 12812,50,228,-178,328,67.4,328,0,0,0,533,-205
ZCTA5 12814,685,56,629,1300,55.1,1246,0,54,0.041538462,166,1134
ZCTA5 12815,517,2222,-1705,1041,51.6,1038,0,0,0,5033,-3992
ZCTA5 12816,2072,1283,789,4636,51.2,4382,74,47,0.01013805,3333,1303
ZCTA5 12817,939,281,658,2006,55.6,1946,37,3,0.001495513,628,1378
ZCTA5 12819,121,147,-26,311,45.6,282,0,0,0,503,-192
ZCTA5 12820,32,1025,-993,96,39.2,88,0,0,0,2917,-2821
ZCTA5 12821,65,96,-31,2764,38.5,880,43,1441,0.521345876,208,2556
ZCTA5 12822,2349,226,2123,6036,44.1,5868,0,12,0.001988072,516,5520
ZCTA5 12823,138,567,-429,462,45.5,462,0,0,0,1457,-995
ZCTA5 12824,423,70,353,949,56.2,929,0,20,0.021074816,157,792
ZCTA5 12827,1349,30,1319,3349,41.8,3151,9,22,0.006569125,48,3301
ZCTA5 12828,3740,191,3549,9866,47,9556,12,25,0.002533955,486,9380
ZCTA5 12831,6804,30,6774,18314,40.7,17580,204,90,0.004914273,76,18238
ZCTA5 12832,2717,948,1769,6353,49.7,6127,11,58,0.009129545,2448,3905
ZCTA5 12833,2102,249,1853,5141,41.8,4853,102,60,0.011670881,1188,3953
ZCTA5 12834,2398,309,2089,6211,41.7,5945,56,38,0.006118177,785,5426
ZCTA5 12835,1273,0,1273,2760,55.5,2677,0,12,0.004347826,0,2760
ZCTA5 12836,297,234,63,593,56.8,567,0,0,0,598,-5
ZCTA5 12837,406,21,385,1083,38.2,1057,0,0,0,60,1023
ZCTA5 12838,302,1494,-1192,735,50.1,708,0,0,0,3538,-2803
ZCTA5 12839,5884,15860,-9976,13612,39,12868,68,109,0.00800764,36752,-23140
ZCTA5 12841,90,695,-605,123,69.1,123,0,0,0,1505,-1382
ZCTA5 12842,262,1728,-1466,595,56.5,571,2,2,0.003361345,4269,-3674
ZCTA5 12843,276,27,249,672,48.4,646,0,21,0.03125,77,595
ZCTA5 12844,103,344,-241,265,58.9,250,0,11,0.041509434,684,-419
ZCTA5 12845,2072,90,1982,4760,50.3,4550,26,64,0.013445378,155,4605
ZCTA5 12846,1570,363,1207,3057,51.7,3011,0,20,0.006542362,838,2219
ZCTA5 12847,164,2423,-2259,376,63.1,324,20,13,0.034574468,5045,-4669
ZCTA5 12849,128,155,-27,320,55,319,0,0,0,397,-77
ZCTA5 12850,1010,1928,-918,2621,47,2515,0,63,0.024036627,4568,-1947
ZCTA5 12851,172,147,25,379,49.4,339,0,2,0.005277045,313,66
ZCTA5 12852,176,2071,-1895,333,66.5,308,10,1,0.003003003,5600,-5267
ZCTA5 12853,600,13157,-12557,1456,58.9,1401,13,8,0.005494505,33238,-31782
ZCTA5 12854,19,607,-588,82,8.6,82,0,0,0,1104,-1022
ZCTA5 12855,112,710,-598,236,54.4,228,0,0,0,2234,-1998
ZCTA5 12856,152,19,133,281,29.1,281,0,0,0,35,246
ZCTA5 12857,316,1016,-700,750,55.1,744,3,0,0,2423,-1673
ZCTA5 12858,58,515,-457,112,65.4,98,0,0,0,1113,-1001
ZCTA5 12859,758,301,457,2146,39.7,2072,0,21,0.009785648,778,1368
ZCTA5 12860,166,820,-654,342,52,330,5,2,0.005847953,2252,-1910
ZCTA5 12861,208,496,-288,544,47.4,507,10,0,0,1225,-681
ZCTA5 12862,105,929,-824,160,52.9,120,0,0,0,2457,-2297
ZCTA5 12863,404,1132,-728,1285,34.2,1285,0,0,0,2808,-1523
ZCTA5 12864,2,1040,-1038,4,-,4,0,0,0,2826,-2822
ZCTA5 12865,1362,975,387,3522,45.9,3297,1,87,0.024701874,2262,1260
ZCTA5 12866,17464,19,17445,38788,44.3,34682,1152,1165,0.030035062,32,38756
ZCTA5 12870,758,247,511,1725,51.7,1685,0,2,0.00115942,622,1103
ZCTA5 12871,1586,36,1550,4025,39.4,3769,17,126,0.031304348,145,3880
ZCTA5 12872,49,795,-746,95,-,95,0,0,0,1866,-1771
ZCTA5 12873,349,104,245,832,45.3,784,0,2,0.002403846,192,640
ZCTA5 12874,75,794,-719,138,62.7,135,0,0,0,2064,-1926
ZCTA5 12878,282,449,-167,749,49.8,705,8,24,0.032042724,4037,-3288
ZCTA5 12883,2103,311,1792,4784,48.5,4666,23,8,0.001672241,888,3896
ZCTA5 12884,261,555,-294,669,33.4,610,0,2,0.002989537,1407,-738
ZCTA5 12885,1958,3,1955,4423,46.4,4100,132,58,0.013113272,12,4411
ZCTA5 12886,77,457,-380,176,57.7,156,0,11,0.0625,1216,-1040
ZCTA5 12887,1779,595,1184,4733,41.7,4344,0,2,0.000422565,1578,3155
ZCTA5 12901,13906,239,13667,32866,36.7,29770,725,894,0.027201363,572,32294
ZCTA5 12903,785,582,203,1707,45.3,1558,54,26,0.0152314,1386,321
ZCTA5 12910,621,84,537,2062,40,1615,21,274,0.132880698,203,1859
ZCTA5 12911,0,466,-466,0,-,0,0,0,#DIV/0!,1298,-1298
ZCTA5 12912,672,270,402,1538,44.4,1503,3,0,0,664,874
ZCTA5 12913,485,133,352,1192,45.5,1147,0,0,0,265,927
ZCTA5 12914,350,1741,-1391,979,34.3,896,0,0,0,3998,-3019
ZCTA5 12915,38,194,-156,79,52.1,76,0,0,0,424,-345
ZCTA5 12916,915,2539,-1624,2376,40.6,2184,0,42,0.017676768,5337,-2961
ZCTA5 12917,469,290,179,1322,40.9,1111,1,60,0.045385779,872,450
ZCTA5 12918,1170,207,963,2828,43.8,2678,0,17,0.006011315,342,2486
ZCTA5 12919,1200,4653,-3453,2971,35,2851,7,7,0.002356109,16001,-13030
ZCTA5 12920,974,161,813,2242,46.9,2105,8,14,0.006244425,392,1850
ZCTA5 12921,916,369,547,2592,37.8,2462,8,9,0.003472222,1157,1435
ZCTA5 12922,25,836,-811,46,52.8,45,0,0,0,1677,-1631
ZCTA5 12923,218,783,-565,466,49.6,459,0,1,0.002145923,1825,-1359
ZCTA5 12924,17,578,-561,61,37.1,58,0,0,0,1542,-1481
ZCTA5 12926,991,487,504,2371,37.8,2225,0,17,0.00716997,1263,1108
ZCTA5 12927,157,95,62,294,60.1,294,0,0,0,198,96
ZCTA5 12928,853,2337,-1484,2019,43.9,1981,0,6,0.002971768,5941,-3922
ZCTA5 12929,336,80,256,4078,37.7,1591,11,1875,0.459784208,172,3906
ZCTA5 12930,299,179,120,851,33.2,721,3,0,0,408,443
ZCTA5 12932,528,1297,-769,1126,56.1,1014,0,27,0.023978686,3395,-2269
ZCTA5 12933,20,405,-385,40,45.7,28,0,0,0,1065,-1025
ZCTA5 12934,418,193,225,992,40.6,983,2,0,0,500,492
ZCTA5 12935,697,119,578,1488,48,1432,0,5,0.003360215,1047,441
ZCTA5 12936,271,2621,-2350,581,61,571,0,3,0.005163511,6680,-6099
ZCTA5 12937,614,84,530,1569,36,1195,4,35,0.022307202,206,1363
ZCTA5 12939,77,647,-570,175,44.3,167,0,0,0,1513,-1338
ZCTA5 12941,632,129,503,1516,48.3,1475,0,18,0.011873351,260,1256
ZCTA5 12942,318,62,256,605,53.3,596,2,0,0,96,509
ZCTA5 12943,149,0,149,339,52.9,329,0,0,0,1875,-1536
ZCTA5 12944,1695,120,1575,4106,40.9,3985,3,37,0.009011203,335,3771
ZCTA5 12945,140,1253,-1113,388,34.3,388,0,0,0,2661,-2273
ZCTA5 12946,2000,549,1451,4633,39.2,4373,10,33,0.007122815,1188,3445
ZCTA5 12950,275,975,-700,670,46.4,605,0,37,0.055223881,2333,-1663
ZCTA5 12952,90,3678,-3588,283,44.4,268,0,3,0.010600707,7842,-7559
ZCTA5 12953,4710,339,4371,14643,39.2,11373,19,2038,0.13917913,1001,13642
ZCTA5 12955,147,2562,-2415,297,48.5,292,0,0,0,6117,-5820
ZCTA5 12956,552,125,427,1210,55.9,1073,0,92,0.076033058,227,983
ZCTA5 12957,637,496,141,1500,40.4,1453,0,0,0,1174,326
ZCTA5 12958,787,1861,-1074,1919,47.5,1906,0,0,0,4534,-2615
ZCTA5 12959,771,661,110,1507,44.3,1496,0,0,0,1640,-133
ZCTA5 12960,489,830,-341,943,67.1,927,0,2,0.002120891,1772,-829
ZCTA5 12961,105,498,-393,127,62.4,42,0,0,0,1145,-1018
ZCTA5 12962,1956,277,1679,4713,43.8,4532,129,9,0.001909612,690,4023
ZCTA5 12964,19,60,-41,60,54.2,52,8,0,0,170,-110
ZCTA5 12965,179,16725,-16546,408,46.4,396,12,0,0,39017,-38609
ZCTA5 12966,1099,0,1099,2825,38.2,2724,16,0,0,1704,1121
ZCTA5 12967,491,530,-39,1251,35,1189,3,1,0.000799361,1723,-472
ZCTA5 12969,142,13070,-12928,288,55.3,279,0,0,0,31318,-31030
ZCTA5 12970,128,515,-387,922,20.6,829,51,25,0.027114967,1443,-521
ZCTA5 12972,2866,2775,91,6912,41.9,6429,81,56,0.008101852,7202,-290
ZCTA5 12973,37,1592,-1555,75,61.8,71,4,0,0,3863,-3788
ZCTA5 12974,973,6177,-5204,2269,55.7,2090,0,6,0.002644337,15188,-12919
ZCTA5 12975,157,5363,-5206,256,43.9,211,2,3,0.01171875,13694,-13438
ZCTA5 12976,109,1659,-1550,185,60.9,171,0,0,0,4470,-4285
ZCTA5 12977,0,712,-712,1741,33.9,578,0,855,0.491097071,1794,-53
ZCTA5 12978,79,3063,-2984,253,47.9,241,0,0,0,8490,-8237
ZCTA5 12979,1138,3338,-2200,2324,45.4,2227,29,11,0.004733219,8816,-6492
ZCTA5 12980,473,3310,-2837,1055,54.5,1005,0,0,0,8580,-7525
ZCTA5 12981,905,6546,-5641,2324,42.3,2302,0,0,0,17361,-15037
ZCTA5 12983,3320,898,2422,7135,44.9,6821,0,124,0.017379117,2341,4794
ZCTA5 12985,408,3718,-3310,939,52.3,924,0,0,0,10725,-9786
ZCTA5 12986,2311,845,1466,5325,45.9,5009,13,156,0.029295775,1981,3344
ZCTA5 12987,106,868,-762,224,57.1,223,0,0,0,2546,-2322
ZCTA5 12989,393,10586,-10193,879,53.6,801,12,0,0,30052,-29173
ZCTA5 12992,1657,13,1644,3800,47.3,3736,19,0,0,26,3774
ZCTA5 12993,674,653,21,1499,53.7,1448,4,16,0.010673783,1651,-152
ZCTA5 12996,863,1674,-811,2042,54.1,1866,6,20,0.009794319,3887,-1845
ZCTA5 12997,549,576,-27,1184,51.1,1157,0,2,0.001689189,1293,-109
ZCTA5 12998,69,6559,-6490,113,60.8,90,10,0,0,15235,-15122
ZCTA5 13020,32,992,-960,82,55.5,82,0,0,0,2277,-2195
ZCTA5 13021,16501,505,15996,37756,43,34015,326,1276,0.033795953,1286,36470
ZCTA5 13024,0,101,-101,1806,38.9,539,0,1105,0.611849391,304,1502
ZCTA5 13026,551,733,-182,1772,32.2,1621,5,20,0.011286682,1995,-223
ZCTA5 13027,14542,8,14534,35417,41,33035,403,476,0.013439874,10,35407
ZCTA5 13028,304,5111,-4807,743,47.6,662,0,0,0,11821,-11078
ZCTA5 13029,2965,2295,670,7853,42.6,7296,23,0,0,5245,2608
ZCTA5 13030,1483,9612,-8129,3705,45.5,3341,92,0,0,24968,-21263
ZCTA5 13031,6754,358,6396,16151,45.9,15066,367,161,0.009968423,840,15311
ZCTA5 13032,4833,326,4507,12960,45.8,11983,10,28,0.002160494,1121,11839
ZCTA5 13033,1341,2570,-1229,3794,38.9,3623,23,0,0,6390,-2596
ZCTA5 13034,739,1797,-1058,1924,43.5,1788,26,13,0.006756757,4648,-2724
ZCTA5 13035,2919,828,2091,8450,41.9,7976,56,208,0.024615385,2427,6023
ZCTA5 13036,3842,2639,1203,9697,41,9431,10,20,0.002062494,6525,3172
ZCTA5 13037,3539,3701,-162,9702,42.1,9220,22,51,0.005256648,10505,-803
ZCTA5 13039,6640,1377,5263,17233,42.8,16263,365,204,0.011837753,3962,13271
ZCTA5 13040,1094,505,589,2670,44.2,2583,0,0,0,1207,1463
ZCTA5 13041,4533,1824,2709,11916,40.2,10545,242,198,0.016616314,4224,7692
ZCTA5 13042,793,686,107,1817,52.8,1768,1,0,0,1726,91
ZCTA5 13044,1210,1747,-537,3041,48,2752,0,0,0,4246,-1205
ZCTA5 13045,10710,94,10616,28158,31.9,25827,244,755,0.026812984,294,27864
ZCTA5 13051,30,9983,-9953,30,-,30,0,0,0,21475,-21445
ZCTA5 13052,691,11653,-10962,1960,40.6,1943,0,0,0,30257,-28297
ZCTA5 13053,1807,1065,742,5033,37.1,4440,167,120,0.023842639,2992,2041
ZCTA5 13054,399,936,-537,1105,48.4,1105,0,0,0,2615,-1510
ZCTA5 13057,6381,70,6311,14300,44.6,13142,331,233,0.016293706,340,13960
ZCTA5 13060,1168,138,1030,2723,47.2,2412,56,22,0.008079324,334,2389
ZCTA5 13061,308,5766,-5458,785,51.3,699,0,63,0.080254777,15951,-15166
ZCTA5 13062,107,2527,-2420,187,78.2,187,0,0,0,6424,-6237
ZCTA5 13063,810,938,-128,1802,49.7,1710,60,0,0,2324,-522
ZCTA5 13065,119,620,-501,301,27,301,0,0,0,1485,-1184
ZCTA5 13066,5361,731,4630,12757,46.1,11387,418,294,0.023046171,1900,10857
ZCTA5 13068,1996,99,1897,4699,43.6,4508,52,0,0,262,4437
ZCTA5 13069,9946,2631,7315,24243,40.3,23169,64,113,0.004661139,6495,17748
ZCTA5 13071,315,49,266,811,37.5,759,25,0,0,166,645
ZCTA5 13072,328,1525,-1197,861,53.9,843,0,0,0,3463,-2602
ZCTA5 13073,2689,82,2607,6612,37.6,5991,14,110,0.016636419,177,6435
ZCTA5 13074,1696,1987,-291,4302,41.7,4087,44,1,0.00023245,6164,-1862
ZCTA5 13076,851,801,50,2269,43.1,2159,23,0,0,2024,245
ZCTA5 13077,2947,300,2647,6642,47.6,6276,243,3,0.000451671,869,5773
ZCTA5 13078,3800,39,3761,11008,45,8917,736,637,0.057867006,84,10924
ZCTA5 13080,1403,60,1343,3507,49.5,3249,0,5,0.00142572,119,3388
ZCTA5 13081,523,13498,-12975,1271,48.6,1195,14,4,0.003147128,37483,-36212
ZCTA5 13082,1526,1318,208,3895,46.9,3772,10,4,0.001026958,3707,188
ZCTA5 13083,823,1487,-664,2016,49.5,1964,19,3,0.001488095,3789,-1773
ZCTA5 13084,1453,31,1422,3580,47.9,3380,0,92,0.025698324,37,3543
ZCTA5 13087,69,2565,-2496,166,50.1,143,0,0,0,6715,-6549
ZCTA5 13088,10334,200,10134,22132,45.1,19212,863,722,0.032622447,486,21646
ZCTA5 13090,11883,14,11869,29237,37.4,24532,681,1385,0.047371481,29,29208
ZCTA5 13092,935,1612,-677,2535,38.9,2238,46,32,0.012623274,4159,-1624
ZCTA5 13101,923,172,751,2496,35.4,2344,0,2,0.000801282,456,2040
ZCTA5 13102,35,2578,-2543,61,32.2,61,0,0,0,6430,-6369
ZCTA5 13103,82,1015,-933,136,46.6,113,1,0,0,3262,-3126
ZCTA5 13104,6444,505,5939,17022,45.1,14626,1541,201,0.011808248,1527,15495
ZCTA5 13108,2675,728,1947,6213,49.8,5958,43,51,0.008208595,1872,4341
ZCTA5 13110,892,883,9,2351,49.5,2174,0,0,0,2398,-47
ZCTA5 13111,557,492,65,1771,34,1524,16,0,0,1599,172
ZCTA5 13112,572,4521,-3949,1622,46.6,1585,0,0,0,10772,-9150
ZCTA5 13113,14,3263,-3249,30,43.5,29,0,0,0,8207,-8177
ZCTA5 13114,2938,97,2841,7246,42.7,7002,11,14,0.0019321,267,6979
ZCTA5 13115,96,241,-145,232,38.8,221,0,0,0,686,-454
ZCTA5 13116,1422,996,426,3653,40.8,3165,30,74,0.020257323,2296,1357
ZCTA5 13117,125,367,-242,307,48.2,275,17,1,0.003257329,770,-463
ZCTA5 13118,2098,597,1501,5956,45,5176,22,527,0.088482203,1891,4065
ZCTA5 13119,0,2150,-2150,0,-,0,0,0,#DIV/0!,5605,-5605
ZCTA5 13120,712,763,-51,1935,41,1664,0,95,0.049095607,2086,-151
ZCTA5 13121,0,276,-276,0,-,0,0,0,#DIV/0!,629,-629
ZCTA5 13122,518,133,385,1202,45.1,1119,0,8,0.006655574,303,899
ZCTA5 13123,0,899,-899,0,-,0,0,0,#DIV/0!,2604,-2604
ZCTA5 13124,62,4315,-4253,144,52.3,141,0,0,0,10729,-10585
ZCTA5 13126,13249,2357,10892,35339,35.8,32017,560,942,0.026656102,5706,29633
ZCTA5 13131,1302,1113,189,3058,43.7,2842,46,31,0.010137345,3179,-121
ZCTA5 13132,1609,2138,-529,3427,53.1,3226,8,20,0.005836008,5209,-1782
ZCTA5 13134,27,7104,-7077,141,29.2,64,0,0,0,15513,-15372
ZCTA5 13135,2348,8311,-5963,6012,42.7,5586,66,116,0.019294744,20777,-14765
ZCTA5 13136,134,7493,-7359,355,37.9,355,0,0,0,19511,-19156
ZCTA5 13138,52,7567,-7515,133,45.2,133,0,0,0,15650,-15517
ZCTA5 13140,1653,5366,-3713,4217,46.4,4060,0,6,0.001422812,13543,-9326
ZCTA5 13141,290,8826,-8536,686,48,674,0,0,0,22475,-21789
ZCTA5 13142,2464,5576,-3112,6280,43.8,5959,0,22,0.003503185,13149,-6869
ZCTA5 13143,923,7797,-6874,2593,35.8,2374,24,55,0.021210953,28368,-25775
ZCTA5 13144,507,2730,-2223,1446,43.5,1374,0,7,0.004840941,6711,-5265
ZCTA5 13145,696,8782,-8086,1426,48,1391,0,0,0,20638,-19212
ZCTA5 13146,777,3054,-2277,2425,33.1,2199,8,21,0.008659794,8289,-5864
ZCTA5 13147,362,5713,-5351,922,38.3,864,0,28,0.030368764,15599,-14677
ZCTA5 13148,4822,6245,-1423,10581,43.3,9849,88,312,0.029486816,15095,-4514
ZCTA5 13152,3396,3711,-315,7856,52.9,7656,20,15,0.001909369,8868,-1012
ZCTA5 13153,120,0,120,344,33.3,344,0,0,0,0,344
ZCTA5 13154,10,75,-65,32,57.4,32,0,0,0,194,-162
ZCTA5 13155,248,539,-291,566,49,539,0,0,0,1546,-980
ZCTA5 13156,880,431,449,1963,55.8,1854,0,11,0.005603668,1045,918
ZCTA5 13157,257,608,-351,439,55.2,432,0,0,0,1387,-948
ZCTA5 13158,500,108,392,1349,50.9,1187,4,144,0.106745738,346,1003
ZCTA5 13159,2139,1531,608,5419,43.1,5135,16,46,0.008488651,3710,1709
ZCTA5 13160,841,2358,-1517,2382,42.1,2221,8,22,0.009235936,6143,-3761
ZCTA5 13162,205,198,7,376,42.3,376,0,0,0,559,-183
ZCTA5 13163,106,139,-33,370,44.5,345,0,18,0.048648649,300,70
ZCTA5 13164,851,204,647,2418,38.2,2339,0,0,0,512,1906
ZCTA5 13165,4275,188,4087,9783,46.3,9161,67,92,0.009404068,532,9251
ZCTA5 13166,2363,597,1766,5482,45.8,5321,9,22,0.004013134,1536,3946
ZCTA5 13167,1260,2635,-1375,2985,46.4,2887,16,0,0,6746,-3761
ZCTA5 13202,3087,1412,1675,7391,28.6,2503,419,3569,0.482884589,3744,3647
ZCTA5 13203,7788,536,7252,17111,38,10045,1423,3992,0.233300216,1244,15867
ZCTA5 13204,8392,397,7995,20094,31.7,10496,255,6656,0.331243157,1181,18913
ZCTA5 13205,7178,911,6267,17747,38.6,6609,634,8283,0.466726771,2076,15671
ZCTA5 13206,7848,461,7387,17132,38.3,12580,457,2288,0.133551249,980,16152
ZCTA5 13207,5290,452,4838,12888,35.6,6402,171,4894,0.379733085,1103,11785
ZCTA5 13208,8832,3793,5039,23177,35.5,11917,3393,5655,0.243991889,11348,11829
ZCTA5 13209,5895,930,4965,13016,45.2,11731,108,517,0.039720344,2249,10767
ZCTA5 13210,7432,393,7039,19606,25.5,11856,1701,4114,0.209833724,985,18621
ZCTA5 13211,2398,2323,75,6274,35.6,5091,416,152,0.024226968,5515,759
ZCTA5 13212,8865,833,8032,20829,44.7,19372,167,472,0.022660713,1952,18877
ZCTA5 13214,3010,553,2457,8782,37.3,6038,303,1470,0.167387839,1301,7481
ZCTA5 13215,5390,1598,3792,14497,42.8,12451,203,870,0.060012416,3899,10598
ZCTA5 13219,6236,139,6097,15725,43.1,14464,169,376,0.02391097,254,15471
ZCTA5 13224,3510,965,2545,8672,41.3,4344,541,2917,0.336369926,2573,6099
ZCTA5 13244,14,23,-9,8165,19.4,5035,1790,711,0.087078996,49,8116
ZCTA5 13290,0,420,-420,0,-,0,0,0,#DIV/0!,1239,-1239
ZCTA5 13301,63,584,-521,181,44,181,0,0,0,1617,-1436
ZCTA5 13302,558,317,241,1416,36.3,1369,1,0,0,680,736
ZCTA5 13303,563,493,70,1407,55,1376,0,1,0.000710732,1087,320
ZCTA5 13304,746,2468,-1722,1806,40.8,1777,14,6,0.003322259,6900,-5094
ZCTA5 13305,83,3227,-3144,184,55.7,184,0,0,0,7878,-7694
ZCTA5 13308,1631,74,1557,4738,40.5,4508,7,27,0.005698607,116,4622
ZCTA5 13309,2525,89,2436,5655,48.3,5453,25,65,0.011494253,230,5425
ZCTA5 13310,268,626,-358,698,36.1,698,0,0,0,1560,-862
ZCTA5 13312,157,108,49,318,63.1,318,0,0,0,244,74
ZCTA5 13313,212,1782,-1570,566,30.9,549,0,0,0,6843,-6277
ZCTA5 13314,24,557,-533,72,43,72,0,0,0,1129,-1057
ZCTA5 13315,526,4221,-3695,1415,45.7,1379,22,4,0.002826855,10094,-8679
ZCTA5 13316,2746,74,2672,6075,51,5963,7,17,0.002798354,271,5804
ZCTA5 13317,1381,25,1356,4025,36.2,3826,21,13,0.003229814,40,3985
ZCTA5 13318,427,1202,-775,1108,46.7,1094,0,0,0,3295,-2187
ZCTA5 13319,325,296,29,652,42.7,652,0,0,0,825,-173
ZCTA5 13320,745,4739,-3994,2065,41.9,2023,0,4,0.001937046,11201,-9136
ZCTA5 13321,356,251,105,712,51.5,663,16,0,0,566,146
ZCTA5 13322,455,350,105,1151,48.7,1127,0,11,0.009556907,993,158
ZCTA5 13323,4433,42,4391,11638,43.1,10993,147,108,0.009279945,128,11510
ZCTA5 13324,836,811,25,2104,48.1,2017,3,7,0.003326996,2475,-371
ZCTA5 13325,422,113,309,1078,44.5,1054,0,0,0,338,740
ZCTA5 13326,2064,3840,-1776,5048,54.1,4516,126,127,0.025158479,8837,-3789
ZCTA5 13327,780,3401,-2621,2106,41.2,2102,0,0,0,8545,-6439
ZCTA5 13328,631,498,133,1592,38.2,1410,27,12,0.007537688,1287,305
ZCTA5 13329,1587,707,880,3930,45.6,3750,23,0,0,1540,2390
ZCTA5 13331,40,1603,-1563,73,67.3,73,0,0,0,7641,-7568
ZCTA5 13332,865,106,759,2681,35.6,2452,22,76,0.028347631,300,2381
ZCTA5 13333,42,306,-264,72,60.3,67,0,0,0,725,-653
ZCTA5 13334,394,2243,-1849,945,39.6,945,0,0,0,5474,-4529
ZCTA5 13335,455,795,-340,1258,45.6,1143,13,6,0.004769475,3604,-2346
ZCTA5 13337,335,1009,-674,643,58.1,627,6,0,0,2827,-2184
ZCTA5 13338,634,130,504,1305,52.5,1268,0,8,0.006130268,265,1040
ZCTA5 13339,2051,1466,585,6281,36,5801,3,68,0.010826302,3889,2392
ZCTA5 13340,3084,6698,-3614,7651,43.4,7170,13,161,0.021043001,16067,-8416
ZCTA5 13342,88,24,64,271,26.3,221,0,0,0,59,212
ZCTA5 13343,642,888,-246,1561,50.4,1526,4,0,0,2186,-625
ZCTA5 13345,64,1643,-1579,141,42.4,130,0,11,0.078014184,3169,-3028
ZCTA5 13346,1953,116,1837,6273,28.3,5394,318,266,0.042403953,361,5912
ZCTA5 13348,583,574,9,1509,49.1,1449,2,5,0.003313453,1215,294
ZCTA5 13350,4253,5524,-1271,9748,48.3,8971,117,204,0.02092737,14191,-4443
ZCTA5 13352,1,871,-870,22,12.4,19,0,0,0,2722,-2700
ZCTA5 13353,14,909,-895,25,30.5,20,0,0,0,2278,-2253
ZCTA5 13354,1205,584,621,3412,42.3,3368,0,6,0.001758499,1499,1913
ZCTA5 13355,353,823,-470,1095,43.3,1084,0,0,0,2169,-1074
ZCTA5 13357,4269,707,3562,10354,42.6,9859,47,166,0.016032451,1934,8420
ZCTA5 13360,40,87,-47,158,22.9,158,0,0,0,213,-55
ZCTA5 13361,245,54,191,704,36.8,658,0,5,0.007102273,77,627
ZCTA5 13363,866,227,639,2329,42.8,2231,0,18,0.007728639,493,1836
ZCTA5 13364,107,1626,-1519,241,60.3,209,0,0,0,4161,-3920
ZCTA5 13365,3073,1633,1440,8204,39.3,7730,9,15,0.001828376,3831,4373
ZCTA5 13367,3534,16976,-13442,8889,40.5,8261,33,334,0.03757453,42329,-33440
ZCTA5 13368,469,0,469,1196,46.4,1146,0,9,0.007525084,12,1184
ZCTA5 13402,552,71,481,1181,50.4,1160,12,5,0.0042337,159,1022
ZCTA5 13403,1719,1823,-104,7110,35.9,6006,25,799,0.112376934,4809,2301
ZCTA5 13404,50,267,-217,117,44.6,117,0,0,0,654,-537
ZCTA5 13406,149,1640,-1491,418,37.6,417,0,0,0,4081,-3663
ZCTA5 13407,1983,929,1054,5163,47.2,4730,98,66,0.012783266,2296,2867
ZCTA5 13408,736,1623,-887,3423,21.3,2957,149,167,0.048787613,4297,-874
ZCTA5 13409,796,1382,-586,2106,50.2,1998,0,43,0.020417854,3071,-965
ZCTA5 13410,262,390,-128,521,48.9,448,3,0,0,978,-457
ZCTA5 13411,1154,182,972,2827,47,2722,10,0,0,534,2293
ZCTA5 13413,6626,282,6344,16169,48.4,14648,709,191,0.011812728,742,15427
ZCTA5 13415,30,280,-250,64,62.3,64,0,0,0,606,-542
ZCTA5 13416,884,1311,-427,2299,41.3,2274,0,9,0.003914746,3639,-1340
ZCTA5 13417,1625,149,1476,3293,47.8,3112,85,29,0.008806559,375,2918
ZCTA5 13418,60,255,-195,196,48.5,196,0,0,0,666,-470
ZCTA5 13420,498,13,485,1083,56.5,1053,0,30,0.027700831,28,1055
ZCTA5 13421,5386,1157,4229,12899,46.4,12069,97,106,0.008217691,2957,9942
ZCTA5 13424,875,595,280,2383,38.1,2049,126,156,0.065463701,1601,782
ZCTA5 13425,831,1118,-287,2035,45.1,1945,20,44,0.021621622,2886,-851
ZCTA5 13428,598,1365,-767,1369,53.8,1337,1,9,0.006574142,3609,-2240
ZCTA5 13431,642,88,554,1769,41,1731,9,5,0.002826456,156,1613
ZCTA5 13433,584,67,517,1557,34.6,1536,1,10,0.006422608,296,1261
ZCTA5 13435,106,363,-257,354,44.7,298,0,48,0.13559322,922,-568
ZCTA5 13436,31,275,-244,63,63.5,55,0,8,0.126984127,567,-504
ZCTA5 13437,117,43,74,297,49.9,281,0,0,0,98,199
ZCTA5 13438,1253,190,1063,2951,48.4,2913,2,13,0.004405286,501,2450
ZCTA5 13439,1400,522,878,3777,39.7,3706,6,28,0.007413291,1347,2430
ZCTA5 13440,16630,1367,15263,41215,40.8,36363,483,1953,0.047385661,3474,37741
ZCTA5 13441,88,4812,-4724,160,23.5,80,0,40,0.25,11530,-11370
ZCTA5 13450,102,783,-681,286,26.4,286,0,0,0,2194,-1908
ZCTA5 13452,1805,178,1627,4881,41.7,4599,24,42,0.008604794,346,4535
ZCTA5 13454,362,886,-524,820,46.5,739,0,0,0,2202,-1382
ZCTA5 13455,17,14458,-14441,55,36.1,55,0,0,0,37480,-37425
ZCTA5 13456,1487,13793,-12306,3904,40.4,3744,77,12,0.00307377,34183,-30279
ZCTA5 13457,23,15760,-15737,36,57.6,36,0,0,0,38411,-38375
ZCTA5 13459,797,184,613,2022,43.1,1938,20,2,0.00098912,3104,-1082
ZCTA5 13460,1619,3511,-1892,4256,41.5,4118,41,9,0.002114662,10386,-6130
ZCTA5 13461,1299,1946,-647,3194,47.3,3039,45,28,0.008766437,4740,-1546
ZCTA5 13464,561,1147,-586,1324,49.9,1305,0,2,0.001510574,3049,-1725
ZCTA5 13468,121,883,-762,358,34.6,357,0,0,0,1993,-1635
ZCTA5 13469,469,540,-71,1234,44.4,1159,75,0,0,1562,-328
ZCTA5 13470,250,1172,-922,712,45.8,666,2,13,0.018258427,2877,-2165
ZCTA5 13471,1022,1067,-45,2607,42.9,2542,4,8,0.003068661,2669,-62
ZCTA5 13472,78,123,-45,169,71,169,0,0,0,354,-185
ZCTA5 13473,426,405,21,1183,38.2,1077,0,7,0.00591716,1052,131
ZCTA5 13475,17,814,-797,42,46,42,0,0,0,1787,-1745
ZCTA5 13476,1301,3514,-2213,3271,39.6,3151,9,52,0.015897279,11118,-7847
ZCTA5 13477,515,905,-390,1218,44.6,1194,0,0,0,1817,-599
ZCTA5 13478,1310,4322,-3012,3220,45.5,3199,21,0,0,10687,-7467
ZCTA5 13480,1274,809,465,3169,45.9,3020,28,15,0.004733354,2298,871
ZCTA5 13482,27,280,-253,56,52.5,56,0,0,0,690,-634
ZCTA5 13483,157,1065,-908,525,31.9,518,0,7,0.013333333,2971,-2446
ZCTA5 13484,0,33,-33,0,-,0,0,0,#DIV/0!,106,-106
ZCTA5 13485,499,1927,-1428,1488,37.1,1478,1,8,0.005376344,5395,-3907
ZCTA5 13486,325,873,-548,668,54.3,655,0,0,0,1843,-1175
ZCTA5 13488,55,742,-687,106,59.5,106,0,0,0,1897,-1791
ZCTA5 13489,178,108,70,495,38.4,487,0,0,0,266,229
ZCTA5 13490,388,526,-138,1049,40.4,999,50,0,0,1582,-533
ZCTA5 13491,1289,119,1170,3584,41.8,3513,12,0,0,344,3240
ZCTA5 13492,4760,1633,3127,11155,44.6,10439,192,251,0.022501121,4500,6655
ZCTA5 13493,806,343,463,2278,37,2192,6,0,0,850,1428
ZCTA5 13494,94,101,-7,226,53.4,225,1,0,0,270,-44
ZCTA5 13495,820,1707,-887,2123,35.1,1920,16,23,0.010833726,4343,-2220
ZCTA5 13501,14700,137,14563,40307,33.9,23320,5852,5748,0.142605503,252,40055
ZCTA5 13502,13199,71,13128,33986,37.2,24987,1384,4426,0.130230095,201,33785
ZCTA5 13601,16326,122,16204,38695,34.9,32728,721,2668,0.068949477,214,38481
ZCTA5 13602,0,39,-39,3765,21.6,2083,256,789,0.209561753,64,3701
ZCTA5 13603,4212,3655,557,12753,23.3,8769,345,1478,0.115894299,10309,2444
ZCTA5 13605,1950,30,1920,5161,36.4,4783,12,56,0.01085061,84,5077
ZCTA5 13606,1116,1087,29,2618,53,2588,0,4,0.001527884,2735,-117
ZCTA5 13607,833,30,803,1594,58.1,1525,9,23,0.014429109,66,1528
ZCTA5 13608,653,1022,-369,1726,39.4,1623,0,1,0.000579374,2470,-744
ZCTA5 13611,155,524,-369,348,45.7,348,0,0,0,1202,-854
ZCTA5 13612,1180,90,1090,2510,44.7,2300,138,0,0,212,2298
ZCTA5 13613,1043,608,435,2595,40.9,2533,0,4,0.001541426,1634,961
ZCTA5 13614,105,782,-677,336,32.4,321,0,0,0,2311,-1975
ZCTA5 13615,294,1281,-987,693,51.6,679,0,3,0.004329004,3443,-2750
ZCTA5 13616,966,994,-28,2265,32.7,1725,121,166,0.073289183,2758,-493
ZCTA5 13617,4130,772,3358,11912,30,10609,257,553,0.046423774,1995,9917
ZCTA5 13618,650,216,434,1467,52.8,1382,16,13,0.008861622,561,906
ZCTA5 13619,4262,816,3446,10650,35.7,9301,118,264,0.024788732,2243,8407
ZCTA5 13620,781,685,96,2154,35.4,2098,17,16,0.007428041,1897,257
ZCTA5 13621,206,7446,-7240,501,33.1,500,0,1,0.001996008,16631,-16130
ZCTA5 13622,731,252,479,1895,41.6,1733,7,64,0.033773087,577,1318
ZCTA5 13623,28,455,-427,45,63,45,0,0,0,1560,-1515
ZCTA5 13624,1952,141,1811,5330,42.8,4546,14,383,0.071857411,367,4963
ZCTA5 13625,663,1254,-591,1669,46.3,1627,0,1,0.000599161,2950,-1281
ZCTA5 13626,885,1321,-436,2320,42.9,2223,17,13,0.005603448,3433,-1113
ZCTA5 13628,85,6515,-6430,224,25.5,224,0,0,0,17146,-16922
ZCTA5 13630,468,189,279,1470,40,1407,0,5,0.003401361,484,986
ZCTA5 13632,70,296,-226,148,61.6,148,0,0,0,608,-460
ZCTA5 13633,94,840,-746,262,37.3,256,0,0,0,2271,-2009
ZCTA5 13634,1489,64,1425,3913,43.8,3760,0,35,0.008944544,143,3770
ZCTA5 13635,393,7,386,1082,40.6,1059,0,1,0.000924214,26,1056
ZCTA5 13636,54,4733,-4679,177,29.8,167,2,1,0.005649718,16339,-16162
ZCTA5 13637,1792,74,1718,4342,27.8,3127,17,681,0.156840166,196,4146
ZCTA5 13638,143,116,27,415,23.7,415,0,0,0,214,201
ZCTA5 13639,40,641,-601,53,68.8,51,0,0,0,1694,-1641
ZCTA5 13640,127,433,-306,233,67,229,0,0,0,1317,-1084
ZCTA5 13641,26,305,-279,50,78.3,50,0,0,0,828,-778
ZCTA5 13642,3694,265,3429,9566,43.1,8340,6,542,0.056659001,739,8827
ZCTA5 13643,21,437,-416,55,8.4,55,0,0,0,1003,-948
ZCTA5 13645,0,1107,-1107,0,-,0,0,0,#DIV/0!,2192,-2192
ZCTA5 13646,818,278,540,2145,45.7,2065,9,7,0.003263403,547,1598
ZCTA5 13647,71,333,-262,160,36.5,153,0,0,0,907,-747
ZCTA5 13648,839,1288,-449,2031,46.2,1973,1,1,0.000492368,3123,-1092
ZCTA5 13649,4,45,-41,9,-,9,0,0,0,77,-68
ZCTA5 13650,620,212,408,1479,55.4,1327,23,4,0.00270453,434,1045
ZCTA5 13651,89,607,-518,150,68.9,150,0,0,0,1365,-1215
ZCTA5 13652,649,21,628,1778,41,1681,3,0,0,64,1714
ZCTA5 13654,900,42,858,2646,36.6,2610,2,5,0.001889645,42,2604
ZCTA5 13655,1450,1088,362,3512,31.6,321,177,6,0.001708428,2368,1144
ZCTA5 13656,1048,1269,-221,3307,32.7,3094,0,158,0.047777442,3009,298
ZCTA5 13658,927,473,454,2696,38.5,2662,0,0,0,919,1777
ZCTA5 13659,153,3001,-2848,360,50.5,346,0,0,0,8116,-7756
ZCTA5 13660,638,2149,-1511,1835,38.3,1784,7,4,0.002179837,5239,-3404
ZCTA5 13661,668,778,-110,1809,38.6,1688,30,11,0.006080708,2128,-319
ZCTA5 13662,7219,905,6314,16383,42.4,15665,129,40,0.002441555,2417,13966
ZCTA5 13664,152,388,-236,438,53.2,377,2,26,0.059360731,916,-478
ZCTA5 13665,336,207,129,835,53.3,820,0,15,0.017964072,470,365
ZCTA5 13666,86,1555,-1469,227,41.3,174,0,4,0.017621145,3926,-3699
ZCTA5 13667,1224,542,682,3101,41.7,2976,0,27,0.008706869,1357,1744
ZCTA5 13668,1381,884,497,3267,50.3,3115,37,38,0.011631466,2212,1055
ZCTA5 13669,5510,1581,3929,15210,41.4,13373,115,960,0.063116371,3855,11355
ZCTA5 13670,175,333,-158,420,53,408,4,0,0,922,-502
ZCTA5 13672,202,64,138,479,54.5,460,0,0,0,160,319
ZCTA5 13673,825,337,488,2255,30.2,1951,23,126,0.055875831,643,1612
ZCTA5 13674,36,2075,-2039,51,90.2,51,0,0,0,5818,-5767
ZCTA5 13675,13,1469,-1456,41,44.1,37,0,0,0,3708,-3667
ZCTA5 13676,5280,617,4663,14038,30.5,12694,321,456,0.03248326,1621,12417
ZCTA5 13678,97,229,-132,97,48.1,97,0,0,0,516,-419
ZCTA5 13679,482,407,75,1245,41.7,1205,17,0,0,980,265
ZCTA5 13680,433,19084,-18651,1324,33.2,1305,4,5,0.003776435,44489,-43165
ZCTA5 13681,419,77,342,1111,33.3,1070,0,1,0.00090009,275,836
ZCTA5 13682,311,647,-336,792,47.7,766,2,0,0,1710,-918
ZCTA5 13683,0,213,-213,0,-,0,0,0,#DIV/0!,499,-499
ZCTA5 13684,451,268,183,1034,46.5,1010,2,10,0.00967118,644,390
ZCTA5 13685,1046,2481,-1435,2165,39.1,2059,10,2,0.000923788,6056,-3891
ZCTA5 13687,231,428,-197,540,46.2,536,0,0,0,1044,-504
ZCTA5 13690,312,307,5,726,49.4,636,3,15,0.020661157,675,51
ZCTA5 13691,1155,1020,135,3103,29.9,2789,3,13,0.004189494,2169,934
ZCTA5 13692,86,71,15,212,60.2,212,0,0,0,154,58
ZCTA5 13693,149,182,-33,337,59.5,331,6,0,0,514,-177
ZCTA5 13694,579,1236,-657,1357,53.3,1289,0,0,0,3617,-2260
ZCTA5 13695,53,383,-330,189,53.4,189,0,0,0,983,-794
ZCTA5 13696,110,8035,-7925,213,32.8,213,0,0,0,18610,-18397
ZCTA5 13697,787,46,741,1727,42.8,1665,22,0,0,116,1611
ZCTA5 13699,0,1521,-1521,2043,19.9,1504,169,226,0.110621635,3861,-1818
ZCTA5 13730,1207,500,707,2872,52.1,2741,55,15,0.005222841,1251,1621
ZCTA5 13731,525,779,-254,977,54.8,892,6,0,0,2199,-1222
ZCTA5 13732,3058,484,2574,7591,41.4,7168,96,56,0.007377157,1277,6314
ZCTA5 13733,2166,193,1973,4973,50.2,4770,0,40,0.008043435,590,4383
ZCTA5 13734,888,1450,-562,2317,45.8,2278,1,0,0,4131,-1814
ZCTA5 13736,820,194,626,1966,43.7,1944,0,0,0,610,1356
ZCTA5 13738,18,82,-64,44,19.7,44,0,0,0,185,-141
ZCTA5 13739,325,513,-188,721,55.5,695,21,0,0,1275,-554
ZCTA5 13740,234,747,-513,495,56.8,439,19,10,0.02020202,1547,-1052
ZCTA5 13743,1567,681,886,3645,48.9,3600,0,3,0.000823045,1715,1930
ZCTA5 13744,457,546,-89,1393,38.2,1369,0,1,0.000717875,1209,184
ZCTA5 13746,866,1713,-847,1919,59.8,1783,18,15,0.007816571,4295,-2376
ZCTA5 13747,22,934,-912,22,-,22,0,0,0,2310,-2288
ZCTA5 13748,1544,427,1117,3511,42.8,3245,0,0,0,1089,2422
ZCTA5 13750,350,5626,-5276,807,54.3,772,0,21,0.026022305,14215,-13408
ZCTA5 13751,49,8215,-8166,101,52.9,101,0,0,0,22709,-22608
ZCTA5 13752,315,1368,-1053,953,31.3,871,0,77,0.080797482,3406,-2453
ZCTA5 13753,1808,0,1808,5848,32.6,5284,117,184,0.031463748,0,5848
ZCTA5 13754,1134,4956,-3822,2777,44,2659,16,19,0.006841916,12167,-9390
ZCTA5 13755,385,1677,-1292,876,52.5,863,0,0,0,4804,-3928
ZCTA5 13756,241,254,-13,431,57.7,431,0,0,0,698,-267
ZCTA5 13757,542,1655,-1113,1526,42.1,1521,0,0,0,4161,-2635
ZCTA5 13760,19362,46,19316,43779,42.5,38584,888,1941,0.044336326,46,43733
ZCTA5 13774,113,574,-461,280,53.1,260,0,0,0,1568,-1288
ZCTA5 13775,724,1907,-1183,1731,49.4,1696,0,7,0.004043905,4277,-2546
ZCTA5 13776,218,518,-300,457,51,427,10,0,0,1470,-1013
ZCTA5 13777,146,203,-57,398,45.6,398,0,0,0,595,-197
ZCTA5 13778,2303,179,2124,5492,42.7,5289,17,25,0.004552076,646,4846
ZCTA5 13780,311,660,-349,889,37,889,0,0,0,1534,-645
ZCTA5 13782,272,287,-15,716,55.1,685,26,4,0.005586592,818,-102
ZCTA5 13783,1080,107,973,2513,56.2,2351,3,81,0.032232392,153,2360
ZCTA5 13784,98,137,-39,240,46.1,240,0,0,0,281,-41
ZCTA5 13786,194,39,155,382,53.9,331,18,5,0.013089005,107,275
ZCTA5 13787,1399,1735,-336,3294,57.4,3179,16,2,0.000607165,4277,-983
ZCTA5 13788,382,9134,-8752,1002,49.7,917,15,18,0.017964072,21926,-20924
ZCTA5 13790,8124,3100,5024,18663,39,15639,988,963,0.051599421,6622,12041
ZCTA5 13795,1537,94,1443,3106,45.3,2598,118,91,0.029298133,248,2858
ZCTA5 13796,465,19,446,1023,55.7,969,0,19,0.018572825,87,936
ZCTA5 13797,832,205,627,2058,43.5,1982,0,4,0.001943635,515,1543
ZCTA5 13801,619,1565,-946,1362,51.5,1309,16,6,0.004405286,4284,-2922
ZCTA5 13802,504,238,266,1038,37.5,968,0,0,0,759,279
ZCTA5 13803,1516,473,1043,4379,33.9,4278,9,11,0.002511989,1059,3320
ZCTA5 13804,79,2579,-2500,237,31.4,229,0,0,0,6465,-6228
ZCTA5 13806,88,8352,-8264,197,35.9,142,22,0,0,18625,-18428
ZCTA5 13807,471,0,471,1155,51.1,1079,7,61,0.052813853,6158,-5003
ZCTA5 13808,520,7981,-7461,1316,42.7,1288,0,2,0.001519757,19376,-18060
ZCTA5 13809,719,3609,-2890,1903,41.6,1832,0,0,0,9288,-7385
ZCTA5 13810,566,11311,-10745,1377,53.9,1297,9,0,0,28342,-26965
ZCTA5 13811,1558,3757,-2199,3955,40.4,3710,65,18,0.004551201,9860,-5905
ZCTA5 13812,908,4110,-3202,2329,45.5,2293,0,0,0,12132,-9803
ZCTA5 13813,255,771,-516,1038,18.2,1033,0,5,0.004816956,2225,-1187
ZCTA5 13814,10,3872,-3862,10,-,10,0,0,0,9413,-9403
ZCTA5 13815,5728,487,5241,13074,44.2,12131,92,184,0.014073734,1325,11749
ZCTA5 13820,7376,2420,4956,21242,31.8,18531,503,894,0.042086433,5654,15588
ZCTA5 13825,1174,2528,-1354,2754,46.8,2567,67,18,0.006535948,10102,-7348
ZCTA5 13826,94,880,-786,238,36.1,234,0,0,0,2266,-2028
ZCTA5 13827,5084,706,4378,11462,48.5,10964,171,102,0.008898971,1816,9646
ZCTA5 13830,2050,9736,-7686,5005,43.2,4806,10,26,0.005194805,23302,-18297
ZCTA5 13832,159,650,-491,401,40.7,398,0,0,0,1767,-1366
ZCTA5 13833,1462,1273,189,4334,31.1,4133,48,0,0,3331,1003
ZCTA5 13834,116,368,-252,232,63.1,232,0,0,0,717,-485
ZCTA5 13835,508,588,-80,1249,51.9,1220,6,0,0,1549,-300
ZCTA5 13838,1603,628,975,3933,46.8,3702,14,80,0.020340707,1647,2286
ZCTA5 13839,502,3693,-3191,1342,44.5,1285,0,0,0,9807,-8465
ZCTA5 13841,234,2555,-2321,559,38.5,512,17,14,0.025044723,7235,-6676
ZCTA5 13842,196,808,-612,641,49.3,499,8,52,0.081123245,2063,-1422
ZCTA5 13843,787,832,-45,2067,43.2,1980,0,0,0,2967,-900
ZCTA5 13844,223,64,159,637,42.9,622,0,0,0,187,450
ZCTA5 13846,226,2162,-1936,481,59.4,474,6,1,0.002079002,5117,-4636
ZCTA5 13847,10,367,-357,16,49.7,16,0,0,0,910,-894
ZCTA5 13849,1987,35,1952,4603,52.6,4387,35,13,0.002824245,101,4502
ZCTA5 13850,9311,773,8538,22847,43.6,18457,2939,513,0.022453714,2156,20691
ZCTA5 13856,2696,106,2590,5993,45.7,5648,32,143,0.023861171,338,5655
ZCTA5 13859,44,1664,-1620,115,42,106,0,0,0,3915,-3800
ZCTA5 13860,48,10692,-10644,140,39.3,140,0,0,0,24425,-24285
ZCTA5 13861,291,2542,-2251,492,46,428,0,0,0,6847,-6355
ZCTA5 13862,1585,6526,-4941,3805,41.4,3657,8,45,0.011826544,15072,-11267
ZCTA5 13863,209,7471,-7262,495,43.9,473,13,2,0.004040404,20065,-19570
ZCTA5 13864,607,6835,-6228,1089,50,803,0,57,0.052341598,17818,-16729
ZCTA5 13865,2521,552,1969,5792,50.1,5685,0,48,0.008287293,1340,4452
ZCTA5 13901,8480,629,7851,19983,40.3,16503,318,1082,0.054146024,1653,18330
ZCTA5 13902,0,3051,-3051,6349,19.5,5056,972,163,0.025673334,8018,-1669
ZCTA5 13903,8127,796,7331,19225,41.2,15755,191,1928,0.100286086,2249,16976
ZCTA5 13904,3637,3772,-135,9448,43.9,7648,305,1081,0.114415749,9184,264
ZCTA5 13905,11321,286,11035,27362,35.2,20281,2306,2668,0.097507492,631,26731
ZCTA5 14001,4121,102,4019,9722,45.1,9294,43,74,0.007611603,271,9451
ZCTA5 14004,3920,1358,2562,11946,41.9,10709,82,998,0.083542608,3222,8724
ZCTA5 14005,737,5631,-4894,2154,35.8,1982,0,3,0.001392758,14678,-12524
ZCTA5 14006,3996,699,3297,9345,47.3,8879,59,182,0.019475655,1823,7522
ZCTA5 14008,609,516,93,1680,42.5,1425,0,40,0.023809524,1338,342
ZCTA5 14009,2558,1841,717,5668,45.1,5429,130,13,0.002293578,5038,630
ZCTA5 14011,2172,2695,-523,7844,41,5991,74,1256,0.160122387,7363,481
ZCTA5 14012,1061,297,764,2756,43.8,2394,35,182,0.066037736,672,2084
ZCTA5 14013,647,2112,-1465,1702,42,1231,21,16,0.009400705,6629,-4927
ZCTA5 14020,10145,7793,2352,22286,42.5,19609,202,922,0.041371264,20324,1962
ZCTA5 14024,578,17534,-16956,1592,38.5,1483,13,62,0.038944724,42670,-41078
ZCTA5 14025,1682,1817,-135,3901,49.9,3654,58,8,0.002050756,4671,-770
ZCTA5 14026,295,1204,-909,498,55.4,498,0,0,0,3061,-2563
ZCTA5 14027,38,149,-111,70,52.8,66,0,0,0,325,-255
ZCTA5 14028,642,2571,-1929,1380,47.8,1369,0,3,0.002173913,7025,-5645
ZCTA5 14029,33,11831,-11798,84,50,84,0,0,0,31685,-31601
ZCTA5 14030,702,442,260,1868,40.1,1828,0,4,0.002141328,1286,582
ZCTA5 14031,3967,4749,-782,9626,50.2,8848,45,30,0.003116559,11388,-1762
ZCTA5 14032,3733,20843,-17110,10734,44.2,10321,31,24,0.002235886,51069,-40335
ZCTA5 14033,684,1205,-521,1539,48,1511,0,23,0.014944769,3099,-1560
ZCTA5 14034,771,764,7,2768,39.3,2088,26,436,0.157514451,2193,575
ZCTA5 14035,32,506,-474,90,43.3,90,0,0,0,1417,-1327
ZCTA5 14036,2217,4217,-2000,5441,49.3,5293,0,68,0.012497703,11087,-5646
ZCTA5 14037,390,1703,-1313,1022,50.2,924,0,0,0,4489,-3467
ZCTA5 14039,38,2110,-2072,66,55.7,59,0,0,0,5464,-5398
ZCTA5 14040,718,0,718,1800,44.9,1800,0,0,0,851,949
ZCTA5 14041,64,1189,-1125,174,35.9,163,2,0,0,3291,-3117
ZCTA5 14042,1860,6,1854,4424,41.9,4241,42,2,0.00045208,11,4413
ZCTA5 14043,11177,238,10939,25644,42.9,23844,132,828,0.032288255,614,25030
ZCTA5 14047,2481,18898,-16417,6260,48.2,6089,0,40,0.006389776,44200,-37940
ZCTA5 14048,6831,1501,5330,14928,44.7,11299,40,1377,0.092242765,3855,11073
ZCTA5 14051,7892,321,7571,19498,45.7,16415,1938,612,0.031387835,726,18772
ZCTA5 14052,7274,11828,-4554,18053,51.4,17507,96,73,0.004043649,29661,-11608
ZCTA5 14054,510,614,-104,1383,37.6,1179,0,10,0.007230658,1542,-159
ZCTA5 14055,683,98,585,1319,51.7,1314,0,0,0,277,1042
ZCTA5 14056,103,1920,-1817,216,36.8,216,0,0,0,4903,-4687
ZCTA5 14057,3165,2399,766,7873,47.5,7576,72,22,0.00279436,6585,1288
ZCTA5 14058,750,18,732,2214,39.1,1989,0,21,0.009485095,65,2149
ZCTA5 14059,3761,46,3715,9553,43.3,9412,52,0,0,119,9434
ZCTA5 14060,190,2036,-1846,358,55.1,322,0,0,0,5054,-4696
ZCTA5 14061,26,817,-791,69,45.7,69,0,0,0,2199,-2130
ZCTA5 14062,1330,850,480,3460,39.5,3282,29,0,0,1914,1546
ZCTA5 14063,5003,3193,1810,13453,39.7,11328,320,565,0.041998067,7737,5716
ZCTA5 14065,597,423,174,1674,38.5,1617,2,0,0,1063,611
ZCTA5 14066,463,606,-143,1186,47.7,1175,0,0,0,1501,-315
ZCTA5 14067,1806,18507,-16701,4387,42.5,4142,0,167,0.038067016,42258,-37871
ZCTA5 14068,2842,729,2113,7528,49.7,6234,441,301,0.03998406,1678,5850
ZCTA5 14069,261,32,229,604,51.5,557,0,1,0.001655629,91,513
ZCTA5 14070,2313,158,2155,6090,38.9,5297,22,60,0.009852217,368,5722
ZCTA5 14072,8800,917,7883,21340,44.6,19548,436,471,0.022071228,2405,18935
ZCTA5 14075,19501,820,18681,44452,47.3,42633,248,463,0.010415729,1837,42615
ZCTA5 14080,1733,1273,460,4107,45,3966,0,29,0.007061115,3277,830
ZCTA5 14081,1228,150,1078,2961,50.4,1877,44,28,0.009456265,219,2742
ZCTA5 14082,221,2254,-2033,657,40.8,656,0,0,0,5735,-5078
ZCTA5 14083,5,6244,-6239,14,66.5,14,0,0,0,13371,-13357
ZCTA5 14085,2818,1905,913,7607,42.6,7210,72,36,0.004732483,3673,3934
ZCTA5 14086,14655,646,14009,34961,45.8,33837,207,429,0.012270816,1216,33745
ZCTA5 14091,561,4536,-3975,1526,37.4,884,5,40,0.02621232,9202,-7676
ZCTA5 14092,4776,9818,-5042,10744,49,9935,137,127,0.011820551,22248,-11504
ZCTA5 14094,21279,9216,12063,50403,42.6,43852,436,2670,0.052973037,22694,27709
ZCTA5 14098,1154,4080,-2926,3092,37.2,2934,0,4,0.001293661,11258,-8166
ZCTA5 14101,710,4066,-3356,1807,49,1633,0,0,0,8071,-6264
ZCTA5 14102,548,5796,-5248,1421,47.5,1323,0,0,0,13318,-11897
ZCTA5 14103,4542,9116,-4574,10641,39.9,9118,142,547,0.051404943,21906,-11265
ZCTA5 14105,1770,4728,-2958,4740,44.5,4580,4,57,0.012025316,11078,-6338
ZCTA5 14108,2157,8945,-6788,5665,40.7,5439,6,17,0.003000883,23220,-17555
ZCTA5 14109,0,8037,-8037,1109,19.5,819,54,72,0.064923354,19625,-18516
ZCTA5 14111,1248,15571,-14323,3191,40.6,3106,4,18,0.005640865,40084,-36893
ZCTA5 14112,37,11230,-11193,75,71,75,0,0,0,23066,-22991
ZCTA5 14113,309,10488,-10179,694,43.6,694,0,0,0,23048,-22354
ZCTA5 14120,18918,8656,10262,44079,45.3,41515,292,720,0.016334309,18953,25126
ZCTA5 14125,1384,5133,-3749,3593,40.3,3355,7,35,0.009741163,11015,-7422
ZCTA5 14126,214,10054,-9840,614,43.5,614,0,0,0,24299,-23685
ZCTA5 14127,12446,22126,-9680,30416,45.2,28475,170,451,0.014827722,52863,-22447
ZCTA5 14129,440,7286,-6846,1235,45.2,950,5,17,0.013765182,15605,-14370
ZCTA5 14130,39,9577,-9538,117,36.3,113,0,4,0.034188034,22790,-22673
ZCTA5 14131,1931,16720,-14789,4988,51.4,4700,3,87,0.01744186,39939,-34951
ZCTA5 14132,2587,14465,-11878,6930,44.5,6284,174,10,0.001443001,32751,-25821
ZCTA5 14134,37,12378,-12341,73,45.3,73,0,0,0,29514,-29441
ZCTA5 14135,46,10370,-10324,122,48.3,122,0,0,0,22821,-22699
ZCTA5 14136,2180,8684,-6504,4916,44.9,4750,0,45,0.009153784,20774,-15858
ZCTA5 14138,738,0,738,1932,42.2,1771,0,11,0.005693582,5492,-3560
ZCTA5 14139,727,5974,-5247,1839,41.6,1776,2,10,0.005437738,12985,-11146
ZCTA5 14141,3306,0,3306,7705,44.7,7552,30,32,0.004153147,75,7630
ZCTA5 14143,426,2601,-2175,1056,41.3,878,0,32,0.03030303,5790,-4734
ZCTA5 14145,502,12644,-12142,1268,50.1,1191,0,0,0,30128,-28860
ZCTA5 14150,19293,6877,12416,41956,42.9,37841,869,1400,0.033368291,17411,24545
ZCTA5 14166,103,4837,-4734,247,67.7,247,0,0,0,14525,-14278
ZCTA5 14167,661,2788,-2127,1815,43.1,1711,0,27,0.014876033,7119,-5304
ZCTA5 14168,35,60,-25,113,33.5,113,0,0,0,133,-20
ZCTA5 14169,71,1482,-1411,80,43.8,80,0,0,0,3607,-3527
ZCTA5 14170,925,515,410,2416,47.1,2313,0,0,0,1165,1251
ZCTA5 14171,777,7140,-6363,1840,48.9,1655,0,15,0.008152174,20526,-18686
ZCTA5 14172,1287,938,349,2836,49.7,2610,0,7,0.002468265,2425,411
ZCTA5 14173,72,1914,-1842,205,51.3,171,0,0,0,4739,-4534
ZCTA5 14174,2447,11587,-9140,5798,46.9,5539,69,28,0.004829251,26440,-20642
ZCTA5 14201,5770,4236,1534,12403,33.1,5871,245,2586,0.208497944,10818,1585
ZCTA5 14202,2164,856,1308,3909,38.5,2379,55,1090,0.278843694,2114,1795
ZCTA5 14203,1433,3373,-1940,2046,32.7,760,201,839,0.410068426,8511,-6465
ZCTA5 14204,4381,2227,2154,8043,42.2,2101,16,5134,0.638319035,5813,2230
ZCTA5 14206,9432,1665,7767,21479,40.3,15982,873,2225,0.103589553,4219,17260
ZCTA5 14207,9902,1131,8771,25661,30.8,12472,3470,3873,0.150929426,2956,22705
ZCTA5 14208,4349,4084,265,11029,32.6,1552,604,8350,0.757094932,11380,-351
ZCTA5 14209,4261,117,4144,9009,32.8,4619,232,3601,0.3997114,335,8674
ZCTA5 14210,7047,3516,3531,15342,42.4,12552,95,1370,0.089297354,8008,7334
ZCTA5 14211,9465,16426,-6961,23458,33.7,3118,3157,15058,0.641913207,40922,-17464
ZCTA5 14212,4972,3237,1735,12127,36.9,5090,2019,3668,0.302465573,11050,1077
ZCTA5 14213,9543,7899,1644,24047,30.1,11751,2907,4553,0.189337547,20177,3870
ZCTA5 14214,8418,223,8195,21505,31.4,10674,1998,6987,0.324901186,555,20950
ZCTA5 14215,16804,2587,14217,42600,32.1,6747,1983,30128,0.707230047,7087,35513
ZCTA5 14216,11788,680,11108,24445,34,18212,325,3344,0.136796891,1677,22768
ZCTA5 14217,10800,3762,7038,22839,43.9,19823,190,1295,0.056701257,9485,13354
ZCTA5 14218,8775,6800,1975,20620,39,15758,77,3050,0.147914646,17785,2835
ZCTA5 14219,5258,2420,2838,11009,47,10380,0,65,0.00590426,5955,5054
ZCTA5 14220,10485,3123,7362,24667,39.7,21507,396,861,0.034904934,7937,16730
ZCTA5 14221,23521,1281,22240,54836,46.6,47132,4203,1411,0.025731271,2680,52156
ZCTA5 14222,6779,3259,3520,16081,31.7,12085,620,1935,0.120328338,8468,7613
ZCTA5 14223,10072,90,9982,22264,42.3,19374,763,1383,0.062118218,243,22021
ZCTA5 14224,17973,909,17064,40968,46.3,39284,129,700,0.017086507,2257,38711
ZCTA5 14225,16038,700,15338,34471,38.2,26621,861,4487,0.130167387,2024,32447
ZCTA5 14226,12635,382,12253,29818,38.1,23123,1764,2526,0.084713931,1528,28290
ZCTA5 14227,9861,153,9708,20990,49.4,18888,300,1474,0.070223916,316,20674
ZCTA5 14228,9964,270,9694,24435,33.3,17611,3495,1964,0.080376509,831,23604
ZCTA5 14260,0,714,-714,814,19,453,129,115,0.141277641,1878,-1064
ZCTA5 14261,0,3224,-3224,4748,19.5,2459,1094,629,0.132476832,8305,-3557
ZCTA5 14301,5773,1729,4044,12033,42.9,7150,55,3607,0.299758996,4345,7688
ZCTA5 14302,126,111,15,229,78.7,107,6,116,0.506550218,288,-59
ZCTA5 14303,2867,2353,514,6466,35.4,4006,306,1091,0.168728735,6101,365
ZCTA5 14304,12496,3058,9438,28625,44.2,26032,479,682,0.023825328,7512,21113
ZCTA5 14305,7150,3971,3179,16873,37.2,10427,158,4702,0.278670065,10576,6297
ZCTA5 14411,4977,703,4274,13194,44.8,11035,97,1505,0.114067,1557,11637
ZCTA5 14413,25,2079,-2054,80,42.6,77,3,0,0,5376,-5296
ZCTA5 14414,2954,508,2446,6774,48.4,6458,116,37,0.005462061,1457,5317
ZCTA5 14415,66,511,-445,142,36.1,142,0,0,0,1215,-1073
ZCTA5 14416,1534,1842,-308,3975,42.5,3881,22,17,0.00427673,4892,-917
ZCTA5 14418,446,209,237,1118,52,1060,55,2,0.001788909,407,711
ZCTA5 14420,6922,1974,4948,19951,32.2,17404,393,855,0.042854995,4737,15214
ZCTA5 14422,734,5851,-5117,1921,40.6,1766,14,21,0.010931806,13829,-11908
ZCTA5 14423,2054,2353,-299,4742,44.3,4177,23,146,0.030788697,6243,-1501
ZCTA5 14424,12522,816,11706,28458,45.3,26504,135,417,0.014653173,2174,26284
ZCTA5 14425,5031,1190,3841,12919,35.4,11848,228,401,0.031039554,2958,9961
ZCTA5 14427,785,4500,-3715,1766,48.6,1657,0,0,0,11490,-9724
ZCTA5 14428,2894,958,1936,7195,46.3,6832,51,71,0.009867964,2876,4319
ZCTA5 14432,2027,3982,-1955,5156,43.8,5017,4,23,0.004460822,9486,-4330
ZCTA5 14433,1620,1036,584,3948,42.8,3762,0,87,0.022036474,2820,1128
ZCTA5 14435,1059,7870,-6811,2220,55.2,2133,0,8,0.003603604,20146,-17926
ZCTA5 14437,3979,5080,-1101,9014,46.1,8583,14,115,0.012757932,13157,-4143
ZCTA5 14441,93,46,47,302,32.7,297,1,0,0,114,188
ZCTA5 14445,3373,2261,1112,7654,39.2,6727,66,420,0.054873269,5425,2229
ZCTA5 14450,18271,1877,16394,43264,45.2,39329,1158,755,0.017450999,4316,38948
ZCTA5 14453,0,800,-800,0,-,0,0,0,#DIV/0!,1978,-1978
ZCTA5 14454,3283,11815,-8532,11349,21.8,10286,263,344,0.030311041,32106,-20757
ZCTA5 14456,7709,251,7458,19210,38.1,15423,631,1262,0.065694951,555,18655
ZCTA5 14462,270,71,199,845,35.9,786,0,0,0,158,687
ZCTA5 14463,134,65,69,287,36.4,282,0,0,0,157,130
ZCTA5 14464,2742,1001,1741,7087,40.8,6880,4,32,0.00451531,4483,2604
ZCTA5 14466,626,36,590,1476,55.1,1470,0,0,0,47,1429
ZCTA5 14467,4426,1168,3258,10589,44.1,8402,747,860,0.081216357,3166,7423
ZCTA5 14468,6717,838,5879,18154,39.9,16982,33,305,0.016800705,2364,15790
ZCTA5 14469,2574,85,2489,5915,49.8,5807,0,28,0.004733728,201,5714
ZCTA5 14470,3146,1894,1252,7554,45.8,7062,70,147,0.019459889,4624,2930
ZCTA5 14471,1256,1671,-415,2778,55.8,2572,10,162,0.058315335,4499,-1721
ZCTA5 14472,3436,19,3417,9407,42,8896,94,53,0.005634102,42,9365
ZCTA5 14475,145,642,-497,320,50.6,305,7,0,0,1611,-1291
ZCTA5 14476,941,2199,-1258,2403,41.7,2192,0,12,0.004993758,5720,-3317
ZCTA5 14477,666,515,151,1682,49.5,1638,2,21,0.012485137,1099,583
ZCTA5 14478,293,6695,-6402,1527,20.5,1499,0,19,0.012442698,18069,-16542
ZCTA5 14479,84,710,-626,136,58.5,136,0,0,0,1628,-1492
ZCTA5 14480,285,1174,-889,730,47.1,657,0,59,0.080821918,3578,-2848
ZCTA5 14481,712,5664,-4952,1774,45.1,1665,22,9,0.005073281,14382,-12608
ZCTA5 14482,3640,2195,1445,8397,43.1,7928,138,108,0.012861736,6211,2186
ZCTA5 14485,1573,2608,-1035,4017,40,3721,73,28,0.006970376,6137,-2120
ZCTA5 14486,132,497,-365,342,48.5,342,0,0,0,1231,-889
ZCTA5 14487,2263,2215,48,5934,45.2,5362,158,4,0.000674082,5398,536
ZCTA5 14489,2642,19666,-17024,7414,42,6376,0,384,0.051793903,50036,-42622
ZCTA5 14502,4270,46,4224,10115,41.6,9193,317,84,0.008304498,65,10050
ZCTA5 14504,654,3707,-3053,1507,39,1428,31,12,0.00796284,10431,-8924
ZCTA5 14505,2038,15,2023,4989,43.4,4720,0,27,0.005411906,262,4727
ZCTA5 14506,370,2906,-2536,775,59.2,763,0,0,0,7694,-6919
ZCTA5 14507,366,2086,-1720,1010,57.2,950,5,33,0.032673267,5159,-4149
ZCTA5 14510,2136,647,1489,4860,44.8,4310,0,157,0.032304527,1687,3173
ZCTA5 14511,136,67,69,454,32.2,384,0,10,0.022026432,225,229
ZCTA5 14512,1891,1228,663,4668,50.2,4484,64,10,0.002142245,1494,3174
ZCTA5 14513,5728,4706,1022,13986,40.9,11505,131,437,0.031245531,13524,462
ZCTA5 14514,2550,11420,-8870,6027,44.8,5042,55,591,0.098058736,30109,-24082
ZCTA5 14515,109,9360,-9251,155,66.2,155,0,0,0,16002,-15847
ZCTA5 14516,824,5191,-4367,2277,37.9,2112,30,68,0.029863856,12390,-10113
ZCTA5 14517,1103,17102,-15999,2684,39.2,2551,0,50,0.018628912,42085,-39401
ZCTA5 14519,5306,7106,-1800,12502,43.6,11542,50,104,0.008318669,14157,-1655
ZCTA5 14521,1123,6585,-5462,3245,39.2,2780,0,299,0.092141757,17403,-14158
ZCTA5 14522,4127,14287,-10160,9636,48,9197,161,26,0.002698215,35695,-26059
ZCTA5 14525,1015,4884,-3869,2493,46.6,2435,0,12,0.004813478,13022,-10529
ZCTA5 14526,8064,81,7983,19931,45.1,17961,587,449,0.022527721,1119,18812
ZCTA5 14527,4830,6888,-2058,12878,44.9,12345,133,98,0.007609877,16573,-3695
ZCTA5 14529,12,11675,-11663,38,63.9,38,0,0,0,27969,-27931
ZCTA5 14530,2498,9376,-6878,6463,37.2,5622,0,232,0.035896642,23091,-16628
ZCTA5 14532,1654,8242,-6588,4124,39.5,3965,0,3,0.000727449,22370,-18246
ZCTA5 14533,793,5729,-4936,1915,42.4,1815,0,10,0.005221932,15078,-13163
ZCTA5 14534,12347,11503,844,33041,48.3,28027,2631,729,0.022063497,25960,7081
ZCTA5 14536,286,12762,-12476,622,46,580,14,5,0.008038585,33133,-32511
ZCTA5 14537,27,5358,-5331,79,48.6,74,0,0,0,11808,-11729
ZCTA5 14539,41,8409,-8368,65,61.8,65,0,0,0,26462,-26397
ZCTA5 14541,799,13955,-13156,4211,34.8,2811,2,1028,0.244122536,35755,-31544
ZCTA5 14542,0,4417,-4417,0,-,0,0,0,#DIV/0!,10563,-10563
ZCTA5 14543,1309,12134,-10825,3242,53,3003,33,137,0.042257866,29627,-26385
ZCTA5 14544,728,0,728,2062,36,1990,19,2,0.000969932,2780,-718
ZCTA5 14545,44,17562,-17518,113,54,106,0,0,0,40408,-40295
ZCTA5 14546,2099,2694,-595,4949,40.6,4571,21,216,0.043645181,6359,-1410
ZCTA5 14548,1759,92,1667,4285,46.6,4020,0,9,0.00210035,274,4011
ZCTA5 14549,154,100,54,343,64,343,0,0,0,311,32
ZCTA5 14550,577,630,-53,1446,36.6,1363,12,49,0.033886584,1486,-40
ZCTA5 14551,2455,1491,964,5586,50.6,4849,31,438,0.078410311,3569,2017
ZCTA5 14555,657,711,-54,1084,59.9,926,0,64,0.05904059,1621,-537
ZCTA5 14556,0,1463,-1463,1733,40,798,8,770,0.444316215,3522,-1789
ZCTA5 14557,55,204,-149,145,51,145,0,0,0,555,-410
ZCTA5 14559,7268,1213,6055,18939,45.2,17974,93,253,0.013358678,2833,16106
ZCTA5 14560,950,899,51,2222,46.7,2083,1,0,0,3046,-824
ZCTA5 14561,1035,299,736,2643,42,2628,0,0,0,638,2005
ZCTA5 14564,6569,768,5801,16144,45.2,14805,472,229,0.014184836,2197,13947
ZCTA5 14568,2555,1398,1157,6423,44.8,6032,27,7,0.001089833,3638,2785
ZCTA5 14569,2877,310,2567,6251,49.6,5989,27,63,0.010078387,758,5493
ZCTA5 14571,474,66,408,1143,56.1,1019,0,81,0.070866142,145,998
ZCTA5 14572,1792,106,1686,4686,39.7,4319,0,31,0.00661545,309,4377
ZCTA5 14580,22955,475,22480,54214,45.8,48881,1875,1424,0.026266278,1243,52971
ZCTA5 14585,97,880,-783,148,67.1,148,0,0,0,2424,-2276
ZCTA5 14586,4582,527,4055,12795,37.4,9002,2003,1304,0.10191481,2080,10715
ZCTA5 14588,0,2256,-2256,0,-,0,0,0,#DIV/0!,5335,-5335
ZCTA5 14589,3176,320,2856,7558,45.1,6983,6,203,0.026858957,949,6609
ZCTA5 14590,2233,395,1838,5055,46.8,4721,7,44,0.008704253,960,4095
ZCTA5 14591,654,564,90,1538,40.5,1381,0,0,0,1267,271
ZCTA5 14592,97,75,22,142,63.4,127,0,0,0,135,7
ZCTA5 14604,1719,1710,9,2436,34.3,1698,209,400,0.164203612,4128,-1692
ZCTA5 14605,4065,1187,2878,11295,29.5,2680,641,6013,0.532359451,2812,8483
ZCTA5 14606,11059,83,10976,27730,38.5,17806,1049,5929,0.213811756,180,27550
ZCTA5 14607,10829,1787,9042,17780,31.9,14757,502,1419,0.079808774,4085,13695
ZCTA5 14608,5626,1444,4182,11987,33.2,3767,464,5873,0.489947443,3701,8286
ZCTA5 14609,17889,1141,16748,40959,37,20997,378,13030,0.318123001,2911,38048
ZCTA5 14610,7155,614,6541,13779,43.8,11680,428,882,0.064010451,1673,12106
ZCTA5 14611,7237,852,6385,18234,32.1,5087,257,10635,0.583251069,2226,16008
ZCTA5 14612,15073,55,15018,34619,45.3,29164,622,2591,0.074843294,253,34366
ZCTA5 14613,6010,660,5350,15697,29.8,5125,1123,8035,0.511881251,1680,14017
ZCTA5 14614,54,427,-373,1155,33.8,442,12,633,0.548051948,2255,-1100
ZCTA5 14615,7598,872,6726,18115,33.9,10335,919,5183,0.286116478,2203,15912
ZCTA5 14616,11388,351,11037,27230,37.5,21085,451,3208,0.117811238,1011,26219
ZCTA5 14617,9708,1906,7802,22466,44.5,20114,245,867,0.03859165,4358,18108
ZCTA5 14618,8302,104,8198,24079,38,19720,1699,1240,0.051497155,181,23898
ZCTA5 14619,5545,416,5129,14447,34.3,3449,137,10052,0.695784592,1009,13438
ZCTA5 14620,12001,288,11713,23711,34,16935,2069,2689,0.113407279,637,23074
ZCTA5 14621,13001,1205,11796,33058,34.8,11035,436,14480,0.438018029,3056,30002
ZCTA5 14622,5899,49,5850,13141,46.2,10664,650,927,0.070542577,100,13041
ZCTA5 14623,8545,1326,7219,25995,26,17922,3716,3017,0.116060781,3441,22554
ZCTA5 14624,15274,8104,7170,38993,41.2,31701,890,4336,0.111199446,18439,20554
ZCTA5 14625,4580,683,3897,9955,51.3,9075,168,129,0.012958312,2022,7933
ZCTA5 14626,12790,429,12361,29738,46.1,24891,991,1940,0.065236398,983,28755
ZCTA5 14627,0,1261,-1261,2938,19.5,2001,409,334,0.113682777,2972,-34
ZCTA5 14642,0,1574,-1574,0,-,0,0,0,#DIV/0!,4093,-4093
ZCTA5 14701,16742,93,16649,39250,39.6,35479,89,761,0.019388535,267,38983
ZCTA5 14706,2535,906,1629,5905,49,5470,43,90,0.015241321,2316,3589
ZCTA5 14707,34,313,-279,76,42.5,76,0,0,0,622,-546
ZCTA5 14708,52,16,36,180,35.1,135,0,0,0,1487,-1307
ZCTA5 14709,506,2972,-2466,1325,41.9,1285,16,14,0.010566038,6691,-5366
ZCTA5 14710,1386,756,630,3392,48.5,3340,22,0,0,2204,1188
ZCTA5 14711,653,972,-319,1985,37.3,1944,2,1,0.000503778,2826,-841
ZCTA5 14712,1298,141,1157,2817,57.7,2719,0,7,0.002484913,329,2488
ZCTA5 14714,196,340,-144,532,44.5,529,0,0,0,824,-292
ZCTA5 14715,1031,2285,-1254,2485,41.8,2445,2,16,0.006438632,5137,-2652
ZCTA5 14716,747,56,691,2554,35.8,1749,30,364,0.142521535,146,2408
ZCTA5 14717,281,2188,-1907,503,59.2,488,0,0,0,5452,-4949
ZCTA5 14718,746,431,315,2053,45.5,1764,10,208,0.101315149,4410,-2357
ZCTA5 14719,1355,385,970,3251,46.2,3078,0,7,0.002153184,871,2380
ZCTA5 14720,350,646,-296,885,45.3,788,0,3,0.003389831,1645,-760
ZCTA5 14721,68,387,-319,152,53.6,150,0,0,0,948,-796
ZCTA5 14722,58,877,-819,195,20.3,161,0,9,0.046153846,2200,-2005
ZCTA5 14723,477,1220,-743,1149,39.5,1115,9,0,0,2884,-1735
ZCTA5 14724,826,198,628,2695,29.5,2600,12,3,0.001113173,473,2222
ZCTA5 14726,587,910,-323,2371,20.7,2337,0,0,0,2314,57
ZCTA5 14727,2090,5305,-3215,5051,49.8,4966,0,0,0,12418,-7367
ZCTA5 14728,462,1322,-860,994,46.5,955,0,0,0,3596,-2602
ZCTA5 14729,381,1072,-691,902,35.2,890,0,2,0.002217295,2577,-1675
ZCTA5 14731,572,872,-300,1277,52.7,1244,0,0,0,2287,-1010
ZCTA5 14732,15,385,-370,44,62.9,44,0,0,0,956,-912
ZCTA5 14733,1456,203,1253,3446,42.3,3352,1,12,0.003482298,616,2830
ZCTA5 14735,941,991,-50,2803,40.8,2744,0,0,0,2273,530
ZCTA5 14736,65,695,-630,167,55.3,167,0,0,0,1834,-1667
ZCTA5 14737,1726,378,1348,4238,45.2,3979,4,11,0.002595564,944,3294
ZCTA5 14738,1382,287,1095,3432,42.7,3373,0,20,0.005827506,689,2743
ZCTA5 14739,1042,1251,-209,2608,41.2,2525,0,61,0.023389571,3265,-657
ZCTA5 14740,417,548,-131,1098,56.2,1082,0,0,0,1224,-126
ZCTA5 14741,746,1466,-720,1843,40.6,1825,0,3,0.001627781,3704,-1861
ZCTA5 14742,84,341,-257,175,45.2,175,0,0,0,761,-586
ZCTA5 14743,833,381,452,2078,47.1,1933,6,95,0.045717036,1093,985
ZCTA5 14744,395,889,-494,2182,21.1,2020,49,82,0.037580202,2168,14
ZCTA5 14747,820,25,795,2097,41.4,2060,0,4,0.001907487,37,2060
ZCTA5 14748,233,8529,-8296,541,46.5,444,4,0,0,19636,-19095
ZCTA5 14750,1947,433,1514,4546,48.6,4346,56,0,0,1067,3479
ZCTA5 14752,130,2056,-1926,286,66.5,274,0,12,0.041958042,5425,-5139
ZCTA5 14753,490,767,-277,1125,43.9,1092,0,8,0.007111111,1924,-799
ZCTA5 14754,222,298,-76,526,42.7,526,0,0,0,771,-245
ZCTA5 14755,1122,1399,-277,2981,41.8,2780,4,77,0.025830258,3135,-154
ZCTA5 14756,0,399,-399,0,-,0,0,0,#DIV/0!,1012,-1012
ZCTA5 14757,1341,354,987,3373,41.6,3062,11,102,0.030240142,956,2417
ZCTA5 14760,7871,5646,2225,17618,42.3,16047,302,320,0.018163242,13065,4553
ZCTA5 14767,786,8482,-7696,2265,35.7,2234,2,0,0,20350,-18085
ZCTA5 14769,333,316,17,787,49.2,773,0,2,0.002541296,741,46
ZCTA5 14770,1060,982,78,2847,39.3,2691,1,21,0.007376185,2339,508
ZCTA5 14772,1604,24578,-22974,3836,43.2,3668,0,39,0.01016684,64394,-60558
ZCTA5 14774,50,0,50,266,47.4,234,0,0,0,2769,-2503
ZCTA5 14775,975,0,975,2524,39.6,2447,15,5,0.001980983,0,2524
ZCTA5 14777,174,283,-109,582,42.5,560,4,0,0,810,-228
ZCTA5 14778,0,64,-64,1421,19.6,1129,56,131,0.0921886,129,1292
ZCTA5 14779,2918,675,2243,7014,39.5,5116,50,112,0.015968064,1863,5151
ZCTA5 14781,738,410,328,1834,40.2,1668,11,0,0,974,860
ZCTA5 14782,958,467,491,2224,48.8,2160,0,23,0.010341727,1214,1010
ZCTA5 14783,72,520,-448,182,41.5,65,24,4,0.021978022,1263,-1081
ZCTA5 14784,299,543,-244,772,49.8,755,0,8,0.010362694,1260,-488
ZCTA5 14785,15,1105,-1090,28,-,28,0,0,0,2643,-2615
ZCTA5 14787,2341,2100,241,4717,50.5,4372,174,8,0.001695993,5619,-902
ZCTA5 14788,35,554,-519,102,46.9,34,0,63,0.617647059,1396,-1294
ZCTA5 14801,1820,4333,-2513,5008,40.1,4923,0,7,0.001397764,10131,-5123
ZCTA5 14802,380,2038,-1658,4431,20.1,3526,146,532,0.120063191,5278,-847
ZCTA5 14803,497,302,195,1297,33.8,1278,14,0,0,775,522
ZCTA5 14804,559,1022,-463,1535,39.8,1456,15,0,0,2457,-922
ZCTA5 14805,394,129,265,810,57.2,805,0,0,0,283,527
ZCTA5 14806,769,208,561,1988,47.3,1965,0,0,0,467,1521
ZCTA5 14807,1159,277,882,2938,41.1,2795,3,17,0.005786249,834,2104
ZCTA5 14808,229,893,-664,530,47.5,507,0,8,0.01509434,2165,-1635
ZCTA5 14809,959,689,270,2905,33.7,2711,7,21,0.007228916,1579,1326
ZCTA5 14810,5196,100,5096,11504,49.2,10758,1,474,0.04120306,100,11404
ZCTA5 14812,1246,1603,-357,3211,42.2,3032,9,10,0.003114295,3919,-708
ZCTA5 14813,848,1772,-924,2199,43.7,2063,1,109,0.049567985,4355,-2156
ZCTA5 14814,811,104,707,2222,35.9,2148,64,10,0.00450045,223,1999
ZCTA5 14815,331,377,-46,722,51.1,678,0,0,0,1091,-369
ZCTA5 14816,228,2694,-2466,577,54.5,526,35,0,0,6722,-6145
ZCTA5 14817,1160,575,585,2782,36.6,2169,141,56,0.020129403,1508,1274
ZCTA5 14818,843,1961,-1118,1968,51.8,1922,15,0,0,4448,-2480
ZCTA5 14819,268,3305,-3037,740,40.4,718,4,0,0,7960,-7220
ZCTA5 14820,241,3,238,627,40.1,596,0,0,0,6,621
ZCTA5 14821,1238,560,678,3280,42.7,3182,33,11,0.003353659,1477,1803
ZCTA5 14822,362,4254,-3892,857,53.7,855,0,0,0,9591,-8734
ZCTA5 14823,1478,389,1089,3691,46.2,3518,103,22,0.005960444,939,2752
ZCTA5 14824,262,653,-391,691,40.7,671,0,14,0.020260492,2120,-1429
ZCTA5 14825,327,5589,-5262,789,50.5,773,5,1,0.001267427,16658,-15869
ZCTA5 14826,761,3137,-2376,1962,41.9,1886,0,14,0.007135576,6927,-4965
ZCTA5 14827,62,6584,-6522,116,37,116,0,0,0,15806,-15690
ZCTA5 14830,8616,4253,4363,19031,40,17788,395,465,0.024433819,9897,9134
ZCTA5 14836,415,13565,-13150,878,44.9,825,0,0,0,32722,-31844
ZCTA5 14837,1976,5361,-3385,5828,39.8,5609,5,76,0.013040494,11789,-5961
ZCTA5 14838,795,86,709,2089,45.8,2021,5,9,0.004308281,166,1923
ZCTA5 14839,247,3855,-3608,600,50,600,0,0,0,9453,-8853
ZCTA5 14840,1212,100,1112,2567,58.4,2452,1,36,0.014024153,215,2352
ZCTA5 14841,278,113,165,644,43.7,619,0,0,0,312,332
ZCTA5 14842,221,6218,-5997,913,28.7,913,0,0,0,15084,-14171
ZCTA5 14843,5405,11416,-6011,12569,44.7,11855,127,112,0.008910812,28476,-15907
ZCTA5 14845,8936,6533,2403,21004,45.3,18652,614,725,0.034517235,16243,4761
ZCTA5 14846,303,1304,-1001,778,38.3,775,0,1,0.001285347,3204,-2426
ZCTA5 14847,931,462,469,2311,43.8,2143,30,23,0.009952402,1228,1083
ZCTA5 14850,28182,6859,21323,67991,27.9,49868,9120,3023,0.044461767,15846,52145
ZCTA5 14853,0,309,-309,2125,19.7,1166,342,373,0.175529412,710,1415
ZCTA5 14854,38,773,-735,77,76.5,77,0,0,0,1900,-1823
ZCTA5 14855,278,58,220,810,34.2,792,13,0,0,121,689
ZCTA5 14856,0,3141,-3141,0,-,0,0,0,#DIV/0!,7926,-7926
ZCTA5 14858,458,4456,-3998,1357,42.1,1280,2,0,0,10061,-8704
ZCTA5 14859,397,3603,-3206,1099,40.7,1074,0,0,0,8603,-7504
ZCTA5 14860,553,6992,-6439,1192,46.4,1138,15,9,0.007550336,16098,-14906
ZCTA5 14861,498,1290,-792,1160,54.1,1153,0,0,0,3021,-1861
ZCTA5 14864,488,940,-452,1093,37,1030,1,0,0,2103,-1010
ZCTA5 14865,1131,62,1069,2740,48.7,2611,0,40,0.01459854,129,2611
ZCTA5 14867,2507,464,2043,5532,44.4,5469,0,48,0.00867679,1054,4478
ZCTA5 14869,523,247,276,1396,36.5,1383,0,0,0,488,908
ZCTA5 14870,3970,2182,1788,9891,41.2,8643,598,339,0.034273582,4981,4910
ZCTA5 14871,1771,857,914,4262,54.7,4201,0,13,0.003050211,1859,2403
ZCTA5 14872,187,1017,-830,398,58,398,0,0,0,2182,-1784
ZCTA5 14873,821,4643,-3822,2260,38.6,2084,70,6,0.002654867,11384,-9124
ZCTA5 14874,56,139,-83,151,47.8,151,0,0,0,354,-203
ZCTA5 14877,224,3392,-3168,713,39.1,674,26,0,0,8155,-7442
ZCTA5 14878,229,906,-677,649,40.7,645,0,0,0,2465,-1816
ZCTA5 14879,892,9567,-8675,2285,44,2107,34,5,0.002188184,26292,-24007
ZCTA5 14880,760,2047,-1287,1711,52.5,1591,8,1,0.000584454,4495,-2784
ZCTA5 14881,118,1103,-985,206,68.8,206,0,0,0,2619,-2413
ZCTA5 14882,1561,0,1561,3971,40.8,3678,27,159,0.040040292,0,3971
ZCTA5 14883,1878,490,1388,4696,36.6,4381,65,138,0.029386712,933,3763
ZCTA5 14884,118,964,-846,317,38.9,316,0,0,0,2535,-2218
ZCTA5 14885,258,213,45,680,45.2,667,0,0,0,523,157
ZCTA5 14886,2824,1362,1462,6597,50.7,6164,27,121,0.01834167,3432,3165
ZCTA5 14889,549,45,504,1433,37.1,1337,11,13,0.009071877,121,1312
ZCTA5 14891,2008,153,1855,4433,47.1,4083,98,79,0.017820889,379,4054
ZCTA5 14892,3231,666,2565,7894,41.3,7397,43,229,0.029009374,1284,6610
ZCTA5 14893,9,553,-544,50,8.4,50,0,0,0,1123,-1073
ZCTA5 14894,411,5321,-4910,1458,42.1,1130,0,227,0.15569273,14362,-12904
ZCTA5 14895,3998,1739,2259,9219,48.4,8916,4,47,0.005098167,4264,4955
ZCTA5 14897,262,331,-69,661,40.1,644,0,0,0,901,-240
ZCTA5 14898,559,5284,-4725,1788,35.5,1704,0,0,0,12434,-10646
ZCTA5 14901,5440,3603,1837,15656,36.8,11992,228,2225,0.142118038,7732,7924
ZCTA5 14903,3121,4733,-1612,7184,46.2,6294,68,337,0.0469098,11435,-4251
ZCTA5 14904,6132,227,5905,14696,35.6,12285,28,1196,0.081382689,578,14118
ZCTA5 14905,3655,4758,-1103,8330,44,7429,178,258,0.030972389,11823,-3493
ZCTA5 15001,14182,5231,8951,32200,48,25982,220,4280,0.132919255,12682,19518
ZCTA5 15003,5160,1044,4116,11414,44,9746,128,872,0.076397407,2423,8991
ZCTA5 15004,142,16732,-16590,377,30.1,362,0,0,0,38270,-37893
ZCTA5 15005,3887,3994,-107,9295,50.4,8792,23,104,0.011188811,9850,-555
ZCTA5 15006,129,51,78,309,51.9,309,0,0,0,76,233
ZCTA5 15007,165,3856,-3691,594,73.2,573,0,0,0,9169,-8575
ZCTA5 15009,6645,26,6619,15813,45.3,15069,104,273,0.017264276,74,15739
ZCTA5 15010,11743,453,11290,28863,40.7,25040,159,2406,0.083359318,1074,27789
ZCTA5 15012,6797,62,6735,15275,47.8,14234,92,303,0.019836334,163,15112
ZCTA5 15014,1463,192,1271,3135,41.8,2871,13,235,0.074960128,329,2806
ZCTA5 15015,505,152,353,1286,47.4,1226,31,4,0.00311042,345,941
ZCTA5 15017,7372,77,7295,16579,43.3,14771,632,543,0.032752277,191,16388
ZCTA5 15018,465,370,95,1092,55.6,821,184,47,0.043040293,821,271
ZCTA5 15019,679,4051,-3372,1464,49.1,1463,0,0,0,9699,-8235
ZCTA5 15020,203,3278,-3075,376,58.3,307,0,0,0,7522,-7146
ZCTA5 15021,2695,133,2562,6460,48.6,6252,4,7,0.001083591,381,6079
ZCTA5 15022,4257,107,4150,10327,45.6,9385,41,389,0.037668248,289,10038
ZCTA5 15024,3474,285,3189,8863,45.9,8044,412,147,0.016585806,775,8088
ZCTA5 15025,7017,2604,4413,16515,44.8,12812,549,2826,0.171117166,5797,10718
ZCTA5 15026,1553,7510,-5957,3924,36.4,3610,0,70,0.01783894,21290,-17366
ZCTA5 15027,1157,9764,-8607,2310,47.7,2243,0,0,0,25717,-23407
ZCTA5 15028,76,11968,-11892,169,52.9,139,0,28,0.165680473,29736,-29567
ZCTA5 15030,484,3822,-3338,1070,40.8,1009,3,12,0.011214953,9232,-8162
ZCTA5 15031,230,8630,-8400,492,29.3,367,102,23,0.046747967,18753,-18261
ZCTA5 15033,2248,16819,-14571,4590,46.2,3281,0,1122,0.244444444,39880,-35290
ZCTA5 15034,850,2559,-1709,1592,48.7,1497,0,75,0.047110553,5639,-4047
ZCTA5 15035,1031,1465,-434,2047,51.8,1801,6,142,0.069369809,3320,-1273
ZCTA5 15037,4279,5893,-1614,10197,47.8,9786,23,69,0.006766696,13912,-3715
ZCTA5 15038,121,8626,-8505,326,55.4,326,0,0,0,19080,-18754
ZCTA5 15042,3397,8428,-5031,8040,50.1,7733,9,39,0.004850746,20298,-12258
ZCTA5 15043,839,2836,-1997,2226,49.4,2129,0,2,0.000898473,6881,-4655
ZCTA5 15044,10641,4350,6291,28424,46.4,27111,502,288,0.010132283,10771,17653
ZCTA5 15045,1897,3862,-1965,4458,39.7,4019,26,272,0.061013908,8335,-3877
ZCTA5 15046,1103,9609,-8506,2622,47.3,2476,49,30,0.011441648,21634,-19012
ZCTA5 15047,128,2849,-2721,227,55,227,0,0,0,6466,-6239
ZCTA5 15049,498,2246,-1748,915,57.7,886,10,0,0,5272,-4357
ZCTA5 15050,897,9371,-8474,2426,45.2,2410,0,1,0.000412201,21661,-19235
ZCTA5 15051,238,4702,-4464,464,53.9,401,0,53,0.114224138,10106,-9642
ZCTA5 15052,1262,3008,-1746,2994,42.2,2827,37,58,0.019372077,6323,-3329
ZCTA5 15053,41,1507,-1466,75,60.8,68,0,0,0,3297,-3222
ZCTA5 15054,236,630,-394,557,29,557,0,0,0,1437,-880
ZCTA5 15055,631,7712,-7081,1131,60.8,1126,0,0,0,20009,-18878
ZCTA5 15056,521,1799,-1278,1061,44.8,853,56,41,0.03864279,4024,-2963
ZCTA5 15057,6301,3490,2811,17637,39.7,15413,1505,177,0.01003572,7535,10102
ZCTA5 15059,1668,12207,-10539,4326,39.7,3796,0,279,0.064493759,28366,-24040
ZCTA5 15060,366,8045,-7679,924,43.8,884,0,12,0.012987013,17782,-16858
ZCTA5 15061,5225,1269,3956,12493,39.8,11440,34,403,0.032258065,2582,9911
ZCTA5 15062,3297,5788,-2491,6941,49.8,5356,85,973,0.14018153,12542,-5601
ZCTA5 15063,4598,9181,-4583,10967,47.6,10482,17,189,0.017233519,19579,-8612
ZCTA5 15064,134,5084,-4950,237,42.3,223,0,0,0,9884,-9647
ZCTA5 15065,5041,3430,1611,11259,48.1,10217,204,301,0.026734168,8066,3193
ZCTA5 15066,5669,10237,-4568,12384,44.7,11055,28,628,0.050710594,22312,-9928
ZCTA5 15067,1076,13951,-12875,2522,45.3,2433,35,3,0.001189532,29504,-26982
ZCTA5 15068,16352,4941,11411,36931,47.3,33061,309,2576,0.069751699,11263,25668
ZCTA5 15071,5017,4548,469,11927,41.4,10710,306,313,0.026242978,9873,2054
ZCTA5 15072,39,5392,-5353,39,-,39,0,0,0,12857,-12818
ZCTA5 15074,3600,11243,-7643,8126,43.9,6736,40,699,0.086020182,27308,-19182
ZCTA5 15075,22,5669,-5647,34,30.5,34,0,0,0,11622,-11588
ZCTA5 15076,411,13175,-12764,827,47.8,793,0,3,0.00362757,29296,-28469
ZCTA5 15077,93,9606,-9513,214,39.7,199,0,0,0,28566,-28352
ZCTA5 15078,200,6189,-5989,563,69.3,563,0,0,0,15002,-14439
ZCTA5 15081,165,5458,-5293,330,49.6,328,0,0,0,12672,-12342
ZCTA5 15082,77,10536,-10459,196,41.5,196,0,0,0,23194,-22998
ZCTA5 15083,452,11499,-11047,948,56.7,938,0,0,0,27045,-26097
ZCTA5 15084,4430,6796,-2366,9882,45,9056,40,309,0.031268974,13813,-3931
ZCTA5 15085,3309,5561,-2252,7889,48.4,7359,173,8,0.00101407,15894,-8005
ZCTA5 15086,257,7811,-7554,559,51.4,492,60,0,0,17448,-16889
ZCTA5 15087,33,15070,-15037,84,34.5,79,0,0,0,31147,-31063
ZCTA5 15088,159,1529,-1370,429,38,394,8,25,0.058275058,2994,-2565
ZCTA5 15089,2964,3234,-270,6556,49.9,6299,0,130,0.019829164,6922,-366
ZCTA5 15090,9652,5218,4434,25459,39.9,21938,1639,514,0.020189324,10504,14955
ZCTA5 15101,10766,568,10198,26233,44.8,24110,802,482,0.018373804,1068,25165
ZCTA5 15102,13470,6264,7206,30765,47.1,28585,536,523,0.016999837,13432,17333
ZCTA5 15104,3744,12152,-8408,8098,39.9,2640,45,4702,0.580637194,27772,-19674
ZCTA5 15106,9375,7330,2045,19234,45.3,16668,316,1292,0.067172715,17864,1370
ZCTA5 15108,16998,6030,10968,43305,40.7,37217,1637,2203,0.050871724,13953,29352
ZCTA5 15110,2138,6605,-4467,5280,33.6,1882,0,2556,0.484090909,12114,-6834
ZCTA5 15112,1470,1133,337,3147,33.6,1283,0,1644,0.522402288,4164,-1017
ZCTA5 15116,5797,6203,-406,14088,46,13148,197,209,0.014835321,14226,-138
ZCTA5 15120,8449,15201,-6752,18332,43.3,13879,142,3599,0.196323369,34208,-15876
ZCTA5 15122,8237,12517,-4280,19348,45.6,16339,194,2163,0.111794501,30324,-10976
ZCTA5 15123,0,17428,-17428,4,32.5,3,0,0,0,41101,-41097
ZCTA5 15126,3093,5263,-2170,6684,40.6,6022,61,52,0.007779773,12821,-6137
ZCTA5 15129,4287,8246,-3959,10302,43.7,9470,132,325,0.031547272,21179,-10877
ZCTA5 15131,3952,7314,-3362,8274,53.8,7689,22,204,0.024655547,20075,-11801
ZCTA5 15132,9155,5590,3565,19591,42.9,10862,272,6910,0.35271298,13468,6123
ZCTA5 15133,2812,0,2812,6078,44.3,5252,48,297,0.048864758,0,6078
ZCTA5 15135,2095,0,2095,4968,47.6,4808,48,26,0.005233494,0,4968
ZCTA5 15136,9988,20424,-10436,23071,41.8,17465,435,3719,0.161198041,49279,-26208
ZCTA5 15137,4651,126,4525,10242,45.2,7763,147,1875,0.183069713,291,9951
ZCTA5 15139,3274,557,2717,6722,45.8,6430,8,31,0.004611723,1396,5326
ZCTA5 15140,1482,1322,160,3117,41,1960,76,789,0.253128008,3609,-492
ZCTA5 15142,786,147,639,1394,49.9,1293,51,0,0,317,1077
ZCTA5 15143,8610,1615,6995,22205,45.9,18653,1786,946,0.042603017,3799,18406
ZCTA5 15144,1852,345,1507,4010,48.8,3812,7,7,0.001745636,850,3160
ZCTA5 15145,2973,42,2931,6764,45.5,4521,66,1524,0.225310467,100,6664
ZCTA5 15146,12360,14281,-1921,28650,45.4,21246,1997,3773,0.131692845,36133,-7483
ZCTA5 15147,7964,2255,5709,16361,50.6,11910,42,3448,0.210745064,5326,11035
ZCTA5 15148,1113,613,500,2500,38,1595,2,770,0.308,1480,1020
ZCTA5 15201,6640,822,5818,13057,35.5,9740,250,2528,0.193612622,2224,10833
ZCTA5 15202,9959,1675,8284,20028,38,16672,191,2021,0.100908728,4351,15677
ZCTA5 15203,5644,286,5358,10207,29.1,8624,259,917,0.089840306,661,9546
ZCTA5 15204,3564,179,3385,8124,37.8,4199,174,3088,0.380108321,480,7644
ZCTA5 15205,10827,498,10329,23410,37.4,19102,940,2274,0.097137975,1257,22153
ZCTA5 15206,14753,623,14130,29435,36.3,16448,1875,8917,0.302938678,1733,27702
ZCTA5 15207,4729,2084,2645,9963,43,7517,179,1598,0.160393456,5271,4692
ZCTA5 15208,4126,466,3660,9153,35.9,3420,191,4994,0.54561346,1016,8137
ZCTA5 15209,5510,3429,2081,11743,46.1,10721,62,450,0.038320702,8249,3494
ZCTA5 15210,11188,901,10287,26964,35.8,15784,1316,7923,0.293836226,2262,24702
ZCTA5 15211,5638,41,5597,10512,36,9252,160,720,0.068493151,113,10399
ZCTA5 15212,14176,278,13898,28461,38.3,18069,533,7698,0.270475387,712,27749
ZCTA5 15213,9597,656,8941,28172,21.6,19192,4130,3452,0.122533012,1654,26518
ZCTA5 15214,6129,684,5445,14935,36.3,8769,142,5350,0.358218949,1701,13234
ZCTA5 15215,5532,343,5189,12966,41.3,11483,722,345,0.026608052,898,12068
ZCTA5 15216,10385,2165,8220,22449,37.5,18745,410,2012,0.089625373,4995,17454
ZCTA5 15217,11662,729,10933,26409,37.2,20698,2715,1214,0.045969177,1623,24786
ZCTA5 15218,6715,700,6015,13563,39.8,9989,359,2647,0.195163312,1681,11882
ZCTA5 15219,5377,247,5130,10453,32.6,2470,607,6762,0.646895628,592,9861
ZCTA5 15220,8826,164,8662,18313,38,12961,3217,1002,0.05471523,230,18083
ZCTA5 15221,15214,86,15128,29264,41.9,13788,526,13179,0.450348551,192,29072
ZCTA5 15222,3018,755,2263,5664,31.6,4356,586,554,0.097810734,1849,3815
ZCTA5 15223,3364,184,3180,7062,42.3,6280,171,153,0.021665251,494,6568
ZCTA5 15224,5574,413,5161,10916,33.6,7790,421,2066,0.189263466,900,10016
ZCTA5 15225,523,352,171,953,48.5,875,8,35,0.036726128,917,36
ZCTA5 15226,6253,14,6239,13725,43.9,12306,238,586,0.042695811,46,13679
ZCTA5 15227,12833,605,12228,29631,40.1,24405,1743,2003,0.067598124,1427,28204
ZCTA5 15228,7437,407,7030,18503,41.8,17101,469,114,0.006161163,1230,17273
ZCTA5 15229,6241,67,6174,15425,38.4,13992,142,667,0.043241491,138,15287
ZCTA5 15232,6198,702,5496,11905,28.3,8524,1859,729,0.061234775,1731,10174
ZCTA5 15233,1447,20,1427,3079,34.8,1293,35,1572,0.510555375,41,3038
ZCTA5 15234,6077,334,5743,14006,42.5,12229,479,351,0.025060688,786,13220
ZCTA5 15235,15290,431,14859,35104,42,17990,125,14413,0.410579991,984,34120
ZCTA5 15236,13446,317,13129,30938,44,25824,2679,1107,0.03578124,835,30103
ZCTA5 15237,18231,82,18149,43211,42.8,39428,2281,586,0.013561362,322,42889
ZCTA5 15238,5396,2883,2513,12565,48.4,10953,1021,170,0.013529646,8839,3726
ZCTA5 15239,8304,120,8184,21172,43.7,19431,160,882,0.041658795,278,20894
ZCTA5 15241,8127,4534,3593,21672,44.3,19696,1283,277,0.012781469,15118,6554
ZCTA5 15243,5788,731,5057,13846,50.2,12116,699,161,0.011627907,1919,11927
ZCTA5 15260,0,235,-235,0,-,0,0,0,#DIV/0!,669,-669
ZCTA5 15275,0,0,0,4,24,1,0,2,0.5,0,4
ZCTA5 15282,0,45,-45,5923,21.5,3782,170,1569,0.264899544,129,5794
ZCTA5 15290,0,308,-308,0,-,0,0,0,#DIV/0!,816,-816
ZCTA5 15301,20943,13067,7876,49802,45.5,44482,599,2818,0.056584073,31878,17924
ZCTA5 15310,101,268,-167,240,47,240,0,0,0,659,-419
ZCTA5 15311,492,256,236,1107,52.8,1104,0,2,0.001806685,640,467
ZCTA5 15312,1534,131,1403,3910,40.3,3795,8,12,0.003069054,291,3619
ZCTA5 15313,156,267,-111,382,47.1,376,0,1,0.002617801,654,-272
ZCTA5 15314,1360,3540,-2180,3354,38.8,3123,0,14,0.00417412,8175,-4821
ZCTA5 15315,233,1691,-1458,695,33.5,695,0,0,0,4706,-4011
ZCTA5 15316,87,133,-46,220,43.6,220,0,0,0,457,-237
ZCTA5 15317,17080,52,17028,42522,41.4,39239,822,1273,0.029937444,132,42390
ZCTA5 15320,2258,75,2183,5388,46.4,5271,0,4,0.00074239,299,5089
ZCTA5 15321,695,1015,-320,1854,36.2,1779,5,0,0,2601,-747
ZCTA5 15322,706,1051,-345,1636,43.1,1561,0,36,0.02200489,2745,-1109
ZCTA5 15323,1574,8008,-6434,3921,45.4,3779,8,19,0.004845703,19374,-15453
ZCTA5 15324,298,491,-193,689,43.2,674,0,0,0,1233,-544
ZCTA5 15325,130,754,-624,249,63.5,249,0,0,0,1835,-1586
ZCTA5 15327,543,62,481,1291,46.6,1248,0,0,0,148,1143
ZCTA5 15329,575,73,502,1499,44.8,1412,0,10,0.006671114,147,1352
ZCTA5 15330,2197,1874,323,5376,53.7,5153,0,10,0.001860119,4407,969
ZCTA5 15331,303,176,127,699,45.2,647,0,31,0.04434907,380,319
ZCTA5 15332,3981,366,3615,8895,45.4,8588,66,60,0.006745363,841,8054
ZCTA5 15333,707,129,578,1708,38,1570,3,43,0.025175644,295,1413
ZCTA5 15334,81,247,-166,359,20.8,359,0,0,0,429,-70
ZCTA5 15337,211,1157,-946,538,47,533,0,0,0,2642,-2104
ZCTA5 15338,632,713,-81,1766,34.6,1705,0,9,0.005096263,2470,-704
ZCTA5 15340,524,853,-329,1256,55.8,1256,0,0,0,2115,-859
ZCTA5 15341,280,133,147,755,34.5,664,5,2,0.002649007,297,458
ZCTA5 15342,2267,964,1303,5167,44.6,4949,18,107,0.020708341,2331,2836
ZCTA5 15344,596,67,529,1398,37.8,1357,3,28,0.020028612,237,1161
ZCTA5 15345,586,259,327,1355,43,1305,0,0,0,525,830
ZCTA5 15346,226,1090,-864,509,52.3,496,0,0,0,2565,-2056
ZCTA5 15347,85,95,-10,250,27.1,250,0,0,0,169,81
ZCTA5 15348,32,91,-59,85,38.2,85,0,0,0,293,-208
ZCTA5 15349,656,119,537,1553,47.4,1505,0,0,0,407,1146
ZCTA5 15350,228,100,128,590,43.8,590,0,0,0,180,410
ZCTA5 15351,475,121,354,1092,37.3,1071,0,0,0,2117,-1025
ZCTA5 15352,364,376,-12,722,42.3,705,0,0,0,1027,-305
ZCTA5 15353,44,85,-41,85,55.5,85,0,0,0,384,-299
ZCTA5 15357,598,143,455,1473,51.4,1451,0,2,0.001357773,377,1096
ZCTA5 15358,398,1163,-765,1127,31.7,1042,0,0,0,3279,-2152
ZCTA5 15359,77,1025,-948,218,37.7,217,0,0,0,2603,-2385
ZCTA5 15360,639,577,62,1734,42.8,1658,6,20,0.011534025,1347,387
ZCTA5 15361,91,44,47,220,60.1,220,0,0,0,140,80
ZCTA5 15362,299,1678,-1379,685,41.6,629,3,0,0,4104,-3419
ZCTA5 15363,313,150,163,754,28.8,703,0,0,0,451,303
ZCTA5 15364,294,0,294,678,48.6,672,0,0,0,0,678
ZCTA5 15365,67,625,-558,225,27.6,199,0,0,0,1613,-1388
ZCTA5 15366,244,178,66,451,66.4,451,0,0,0,424,27
ZCTA5 15367,3212,45,3167,9536,43,8737,435,66,0.006921141,89,9447
ZCTA5 15368,156,917,-761,357,50.1,357,0,0,0,2096,-1739
ZCTA5 15370,4841,944,3897,14031,42.9,12093,121,1040,0.074121588,2342,11689
ZCTA5 15376,564,426,138,1436,49.1,1363,19,0,0,1173,263
ZCTA5 15377,253,112,141,658,47.9,585,0,0,0,367,291
ZCTA5 15378,18,1692,-1674,38,51.9,38,0,0,0,3956,-3918
ZCTA5 15379,30,811,-781,83,41.4,79,0,3,0.036144578,2099,-2016
ZCTA5 15380,296,485,-189,690,32.3,684,0,0,0,1388,-698
ZCTA5 15401,13424,75,13349,30337,45.3,26612,180,2257,0.0743976,166,30171
ZCTA5 15410,381,327,54,999,33.4,999,0,0,0,708,291
ZCTA5 15411,278,2448,-2170,693,41,684,0,0,0,6636,-5943
ZCTA5 15412,104,911,-807,244,40.5,232,0,0,0,2179,-1935
ZCTA5 15413,169,882,-713,384,49,342,0,22,0.057291667,2415,-2031
ZCTA5 15416,186,280,-94,481,37.8,408,73,0,0,672,-191
ZCTA5 15417,3246,258,2988,7859,43.3,6790,11,659,0.083852907,512,7347
ZCTA5 15419,1395,207,1188,3881,23.1,3046,15,560,0.144292708,632,3249
ZCTA5 15420,86,754,-668,294,23.1,294,0,0,0,1891,-1597
ZCTA5 15421,50,133,-83,78,68.7,78,0,0,0,373,-295
ZCTA5 15422,121,431,-310,243,47.5,164,0,79,0.325102881,1108,-865
ZCTA5 15423,768,50,718,2140,40.3,1975,19,65,0.030373832,83,2057
ZCTA5 15424,884,6266,-5382,1930,50.4,1850,1,24,0.012435233,16528,-14598
ZCTA5 15425,8121,56,8065,18455,44.7,17350,144,196,0.010620428,128,18327
ZCTA5 15427,398,0,398,938,45.5,817,0,69,0.073560768,2223,-1285
ZCTA5 15428,773,138,635,2010,42.3,1826,3,74,0.03681592,452,1558
ZCTA5 15429,221,749,-528,504,46,412,0,47,0.093253968,2070,-1566
ZCTA5 15430,111,4932,-4821,289,41.5,283,0,0,0,11641,-11352
ZCTA5 15431,1791,2060,-269,4360,47.6,4220,0,0,0,5187,-827
ZCTA5 15432,189,1562,-1373,388,47.2,360,0,17,0.043814433,3992,-3604
ZCTA5 15433,365,76,289,700,68.2,700,0,0,0,279,421
ZCTA5 15434,127,586,-459,298,41.7,255,0,16,0.053691275,1477,-1179
ZCTA5 15435,47,349,-302,100,62.7,100,0,0,0,865,-765
ZCTA5 15436,1086,883,203,2538,43.6,2348,4,91,0.035855004,2085,453
ZCTA5 15437,774,182,592,2821,31.3,2387,13,27,0.009571074,440,2381
ZCTA5 15438,918,3300,-2382,2309,47.2,2286,0,0,0,8004,-5695
ZCTA5 15440,60,302,-242,136,60.8,136,0,0,0,802,-666
ZCTA5 15442,966,251,715,2016,45.6,1909,19,27,0.013392857,625,1391
ZCTA5 15443,65,108,-43,211,6.9,12,0,199,0.943127962,278,-67
ZCTA5 15444,171,1595,-1424,701,22.3,519,0,84,0.119828816,4085,-3384
ZCTA5 15445,1304,387,917,2909,46.5,2903,1,0,0,956,1953
ZCTA5 15446,59,70,-11,151,32.8,151,0,0,0,134,17
ZCTA5 15447,47,1232,-1185,235,9,214,0,2,0.008510638,3021,-2786
ZCTA5 15448,71,169,-98,190,40.5,190,0,0,0,455,-265
ZCTA5 15449,183,220,-37,386,54.2,386,0,0,0,439,-53
ZCTA5 15450,79,709,-630,2509,37.7,1246,0,1050,0.418493424,1627,882
ZCTA5 15451,345,371,-26,921,46.4,913,0,0,0,927,-6
ZCTA5 15454,50,2375,-2325,132,53.2,108,0,0,0,6401,-6269
ZCTA5 15455,216,979,-763,693,40.3,693,0,0,0,2409,-1716
ZCTA5 15456,970,26,944,2269,51.8,1957,0,229,0.100925518,46,2223
ZCTA5 15458,997,1478,-481,2704,45.2,2511,0,23,0.008505917,3651,-947
ZCTA5 15459,573,757,-184,1713,41.4,1654,0,24,0.014010508,2206,-493
ZCTA5 15460,58,822,-764,158,51.2,158,0,0,0,1960,-1802
ZCTA5 15461,1555,74,1481,3771,39.6,3333,34,232,0.061522143,203,3568
ZCTA5 15462,88,60,28,188,36.3,188,0,0,0,132,56
ZCTA5 15463,125,61,64,246,60.9,246,0,0,0,168,78
ZCTA5 15464,672,1251,-579,1603,51.4,1599,0,0,0,3093,-1490
ZCTA5 15465,183,30,153,358,45.7,358,0,0,0,89,269
ZCTA5 15466,168,25084,-24916,481,30.8,473,0,0,0,59819,-59338
ZCTA5 15467,59,1446,-1387,121,56.3,121,0,0,0,3524,-3403
ZCTA5 15468,1074,220,854,2647,44.7,2489,0,38,0.014355875,522,2125
ZCTA5 15469,975,68,907,2192,56.2,2182,0,5,0.002281022,165,2027
ZCTA5 15470,260,6055,-5795,581,54.5,581,0,0,0,14446,-13865
ZCTA5 15472,86,154,-68,141,59.2,141,0,0,0,457,-316
ZCTA5 15473,1593,64,1529,3429,51.1,3358,2,9,0.002624672,273,3156
ZCTA5 15474,673,191,482,2246,31.6,2040,0,33,0.014692787,513,1733
ZCTA5 15475,457,1083,-626,1040,51.5,929,0,34,0.032692308,2558,-1518
ZCTA5 15476,34,412,-378,62,67.3,41,0,10,0.161290323,932,-870
ZCTA5 15477,411,9,402,833,42.8,737,0,1,0.00120048,44,789
ZCTA5 15478,2352,683,1669,5630,44.3,5333,24,38,0.006749556,1380,4250
ZCTA5 15479,909,348,561,2180,50.1,2115,0,54,0.024770642,781,1399
ZCTA5 15480,778,189,589,1644,52.3,1616,0,6,0.003649635,346,1298
ZCTA5 15482,158,24,134,266,58.6,266,0,0,0,24,242
ZCTA5 15483,162,2260,-2098,325,42.5,299,0,0,0,4854,-4529
ZCTA5 15484,255,2670,-2415,793,39.6,782,11,0,0,6361,-5568
ZCTA5 15486,895,299,596,1886,52.4,1832,23,4,0.002120891,786,1100
ZCTA5 15488,50,258,-208,100,85.5,100,0,0,0,592,-492
ZCTA5 15489,172,480,-308,408,36.9,400,0,0,0,1230,-822
ZCTA5 15490,121,3679,-3558,299,40.2,299,0,0,0,9454,-9155
ZCTA5 15492,58,139,-81,214,34.5,136,0,0,0,266,-52
ZCTA5 15501,6241,218,6023,16077,44.4,15143,0,478,0.029731915,639,15438
ZCTA5 15502,82,48,34,113,67.2,113,0,0,0,98,15
ZCTA5 15510,0,1402,-1402,2617,37.9,1234,0,1224,0.46771112,4189,-1572
ZCTA5 15520,138,751,-613,384,49,384,0,0,0,1877,-1493
ZCTA5 15521,706,128,578,1934,45.8,1909,0,0,0,295,1639
ZCTA5 15522,4734,958,3776,11214,52.1,10748,71,160,0.014267879,2412,8802
ZCTA5 15530,2024,230,1794,4987,49,4873,37,4,0.000802085,788,4199
ZCTA5 15531,1526,229,1297,3528,46.7,3438,26,1,0.000283447,469,3059
ZCTA5 15532,64,17979,-17915,149,37.6,149,0,0,0,45361,-45212
ZCTA5 15533,514,8548,-8034,1241,35.2,1219,0,0,0,19309,-18068
ZCTA5 15534,382,75,307,965,47,925,27,0,0,194,771
ZCTA5 15535,794,76,718,2007,45.8,1999,0,0,0,190,1817
ZCTA5 15536,153,11806,-11653,326,52.6,320,0,6,0.018404908,28805,-28479
ZCTA5 15537,3447,190,3257,8075,48.5,7746,39,60,0.007430341,545,7530
ZCTA5 15538,274,4341,-4067,662,56,658,0,0,0,10108,-9446
ZCTA5 15539,136,3863,-3727,280,32.6,280,0,0,0,8419,-8139
ZCTA5 15540,141,149,-8,337,59.3,330,0,0,0,357,-20
ZCTA5 15541,1432,168,1264,3445,47.6,3342,0,3,0.000870827,477,2968
ZCTA5 15542,446,76,370,1080,52.5,993,42,0,0,206,874
ZCTA5 15544,49,232,-183,131,50.9,117,0,14,0.106870229,496,-365
ZCTA5 15545,1079,606,473,2773,48.7,2710,10,0,0,1625,1148
ZCTA5 15546,211,7030,-6819,656,32.6,656,0,0,0,16497,-15841
ZCTA5 15547,252,5350,-5098,955,34.5,945,0,6,0.006282723,13508,-12553
ZCTA5 15550,700,1359,-659,1789,41.1,1749,0,0,0,3170,-1381
ZCTA5 15551,240,312,-72,602,51.3,597,0,0,0,964,-362
ZCTA5 15552,2177,1654,523,5958,43.2,5767,33,8,0.001342732,3578,2380
ZCTA5 15554,1042,555,487,2144,52.7,2109,0,0,0,1374,770
ZCTA5 15555,43,402,-359,89,45.2,89,0,0,0,977,-888
ZCTA5 15557,1360,82,1278,3380,46.4,3279,30,22,0.006508876,151,3229
ZCTA5 15558,712,164,548,2096,39.1,1912,0,0,0,360,1736
ZCTA5 15559,815,171,644,1925,48.5,1886,0,0,0,324,1601
ZCTA5 15560,64,1503,-1439,153,36.8,153,0,0,0,3610,-3457
ZCTA5 15561,56,60,-4,134,35.9,134,0,0,0,114,20
ZCTA5 15562,88,1952,-1864,336,53,243,0,0,0,4938,-4602
ZCTA5 15563,1199,3678,-2479,2777,49,2684,24,0,0,8302,-5525
ZCTA5 15564,51,338,-287,116,42.5,116,0,0,0,810,-694
ZCTA5 15565,2,400,-398,6,43.5,6,0,0,0,970,-964
ZCTA5 15601,24325,480,23845,56589,46.6,52978,487,1140,0.020145258,1071,55518
ZCTA5 15610,1820,261,1559,4071,51.7,4056,0,15,0.003684598,569,3502
ZCTA5 15611,150,102,48,266,55.3,259,0,0,0,195,71
ZCTA5 15612,176,3917,-3741,354,38.8,328,0,0,0,9037,-8683
ZCTA5 15613,5240,16,5224,12759,50.2,12418,63,72,0.005643075,33,12726
ZCTA5 15615,114,367,-253,216,62.7,196,10,0,0,743,-527
ZCTA5 15616,212,69,143,438,61.4,435,0,0,0,153,285
ZCTA5 15617,123,100,23,229,53.2,221,0,0,0,193,36
ZCTA5 15618,1016,138,878,2312,52.2,2289,7,0,0,293,2019
ZCTA5 15619,162,1370,-1208,332,47.4,332,0,0,0,3056,-2724
ZCTA5 15620,276,302,-26,606,42.6,606,0,0,0,666,-60
ZCTA5 15622,553,13355,-12802,1288,56.1,1288,0,0,0,34692,-33404
ZCTA5 15623,313,140,173,903,27.3,879,0,0,0,342,561
ZCTA5 15624,218,168,50,436,49.1,436,0,0,0,498,-62
ZCTA5 15625,27,65,-38,40,73.5,40,0,0,0,192,-152
ZCTA5 15626,2443,77,2366,4826,52.2,4457,150,1,0.000207211,181,4645
ZCTA5 15627,2751,2093,658,6476,47.8,6330,28,52,0.008029648,4990,1486
ZCTA5 15628,197,248,-51,464,44.4,433,0,0,0,649,-185
ZCTA5 15629,294,255,39,644,45.4,598,11,29,0.045031056,654,-10
ZCTA5 15631,383,4594,-4211,893,39.5,868,3,11,0.012318029,11148,-10255
ZCTA5 15632,3814,90,3724,9340,49.1,8493,452,231,0.024732334,243,9097
ZCTA5 15633,218,940,-722,558,40.1,558,0,0,0,2203,-1645
ZCTA5 15634,220,16,204,355,61.9,343,12,0,0,38,317
ZCTA5 15635,93,923,-830,142,49.4,142,0,0,0,2273,-2131
ZCTA5 15636,1561,531,1030,4312,45.4,4159,15,2,0.000463822,1328,2984
ZCTA5 15637,611,60,551,1607,43.6,1479,0,18,0.011200996,144,1463
ZCTA5 15638,45,1335,-1290,59,81,59,0,0,0,3167,-3108
ZCTA5 15639,907,585,322,2057,45.7,1947,1,0,0,1614,443
ZCTA5 15640,143,22,121,435,39.5,435,0,0,0,46,389
ZCTA5 15641,228,129,99,492,43.3,456,24,0,0,315,177
ZCTA5 15642,19025,655,18370,46257,45.3,44035,567,575,0.012430551,1691,44566
ZCTA5 15644,8551,47,8504,18369,47.6,16329,123,951,0.051772007,115,18254
ZCTA5 15646,77,142,-65,182,37.3,107,0,0,0,343,-161
ZCTA5 15647,9,284,-275,38,12.9,38,0,0,0,604,-566
ZCTA5 15650,11308,49,11259,26934,45,25651,322,302,0.011212594,119,26815
ZCTA5 15655,128,82,46,237,64.4,230,0,0,0,185,52
ZCTA5 15656,3978,149,3829,9737,45.9,9301,17,145,0.01489165,340,9397
ZCTA5 15658,3752,32,3720,8315,53.3,8093,15,0,0,69,8246
ZCTA5 15660,140,364,-224,265,51.7,265,0,0,0,901,-636
ZCTA5 15661,283,47,236,856,41.1,803,0,0,0,147,709
ZCTA5 15662,363,198,165,1027,37.4,927,0,0,0,472,555
ZCTA5 15663,242,59,183,550,47.8,545,0,0,0,158,392
ZCTA5 15665,497,782,-285,1326,34.8,1283,0,0,0,2093,-767
ZCTA5 15666,6793,2916,3877,15017,49.8,14580,36,154,0.010255044,7187,7830
ZCTA5 15668,5425,59,5366,14066,49,13150,397,222,0.015782739,129,13937
ZCTA5 15670,1248,44,1204,3114,54.3,3089,6,1,0.00032113,87,3027
ZCTA5 15671,256,218,38,615,36.6,516,0,50,0.081300813,576,39
ZCTA5 15672,1386,201,1185,3287,45.9,3172,25,33,0.01003955,512,2775
ZCTA5 15673,614,105,509,1224,52.4,1206,4,0,0,209,1015
ZCTA5 15674,156,605,-449,333,43.5,333,0,0,0,1505,-1172
ZCTA5 15675,406,1107,-701,1165,30.9,1073,0,15,0.012875536,2975,-1810
ZCTA5 15676,257,48,209,731,29.4,688,0,0,0,141,590
ZCTA5 15677,198,25,173,339,54.5,276,0,55,0.162241888,44,295
ZCTA5 15678,257,263,-6,700,40.4,675,0,0,0,771,-71
ZCTA5 15679,1384,48,1336,2642,54.3,2385,43,0,0,90,2552
ZCTA5 15680,149,660,-511,274,37.8,274,0,0,0,1808,-1534
ZCTA5 15681,1883,5835,-3952,4705,44.1,4400,55,21,0.004463337,14465,-9760
ZCTA5 15682,113,118,-5,299,47.4,293,0,3,0.010033445,314,-15
ZCTA5 15683,3504,396,3108,8057,45.9,7605,67,76,0.009432791,1050,7007
ZCTA5 15684,147,612,-465,353,54.8,353,0,0,0,1731,-1378
ZCTA5 15686,432,161,271,1066,50,1059,7,0,0,462,604
ZCTA5 15687,524,1263,-739,1178,54.6,1167,0,0,0,3297,-2119
ZCTA5 15688,386,353,33,924,44.4,924,0,0,0,889,35
ZCTA5 15689,50,27,23,121,36.6,121,0,0,0,58,63
ZCTA5 15690,4034,44,3990,9239,43,8557,29,268,0.029007468,95,9144
ZCTA5 15691,161,49,112,471,32,452,0,0,0,128,343
ZCTA5 15692,444,55,389,864,31.9,808,0,0,0,251,613
ZCTA5 15693,130,41,89,311,58,311,0,0,0,127,184
ZCTA5 15695,133,31,102,309,46.9,309,0,0,0,73,236
ZCTA5 15696,109,41,68,236,55.4,234,0,0,0,78,158
ZCTA5 15697,1309,32,1277,2952,44.6,2837,0,23,0.007791328,69,2883
ZCTA5 15698,274,8082,-7808,518,62.5,518,0,0,0,19391,-18873
ZCTA5 15701,12702,73,12629,30535,37.7,27769,654,1090,0.035696741,157,30378
ZCTA5 15705,0,635,-635,3017,19.5,2162,61,537,0.177991382,1611,1406
ZCTA5 15710,111,2125,-2014,198,53.3,197,0,1,0.005050505,5284,-5086
ZCTA5 15711,136,4029,-3893,315,40.2,315,0,0,0,9800,-9485
ZCTA5 15712,48,101,-53,124,32.6,106,0,0,0,344,-220
ZCTA5 15713,96,124,-28,374,21.2,374,0,0,0,368,6
ZCTA5 15714,1990,458,1532,4896,39.8,4831,46,0,0,1158,3738
ZCTA5 15715,220,123,97,505,44.8,494,0,0,0,281,224
ZCTA5 15716,176,1967,-1791,359,48.5,328,0,4,0.011142061,4567,-4208
ZCTA5 15717,4078,787,3291,9610,50.2,8792,23,343,0.035691988,1882,7728
ZCTA5 15720,105,180,-75,284,43.5,255,0,0,0,440,-156
ZCTA5 15721,78,1493,-1415,168,50.8,168,0,0,0,3529,-3361
ZCTA5 15722,903,1628,-725,2268,45.5,2209,0,12,0.005291005,3681,-1413
ZCTA5 15723,12,109,-97,12,-,12,0,0,0,221,-209
ZCTA5 15724,856,373,483,2176,52.5,2161,0,1,0.000459559,1096,1080
ZCTA5 15725,560,517,43,1280,48.7,1244,0,0,0,1225,55
ZCTA5 15727,87,2695,-2608,218,43.7,218,0,0,0,6742,-6524
ZCTA5 15728,1350,2666,-1316,3679,38.8,3602,6,7,0.001902691,6190,-2511
ZCTA5 15729,517,368,149,991,53.2,978,0,0,0,908,83
ZCTA5 15730,60,5604,-5544,172,37.1,140,0,0,0,13232,-13060
ZCTA5 15731,146,428,-282,291,58,291,0,0,0,931,-640
ZCTA5 15732,615,68,547,1481,49.6,1465,0,0,0,155,1326
ZCTA5 15733,61,73,-12,130,45.1,130,0,0,0,145,-15
ZCTA5 15734,163,705,-542,398,35.6,273,0,0,0,1833,-1435
ZCTA5 15736,168,591,-423,336,58,327,0,0,0,1378,-1042
ZCTA5 15737,53,85,-32,117,53.3,117,0,0,0,241,-124
ZCTA5 15738,74,551,-477,139,57.6,139,0,0,0,1256,-1117
ZCTA5 15739,162,579,-417,409,36.6,394,0,0,0,1290,-881
ZCTA5 15741,23,2263,-2240,56,49.3,56,0,0,0,4077,-4021
ZCTA5 15742,343,5481,-5138,989,40.3,986,0,0,0,13035,-12046
ZCTA5 15744,11,6577,-6566,36,41,36,0,0,0,16475,-16439
ZCTA5 15745,110,9317,-9207,259,49.1,259,0,0,0,20971,-20712
ZCTA5 15746,54,5149,-5095,120,58,120,0,0,0,11156,-11036
ZCTA5 15747,664,2306,-1642,1814,39.4,1797,0,0,0,5397,-3583
ZCTA5 15748,2835,364,2471,6882,45.4,6649,22,5,0.000726533,933,5949
ZCTA5 15750,112,91,21,290,64.3,290,0,0,0,235,55
ZCTA5 15752,16,56,-40,35,26.1,35,0,0,0,162,-127
ZCTA5 15753,176,681,-505,458,43.2,455,0,0,0,1769,-1311
ZCTA5 15754,159,517,-358,421,31.2,421,0,0,0,965,-544
ZCTA5 15756,71,66,5,219,29.4,209,0,0,0,154,65
ZCTA5 15757,569,1117,-548,1350,51.4,1344,0,0,0,2688,-1338
ZCTA5 15759,1062,385,677,2900,45.2,2811,0,6,0.002068966,819,2081
ZCTA5 15760,44,1014,-970,133,25.5,128,0,0,0,2236,-2103
ZCTA5 15761,54,33,21,183,32.5,183,0,0,0,73,110
ZCTA5 15762,337,80,257,989,45.8,988,0,0,0,163,826
ZCTA5 15763,12,3567,-3555,15,68.2,15,0,0,0,9483,-9468
ZCTA5 15764,42,101,-59,93,62.5,88,0,0,0,148,-55
ZCTA5 15765,648,965,-317,1713,53.2,1665,6,5,0.002918856,2524,-811
ZCTA5 15767,5716,637,5079,14259,44,13856,81,48,0.003366295,1678,12581
ZCTA5 15770,86,292,-206,192,63.4,192,0,0,0,756,-564
ZCTA5 15771,370,1038,-668,931,48.5,931,0,0,0,2496,-1565
ZCTA5 15772,568,541,27,1658,38.7,1620,0,0,0,4027,-2369
ZCTA5 15773,161,849,-688,476,48.2,463,0,0,0,2091,-1615
ZCTA5 15774,1195,1729,-534,2842,47.7,2834,0,0,0,4103,-1261
ZCTA5 15775,236,1572,-1336,540,53.9,540,0,0,0,3939,-3399
ZCTA5 15776,26,55,-29,46,41.8,46,0,0,0,222,-176
ZCTA5 15777,35,2823,-2788,76,59.7,76,0,0,0,6997,-6921
ZCTA5 15778,64,256,-192,368,43.8,343,0,0,0,637,-269
ZCTA5 15779,91,211,-120,561,50.3,503,0,51,0.090909091,516,45
ZCTA5 15780,49,63,-14,109,55.2,109,0,0,0,173,-64
ZCTA5 15781,46,640,-594,94,61.7,94,0,0,0,1431,-1337
ZCTA5 15783,35,53,-18,79,45.6,79,0,0,0,158,-79
ZCTA5 15784,32,1120,-1088,63,57.2,63,0,0,0,2496,-2433
ZCTA5 15801,8220,1221,6999,20275,45.3,19472,137,184,0.009075216,3018,17257
ZCTA5 15821,49,1038,-989,91,57.3,88,0,0,0,2544,-2453
ZCTA5 15823,534,254,280,1246,45.4,1230,0,1,0.000802568,635,611
ZCTA5 15824,2087,802,1285,5132,45.8,4962,0,37,0.007209665,2144,2988
ZCTA5 15825,3811,194,3617,9652,42.6,9355,0,58,0.006009117,503,9149
ZCTA5 15827,120,293,-173,334,50.1,334,0,0,0,757,-423
ZCTA5 15828,108,41,67,211,61.1,211,0,0,0,103,108
ZCTA5 15829,465,4792,-4327,1201,44.4,1163,0,2,0.001665279,10831,-9630
ZCTA5 15831,31,17570,-17539,49,49.3,37,0,0,0,40381,-40332
ZCTA5 15832,129,5876,-5747,247,63.7,227,0,0,0,15866,-15619
ZCTA5 15834,1933,418,1515,4221,50.7,3979,5,7,0.001658375,1131,3090
ZCTA5 15840,741,177,564,1753,48,1700,11,16,0.00912721,480,1273
ZCTA5 15841,91,1687,-1596,211,43.8,211,0,0,0,4252,-4041
ZCTA5 15845,1332,88,1244,2922,46.1,2836,0,0,0,218,2704
ZCTA5 15846,1419,2088,-669,3309,49,3203,49,57,0.017225748,5673,-2364
ZCTA5 15847,21,102,-81,45,31.9,45,0,0,0,269,-224
ZCTA5 15848,335,861,-526,835,46.4,822,11,0,0,2100,-1265
ZCTA5 15849,530,331,199,1259,49.5,1239,12,1,0.000794281,692,567
ZCTA5 15851,2661,146,2515,7074,40.3,6818,22,50,0.007068137,305,6769
ZCTA5 15853,2687,2507,180,6400,44.6,6177,0,99,0.01546875,5885,515
ZCTA5 15856,385,755,-370,842,55,834,2,0,0,2045,-1203
ZCTA5 15857,5793,29,5764,13029,49.3,12618,44,51,0.003914345,88,12941
ZCTA5 15860,513,100,413,1155,53.5,1146,2,0,0,252,903
ZCTA5 15861,60,1775,-1715,111,62.1,105,0,0,0,4527,-4416
ZCTA5 15863,69,1402,-1333,134,53.8,134,0,0,0,3753,-3619
ZCTA5 15864,700,401,299,1795,44.1,1783,0,0,0,1028,767
ZCTA5 15865,532,760,-228,1066,44.8,1061,0,5,0.004690432,2000,-934
ZCTA5 15866,58,560,-502,218,29,205,0,0,0,1511,-1293
ZCTA5 15868,725,5274,-4549,1838,46.7,1775,0,0,0,13694,-11856
ZCTA5 15870,525,65,460,1249,46.6,1191,9,0,0,139,1110
ZCTA5 15901,1919,1425,494,3512,50.4,2342,13,869,0.247437358,3480,32
ZCTA5 15902,4930,603,4327,11454,43.5,9023,25,1338,0.116815086,1546,9908
ZCTA5 15904,6619,1230,5389,16509,44.8,15693,225,228,0.013810649,3018,13491
ZCTA5 15905,8752,944,7808,20082,46.9,18825,176,478,0.02380241,2233,17849
ZCTA5 15906,4660,1697,2963,10104,45,8445,0,1056,0.104513064,4106,5998
ZCTA5 15909,2081,162,1919,4976,49,4804,23,61,0.012258842,365,4611
ZCTA5 15920,257,3175,-2918,551,59.5,540,0,0,0,8412,-7861
ZCTA5 15921,153,2092,-1939,310,57.2,310,0,0,0,5015,-4705
ZCTA5 15922,28,4749,-4721,112,42.4,110,0,1,0.008928571,13635,-13523
ZCTA5 15923,612,3150,-2538,1634,46.2,1609,3,13,0.007955936,8118,-6484
ZCTA5 15924,378,1029,-651,943,43.5,942,0,0,0,2718,-1775
ZCTA5 15925,56,3114,-3058,157,37.3,157,0,0,0,6686,-6529
ZCTA5 15926,1044,10259,-9215,2564,46.3,2498,14,0,0,28130,-25566
ZCTA5 15927,355,13837,-13482,782,47.9,782,0,0,0,34664,-33882
ZCTA5 15928,860,2252,-1392,1935,57.3,1685,84,0,0,5589,-3654
ZCTA5 15929,38,6671,-6633,130,25.7,130,0,0,0,15040,-14910
ZCTA5 15930,165,127,38,357,55.6,357,0,0,0,277,80
ZCTA5 15931,3805,402,3403,9326,46,9021,20,180,0.019300879,1159,8167
ZCTA5 15934,0,635,-635,0,-,0,0,0,#DIV/0!,1472,-1472
ZCTA5 15935,1129,142,987,2981,46.4,2931,0,2,0.000670916,348,2633
ZCTA5 15936,685,218,467,1517,56.7,1502,0,0,0,583,934
ZCTA5 15937,305,1246,-941,646,53.7,637,0,0,0,3271,-2625
ZCTA5 15938,983,1225,-242,2422,47.2,2410,0,4,0.001651528,2853,-431
ZCTA5 15940,590,7213,-6623,3720,32.2,3090,11,470,0.126344086,17028,-13308
ZCTA5 15942,706,832,-126,1981,45.4,1974,0,0,0,2296,-315
ZCTA5 15943,1733,2158,-425,3972,47.1,3891,8,35,0.008811682,5010,-1038
ZCTA5 15944,1114,889,225,3001,43.4,2860,3,0,0,2322,679
ZCTA5 15945,47,750,-703,158,23.5,158,0,0,0,1876,-1718
ZCTA5 15946,2725,7366,-4641,6675,48.2,6579,10,10,0.001498127,18272,-11597
ZCTA5 15948,179,5213,-5034,525,37.6,525,0,0,0,15889,-15364
ZCTA5 15949,225,819,-594,462,57.1,462,0,0,0,1947,-1485
ZCTA5 15951,299,276,23,491,59.2,479,0,12,0.024439919,821,-330
ZCTA5 15952,492,149,343,1335,39.1,1294,0,8,0.005992509,364,971
ZCTA5 15953,20,616,-596,77,13.9,77,0,0,0,1557,-1480
ZCTA5 15954,1133,1659,-526,2396,52.7,2350,4,8,0.003338898,4040,-1644
ZCTA5 15955,878,365,513,2194,47.9,2114,29,43,0.019598906,783,1411
ZCTA5 15956,1186,4568,-3382,2616,41.8,2517,9,0,0,13049,-10433
ZCTA5 15957,132,93,39,360,41.1,360,0,0,0,215,145
ZCTA5 15958,821,812,9,2019,43,1977,0,2,0.000990589,1908,111
ZCTA5 15960,88,2085,-1997,170,53.4,170,0,0,0,7128,-6958
ZCTA5 15961,376,1308,-932,908,41.3,893,0,0,0,2969,-2061
ZCTA5 15962,116,1080,-964,398,36.6,397,0,0,0,2682,-2284
ZCTA5 15963,4485,6114,-1629,10164,47,10021,0,6,0.000590319,14080,-3916
ZCTA5 16001,18074,7568,10506,39892,46.3,37392,136,600,0.01504061,16857,23035
ZCTA5 16002,6348,3090,3258,15771,48.9,15134,16,352,0.022319447,7378,8393
ZCTA5 16020,443,48,395,1201,44.1,1183,6,4,0.003330558,100,1101
ZCTA5 16022,135,1064,-929,319,51.1,316,2,0,0,2595,-2276
ZCTA5 16023,1700,1247,453,4614,50.5,4498,110,0,0,2722,1892
ZCTA5 16024,105,9,96,301,41.5,265,0,0,0,75,226
ZCTA5 16025,1922,1195,727,4763,46.5,4633,9,27,0.005668696,3305,1458
ZCTA5 16027,153,1449,-1296,432,37.3,421,0,0,0,3618,-3186
ZCTA5 16028,861,1855,-994,2040,46.5,1909,8,5,0.00245098,4770,-2730
ZCTA5 16029,370,376,-6,910,33.8,903,0,0,0,851,59
ZCTA5 16030,104,333,-229,286,39,269,11,0,0,706,-420
ZCTA5 16033,3065,7777,-4712,7056,48.4,6918,55,0,0,18426,-11370
ZCTA5 16034,742,409,333,1792,44.2,1736,0,31,0.017299107,1175,617
ZCTA5 16035,52,48,4,184,37.8,184,0,0,0,99,85
ZCTA5 16036,128,164,-36,316,50.8,310,0,0,0,362,-46
ZCTA5 16037,1828,55,1773,4751,46.5,4619,12,5,0.00105241,137,4614
ZCTA5 16038,1291,3703,-2412,3404,45.4,3328,0,15,0.00440658,9863,-6459
ZCTA5 16040,330,61,269,933,38.3,924,0,1,0.001071811,158,775
ZCTA5 16041,783,494,289,2060,47,2018,1,0,0,1291,769
ZCTA5 16045,422,952,-530,1130,40.5,1056,0,34,0.030088496,2456,-1326
ZCTA5 16046,6645,44,6601,18345,39.8,17096,766,213,0.011610793,112,18233
ZCTA5 16048,64,526,-462,167,46.2,160,0,0,0,1340,-1173
ZCTA5 16049,1215,3453,-2238,3092,45.5,2990,0,19,0.00614489,8043,-4951
ZCTA5 16050,468,169,299,1105,46.3,1058,8,27,0.024434389,376,729
ZCTA5 16051,1268,1994,-726,3120,42.5,2969,3,2,0.000641026,5010,-1890
ZCTA5 16052,915,220,695,2360,50.4,2234,4,0,0,607,1753
ZCTA5 16053,1599,1747,-148,3721,50.1,3645,0,0,0,4370,-649
ZCTA5 16054,170,401,-231,344,56,340,0,0,0,919,-575
ZCTA5 16055,3329,510,2819,8194,52.9,7971,46,15,0.001830608,1192,7002
ZCTA5 16056,1948,115,1833,4260,49,4152,30,0,0,404,3856
ZCTA5 16057,4533,177,4356,14184,24.5,13092,179,196,0.013818387,401,13783
ZCTA5 16059,3750,633,3117,9155,44.1,8962,97,28,0.003058438,4091,5064
ZCTA5 16061,1013,515,498,2729,47.3,2711,0,8,0.002931477,1201,1528
ZCTA5 16063,3623,1942,1681,8086,44.2,7847,11,86,0.010635667,4576,3510
ZCTA5 16066,13045,110,12935,32425,40.4,29811,1198,353,0.010886662,195,32230
ZCTA5 16101,13390,75,13315,31267,45.2,26575,61,2481,0.079348834,184,31083
ZCTA5 16102,2192,110,2082,5441,42.3,4883,14,88,0.016173498,283,5158
ZCTA5 16105,6763,1234,5529,15690,46.3,15115,82,213,0.013575526,3247,12443
ZCTA5 16110,167,858,-691,456,45.8,456,0,0,0,2035,-1579
ZCTA5 16111,404,103,301,1206,34.4,1153,2,6,0.004975124,295,911
ZCTA5 16112,601,42,559,1527,41.3,1469,0,0,0,122,1405
ZCTA5 16113,153,1450,-1297,363,47.6,359,0,1,0.002754821,3575,-3212
ZCTA5 16114,229,649,-420,591,52.6,574,10,0,0,1785,-1194
ZCTA5 16115,1389,505,884,3435,44.2,3339,3,6,0.001746725,1873,1562
ZCTA5 16116,1087,812,275,2691,48.1,2674,0,0,0,1926,765
ZCTA5 16117,7221,739,6482,15549,48.3,15023,23,165,0.010611615,1881,13668
ZCTA5 16120,948,174,774,2430,48,2311,18,8,0.003292181,380,2050
ZCTA5 16121,2024,1152,872,4320,39.8,1650,24,2308,0.534259259,3084,1236
ZCTA5 16123,968,144,824,2711,47,2708,2,0,0,467,2244
ZCTA5 16124,648,6586,-5938,1672,45.1,1659,0,0,0,15984,-14312
ZCTA5 16125,7025,218,6807,17627,44.6,16724,94,190,0.010778919,515,17112
ZCTA5 16127,5260,6,5254,15466,35.9,14467,80,406,0.026251132,17,15449
ZCTA5 16130,832,898,-66,2110,45.1,2046,2,0,0,2205,-95
ZCTA5 16131,377,2069,-1692,909,47.3,903,0,0,0,5513,-4604
ZCTA5 16132,187,2513,-2326,425,28.7,425,0,0,0,5435,-5010
ZCTA5 16133,572,658,-86,1586,41.6,1559,0,0,0,1727,-141
ZCTA5 16134,1626,518,1108,3804,51,3745,9,4,0.001051525,1247,2557
ZCTA5 16136,328,35,293,777,40.2,732,0,2,0.002574003,166,611
ZCTA5 16137,4425,41,4384,12885,44,11717,33,734,0.056965464,116,12769
ZCTA5 16140,155,6922,-6767,404,38.3,404,0,0,0,16426,-16022
ZCTA5 16141,666,165,501,1718,45.3,1611,61,12,0.006984866,511,1207
ZCTA5 16142,1899,1102,797,5534,35.4,5261,4,56,0.010119263,3176,2358
ZCTA5 16143,873,45,828,1966,51.9,1957,8,0,0,97,1869
ZCTA5 16145,1155,218,937,2616,46.5,2461,0,3,0.001146789,548,2068
ZCTA5 16146,6006,30,5976,13222,42.8,10606,38,1816,0.137346846,83,13139
ZCTA5 16148,7805,25,7780,16693,49.6,14992,207,848,0.050799736,59,16634
ZCTA5 16150,3166,106,3060,7136,47.3,6783,40,284,0.039798206,206,6930
ZCTA5 16151,33,136,-103,89,36.6,89,0,0,0,391,-302
ZCTA5 16153,922,12082,-11160,2228,43.3,2145,12,0,0,28259,-26031
ZCTA5 16154,886,744,142,1961,54.4,1773,115,0,0,1811,150
ZCTA5 16155,50,818,-768,131,83.3,127,4,0,0,2046,-1915
ZCTA5 16156,1167,914,253,3275,39.4,3223,7,12,0.003664122,2569,706
ZCTA5 16157,1292,179,1113,2872,50.6,2785,22,12,0.004178273,404,2468
ZCTA5 16159,2154,259,1895,4585,54.2,4449,1,46,0.010032715,657,3928
ZCTA5 16160,455,1389,-934,880,52.9,849,0,24,0.027272727,3310,-2430
ZCTA5 16161,301,1442,-1141,581,48.7,474,0,45,0.077452668,3316,-2735
ZCTA5 16172,4,1022,-1018,767,20.3,660,0,76,0.099087353,2518,-1751
ZCTA5 16201,6861,938,5923,16730,46.3,16054,72,162,0.009683204,2637,14093
ZCTA5 16210,289,693,-404,767,40.4,756,0,0,0,1503,-736
ZCTA5 16211,26,108,-82,66,53,65,0,0,0,245,-179
ZCTA5 16212,127,1243,-1116,232,51.8,230,0,0,0,3201,-2969
ZCTA5 16213,56,4573,-4517,125,44.8,124,0,0,0,11246,-11121
ZCTA5 16214,3194,551,2643,8744,28.5,8000,95,429,0.049062214,1469,7275
ZCTA5 16217,53,36,17,99,64.8,99,0,0,0,77,22
ZCTA5 16218,417,450,-33,1241,39.1,1119,0,94,0.075745367,1227,14
ZCTA5 16220,43,432,-389,99,50,99,0,0,0,1118,-1019
ZCTA5 16222,1019,8296,-7277,2866,37.8,2829,21,0,0,18834,-15968
ZCTA5 16223,46,118,-72,73,53.8,73,0,0,0,393,-320
ZCTA5 16224,385,1422,-1037,969,50.8,950,0,0,0,3315,-2346
ZCTA5 16226,3494,186,3308,8031,46.1,7811,15,93,0.011580127,389,7642
ZCTA5 16228,143,1339,-1196,321,45.7,310,9,2,0.00623053,3286,-2965
ZCTA5 16229,2233,843,1390,5549,45.1,5326,100,47,0.008469995,1940,3609
ZCTA5 16230,191,1774,-1583,526,40.7,520,0,5,0.009505703,6558,-6032
ZCTA5 16232,1655,327,1328,4316,42.1,4224,1,0,0,819,3497
ZCTA5 16233,436,2254,-1818,1087,48.8,1083,0,0,0,7107,-6020
ZCTA5 16235,521,1241,-720,1253,43.5,1154,5,0,0,3270,-2017
ZCTA5 16236,125,303,-178,265,55.8,265,0,0,0,868,-603
ZCTA5 16238,158,1321,-1163,406,45.5,396,0,2,0.004926108,3562,-3156
ZCTA5 16239,520,4344,-3824,4321,37.4,2568,101,1274,0.294839158,11151,-6830
ZCTA5 16240,619,652,-33,1655,41.4,1641,3,11,0.006646526,1832,-177
ZCTA5 16242,1752,576,1176,4401,44.8,4327,25,13,0.002953874,1433,2968
ZCTA5 16244,151,4618,-4467,363,38.4,363,0,0,0,10984,-10621
ZCTA5 16245,124,3015,-2891,305,45.6,301,4,0,0,8701,-8396
ZCTA5 16246,64,93,-29,210,34.2,210,0,0,0,282,-72
ZCTA5 16248,1234,3191,-1957,3127,49.5,2968,49,30,0.00959386,8378,-5251
ZCTA5 16249,795,228,567,1970,46.6,1930,0,0,0,557,1413
ZCTA5 16250,147,932,-785,473,28.9,466,0,0,0,2532,-2059
ZCTA5 16253,64,81,-17,125,36.8,125,0,0,0,159,-34
ZCTA5 16254,1348,1770,-422,3642,43.4,3492,12,63,0.017298188,4532,-890
ZCTA5 16255,695,1942,-1247,1821,47.1,1749,1,2,0.001098298,4644,-2823
ZCTA5 16256,437,1517,-1080,2136,18.8,2124,0,0,0,3822,-1686
ZCTA5 16258,758,127,631,1652,44.7,1555,0,3,0.001815981,304,1348
ZCTA5 16259,864,4880,-4016,2089,46.9,2050,0,0,0,12591,-10502
ZCTA5 16260,164,2074,-1910,312,57.5,312,0,0,0,5232,-4920
ZCTA5 16262,1260,963,297,2871,48.6,2852,5,0,0,3494,-623
ZCTA5 16263,117,799,-682,310,44.3,310,0,0,0,2087,-1777
ZCTA5 16301,6196,241,5955,15063,44.8,14198,17,159,0.010555666,708,14355
ZCTA5 16311,190,2960,-2770,400,52.4,398,0,0,0,7879,-7479
ZCTA5 16312,0,392,-392,0,-,0,0,0,#DIV/0!,948,-948
ZCTA5 16313,782,3667,-2885,1876,51.5,1833,9,0,0,10017,-8141
ZCTA5 16314,2084,1101,983,5354,43.6,5140,28,20,0.003735525,3027,2327
ZCTA5 16316,2105,517,1588,4685,51,4567,12,0,0,1349,3336
ZCTA5 16317,565,0,565,1334,48.5,1298,0,0,0,1013,321
ZCTA5 16319,472,1366,-894,1248,56,1196,0,0,0,2388,-1140
ZCTA5 16321,15,7103,-7088,16,62.5,16,0,0,0,17560,-17544
ZCTA5 16322,45,5503,-5458,102,50.6,102,0,0,0,15309,-15207
ZCTA5 16323,6382,6754,-372,15088,47.7,14218,79,352,0.023329799,17461,-2373
ZCTA5 16326,97,7457,-7360,225,57.1,225,0,0,0,16913,-16688
ZCTA5 16327,971,9752,-8781,2605,42.6,2507,8,34,0.013051823,23576,-20971
ZCTA5 16328,93,4201,-4108,235,49.8,232,0,0,0,10824,-10589
ZCTA5 16329,173,6795,-6622,433,49.7,427,0,0,0,16474,-16041
ZCTA5 16331,32,11682,-11650,96,53.2,96,0,0,0,27165,-27069
ZCTA5 16332,17,9506,-9489,44,51.8,44,0,0,0,25479,-25435
ZCTA5 16333,110,4487,-4377,245,57.9,242,0,0,0,11381,-11136
ZCTA5 16334,199,0,199,412,48.6,412,0,0,0,1092,-680
ZCTA5 16335,11185,0,11185,27493,43.3,25342,270,797,0.028989197,1502,25991
ZCTA5 16340,689,13391,-12702,1777,45.2,1679,31,0,0,33538,-31761
ZCTA5 16341,755,12263,-11508,1727,53.3,1684,22,0,0,29941,-28214
ZCTA5 16342,928,984,-56,2403,53.2,2300,18,5,0.002080732,2406,-3
ZCTA5 16343,233,605,-372,601,41.3,586,0,15,0.024958403,1576,-975
ZCTA5 16344,179,37,142,468,32.2,468,0,0,0,87,381
ZCTA5 16345,1469,1200,269,3642,49.3,3512,22,11,0.003020319,2917,725
ZCTA5 16346,1494,108,1386,3335,46.3,3200,39,25,0.007496252,231,3104
ZCTA5 16347,644,172,472,1640,50.3,1600,0,34,0.020731707,418,1222
ZCTA5 16350,871,249,622,2476,38.6,2397,0,4,0.001615509,598,1878
ZCTA5 16351,733,58,675,1727,54.8,1606,11,8,0.00463231,205,1522
ZCTA5 16352,74,182,-108,205,53.1,205,0,0,0,516,-311
ZCTA5 16353,1163,81,1082,2695,56.8,2682,5,0,0,195,2500
ZCTA5 16354,4406,1597,2809,10572,44.1,10239,81,116,0.01097238,4021,6551
ZCTA5 16360,525,891,-366,1333,43.3,1292,0,20,0.015003751,2183,-850
ZCTA5 16361,17,2128,-2111,21,63.8,21,0,0,0,5872,-5851
ZCTA5 16362,395,16,379,947,53.4,936,2,6,0.006335797,28,919
ZCTA5 16364,467,59,408,1303,48.9,1296,0,0,0,167,1136
ZCTA5 16365,7676,92,7584,17423,47.2,16768,67,180,0.010331171,227,17196
ZCTA5 16370,88,5042,-4954,230,51.5,230,0,0,0,12725,-12495
ZCTA5 16371,1250,310,940,3182,44.5,2949,4,18,0.00565682,814,2368
ZCTA5 16372,235,1029,-794,565,41.7,507,19,0,0,2388,-1823
ZCTA5 16373,1223,29,1194,3069,44.1,2934,31,49,0.015966113,75,2994
ZCTA5 16374,731,617,114,1592,56.5,1555,0,0,0,1583,9
ZCTA5 16401,1597,344,1253,4108,47,3961,16,35,0.008519961,859,3249
ZCTA5 16402,276,1078,-802,717,51.4,698,0,0,0,2613,-1896
ZCTA5 16403,2264,60,2204,6877,39.9,6423,41,230,0.033444816,133,6744
ZCTA5 16404,1186,993,193,3256,44.3,3041,9,20,0.006142506,2437,819
ZCTA5 16405,227,276,-49,552,50.1,505,0,3,0.005434783,593,-41
ZCTA5 16406,1302,6150,-4848,3408,41.9,3339,0,29,0.00850939,14826,-11418
ZCTA5 16407,4638,786,3852,10915,42.8,9907,48,223,0.0204306,1990,8925
ZCTA5 16410,666,1468,-802,1952,47.7,1867,6,31,0.015881148,5862,-3910
ZCTA5 16411,529,5740,-5211,1406,43.6,1358,0,0,0,18025,-16619
ZCTA5 16412,4141,587,3554,9635,39.1,9213,50,80,0.008303062,1442,8193
ZCTA5 16415,3409,550,2859,9784,39.8,8927,141,56,0.00572363,1495,8289
ZCTA5 16416,73,486,-413,149,61.1,132,0,0,0,1187,-1038
ZCTA5 16417,3619,126,3493,8694,45,8484,41,0,0,314,8380
ZCTA5 16420,198,362,-164,457,54.3,456,0,0,0,1011,-554
ZCTA5 16421,954,2354,-1400,2422,48.3,2361,0,5,0.00206441,5600,-3178
ZCTA5 16422,85,685,-600,281,44.3,281,0,0,0,2053,-1772
ZCTA5 16423,1608,151,1457,3851,39.1,3457,7,28,0.007270839,285,3566
ZCTA5 16424,1889,1491,398,4544,48.4,4413,1,0,0,3558,986
ZCTA5 16426,1495,656,839,3476,50.9,3314,0,15,0.004315305,1709,1767
ZCTA5 16427,77,1449,-1372,178,45.5,165,3,2,0.011235955,3616,-3438
ZCTA5 16428,4940,907,4033,12614,40.9,11639,45,177,0.014032028,2353,10261
ZCTA5 16430,71,12,59,178,55.7,174,0,0,0,18,160
ZCTA5 16433,1873,232,1641,5039,44.6,4844,39,32,0.006350466,547,4492
ZCTA5 16434,894,72,822,3232,26.9,3171,3,36,0.011138614,180,3052
ZCTA5 16435,662,2200,-1538,1689,45.1,1626,14,14,0.008288928,5436,-3747
ZCTA5 16436,276,198,78,801,44.1,772,0,2,0.002496879,539,262
ZCTA5 16438,3041,67,2974,7246,47.2,6898,33,1,0.000138007,110,7136
ZCTA5 16440,339,1180,-841,811,46.8,734,2,10,0.012330456,2833,-2022
ZCTA5 16441,3707,344,3363,9407,46.9,9067,21,19,0.002019773,845,8562
ZCTA5 16442,1103,171,932,3231,36.9,3149,11,14,0.004333024,396,2835
ZCTA5 16443,427,55,372,1033,40.9,975,0,13,0.012584705,176,857
ZCTA5 16444,0,175,-175,917,19.7,807,15,71,0.07742639,418,499
ZCTA5 16475,0,113,-113,2496,39.7,1231,0,1164,0.466346154,412,2084
ZCTA5 16501,1069,5362,-4293,1553,53.9,1182,4,274,0.176432711,13373,-11820
ZCTA5 16502,6770,216,6554,15548,35.3,10884,371,1509,0.097054284,595,14953
ZCTA5 16503,5447,161,5286,15876,30.4,8090,428,5554,0.349836231,329,15547
ZCTA5 16504,6542,295,6247,15922,37,12413,420,2021,0.12693129,758,15164
ZCTA5 16505,7654,1652,6002,16081,49,15049,252,235,0.014613519,4505,11576
ZCTA5 16506,10020,91,9929,24635,44.7,22789,766,367,0.014897504,205,24430
ZCTA5 16507,3609,406,3203,9111,30.8,6013,203,1682,0.184612007,1222,7889
ZCTA5 16508,6812,0,6812,15438,37.5,12973,237,1023,0.06626506,822,14616
ZCTA5 16509,11927,7341,4586,27969,42,24846,478,978,0.034967285,17979,9990
ZCTA5 16510,9892,551,9341,25483,39.8,20526,979,2130,0.083585135,1268,24215
ZCTA5 16511,4480,40,4440,11555,37.1,9790,243,1081,0.093552575,77,11478
ZCTA5 16546,0,61,-61,996,19.5,897,55,23,0.023092369,114,882
ZCTA5 16550,0,224,-224,0,-,0,0,0,#DIV/0!,538,-538
ZCTA5 16563,0,78,-78,1556,19.5,1221,201,82,0.052699229,190,1366
ZCTA5 16601,13139,12,13127,32539,41.7,30257,159,598,0.018377946,32,32507
ZCTA5 16602,11685,303,11382,28176,42,25963,112,1210,0.04294435,676,27500
ZCTA5 16611,965,56,909,2584,44.3,2467,0,37,0.014318885,105,2479
ZCTA5 16613,650,1209,-559,1509,49.6,1458,0,0,0,2995,-1486
ZCTA5 16616,69,90,-21,154,56.3,154,0,0,0,260,-106
ZCTA5 16617,1125,81,1044,2606,44.1,2553,0,5,0.001918649,169,2437
ZCTA5 16619,117,107,10,331,39.5,313,0,18,0.054380665,286,45
ZCTA5 16620,131,2633,-2502,338,51.5,324,1,5,0.014792899,6090,-5752
ZCTA5 16621,259,579,-320,692,41.5,689,0,0,0,2685,-1993
ZCTA5 16622,45,435,-390,104,59.7,104,0,0,0,1053,-949
ZCTA5 16623,205,1645,-1440,568,49.4,567,0,0,0,3856,-3288
ZCTA5 16624,86,193,-107,190,53.5,188,0,0,0,459,-269
ZCTA5 16625,1480,233,1247,3772,46.7,3717,0,5,0.001325557,590,3182
ZCTA5 16627,855,559,296,2254,44.3,1998,0,12,0.005323869,1484,770
ZCTA5 16630,2005,1128,877,4938,44.2,4627,16,77,0.015593358,2818,2120
ZCTA5 16631,18,1747,-1729,58,32.5,58,0,0,0,4504,-4446
ZCTA5 16633,106,161,-55,400,32.4,400,0,0,0,408,-8
ZCTA5 16634,124,17476,-17352,275,50.8,258,11,0,0,41731,-41456
ZCTA5 16635,5197,0,5197,12317,45.1,12022,168,1,8.12E-05,13495,-1178
ZCTA5 16636,331,10343,-10012,1012,36.7,997,0,2,0.001976285,24057,-23045
ZCTA5 16637,1093,421,672,2415,55.4,2237,0,0,0,1192,1223
ZCTA5 16638,22,98,-76,76,34.8,76,0,0,0,280,-204
ZCTA5 16639,563,780,-217,1429,48,1400,0,0,0,1931,-502
ZCTA5 16640,355,10423,-10068,885,47.3,874,2,2,0.002259887,26859,-25974
ZCTA5 16641,1017,95,922,2557,40.7,2479,1,4,0.001564333,132,2425
ZCTA5 16645,83,183,-100,190,52,190,0,0,0,583,-393
ZCTA5 16646,908,1410,-502,2175,47.4,2163,0,0,0,4069,-1894
ZCTA5 16647,301,1755,-1454,820,41.9,791,0,10,0.012195122,4652,-3832
ZCTA5 16648,6123,287,5836,14593,51.3,14169,240,76,0.005207976,701,13892
ZCTA5 16650,638,6045,-5407,1618,47.7,1583,29,1,0.000618047,13988,-12370
ZCTA5 16651,1397,130,1267,6034,42.8,4348,26,1156,0.191581041,343,5691
ZCTA5 16652,5449,2290,3159,15822,42.8,14045,81,865,0.054670712,5448,10374
ZCTA5 16654,9,76,-67,2353,40.1,978,20,1142,0.485337867,156,2197
ZCTA5 16655,535,135,400,1301,48.8,1298,0,0,0,274,1027
ZCTA5 16656,468,459,9,1202,48.7,1165,0,0,0,1160,42
ZCTA5 16657,548,51,497,1403,46.7,1288,60,37,0.02637206,93,1310
ZCTA5 16659,79,658,-579,191,36.8,190,0,0,0,1637,-1446
ZCTA5 16661,377,160,217,929,46.3,902,21,4,0.004305705,473,456
ZCTA5 16662,2148,208,1940,5690,44.2,5564,3,28,0.004920914,550,5140
ZCTA5 16664,690,2294,-1604,2170,33.7,2030,15,65,0.029953917,6038,-3868
ZCTA5 16665,160,243,-83,400,31.3,400,0,0,0,408,-8
ZCTA5 16666,1301,1127,174,2945,53,2850,4,4,0.001358234,3041,-96
ZCTA5 16667,557,310,247,1521,44,1464,0,49,0.032215648,1287,234
ZCTA5 16668,1415,169,1246,3502,44.2,3401,0,21,0.005996573,409,3093
ZCTA5 16669,831,191,640,2071,44.9,1965,6,0,0,471,1600
ZCTA5 16670,33,132,-99,64,31.5,64,0,0,0,282,-218
ZCTA5 16671,170,361,-191,424,45.4,417,0,0,0,976,-552
ZCTA5 16672,88,112,-24,262,46.5,239,0,0,0,459,-197
ZCTA5 16673,2064,81,1983,5233,43.7,5080,1,25,0.004777374,154,5079
ZCTA5 16674,179,337,-158,469,39.7,445,0,0,0,979,-510
ZCTA5 16675,38,103,-65,84,58,84,0,0,0,331,-247
ZCTA5 16677,140,1614,-1474,323,37,323,0,0,0,4044,-3721
ZCTA5 16678,1010,209,801,2399,46.5,2336,0,21,0.008753647,616,1783
ZCTA5 16679,258,139,119,645,54.9,632,0,0,0,374,271
ZCTA5 16680,130,118,12,323,43.3,291,0,22,0.068111455,236,87
ZCTA5 16682,56,301,-245,112,26.6,112,0,0,0,778,-666
ZCTA5 16683,130,897,-767,308,47.7,301,0,4,0.012987013,2005,-1697
ZCTA5 16684,26,4199,-4173,26,-,26,0,0,0,9904,-9878
ZCTA5 16685,108,177,-69,327,38.1,323,0,0,0,424,-97
ZCTA5 16686,5474,2340,3134,13746,40.5,13229,41,96,0.00698385,6534,7212
ZCTA5 16689,161,16,145,391,42.3,388,0,0,0,27,364
ZCTA5 16691,140,459,-319,290,52.6,286,0,0,0,1430,-1140
ZCTA5 16692,346,504,-158,897,37.2,879,2,1,0.001114827,1361,-464
ZCTA5 16693,1501,1497,4,4226,39.1,3995,7,41,0.009701846,3535,691
ZCTA5 16694,121,141,-20,374,27.8,374,0,0,0,351,23
ZCTA5 16695,341,697,-356,1034,31.5,981,0,0,0,1651,-617
ZCTA5 16699,0,648,-648,0,-,0,0,0,#DIV/0!,1541,-1541
ZCTA5 16701,6682,191,6491,16928,42,16045,112,113,0.006675331,545,16383
ZCTA5 16720,477,775,-298,1235,49.7,1213,0,0,0,2066,-831
ZCTA5 16724,41,105,-64,98,46.1,95,0,0,0,329,-231
ZCTA5 16725,15,4507,-4492,64,34.2,64,0,0,0,10335,-10271
ZCTA5 16726,223,157,66,537,48.8,530,0,0,0,426,111
ZCTA5 16727,55,761,-706,209,25.4,209,0,0,0,1841,-1632
ZCTA5 16729,289,868,-579,733,42.3,733,0,0,0,2368,-1635
ZCTA5 16730,52,2336,-2284,102,61.3,102,0,0,0,5809,-5707
ZCTA5 16731,1056,564,492,2400,49.8,2368,4,7,0.002916667,1453,947
ZCTA5 16732,63,947,-884,129,60.6,129,0,0,0,2259,-2130
ZCTA5 16733,47,263,-216,181,65.3,87,0,0,0,579,-398
ZCTA5 16734,103,869,-766,208,50.1,203,0,0,0,2070,-1862
ZCTA5 16735,2531,631,1900,6158,44.7,5965,29,52,0.0084443,1588,4570
ZCTA5 16738,498,1239,-741,2321,39.9,1437,0,736,0.317104696,3088,-767
ZCTA5 16740,372,275,97,962,39.6,910,0,0,0,830,132
ZCTA5 16743,1482,273,1209,3848,42,3708,15,4,0.001039501,712,3136
ZCTA5 16744,83,656,-573,224,44.2,224,0,0,0,1579,-1355
ZCTA5 16745,280,924,-644,663,50.5,658,5,0,0,2274,-1611
ZCTA5 16746,435,489,-54,1036,47.7,985,2,1,0.000965251,1353,-317
ZCTA5 16748,1022,243,779,2789,46.3,2780,0,2,0.000717103,711,2078
ZCTA5 16749,1534,2515,-981,3902,45.1,3803,3,28,0.007175807,7128,-3226
ZCTA5 16750,274,472,-198,605,46.2,492,0,18,0.029752066,1205,-600
ZCTA5 16801,16854,945,15909,43551,26.1,36336,3868,1172,0.026910978,2255,41296
ZCTA5 16802,84,87,-3,11663,19.4,9329,1359,549,0.047071937,245,11418
ZCTA5 16803,10215,317,9898,24057,29.2,17043,4073,1356,0.05636613,694,23363
ZCTA5 16820,434,149,285,1567,21.4,1563,0,0,0,434,1133
ZCTA5 16821,92,167,-75,228,56.1,228,0,0,0,431,-203
ZCTA5 16822,743,42,701,1865,46.3,1801,0,9,0.004825737,110,1755
ZCTA5 16823,11127,289,10838,29495,44.5,25919,237,2323,0.078759112,630,28865
ZCTA5 16825,124,214,-90,225,26.3,157,0,0,0,440,-215
ZCTA5 16826,187,919,-732,383,58,383,0,0,0,2239,-1856
ZCTA5 16827,1797,1940,-143,4752,42.6,4565,47,46,0.009680135,5182,-430
ZCTA5 16828,1972,645,1327,4633,48.6,4346,51,0,0,1547,3086
ZCTA5 16829,258,1479,-1221,722,40.9,718,2,0,0,3456,-2734
ZCTA5 16830,5567,209,5358,13571,41.3,13346,62,22,0.001621104,679,12892
ZCTA5 16832,116,4166,-4050,289,54.5,287,0,0,0,11854,-11565
ZCTA5 16833,2181,1690,491,5261,44,5014,12,19,0.003611481,5304,-43
ZCTA5 16834,237,149,88,609,45.1,609,0,0,0,346,263
ZCTA5 16835,90,383,-293,258,48.5,258,0,0,0,1169,-911
ZCTA5 16836,470,2092,-1622,1085,51.3,1079,0,2,0.001843318,5522,-4437
ZCTA5 16837,45,959,-914,101,27.5,101,0,0,0,2185,-2084
ZCTA5 16838,749,0,749,1877,48.4,1853,2,0,0,0,1877
ZCTA5 16839,153,13875,-13722,505,31.6,505,0,0,0,34659,-34154
ZCTA5 16840,129,13550,-13421,387,34.1,387,0,0,0,34476,-34089
ZCTA5 16841,2450,8410,-5960,6723,40.6,6581,2,11,0.001636174,20801,-14078
ZCTA5 16843,243,233,10,557,52.4,557,0,0,0,603,-46
ZCTA5 16844,939,750,189,2518,47.9,2479,0,0,0,1837,681
ZCTA5 16845,303,1885,-1582,979,45.1,909,0,31,0.031664964,4455,-3476
ZCTA5 16847,95,6796,-6701,390,38.8,209,0,169,0.433333333,17940,-17550
ZCTA5 16848,98,3712,-3614,211,43.8,205,6,0,0,9041,-8830
ZCTA5 16849,68,348,-280,108,58,108,0,0,0,833,-725
ZCTA5 16851,567,10708,-10141,1234,43.9,1127,0,26,0.021069692,29139,-27905
ZCTA5 16852,115,1337,-1222,287,38,284,0,0,0,3458,-3171
ZCTA5 16853,143,777,-634,328,42.1,328,0,0,0,2141,-1813
ZCTA5 16854,307,6805,-6498,650,43.9,627,0,0,0,16642,-15992
ZCTA5 16855,38,1302,-1264,73,42.1,73,0,0,0,3550,-3477
ZCTA5 16856,34,141,-107,69,64.9,69,0,0,0,2164,-2095
ZCTA5 16858,1561,1401,160,3790,49.3,3704,0,0,0,3650,140
ZCTA5 16859,200,241,-41,467,50.5,440,0,0,0,626,-159
ZCTA5 16860,231,363,-132,308,52.4,308,0,0,0,820,-512
ZCTA5 16861,146,3113,-2967,270,57.3,259,11,0,0,8216,-7946
ZCTA5 16863,234,6809,-6575,540,50.6,531,0,0,0,17023,-16483
ZCTA5 16864,54,1259,-1205,107,50.6,107,0,0,0,2605,-2498
ZCTA5 16865,579,292,287,1308,50.7,1221,0,26,0.019877676,754,554
ZCTA5 16866,3588,8560,-4972,9868,45.7,8733,129,632,0.064045399,22528,-12660
ZCTA5 16868,520,347,173,1072,54,1072,0,0,0,958,114
ZCTA5 16870,2701,3030,-329,7735,41.4,7396,150,25,0.003232062,8150,-415
ZCTA5 16871,30,9,21,62,31.6,62,0,0,0,34,28
ZCTA5 16872,396,937,-541,1404,32,1397,7,0,0,2223,-819
ZCTA5 16874,501,104,397,1304,45,1267,7,0,0,288,1016
ZCTA5 16875,1480,14940,-13460,3878,43.3,3688,103,24,0.006188757,37257,-33379
ZCTA5 16876,102,3049,-2947,246,45.5,245,0,0,0,5853,-5607
ZCTA5 16877,735,9191,-8456,1966,46.4,1964,0,1,0.000508647,21001,-19035
ZCTA5 16878,732,1283,-551,1817,48.1,1789,4,7,0.003852504,3160,-1343
ZCTA5 16879,156,11659,-11503,374,52,370,0,0,0,30057,-29683
ZCTA5 16881,1009,845,164,2402,49,2253,0,0,0,2600,-198
ZCTA5 16882,182,1423,-1241,520,42.2,514,0,0,0,3867,-3347
ZCTA5 16901,4413,1132,3281,10686,47.8,10385,34,91,0.008515815,3204,7482
ZCTA5 16910,34,13579,-13545,77,41.9,77,0,0,0,33277,-33200
ZCTA5 16911,87,1752,-1665,260,65.3,260,0,0,0,4366,-4106
ZCTA5 16912,856,686,170,2552,36.2,2463,52,15,0.005877743,1812,740
ZCTA5 16914,911,2155,-1244,2392,45.4,2282,9,22,0.009197324,4890,-2498
ZCTA5 16915,2303,14674,-12371,5918,48.1,5601,70,42,0.007096992,34210,-28292
ZCTA5 16917,474,23,451,1076,50.9,1057,0,0,0,40,1036
ZCTA5 16920,727,8265,-7538,1859,45.8,1764,2,33,0.017751479,22116,-20257
ZCTA5 16921,258,681,-423,570,55.2,566,0,0,0,1868,-1298
ZCTA5 16922,759,3024,-2265,1738,51.1,1708,0,0,0,7971,-6233
ZCTA5 16923,525,541,-16,1333,53.2,1321,0,0,0,1441,-108
ZCTA5 16925,1223,2780,-1557,3319,45.3,3250,48,0,0,7058,-3739
ZCTA5 16926,386,1590,-1204,1051,36.1,1036,0,3,0.002854424,4145,-3094
ZCTA5 16927,198,1214,-1016,518,45.4,493,0,23,0.044401544,3326,-2808
ZCTA5 16928,546,177,369,1476,47.2,1403,10,3,0.00203252,349,1127
ZCTA5 16929,933,1667,-734,2421,45.5,2249,48,25,0.010326311,3886,-1465
ZCTA5 16930,451,2413,-1962,1166,43.7,1131,1,6,0.005145798,5664,-4498
ZCTA5 16932,306,5428,-5122,750,35.6,744,0,6,0.008,14630,-13880
ZCTA5 16933,2609,1681,928,6339,39.4,6046,19,122,0.019245938,4723,1616
ZCTA5 16935,471,56,415,1144,44.6,1100,10,0,0,131,1013
ZCTA5 16936,893,6580,-5687,2179,49.8,2066,31,9,0.004130335,15058,-12879
ZCTA5 16937,47,49,-2,121,53.9,121,0,0,0,77,44
ZCTA5 16938,340,140,200,755,54,745,0,5,0.006622517,376,379
ZCTA5 16939,120,1818,-1698,480,23.4,480,0,0,0,5186,-4706
ZCTA5 16940,24,3001,-2977,56,46.7,56,0,0,0,7427,-7371
ZCTA5 16941,32,45,-13,110,32.7,110,0,0,0,101,9
ZCTA5 16942,300,12,288,830,37,811,0,2,0.002409639,41,789
ZCTA5 16943,181,6,175,407,54.9,400,0,0,0,21,386
ZCTA5 16946,1054,8452,-7398,2505,46.4,2447,0,33,0.013173653,19796,-17291
ZCTA5 16947,1654,101,1553,4515,45.7,4270,18,41,0.009080842,252,4263
ZCTA5 16948,587,57,530,1763,35.9,1692,0,6,0.00340329,76,1687
ZCTA5 16950,1293,1325,-32,3309,46.2,3249,10,1,0.000302206,3367,-58
ZCTA5 17002,174,29,145,549,27.2,544,0,3,0.005464481,73,476
ZCTA5 17003,4231,1770,2461,12123,38.4,11016,342,205,0.016910006,4291,7832
ZCTA5 17004,1616,817,799,5168,35.2,5086,0,37,0.007159443,2385,2783
ZCTA5 17005,129,1137,-1008,290,50.4,270,0,0,0,3131,-2841
ZCTA5 17006,312,235,77,1010,31.8,986,2,0,0,505,505
ZCTA5 17007,2107,2096,11,5963,43.5,5676,71,0,0,5140,823
ZCTA5 17009,791,221,570,1757,42.6,1666,0,28,0.015936255,702,1055
ZCTA5 17010,99,1049,-950,463,12.4,463,0,0,0,2751,-2288
ZCTA5 17011,13698,365,13333,38061,40,30038,1816,2938,0.077191876,906,37155
ZCTA5 17013,14156,944,13212,35643,38.9,29754,783,2953,0.082849367,2382,33261
ZCTA5 17014,64,448,-384,180,38.2,180,0,0,0,1044,-864
ZCTA5 17015,9405,1458,7947,24595,44.7,23442,289,143,0.00581419,2099,22496
ZCTA5 17016,371,4376,-4005,1027,39.4,947,0,80,0.077896787,7852,-6825
ZCTA5 17017,643,4474,-3831,1490,51,1479,0,2,0.001342282,11391,-9901
ZCTA5 17018,1810,8007,-6197,4107,46.3,4002,3,49,0.01193085,21179,-17072
ZCTA5 17019,7323,10143,-2820,19058,43.8,17644,247,370,0.019414419,23077,-4019
ZCTA5 17020,3484,10235,-6751,8551,46.3,8297,43,33,0.003859198,24153,-15602
ZCTA5 17021,452,11863,-11411,983,57.4,983,0,0,0,30464,-29481
ZCTA5 17022,12089,13401,-1312,31175,40.5,28696,268,778,0.024955894,33427,-2252
ZCTA5 17023,1266,3896,-2630,3362,42.3,3164,0,3,0.000892326,11096,-7734
ZCTA5 17024,722,0,722,2002,44.7,1967,0,0,0,0,2002
ZCTA5 17025,7199,10139,-2940,16883,42,14590,975,630,0.037315643,25417,-8534
ZCTA5 17026,1298,11572,-10274,3597,41.2,3495,8,25,0.006950236,30037,-26440
ZCTA5 17027,216,95,121,2600,20.1,2146,95,141,0.054230769,206,2394
ZCTA5 17028,1386,153,1233,3416,43.7,3246,3,14,0.004098361,336,3080
ZCTA5 17029,94,307,-213,258,51.5,258,0,0,0,937,-679
ZCTA5 17030,293,226,67,646,44,516,0,8,0.012383901,621,25
ZCTA5 17032,3094,513,2581,7596,47.2,7166,121,56,0.007372301,1112,6484
ZCTA5 17033,6314,71,6243,17273,44.2,13627,842,585,0.033867886,205,17068
ZCTA5 17034,1239,34,1205,2691,39.4,2108,27,397,0.1475288,77,2614
ZCTA5 17035,341,149,192,792,57.6,754,0,15,0.018939394,357,435
ZCTA5 17036,9024,177,8847,21815,42.1,19652,1138,164,0.007517763,597,21218
ZCTA5 17037,296,209,87,942,29.2,936,0,0,0,536,406
ZCTA5 17038,3343,4313,-970,8409,38.5,7708,80,46,0.005470329,10260,-1851
ZCTA5 17039,43,107,-64,71,60.8,71,0,0,0,287,-216
ZCTA5 17040,884,884,0,2362,40.1,2274,41,9,0.00381033,2149,213
ZCTA5 17041,68,7421,-7353,205,43.4,205,0,0,0,19662,-19457
ZCTA5 17042,15485,431,15054,39095,43.7,31618,616,1454,0.037191457,1141,37954
ZCTA5 17043,2904,538,2366,5820,39.8,4971,105,298,0.051202749,1323,4497
ZCTA5 17044,8849,2122,6727,20446,43.4,19035,169,121,0.005918028,4909,15537
ZCTA5 17045,1337,308,1029,3623,42.6,3408,26,115,0.031741651,821,2802
ZCTA5 17046,11973,3196,8777,31406,38.3,22099,418,696,0.02216137,8271,23135
ZCTA5 17047,915,658,257,2976,32.8,2887,0,61,0.020497312,2100,876
ZCTA5 17048,1458,641,817,3766,41.1,3396,42,13,0.003451938,1653,2113
ZCTA5 17049,1042,58,984,3055,38.7,2976,6,71,0.023240589,162,2893
ZCTA5 17050,16241,1124,15117,41723,41,32952,5938,948,0.022721281,3314,38409
ZCTA5 17051,1931,4786,-2855,4886,49.2,4805,9,2,0.000409333,12026,-7140
ZCTA5 17052,551,604,-53,1500,45.8,1455,0,2,0.001333333,1548,-48
ZCTA5 17053,2193,906,1287,5100,44.7,4877,21,56,0.010980392,2374,2726
ZCTA5 17054,77,36,41,178,57.3,178,0,0,0,91,87
ZCTA5 17055,17310,111,17199,38912,42.7,34192,1396,1395,0.035850123,308,38604
ZCTA5 17056,13,126,-113,35,29.5,17,0,0,0,297,-262
ZCTA5 17057,9726,67,9659,23399,39.3,18796,631,1569,0.067054148,214,23185
ZCTA5 17058,578,60,518,1641,40.2,1532,10,38,0.023156612,111,1530
ZCTA5 17059,3016,1348,1668,7861,44.7,7615,9,9,0.001144893,3707,4154
ZCTA5 17060,360,121,239,1040,36.3,1034,0,0,0,298,742
ZCTA5 17061,2852,0,2852,6961,39.6,6669,80,60,0.008619451,2,6959
ZCTA5 17062,1481,418,1063,4147,41.6,4057,7,5,0.001205691,1104,3043
ZCTA5 17063,1327,49,1278,3262,42.7,3184,0,0,0,49,3213
ZCTA5 17064,326,10304,-9978,979,45.6,979,0,0,0,28304,-27325
ZCTA5 17065,1552,473,1079,3596,46.9,3251,2,92,0.025583982,1105,2491
ZCTA5 17066,1998,0,1998,4995,38.3,4637,0,188,0.037637638,227,4768
ZCTA5 17067,6007,458,5549,15911,43.3,15418,76,159,0.009993087,1530,14381
ZCTA5 17068,1581,280,1301,4335,45.4,3931,0,140,0.032295271,698,3637
ZCTA5 17069,129,981,-852,318,48.9,312,0,0,0,2369,-2051
ZCTA5 17070,7393,207,7186,16907,43.9,15241,442,401,0.023717987,661,16246
ZCTA5 17071,50,238,-188,124,38.7,112,0,0,0,616,-492
ZCTA5 17073,2003,1083,920,5578,38.7,5325,36,87,0.015596988,2692,2886
ZCTA5 17074,2913,10902,-7989,7289,42.6,6925,27,77,0.010563863,27389,-20100
ZCTA5 17075,62,90,-28,152,35.7,147,0,0,0,221,-69
ZCTA5 17076,37,127,-90,134,54.2,134,0,0,0,319,-185
ZCTA5 17077,31,133,-102,42,62.5,39,0,0,0,252,-210
ZCTA5 17078,9087,1341,7746,22989,40.9,20163,641,369,0.016051155,3654,19335
ZCTA5 17080,109,1105,-996,307,40.6,268,0,32,0.104234528,2894,-2587
ZCTA5 17081,172,1083,-911,278,73,278,0,0,0,3190,-2912
ZCTA5 17082,1051,123,928,2978,40.1,2761,0,48,0.0161182,277,2701
ZCTA5 17084,1775,2255,-480,4761,39.2,4596,0,67,0.014072674,6021,-1260
ZCTA5 17086,782,685,97,2109,46.5,2101,0,0,0,1682,427
ZCTA5 17087,864,131,733,2551,38.6,2467,3,6,0.002352019,286,2265
ZCTA5 17088,263,4450,-4187,668,42.2,654,0,14,0.020958084,10600,-9932
ZCTA5 17090,2326,2272,54,5464,45.7,5189,0,0,0,5870,-406
ZCTA5 17093,399,10460,-10061,1083,23.2,1068,15,0,0,26570,-25487
ZCTA5 17094,920,3135,-2215,2469,37.2,2226,94,17,0.006885379,8427,-5958
ZCTA5 17097,329,271,58,791,43.1,762,20,0,0,748,43
ZCTA5 17098,987,116,871,2376,40.2,2188,5,65,0.027356902,334,2042
ZCTA5 17099,568,3872,-3304,1185,58.2,1185,0,0,0,10440,-9255
ZCTA5 17101,1681,2914,-1233,2233,32.1,1393,104,624,0.279444693,7895,-5662
ZCTA5 17102,4381,857,3524,7716,37.8,4391,179,2356,0.305339554,2401,5315
ZCTA5 17103,4787,2238,2549,13368,28.6,3571,141,7821,0.58505386,6692,6676
ZCTA5 17104,7446,1629,5817,20112,29.5,6204,584,11096,0.551710422,4161,15951
ZCTA5 17109,10797,10573,224,25538,37.8,13054,2556,6844,0.267992795,28710,-3172
ZCTA5 17110,10897,3139,7758,25905,41.1,13699,1463,8188,0.316077977,8082,17823
ZCTA5 17111,14471,872,13599,37332,38.7,22131,4797,8084,0.216543448,2387,34945
ZCTA5 17112,15384,19817,-4433,37299,45,31408,1680,3208,0.086007668,49876,-12577
ZCTA5 17113,4086,2602,1484,10956,37.8,5952,95,3444,0.314348302,6981,3975
ZCTA5 17120,0,4148,-4148,0,-,0,0,0,#DIV/0!,10958,-10958
ZCTA5 17201,12214,36,12178,27638,40.4,21225,337,2596,0.093928649,122,27516
ZCTA5 17202,11864,1444,10420,31703,43.2,28870,296,784,0.024729521,3512,28191
ZCTA5 17210,83,2974,-2891,192,45.3,192,0,0,0,7606,-7414
ZCTA5 17211,187,2279,-2092,455,49.7,435,4,4,0.008791209,6241,-5786
ZCTA5 17212,211,2844,-2633,531,47.3,518,0,0,0,7452,-6921
ZCTA5 17213,245,4881,-4636,638,52,614,0,0,0,12907,-12269
ZCTA5 17214,505,463,42,856,58.9,801,0,15,0.017523364,1272,-416
ZCTA5 17215,66,1152,-1086,189,55.1,189,0,0,0,2805,-2616
ZCTA5 17217,42,96,-54,121,45.5,121,0,0,0,249,-128
ZCTA5 17219,246,8658,-8412,486,51.8,486,0,0,0,21800,-21314
ZCTA5 17220,162,2189,-2027,424,44.2,424,0,0,0,5942,-5518
ZCTA5 17221,201,2174,-1973,488,48.8,488,0,0,0,5380,-4892
ZCTA5 17222,4493,5067,-574,10659,48.7,10073,53,204,0.019138756,13701,-3042
ZCTA5 17223,130,3696,-3566,287,45,280,0,5,0.017421603,9762,-9475
ZCTA5 17224,857,1338,-481,1701,43,1580,0,3,0.001763668,3694,-1993
ZCTA5 17225,7927,972,6955,21426,39.5,19823,231,428,0.01997573,2158,19268
ZCTA5 17228,411,2118,-1707,1081,35,1062,0,2,0.001850139,5556,-4475
ZCTA5 17229,548,3030,-2482,1243,43.5,1211,0,0,0,7425,-6182
ZCTA5 17232,25,2066,-2041,43,61.6,43,0,0,0,5330,-5287
ZCTA5 17233,2294,96,2198,5357,46.9,5010,9,168,0.031360836,241,5116
ZCTA5 17235,252,1588,-1336,834,37.2,561,47,174,0.208633094,4229,-3395
ZCTA5 17236,3022,6056,-3034,7894,45.2,7532,54,182,0.023055485,17100,-9206
ZCTA5 17237,633,13857,-13224,1838,32.8,1626,25,43,0.023394995,35767,-33929
ZCTA5 17238,740,14890,-14150,1928,46.1,1861,0,3,0.001556017,39648,-37720
ZCTA5 17239,65,13979,-13914,176,40.3,176,0,0,0,35861,-35685
ZCTA5 17240,1335,8870,-7535,3752,36.5,3707,8,19,0.005063966,21738,-17986
ZCTA5 17241,4342,775,3567,11192,43.4,10790,49,93,0.008309507,2124,9068
ZCTA5 17243,514,9097,-8583,1314,54.1,1292,0,15,0.011415525,22534,-21220
ZCTA5 17244,794,1887,-1093,2098,43.7,2009,18,0,0,4491,-2393
ZCTA5 17246,193,1113,-920,582,43.1,580,0,1,0.001718213,2618,-2036
ZCTA5 17247,202,392,-190,419,81.8,392,0,11,0.026252983,1669,-1250
ZCTA5 17249,118,12,106,333,53.1,333,0,0,0,24,309
ZCTA5 17250,71,63,8,110,61.4,110,0,0,0,127,-17
ZCTA5 17251,23,1333,-1310,84,34.4,84,0,0,0,4424,-4340
ZCTA5 17252,1400,6785,-5385,4024,35.2,3971,46,0,0,17534,-13510
ZCTA5 17253,126,1668,-1542,349,43.4,341,0,4,0.011461318,4596,-4247
ZCTA5 17254,203,5523,-5320,444,77.6,442,0,2,0.004504505,15501,-15057
ZCTA5 17255,450,412,38,1163,44.4,1141,3,0,0,1477,-314
ZCTA5 17257,11189,1990,9199,28509,34.8,25959,580,1171,0.041074748,6841,21668
ZCTA5 17260,403,1698,-1295,984,53.9,980,0,3,0.00304878,4670,-3686
ZCTA5 17261,0,12200,-12200,120,17.3,14,7,63,0.525,31940,-31820
ZCTA5 17262,336,1897,-1561,902,43.3,857,0,0,0,6310,-5408
ZCTA5 17263,235,1257,-1022,794,29.3,661,0,133,0.167506297,4206,-3412
ZCTA5 17264,928,1201,-273,2322,42.6,2312,0,0,0,3414,-1092
ZCTA5 17265,162,533,-371,427,48.6,418,9,0,0,2009,-1582
ZCTA5 17266,167,834,-667,510,37.3,500,0,0,0,2799,-2289
ZCTA5 17267,1080,2399,-1319,2805,45.6,2658,53,14,0.004991087,6936,-4131
ZCTA5 17268,11613,3309,8304,28790,41,26645,37,1054,0.036609934,9658,19132
ZCTA5 17271,192,15626,-15434,480,31,461,19,0,0,41887,-41407
ZCTA5 17301,1455,8305,-6850,4200,40.6,4040,40,0,0,21582,-17382
ZCTA5 17302,1071,2758,-1687,2575,49.4,2482,0,28,0.010873786,7016,-4441
ZCTA5 17303,138,222,-84,395,38.8,315,0,17,0.043037975,780,-385
ZCTA5 17304,1024,3485,-2461,2712,43.7,2465,0,27,0.009955752,10764,-8052
ZCTA5 17306,187,7333,-7146,566,41.5,438,0,21,0.037102473,18710,-18144
ZCTA5 17307,2277,3088,-811,5712,45.5,5128,167,90,0.015756303,7133,-1421
ZCTA5 17309,724,2330,-1606,1947,37,1881,24,13,0.006676939,7659,-5712
ZCTA5 17311,81,5273,-5192,168,60.4,168,0,0,0,14022,-13854
ZCTA5 17313,4345,1884,2461,11095,37.6,9517,52,412,0.037133844,4869,6226
ZCTA5 17314,2059,1437,622,6066,41.7,5741,0,129,0.021266073,4721,1345
ZCTA5 17315,11016,1258,9758,26667,47,24781,179,858,0.032174598,3869,22798
ZCTA5 17316,3118,822,2296,8511,44.4,8302,13,6,0.00070497,2248,6263
ZCTA5 17317,174,4262,-4088,455,35.5,439,0,0,0,12305,-11850
ZCTA5 17318,148,1926,-1778,473,39.1,473,0,0,0,5513,-5040
ZCTA5 17319,4172,90,4082,11276,38.9,10633,15,143,0.012681802,231,11045
ZCTA5 17320,3122,1122,2000,8195,45.3,7600,0,111,0.013544844,3424,4771
ZCTA5 17321,875,66,809,2268,48.5,2120,9,13,0.005731922,173,2095
ZCTA5 17322,2364,2664,-300,5938,43.8,5733,24,40,0.006736275,7754,-1816
ZCTA5 17323,45,2055,-2010,100,39,96,0,0,0,5886,-5786
ZCTA5 17324,1610,351,1259,3846,49.8,3624,0,167,0.043421737,916,2930
ZCTA5 17325,10826,754,10072,28701,45.1,25802,469,609,0.021218773,2127,26574
ZCTA5 17327,3145,3797,-652,8125,42.3,7667,69,27,0.003323077,8972,-847
ZCTA5 17329,999,19875,-18876,2973,46.6,2797,22,0,0,48895,-45922
ZCTA5 17331,21623,19810,1813,54091,41.7,48420,658,1507,0.027860457,53388,703
ZCTA5 17339,2627,25102,-22475,6232,46.7,5864,34,4,0.000641849,62628,-56396
ZCTA5 17340,4304,232,4072,11409,40.5,10702,22,197,0.01726707,566,10843
ZCTA5 17342,178,18211,-18033,602,35.1,504,8,0,0,44600,-43998
ZCTA5 17343,95,4312,-4217,124,55.7,124,0,0,0,10508,-10384
ZCTA5 17344,1485,768,717,3616,36.4,3351,61,0,0,1951,1665
ZCTA5 17345,3470,23,3447,7915,46.1,7266,83,203,0.025647505,46,7869
ZCTA5 17347,2557,2154,403,6538,43,6027,41,188,0.028754971,5445,1093
ZCTA5 17349,2935,31,2904,7912,47.5,7449,32,61,0.007709808,52,7860
ZCTA5 17350,5256,1933,3323,13291,43.6,12389,12,188,0.01414491,5283,8008
ZCTA5 17352,549,43,506,1595,47.8,1574,5,0,0,91,1504
ZCTA5 17353,1121,119,1002,2871,47.5,2770,3,4,0.001393243,306,2565
ZCTA5 17355,156,60,96,335,45.2,329,2,0,0,116,219
ZCTA5 17356,9080,2495,6585,22871,40.8,21551,212,450,0.019675572,6160,16711
ZCTA5 17360,2259,23,2236,5996,37.5,5402,62,297,0.049533022,44,5952
ZCTA5 17361,2463,4987,-2524,6267,51.8,5734,0,95,0.015158768,12952,-6685
ZCTA5 17362,5407,28,5379,14229,45.7,13286,102,341,0.023965142,59,14170
ZCTA5 17363,3319,1266,2053,8455,48.1,7871,43,294,0.034772324,3234,5221
ZCTA5 17364,1482,7111,-5629,3830,41.8,3659,25,36,0.009399478,18768,-14938
ZCTA5 17365,1094,996,98,2648,49.5,2489,0,34,0.012839879,3188,-540
ZCTA5 17366,2344,130,2214,6099,37.7,5647,0,292,0.047876701,254,5845
ZCTA5 17368,2471,108,2363,6280,44.7,5898,16,73,0.011624204,275,6005
ZCTA5 17370,2365,55,2310,6114,42.7,5615,4,245,0.040071966,117,5997
ZCTA5 17371,138,2971,-2833,323,33.7,321,0,0,0,7479,-7156
ZCTA5 17372,1502,1848,-346,3874,44.8,3385,20,49,0.012648425,4942,-1068
ZCTA5 17401,7286,5223,2063,18270,30.7,9825,74,4617,0.25270936,12059,6211
ZCTA5 17402,13607,4518,9089,37967,38.1,29674,1018,3280,0.086390813,12000,25967
ZCTA5 17403,14963,375,14588,39842,36.9,28355,1462,5739,0.144043974,908,38934
ZCTA5 17404,14699,254,14445,37699,38.4,29485,565,4399,0.116687445,529,37170
ZCTA5 17406,9271,186,9085,23944,39.4,20964,336,1406,0.058720347,493,23451
ZCTA5 17407,877,144,733,2751,38.1,2571,2,37,0.013449655,370,2381
ZCTA5 17408,9665,992,8673,23623,44.6,20040,883,1284,0.054353808,2210,21413
ZCTA5 17501,1895,400,1495,4643,41.5,4459,76,28,0.006030584,980,3663
ZCTA5 17502,1058,37,1021,2557,48.4,2319,0,69,0.026984748,71,2486
ZCTA5 17504,39,96,-57,130,46.4,130,0,0,0,226,-96
ZCTA5 17505,427,1306,-879,1543,31.5,1543,0,0,0,3405,-1862
ZCTA5 17506,125,939,-814,396,34.3,228,0,168,0.424242424,2683,-2287
ZCTA5 17507,58,386,-328,108,60.7,108,0,0,0,1193,-1085
ZCTA5 17508,282,108,174,922,35.5,449,256,0,0,237,685
ZCTA5 17509,1359,2589,-1230,4927,28.2,4706,23,48,0.009742237,6927,-2000
ZCTA5 17512,7572,50,7522,18395,42.8,16278,98,919,0.049959228,72,18323
ZCTA5 17516,1965,76,1889,4891,48.6,4558,88,23,0.004702515,204,4687
ZCTA5 17517,5464,7051,-1587,15908,38.6,15060,248,61,0.003834549,16532,-624
ZCTA5 17518,495,920,-425,1681,28.6,1662,0,0,0,6031,-4350
ZCTA5 17519,2384,527,1857,6358,39,6050,101,9,0.001415539,1456,4902
ZCTA5 17520,2041,716,1325,5076,42.1,4085,61,253,0.049842396,1961,3115
ZCTA5 17522,13425,1735,11690,33800,37.1,31691,143,520,0.015384615,4425,29375
ZCTA5 17527,1968,11216,-9248,6304,34.6,5953,0,181,0.028711929,31122,-24818
ZCTA5 17529,1296,2319,-1023,4663,27.5,4600,0,12,0.002573451,5638,-975
ZCTA5 17532,1227,7480,-6253,3328,37.4,3171,0,16,0.004807692,18501,-15173
ZCTA5 17534,49,0,49,69,71.2,41,0,28,0.405797101,0,69
ZCTA5 17535,737,426,311,3124,24.7,2860,30,123,0.039372599,1103,2021
ZCTA5 17536,1078,1801,-723,3542,38.8,3542,0,0,0,4115,-573
ZCTA5 17538,3116,262,2854,7531,50.4,6954,108,295,0.039171425,598,6933
ZCTA5 17540,3688,79,3609,11483,31.1,9923,520,370,0.032221545,265,11218
ZCTA5 17543,17898,769,17129,45718,42.3,42156,1137,607,0.013277046,1822,43896
ZCTA5 17545,8802,309,8493,22273,44.1,20966,444,20,0.000897948,684,21589
ZCTA5 17547,3265,1477,1788,8436,33.9,7483,7,239,0.028330963,3516,4920
ZCTA5 17550,197,69,128,452,41.7,358,0,0,0,163,289
ZCTA5 17551,3953,66,3887,10750,29.4,8250,626,429,0.039906977,159,10591
ZCTA5 17552,8468,6488,1980,19556,43.7,17908,212,315,0.016107588,19819,-263
ZCTA5 17554,2993,210,2783,7505,39.2,6220,269,575,0.07661559,524,6981
ZCTA5 17555,2027,1742,285,6711,33.3,6516,92,34,0.005066309,4960,1751
ZCTA5 17557,5405,3502,1903,15393,42.3,14583,173,175,0.011368804,8947,6446
ZCTA5 17560,1905,3961,-2056,5193,36.6,4761,21,0,0,9954,-4761
ZCTA5 17562,1293,918,375,4558,27.8,4149,0,24,0.005265467,2449,2109
ZCTA5 17563,1098,1430,-332,4031,27.6,3481,0,57,0.014140412,3477,554
ZCTA5 17565,819,5107,-4288,2389,46,2360,0,0,0,12136,-9747
ZCTA5 17566,4284,250,4034,12379,35,11572,311,163,0.013167461,639,11740
ZCTA5 17568,39,3681,-3642,200,13.6,200,0,0,0,7833,-7633
ZCTA5 17569,2428,1200,1228,7261,38,7104,23,67,0.009227379,3377,3884
ZCTA5 17570,101,382,-281,301,49.3,301,0,0,0,885,-584
ZCTA5 17572,1274,1591,-317,3740,30.6,3701,0,0,0,3719,21
ZCTA5 17576,0,3363,-3363,0,-,0,0,0,#DIV/0!,7492,-7492
ZCTA5 17578,2380,1310,1070,7189,36,6949,89,55,0.007650577,3264,3925
ZCTA5 17579,2152,867,1285,6519,36.3,6439,0,22,0.003374751,2145,4374
ZCTA5 17581,42,47,-5,74,68.5,66,0,0,0,95,-21
ZCTA5 17582,681,140,541,1639,41.4,1623,0,0,0,392,1247
ZCTA5 17584,4287,762,3525,11134,46.7,10116,442,92,0.008262978,2669,8465
ZCTA5 17601,22670,63,22607,56411,43.4,47661,2517,2116,0.037510415,150,56261
ZCTA5 17602,18345,3277,15068,50288,37.3,32876,1744,7473,0.148604041,10372,39916
ZCTA5 17603,26716,79,26637,67601,34.9,45990,2874,5541,0.081966243,172,67429
ZCTA5 17606,148,429,-281,265,83.8,265,0,0,0,1037,-772
ZCTA5 17701,17634,5191,12443,43363,37.2,36057,409,4674,0.107787745,14989,28374
ZCTA5 17702,4258,4420,-162,10500,42.2,9809,208,221,0.021047619,9751,749
ZCTA5 17720,136,798,-662,257,58.6,257,0,0,0,1692,-1435
ZCTA5 17721,716,496,220,1635,44.8,1585,6,4,0.002446483,1400,235
ZCTA5 17723,33,33,0,74,56.5,74,0,0,0,64,10
ZCTA5 17724,1857,749,1108,4705,41.5,4648,11,13,0.002763018,1672,3033
ZCTA5 17727,16,103,-87,22,76.1,11,0,0,0,250,-228
ZCTA5 17728,2001,81,1920,4682,50.4,4570,6,35,0.007475438,214,4468
ZCTA5 17729,52,430,-378,105,64.2,105,0,0,0,912,-807
ZCTA5 17730,51,97,-46,51,-,51,0,0,0,142,-91
ZCTA5 17731,89,127,-38,172,58.9,162,0,0,0,303,-131
ZCTA5 17737,2736,877,1859,6617,44.7,6003,19,18,0.002720266,2076,4541
ZCTA5 17739,19,9858,-9839,27,68.2,27,0,0,0,24090,-24063
ZCTA5 17740,4575,109,4466,11885,44.1,11621,24,51,0.004291123,315,11570
ZCTA5 17742,24,2601,-2577,58,49.5,58,0,0,0,7377,-7319
ZCTA5 17744,1129,1875,-746,2747,49.9,2663,2,19,0.006916636,4610,-1863
ZCTA5 17745,7037,148,6889,17792,36.6,16696,172,356,0.020008993,287,17505
ZCTA5 17747,1010,163,847,3474,27.3,3369,14,14,0.004029937,401,3073
ZCTA5 17748,63,730,-667,121,59.9,106,0,0,0,1829,-1708
ZCTA5 17749,126,209,-83,317,41.5,317,0,0,0,478,-161
ZCTA5 17750,29,2145,-2116,107,7.6,107,0,0,0,8557,-8450
ZCTA5 17751,2727,34,2693,7311,41.8,7058,75,56,0.007659691,68,7243
ZCTA5 17752,1739,247,1492,4656,41.5,4510,42,22,0.004725086,556,4100
ZCTA5 17754,4976,794,4182,12285,44.8,11501,152,82,0.006674807,1804,10481
ZCTA5 17756,4333,353,3980,12587,40.6,11793,79,423,0.033606102,840,11747
ZCTA5 17758,423,944,-521,1031,48.9,914,8,88,0.085354025,2492,-1461
ZCTA5 17760,241,338,-97,607,43,605,2,0,0,834,-227
ZCTA5 17762,242,239,3,479,49.6,452,0,0,0,497,-18
ZCTA5 17763,138,102,36,293,51.3,293,0,0,0,269,24
ZCTA5 17764,1077,63,1014,2337,52.2,2199,5,18,0.007702182,111,2226
ZCTA5 17765,406,138,268,1156,44.1,1134,0,0,0,298,858
ZCTA5 17768,142,2334,-2192,375,53.9,374,0,0,0,4954,-4579
ZCTA5 17769,20,101,-81,36,64.7,36,0,0,0,282,-246
ZCTA5 17771,1234,122,1112,3096,45.4,2976,13,20,0.006459948,301,2795
ZCTA5 17772,963,125,838,2380,47.2,2230,12,12,0.005042017,227,2153
ZCTA5 17774,429,223,206,1136,45.9,1115,4,0,0,489,647
ZCTA5 17776,96,2044,-1948,181,56.8,177,0,0,0,4558,-4377
ZCTA5 17777,2652,144,2508,6862,41.2,6615,50,38,0.005537744,296,6566
ZCTA5 17778,47,653,-606,143,31.8,143,0,0,0,1371,-1228
ZCTA5 17779,18,1574,-1556,30,58.7,30,0,0,0,3658,-3628
ZCTA5 17801,6588,2794,3794,16165,43.7,15178,20,184,0.011382617,6962,9203
ZCTA5 17810,644,3786,-3142,6011,39.7,3762,55,1832,0.30477458,9287,-3276
ZCTA5 17812,612,269,343,1626,43.6,1565,0,2,0.001230012,682,944
ZCTA5 17813,728,934,-206,2028,42.3,1961,2,0,0,2090,-62
ZCTA5 17814,1843,995,848,4921,47.2,4473,17,104,0.021133916,2347,2574
ZCTA5 17815,11058,117,10941,29131,34,27092,463,632,0.021695101,330,28801
ZCTA5 17820,2140,1498,642,5328,47.8,5102,17,8,0.001501502,3402,1926
ZCTA5 17821,7674,4613,3061,18818,42.7,17253,708,341,0.018120948,11249,7569
ZCTA5 17822,5,145,-140,17,-,17,0,0,0,304,-287
ZCTA5 17823,464,2694,-2230,1289,43,1271,8,1,0.000775795,6820,-5531
ZCTA5 17824,1553,106,1447,3746,53.3,3717,0,24,0.006406834,177,3569
ZCTA5 17827,316,41,275,875,50.2,785,0,8,0.009142857,75,800
ZCTA5 17829,92,1327,-1235,264,39,264,0,0,0,3161,-2897
ZCTA5 17830,800,1093,-293,2009,45.1,1989,10,0,0,2729,-720
ZCTA5 17832,303,168,135,646,48.8,646,0,0,0,395,251
ZCTA5 17834,1488,651,837,3482,48.2,3259,50,4,0.001148765,1479,2003
ZCTA5 17835,21,461,-440,106,17.8,99,7,0,0,1075,-969
ZCTA5 17836,66,2036,-1970,204,23,201,0,0,0,5553,-5349
ZCTA5 17837,6299,6759,-460,18819,38.8,16602,599,1049,0.055741538,18258,561
ZCTA5 17840,174,4429,-4255,406,41.8,406,0,0,0,11377,-10971
ZCTA5 17841,1663,11130,-9467,4465,47.3,4394,4,38,0.008510638,32466,-28001
ZCTA5 17842,3259,0,3259,8390,42.4,8184,19,23,0.002741359,0,8390
ZCTA5 17844,3801,14717,-10916,10113,36,9889,26,28,0.002768714,37225,-27112
ZCTA5 17845,642,14003,-13361,1923,40.8,1848,10,14,0.007280291,32833,-30910
ZCTA5 17846,1474,7630,-6156,3845,44.6,3636,95,11,0.002860858,20648,-16803
ZCTA5 17847,4853,286,4567,11606,43.2,11286,22,61,0.005255902,752,10854
ZCTA5 17850,267,2585,-2318,618,35.7,575,0,0,0,6888,-6270
ZCTA5 17851,3343,3741,-398,7387,48.4,7071,39,74,0.010017598,9314,-1927
ZCTA5 17853,1075,2615,-1540,3163,40.5,3096,17,16,0.005058489,8486,-5323
ZCTA5 17855,284,94,190,818,40.1,802,0,0,0,218,600
ZCTA5 17856,1244,4575,-3331,2709,50,2659,0,19,0.007013658,12475,-9766
ZCTA5 17857,3273,2895,378,7707,46.6,7213,0,215,0.027896717,7100,607
ZCTA5 17858,31,1130,-1099,81,34.5,77,0,0,0,3011,-2930
ZCTA5 17859,1084,5825,-4741,2737,49,2630,29,9,0.003288272,15572,-12835
ZCTA5 17860,1031,2132,-1101,2627,41.3,2498,0,0,0,5308,-2681
ZCTA5 17861,83,15367,-15284,222,33.9,222,0,0,0,41744,-41522
ZCTA5 17862,135,9783,-9648,393,39.8,360,0,0,0,25696,-25303
ZCTA5 17864,674,0,674,2203,32.3,2154,3,3,0.001361779,0,2203
ZCTA5 17865,23,6845,-6822,31,39.9,31,0,0,0,16998,-16967
ZCTA5 17866,3386,1425,1961,10065,42,8062,23,1598,0.158768008,3965,6100
ZCTA5 17867,63,11143,-11080,168,37,167,0,0,0,26876,-26708
ZCTA5 17868,429,1039,-610,1007,50.7,873,15,16,0.015888779,2560,-1553
ZCTA5 17870,5295,1669,3626,14770,39.6,13862,96,348,0.023561273,4508,10262
ZCTA5 17872,3964,5056,-1092,9257,39.9,8337,9,102,0.011018689,12294,-3037
ZCTA5 17876,718,362,356,1814,44,1631,63,2,0.001102536,855,959
ZCTA5 17878,551,3454,-2903,1456,48.9,1432,0,3,0.00206044,9240,-7784
ZCTA5 17880,36,400,-364,119,35.8,119,0,0,0,1174,-1055
ZCTA5 17881,600,9186,-8586,1456,41.7,1367,0,0,0,24108,-22652
ZCTA5 17884,64,261,-197,152,31.5,152,0,0,0,584,-432
ZCTA5 17885,105,8594,-8489,256,47.5,256,0,0,0,24305,-24049
ZCTA5 17886,382,2209,-1827,1319,20,665,19,12,0.009097801,5712,-4393
ZCTA5 17887,222,7036,-6814,622,28.3,613,0,0,0,17774,-17152
ZCTA5 17888,195,41,154,490,46.9,483,2,0,0,130,360
ZCTA5 17889,963,2877,-1914,2850,43.4,2735,37,15,0.005263158,8148,-5298
ZCTA5 17901,9608,361,9247,22693,44.1,21662,82,624,0.027497466,920,21773
ZCTA5 17920,132,4443,-4311,255,60.1,255,0,0,0,10741,-10486
ZCTA5 17921,2419,2312,107,6836,44.9,5503,29,952,0.139262727,6308,528
ZCTA5 17922,1878,3291,-1413,5047,42.5,4997,0,6,0.001188825,9136,-4089
ZCTA5 17923,193,2238,-2045,323,58.1,323,0,0,0,6108,-5785
ZCTA5 17925,128,1139,-1011,320,39.9,301,0,6,0.01875,2786,-2466
ZCTA5 17929,526,931,-405,1239,43,1216,7,7,0.005649718,2375,-1136
ZCTA5 17930,137,2738,-2601,281,50.1,281,0,0,0,7280,-6999
ZCTA5 17931,1951,181,1770,8968,39.6,6400,78,2070,0.230820696,477,8491
ZCTA5 17933,107,4481,-4374,190,74.2,190,0,0,0,11487,-11297
ZCTA5 17934,94,111,-17,210,46.5,210,0,0,0,274,-64
ZCTA5 17935,710,214,496,1576,43.1,1467,8,7,0.004441624,527,1049
ZCTA5 17936,377,368,9,1087,33,1081,0,0,0,1027,60
ZCTA5 17938,1075,191,884,2582,40.1,2560,0,2,0.000774593,584,1998
ZCTA5 17941,274,283,-9,750,42.2,744,0,0,0,701,49
ZCTA5 17943,13,3340,-3327,28,31.9,17,0,0,0,8337,-8309
ZCTA5 17944,83,2452,-2369,169,32.9,169,0,0,0,6099,-5930
ZCTA5 17945,156,1262,-1106,253,47.5,253,0,0,0,3302,-3049
ZCTA5 17946,127,1470,-1343,280,45.4,280,0,0,0,3773,-3493
ZCTA5 17948,1686,16070,-14384,4203,39.4,3904,38,9,0.002141328,48483,-44280
ZCTA5 17949,97,18476,-18379,206,47,206,0,0,0,48021,-47815
ZCTA5 17951,141,16587,-16446,339,26.4,339,0,0,0,43396,-43057
ZCTA5 17952,100,0,100,213,49.8,213,0,0,0,61,152
ZCTA5 17953,156,2624,-2468,335,55.3,329,1,0,0,6829,-6494
ZCTA5 17954,2003,6385,-4382,4542,45.5,4056,16,0,0,16274,-11732
ZCTA5 17957,140,0,140,393,41.8,393,0,0,0,0,393
ZCTA5 17959,570,10805,-10235,1421,42.7,1382,1,5,0.003518649,27593,-26172
ZCTA5 17960,1839,4890,-3051,4522,49,4392,21,3,0.000663423,11859,-7337
ZCTA5 17961,2866,2678,188,6781,48.8,6326,80,23,0.00339183,7222,-441
ZCTA5 17963,3683,552,3131,9166,49,8969,27,32,0.003491163,1357,7809
ZCTA5 17964,278,39,239,814,44.7,806,0,0,0,100,714
ZCTA5 17965,829,839,-10,1853,47.4,1810,7,0,0,2324,-471
ZCTA5 17967,906,482,424,2279,46.7,2235,0,2,0.000877578,1042,1237
ZCTA5 17968,76,1100,-1024,247,37.4,241,0,0,0,2415,-2168
ZCTA5 17970,1365,603,762,3182,47.5,3159,0,1,0.000314268,1283,1899
ZCTA5 17972,4760,157,4603,11511,43.2,11125,153,70,0.00608114,381,11130
ZCTA5 17974,110,130,-20,343,33.6,343,0,0,0,304,39
ZCTA5 17976,2438,3492,-1054,6338,38.4,5256,0,162,0.025560114,9279,-2941
ZCTA5 17978,220,77,143,728,35.8,725,0,0,0,142,586
ZCTA5 17979,24,2577,-2553,61,61.7,61,0,0,0,5500,-5439
ZCTA5 17980,1173,5,1168,2936,42.9,2875,0,0,0,5,2931
ZCTA5 17981,987,3612,-2625,2658,43.3,2615,0,1,0.000376223,9579,-6921
ZCTA5 17982,200,39,161,405,61.6,405,0,0,0,85,320
ZCTA5 17983,559,308,251,1404,40.3,1326,0,0,0,658,746
ZCTA5 17985,557,1776,-1219,1386,47.2,1299,0,46,0.033189033,3953,-2567
ZCTA5 18011,1983,207,1776,5702,36.1,4831,147,187,0.03279551,391,5311
ZCTA5 18012,0,7648,-7648,0,-,0,0,0,#DIV/0!,18894,-18894
ZCTA5 18013,6797,1485,5312,18126,41.3,16633,124,342,0.018867925,3515,14611
ZCTA5 18014,4446,151,4295,12036,44.1,10922,17,393,0.032652044,490,11546
ZCTA5 18015,11686,1684,10002,33127,32.3,22032,1456,2974,0.089775712,3929,29198
ZCTA5 18017,16169,359,15810,40142,44.4,29501,1561,2856,0.071147427,945,39197
ZCTA5 18018,13394,98,13296,31417,38.6,23654,436,2343,0.074577458,214,31203
ZCTA5 18020,7906,186,7720,21275,43.5,17363,1163,1051,0.049400705,440,20835
ZCTA5 18030,243,158,85,549,41.4,527,1,17,0.030965392,482,67
ZCTA5 18031,4078,69,4009,11882,37.2,7305,1966,1259,0.105958593,178,11704
ZCTA5 18032,3933,240,3693,9459,40.2,8478,15,141,0.014906438,585,8874
ZCTA5 18034,3066,1413,1653,9270,40.8,8435,285,62,0.006688242,3721,5549
ZCTA5 18035,14,1236,-1222,38,52.3,38,0,0,0,3045,-3007
ZCTA5 18036,5689,62,5627,14385,47.8,12927,231,194,0.01348627,107,14278
ZCTA5 18037,3083,4824,-1741,7268,45.6,6576,4,55,0.007567419,11205,-3937
ZCTA5 18038,1391,338,1053,3436,48.2,3373,0,0,0,769,2667
ZCTA5 18040,6428,1660,4768,17022,45,13913,839,1449,0.085125132,4241,12781
ZCTA5 18041,2146,208,1938,5779,42,5381,88,31,0.00536425,532,5247
ZCTA5 18042,15971,9435,6536,43834,37.1,29364,1212,6260,0.142811516,27877,15957
ZCTA5 18045,11617,5985,5632,29198,46.4,23681,1622,1404,0.048085485,17289,11909
ZCTA5 18046,55,634,-579,142,35.6,142,0,0,0,1794,-1652
ZCTA5 18049,7215,921,6294,18111,43.2,16590,443,454,0.025067638,2711,15400
ZCTA5 18051,1239,39,1200,3102,50,2928,0,0,0,99,3003
ZCTA5 18052,11892,3665,8227,29108,40.6,22008,1176,2010,0.069053181,10769,18339
ZCTA5 18053,948,957,-9,2554,43.2,2499,0,55,0.021534847,2269,285
ZCTA5 18054,1701,1701,0,5137,37.6,4821,70,83,0.01615729,4782,355
ZCTA5 18055,4616,276,4340,11828,45.3,10752,261,163,0.013780859,614,11214
ZCTA5 18056,416,2714,-2298,1557,27.8,850,18,11,0.007064868,7477,-5920
ZCTA5 18058,3593,3232,361,10153,43.6,9273,0,204,0.020092583,10112,41
ZCTA5 18059,366,432,-66,855,54.1,837,12,0,0,1191,-336
ZCTA5 18062,10126,864,9262,26604,43.8,22414,948,783,0.029431664,2515,24089
ZCTA5 18063,126,171,-45,301,62.9,294,0,0,0,761,-460
ZCTA5 18064,10018,1419,8599,26846,44.5,25471,420,365,0.013596066,4467,22379
ZCTA5 18065,163,107,56,231,67.5,226,0,0,0,297,-66
ZCTA5 18066,2199,1692,507,5776,45.6,5472,0,124,0.021468144,4102,1674
ZCTA5 18067,7881,5423,2458,19162,43.9,17217,285,300,0.015655986,14610,4552
ZCTA5 18069,2988,51,2937,8205,47.2,7064,503,260,0.031687995,140,8065
ZCTA5 18070,154,170,-16,326,49,326,0,0,0,424,-98
ZCTA5 18071,4563,1533,3030,10758,47.2,10436,31,50,0.004647704,3771,6987
ZCTA5 18072,2679,1457,1222,6908,44.2,6525,0,103,0.014910249,3479,3429
ZCTA5 18073,4080,880,3200,10896,42.6,10020,238,330,0.030286344,2679,8217
ZCTA5 18074,2155,1024,1131,5375,45.3,5264,78,8,0.001488372,2413,2962
ZCTA5 18076,1264,110,1154,3067,44.4,2743,5,200,0.065210303,239,2828
ZCTA5 18077,911,668,243,2273,48.9,2177,6,17,0.007479103,2006,267
ZCTA5 18078,2801,191,2610,7546,45.3,7152,98,15,0.001987808,457,7089
ZCTA5 18079,192,419,-227,599,36.8,599,0,0,0,1154,-555
ZCTA5 18080,4444,4452,-8,11028,40.9,10593,2,35,0.00317374,12352,-1324
ZCTA5 18081,41,191,-150,162,14.3,162,0,0,0,445,-283
ZCTA5 18083,248,570,-322,674,36.8,651,2,0,0,1417,-743
ZCTA5 18085,336,110,226,822,39.8,754,8,53,0.064476886,275,547
ZCTA5 18086,241,18,223,518,59.1,518,0,0,0,129,389
ZCTA5 18087,253,10691,-10438,747,40.1,685,34,12,0.016064257,28578,-27831
ZCTA5 18088,3231,490,2741,8139,45.5,7540,17,134,0.016463939,1396,6743
ZCTA5 18091,2203,175,2028,5634,43.2,5439,38,48,0.008519702,499,5135
ZCTA5 18092,1265,1236,29,3370,47.4,3237,35,31,0.009198813,3262,108
ZCTA5 18101,1931,2742,-811,5437,30.1,2510,57,876,0.161118264,6926,-1489
ZCTA5 18102,17425,974,16451,51996,30.3,23979,660,7506,0.144357258,2574,49422
ZCTA5 18103,18745,5789,12956,49023,38.3,31295,1297,5251,0.107112988,13902,35121
ZCTA5 18104,17389,8797,8592,45959,38.7,34770,3294,3057,0.066515808,22260,23699
ZCTA5 18106,2790,57,2733,6621,48.2,5364,440,384,0.057997281,162,6459
ZCTA5 18109,6966,2130,4836,17266,33.9,9833,409,2660,0.154060002,5638,11628
ZCTA5 18195,0,506,-506,0,-,0,0,0,#DIV/0!,1046,-1046
ZCTA5 18201,11586,470,11116,31258,37.5,19251,219,2012,0.064367522,1168,30090
ZCTA5 18202,5071,1690,3381,13343,42.3,9780,3,1282,0.096080342,4411,8932
ZCTA5 18210,2983,28,2955,7402,48.8,6201,191,585,0.079032694,55,7347
ZCTA5 18211,416,1785,-1369,987,56.9,987,0,0,0,4444,-3457
ZCTA5 18212,9,1922,-1913,17,85.1,17,0,0,0,4880,-4863
ZCTA5 18214,766,535,231,1676,54,1651,12,0,0,1441,235
ZCTA5 18216,448,2027,-1579,1131,49.1,1052,0,0,0,5045,-3914
ZCTA5 18218,884,91,793,2224,38.9,2036,0,80,0.035971223,290,1934
ZCTA5 18219,510,4659,-4149,1041,53.6,873,94,44,0.042267051,11526,-10485
ZCTA5 18220,134,13,121,281,45.7,279,0,0,0,33,248
ZCTA5 18221,149,5346,-5197,406,33.8,406,0,0,0,13528,-13122
ZCTA5 18222,3570,2911,659,9741,45.7,8788,115,331,0.033980084,7094,2647
ZCTA5 18223,26,1671,-1645,55,-,55,0,0,0,4225,-4170
ZCTA5 18224,2711,272,2439,6353,45.4,5680,109,151,0.023768298,656,5697
ZCTA5 18225,0,5454,-5454,0,-,0,0,0,#DIV/0!,14446,-14446
ZCTA5 18229,3653,72,3581,8988,49,8479,24,103,0.011459724,164,8824
ZCTA5 18230,55,407,-352,150,51.5,150,0,0,0,1002,-852
ZCTA5 18231,210,171,39,474,30.4,386,7,32,0.067510549,492,-18
ZCTA5 18232,1722,144,1578,4158,38.2,3772,0,122,0.029341029,407,3751
ZCTA5 18234,335,116,219,453,65.1,453,0,0,0,241,212
ZCTA5 18235,7827,4922,2905,19404,47.4,18594,46,121,0.006235828,13539,5865
ZCTA5 18237,1408,733,675,3794,35.8,2934,61,24,0.006325778,2020,1774
ZCTA5 18239,66,1516,-1450,109,50.5,109,0,0,0,3873,-3764
ZCTA5 18240,1451,4130,-2679,3817,41.3,3465,0,206,0.053969086,9975,-6158
ZCTA5 18241,238,190,48,401,65.5,401,0,0,0,392,9
ZCTA5 18242,151,2189,-2038,344,36.1,193,0,0,0,5079,-4735
ZCTA5 18244,132,412,-280,359,39.5,352,0,1,0.002785515,1084,-725
ZCTA5 18245,169,25,144,278,68.6,278,0,0,0,37,241
ZCTA5 18246,96,49,47,334,28.1,287,0,0,0,102,232
ZCTA5 18248,183,168,15,529,40.4,496,0,29,0.054820416,422,107
ZCTA5 18249,1434,42,1392,3836,47.2,3636,93,70,0.018248175,124,3712
ZCTA5 18250,1222,1326,-104,3069,39.3,2877,0,0,0,3131,-62
ZCTA5 18252,4623,26,4597,11296,45.1,10227,0,30,0.002655807,85,11211
ZCTA5 18254,347,77,270,1034,34.4,822,0,61,0.058994197,196,838
ZCTA5 18255,1589,130,1459,4254,44.7,4120,0,38,0.008932769,248,4006
ZCTA5 18256,79,169,-90,172,56.1,172,0,0,0,451,-279
ZCTA5 18301,9701,98,9603,29685,39.9,18725,557,6304,0.212363146,287,29398
ZCTA5 18302,6036,442,5594,17649,42.8,11788,459,2843,0.161085614,921,16728
ZCTA5 18321,617,640,-23,1743,45,1662,52,0,0,1575,168
ZCTA5 18322,909,5552,-4643,2829,47.6,2708,66,43,0.015199717,17306,-14477
ZCTA5 18323,58,221,-163,80,63.9,80,0,0,0,506,-426
ZCTA5 18324,3668,989,2679,9587,45.3,5277,178,2502,0.260978408,2294,7293
ZCTA5 18325,1022,191,831,2819,35.6,2196,0,0,0,525,2294
ZCTA5 18326,1420,1613,-193,3828,39.6,2954,59,737,0.192528736,7437,-3609
ZCTA5 18327,295,204,91,613,46.5,533,39,23,0.037520392,380,233
ZCTA5 18328,3041,453,2588,7864,45.2,7434,12,47,0.005976602,1022,6842
ZCTA5 18330,3102,8766,-5664,9247,42.4,7385,110,1098,0.118741213,20619,-11372
ZCTA5 18331,176,8850,-8674,430,56.3,409,20,0,0,20973,-20543
ZCTA5 18332,942,2044,-1102,2977,38.1,2196,0,577,0.193819281,4884,-1907
ZCTA5 18333,0,4782,-4782,0,-,0,0,0,#DIV/0!,11731,-11731
ZCTA5 18334,1715,5063,-3348,5277,42.9,3948,14,432,0.081864696,14243,-8966
ZCTA5 18335,437,4566,-4129,1472,52.3,1176,47,249,0.169157609,14632,-13160
ZCTA5 18336,1578,5492,-3914,3536,47.8,3241,194,51,0.014423077,11997,-8461
ZCTA5 18337,5837,2137,3700,15299,45,13449,104,608,0.03974116,4965,10334
ZCTA5 18340,36,3631,-3595,155,31.2,155,0,0,0,8323,-8168
ZCTA5 18342,217,2187,-1970,543,45.3,362,181,0,0,4953,-4410
ZCTA5 18343,1668,110,1558,4020,52.6,3474,97,144,0.035820896,238,3782
ZCTA5 18344,1271,7976,-6705,3616,42.2,2940,159,384,0.10619469,19239,-15623
ZCTA5 18346,1070,1538,-468,2605,46.6,2002,124,212,0.081381958,4788,-2183
ZCTA5 18347,1538,6201,-4663,2917,61.2,2917,0,0,0,17400,-14483
ZCTA5 18349,59,1089,-1030,160,13.9,31,0,129,0.80625,2767,-2607
ZCTA5 18350,393,824,-431,722,66.6,641,81,0,0,1938,-1216
ZCTA5 18351,175,233,-58,507,40.4,480,0,2,0.003944773,551,-44
ZCTA5 18353,4608,882,3726,11993,52.4,10721,399,453,0.037772034,2084,9909
ZCTA5 18354,518,1589,-1071,1447,43.1,1306,80,61,0.042156185,3878,-2431
ZCTA5 18355,478,69,409,1276,38.5,1149,56,16,0.012539185,224,1052
ZCTA5 18356,32,1990,-1958,70,-,70,0,0,0,6154,-6084
ZCTA5 18357,52,80,-28,64,93.2,63,0,0,0,208,-144
ZCTA5 18360,10799,948,9851,28609,45,21984,698,3524,0.123178021,2382,26227
ZCTA5 18370,421,251,170,1120,33.4,853,0,186,0.166071429,590,530
ZCTA5 18371,269,189,80,665,49.9,406,0,213,0.320300752,386,279
ZCTA5 18372,928,190,738,2532,42.7,1724,26,534,0.210900474,660,1872
ZCTA5 18403,2798,93,2705,6825,45.3,6717,79,1,0.00014652,263,6562
ZCTA5 18405,926,675,251,2309,49.5,2192,6,0,0,1739,570
ZCTA5 18407,6141,1258,4883,14562,42.8,13637,141,99,0.006798517,3219,11343
ZCTA5 18411,8762,476,8286,23002,42.9,20937,883,421,0.018302756,1194,21808
ZCTA5 18413,30,150,-120,53,-,53,0,0,0,354,-301
ZCTA5 18414,2211,5723,-3512,5488,47,5307,23,34,0.006195335,13474,-7986
ZCTA5 18415,743,1648,-905,1468,57.6,1305,13,0,0,4113,-2645
ZCTA5 18417,379,607,-228,946,51.9,909,15,0,0,1465,-519
ZCTA5 18419,1770,7248,-5478,4529,45.8,4112,36,141,0.0311327,17157,-12628
ZCTA5 18420,73,3104,-3031,169,38.9,167,0,0,0,7142,-6973
ZCTA5 18421,1927,1721,206,4633,47.7,4410,24,68,0.014677315,3950,683
ZCTA5 18424,2041,5556,-3515,5161,50.2,4816,19,132,0.025576439,12652,-7491
ZCTA5 18425,426,3309,-2883,1011,54.6,1000,0,0,0,7321,-6310
ZCTA5 18426,1527,3775,-2248,3530,55.7,3223,43,28,0.007932011,8850,-5320
ZCTA5 18428,5178,49,5129,12250,51.7,10890,244,269,0.021959184,138,12112
ZCTA5 18430,29,2512,-2483,75,46.9,71,4,0,0,6581,-6506
ZCTA5 18431,5262,879,4383,12518,46.8,12106,62,36,0.002875859,2252,10266
ZCTA5 18433,2940,4803,-1863,6840,47.4,6617,10,14,0.002046784,12498,-5658
ZCTA5 18434,1693,1309,384,3869,46.1,3275,89,0,0,3209,660
ZCTA5 18435,440,2179,-1739,1023,66.2,893,0,0,0,5418,-4395
ZCTA5 18436,4717,1004,3713,12805,49.6,12399,38,17,0.001327606,3005,9800
ZCTA5 18437,77,16376,-16299,159,57.3,157,2,0,0,41121,-40962
ZCTA5 18438,562,13890,-13328,1183,60.4,1036,0,0,0,31277,-30094
ZCTA5 18439,166,6403,-6237,472,52.3,462,0,6,0.012711864,14324,-13852
ZCTA5 18440,20,7196,-7176,37,59.9,37,0,0,0,16268,-16231
ZCTA5 18441,172,5819,-5647,415,48.9,404,5,0,0,15850,-15435
ZCTA5 18443,141,3447,-3306,380,35.8,380,0,0,0,9937,-9557
ZCTA5 18444,5364,1407,3957,14133,45.7,13463,77,197,0.013939008,2892,11241
ZCTA5 18445,924,3484,-2560,2437,50.5,2095,75,16,0.006565449,8744,-6307
ZCTA5 18446,1379,2286,-907,3361,49.8,3292,11,6,0.001785183,6107,-2746
ZCTA5 18447,4369,631,3738,10299,45.4,10088,10,0,0,1583,8716
ZCTA5 18451,238,53,185,560,61.2,551,0,3,0.005357143,125,435
ZCTA5 18452,2301,55,2246,5145,54.7,4925,0,50,0.009718173,158,4987
ZCTA5 18453,463,85,378,1236,47.7,1213,12,0,0,214,1022
ZCTA5 18454,51,538,-487,94,69.7,94,0,0,0,1456,-1362
ZCTA5 18455,53,549,-496,114,70.8,114,0,0,0,1153,-1039
ZCTA5 18456,113,1448,-1335,223,51.5,219,0,4,0.01793722,3673,-3450
ZCTA5 18457,32,108,-76,123,16.4,123,0,0,0,244,-121
ZCTA5 18458,1455,510,945,3617,49.9,3435,59,0,0,1314,2303
ZCTA5 18460,82,28,54,179,56.7,179,0,0,0,107,72
ZCTA5 18461,131,653,-522,203,61.3,203,0,0,0,1487,-1284
ZCTA5 18462,214,118,96,554,48,538,3,0,0,216,338
ZCTA5 18463,86,318,-232,242,57.9,232,0,5,0.020661157,817,-575
ZCTA5 18464,592,372,220,1550,51.1,1347,77,47,0.030322581,846,704
ZCTA5 18465,492,449,43,1206,50.1,1168,3,15,0.012437811,1099,107
ZCTA5 18466,5753,718,5035,17492,38.9,9197,750,4534,0.259204208,1814,15678
ZCTA5 18469,165,774,-609,405,70.9,348,17,0,0,1954,-1549
ZCTA5 18470,793,1422,-629,1901,49.9,1731,5,8,0.004208311,3654,-1753
ZCTA5 18471,207,1248,-1041,529,48.2,529,0,0,0,3315,-2786
ZCTA5 18472,1520,4664,-3144,7343,40.7,5557,38,1431,0.194879477,11007,-3664
ZCTA5 18473,179,92,87,360,45.4,294,0,0,0,294,66
ZCTA5 18503,577,69,508,1230,33.6,1045,55,91,0.07398374,151,1079
ZCTA5 18504,8507,710,7797,20536,41.7,17300,302,323,0.015728477,2061,18475
ZCTA5 18505,8360,130,8230,21643,36.2,15324,1747,1384,0.063946773,314,21329
ZCTA5 18507,2132,297,1835,5480,40.5,4768,113,329,0.060036496,798,4682
ZCTA5 18508,4771,2251,2520,11292,39.4,9727,166,558,0.049415515,5886,5406
ZCTA5 18509,5275,3517,1758,14336,36.8,11916,373,985,0.068708147,9011,5325
ZCTA5 18510,4822,830,3992,13310,28.7,9429,1423,946,0.07107438,2249,11061
ZCTA5 18512,5678,295,5383,12811,41.8,11913,476,65,0.005073765,766,12045
ZCTA5 18517,2139,1725,414,5210,45.1,4922,53,28,0.00537428,4692,518
ZCTA5 18518,3688,535,3153,8494,44.7,7312,126,51,0.006004238,1345,7149
ZCTA5 18519,2280,10498,-8218,5242,45,4803,22,135,0.025753529,27949,-22707
ZCTA5 18602,140,6960,-6820,386,34.3,306,2,0,0,20482,-20096
ZCTA5 18603,8364,0,8364,19524,47.6,18487,52,383,0.019616882,0,19524
ZCTA5 18610,1322,38,1284,4385,38.4,2082,312,1232,0.280957811,47,4338
ZCTA5 18612,6148,7173,-1025,18382,43.5,16067,152,1564,0.085083234,21519,-3137
ZCTA5 18614,888,314,574,1831,56.7,1801,0,10,0.005461496,903,928
ZCTA5 18615,747,890,-143,1757,48.6,1741,0,2,0.001138304,2338,-581
ZCTA5 18616,304,71,233,765,60.7,741,0,0,0,139,626
ZCTA5 18617,696,361,335,1461,41.6,1134,46,153,0.104722793,969,492
ZCTA5 18618,1569,2088,-519,3627,44.8,3428,26,16,0.004411359,6245,-2618
ZCTA5 18619,59,2631,-2572,137,58.6,135,0,1,0.00729927,8510,-8373
ZCTA5 18621,1950,982,968,5991,46.8,5169,11,477,0.079619429,2543,3448
ZCTA5 18622,55,146,-91,159,49.9,159,0,0,0,414,-255
ZCTA5 18623,944,26,918,2332,45.5,2210,2,4,0.001715266,37,2295
ZCTA5 18624,256,13,243,433,60.6,318,46,0,0,60,373
ZCTA5 18625,57,5996,-5939,108,62,104,0,0,0,14087,-13979
ZCTA5 18626,180,10791,-10611,547,62.8,542,0,5,0.009140768,28982,-28435
ZCTA5 18627,0,1369,-1369,0,-,0,0,0,#DIV/0!,3719,-3719
ZCTA5 18628,97,8833,-8736,211,47.8,204,0,0,0,24361,-24150
ZCTA5 18629,775,2245,-1470,1813,54.1,1767,0,2,0.001103144,6949,-5136
ZCTA5 18630,1101,89,1012,2898,46,2803,16,4,0.001380262,192,2706
ZCTA5 18631,435,12780,-12345,904,50.7,904,0,0,0,34511,-33607
ZCTA5 18632,188,3110,-2922,578,42.2,530,0,0,0,9677,-9099
ZCTA5 18634,5515,560,4955,13281,42.8,11419,37,687,0.051728033,1551,11730
ZCTA5 18635,1487,4841,-3354,3622,45.7,3482,6,85,0.023467697,12838,-9216
ZCTA5 18636,626,185,441,1524,47.4,1464,38,0,0,492,1032
ZCTA5 18640,6839,5193,1646,16150,39.7,14379,139,957,0.059256966,13408,2742
ZCTA5 18641,2955,13785,-10830,6924,45.6,6079,87,250,0.036106297,38005,-31081
ZCTA5 18642,1763,5632,-3869,3814,51.4,3571,0,162,0.042475092,15132,-11318
ZCTA5 18643,5696,244,5452,12728,47.8,12255,34,32,0.002514142,664,12064
ZCTA5 18644,3425,1469,1956,7703,45.6,7468,7,98,0.012722316,3730,3973
ZCTA5 18651,3818,15481,-11663,8816,46.5,7746,24,543,0.061592559,41577,-32761
ZCTA5 18655,2318,6679,-4361,5395,49.6,5156,19,5,0.000926784,19036,-13641
ZCTA5 18656,879,1558,-679,2170,49.2,2112,7,7,0.003225806,4132,-1962
ZCTA5 18657,4480,171,4309,11247,44.2,10779,59,97,0.008624522,503,10744
ZCTA5 18660,1360,6189,-4829,3342,45.6,3292,0,9,0.002692998,17236,-13894
ZCTA5 18661,2039,12420,-10381,4994,47.2,4820,9,36,0.00720865,32883,-27889
ZCTA5 18701,1051,5271,-4220,3582,22,2843,55,393,0.109715243,12646,-9064
ZCTA5 18702,17152,3842,13310,42772,38.1,28022,1163,5175,0.120990368,9544,33228
ZCTA5 18704,13420,7771,5649,30742,41.4,27157,264,1316,0.042807885,21400,9342
ZCTA5 18705,6442,8144,-1702,15334,41.2,12129,86,926,0.060388679,20805,-5471
ZCTA5 18706,6792,7200,-408,16113,38.9,13911,199,238,0.014770682,20509,-4396
ZCTA5 18707,6010,281,5729,16185,44.4,15311,453,32,0.001977139,1011,15174
ZCTA5 18708,3719,7686,-3967,8472,48.3,7830,295,95,0.011213409,21184,-12712
ZCTA5 18709,1471,2396,-925,2825,47.9,2680,0,64,0.022654867,6752,-3927
ZCTA5 18801,3140,12365,-9225,7983,48.9,7667,27,29,0.00363272,35496,-27513
ZCTA5 18810,2784,7431,-4647,5792,47.8,5504,55,17,0.002935083,20805,-15013
ZCTA5 18812,617,6632,-6015,1564,56.5,1531,5,0,0,16421,-14857
ZCTA5 18814,80,129,-49,193,27.7,176,0,3,0.015544041,407,-214
ZCTA5 18816,23,9446,-9423,61,57.3,39,0,9,0.147540984,23407,-23346
ZCTA5 18817,39,21430,-21391,131,39.8,131,0,0,0,55741,-55610
ZCTA5 18818,529,3761,-3232,1209,50.6,1147,0,5,0.004135649,10324,-9115
ZCTA5 18820,34,1500,-1466,81,39.7,67,0,0,0,4104,-4023
ZCTA5 18821,465,7571,-7106,1157,44.6,1079,31,22,0.019014693,22500,-21343
ZCTA5 18822,1317,2009,-692,3163,48.2,3096,1,12,0.003793867,5679,-2516
ZCTA5 18823,75,12077,-12002,169,63.8,169,0,0,0,30645,-30476
ZCTA5 18824,476,8100,-7624,1227,51.1,1201,0,5,0.00407498,19684,-18457
ZCTA5 18825,73,1622,-1549,172,57.2,170,0,0,0,3998,-3826
ZCTA5 18826,605,4667,-4062,1451,54.5,1426,5,0,0,12512,-11061
ZCTA5 18828,108,1884,-1776,238,47.1,216,11,0,0,4792,-4554
ZCTA5 18829,284,2373,-2089,704,50.4,674,3,0,0,6617,-5913
ZCTA5 18830,243,3242,-2999,532,53.7,530,0,0,0,8520,-7988
ZCTA5 18831,422,1994,-1572,1017,54.1,924,37,3,0.002949853,5591,-4574
ZCTA5 18832,724,1321,-597,1720,41.8,1703,9,0,0,3220,-1500
ZCTA5 18833,835,5412,-4577,2024,52.1,1993,0,0,0,12736,-10712
ZCTA5 18834,1228,11111,-9883,3261,46.6,3200,0,0,0,30748,-27487
ZCTA5 18837,1013,7834,-6821,2677,40.1,2589,6,18,0.006723945,20236,-17559
ZCTA5 18840,4322,2361,1961,11068,36.5,10519,93,90,0.00813155,6043,5025
ZCTA5 18842,56,985,-929,162,40.7,161,0,0,0,2472,-2310
ZCTA5 18843,92,6567,-6475,229,38.7,157,0,38,0.165938865,16461,-16232
ZCTA5 18844,639,7551,-6912,1720,46.6,1691,6,8,0.004651163,17781,-16061
ZCTA5 18845,171,12802,-12631,498,54.9,487,7,0,0,35306,-34808
ZCTA5 18846,264,11128,-10864,671,50.6,628,0,0,0,28326,-27655
ZCTA5 18847,2026,9444,-7418,5287,42,5187,32,26,0.004917723,25931,-20644
ZCTA5 18848,3648,6277,-2629,8860,46.6,8470,2,178,0.020090293,17437,-8577
ZCTA5 18850,828,4902,-4074,1999,47.8,1886,20,6,0.003001501,13508,-11509
ZCTA5 18851,255,5548,-5293,610,50.7,578,6,0,0,15677,-15067
ZCTA5 18853,1684,5943,-4259,4084,47.6,3953,13,26,0.006366308,17482,-13398
ZCTA5 18854,621,3661,-3040,1584,47.1,1546,15,5,0.003156566,11228,-9644
ZCTA5 18901,10681,7564,3117,27996,44.6,25283,642,592,0.021145878,20101,7895
ZCTA5 18902,7892,14015,-6123,22285,45.2,19590,1191,129,0.005788647,35864,-13579
ZCTA5 18912,107,8612,-8505,188,61.2,188,0,0,0,24718,-24530
ZCTA5 18913,74,1911,-1837,243,47.2,243,0,0,0,6284,-6041
ZCTA5 18914,7757,19511,-11754,21287,44.1,18611,1397,610,0.028655987,50915,-29628
ZCTA5 18915,464,2704,-2240,1268,45.1,790,369,75,0.059148265,7182,-5914
ZCTA5 18917,969,4047,-3078,2222,40.9,1852,104,80,0.0360036,9192,-6970
ZCTA5 18920,148,7283,-7135,320,52.8,267,0,0,0,18392,-18072
ZCTA5 18921,114,2250,-2136,210,50.5,210,0,0,0,5887,-5677
ZCTA5 18923,496,2704,-2208,1430,40.9,1388,42,0,0,7391,-5961
ZCTA5 18925,2171,2635,-464,6567,40.1,5544,781,121,0.018425461,6571,-4
ZCTA5 18927,144,4522,-4378,299,40,276,0,23,0.076923077,10961,-10662
ZCTA5 18929,3352,3367,-15,9718,38.4,8815,397,21,0.002160938,9347,371
ZCTA5 18930,931,3637,-2706,2343,54.1,2273,11,0,0,10189,-7846
ZCTA5 18932,124,14138,-14014,260,68.1,244,0,16,0.061538462,40924,-40664
ZCTA5 18933,57,13221,-13164,88,67.5,88,0,0,0,35748,-35660
ZCTA5 18935,113,1841,-1728,317,50,299,0,0,0,8525,-8208
ZCTA5 18936,79,4179,-4100,287,29.8,263,11,13,0.045296167,11252,-10965
ZCTA5 18938,6380,12462,-6082,14115,57,12961,546,95,0.006730429,32683,-18568
ZCTA5 18940,11527,7504,4023,29664,46.1,24803,2435,481,0.016214941,18868,10796
ZCTA5 18942,1054,1518,-464,2554,57.9,2348,10,0,0,3539,-985
ZCTA5 18944,9845,3383,6462,27076,42.1,24954,361,291,0.010747525,7270,19806
ZCTA5 18946,141,5592,-5451,530,55.3,507,23,0,0,13994,-13464
ZCTA5 18947,2398,2308,90,6258,51.4,5912,71,31,0.004953659,3592,2666
ZCTA5 18950,30,14914,-14884,60,70.5,60,0,0,0,22850,-22790
ZCTA5 18951,13960,15667,-1707,36595,43.5,32427,654,754,0.020603908,53002,-16407
ZCTA5 18954,3598,5942,-2344,10081,49.6,8756,293,144,0.014284297,10833,-752
ZCTA5 18955,530,6658,-6128,1473,49.2,1355,0,44,0.029871012,11802,-10329
ZCTA5 18960,4729,0,4729,11963,46.9,10937,117,68,0.005684193,0,11963
ZCTA5 18962,117,23776,-23659,329,45.2,277,3,17,0.051671733,67295,-66966
ZCTA5 18964,5200,0,5200,13993,40.5,11895,1225,165,0.01179161,0,13993
ZCTA5 18966,14215,36,14179,36658,48.2,34633,850,200,0.005455835,106,36552
ZCTA5 18969,6250,12772,-6522,15505,44.3,13538,518,479,0.03089326,30745,-15240
ZCTA5 18970,313,13420,-13107,692,47.1,653,0,3,0.00433526,32605,-31913
ZCTA5 18972,1341,12360,-11019,3116,55,2984,3,55,0.017650834,32338,-29222
ZCTA5 18974,17264,4074,13190,42544,46.6,37014,1604,1362,0.032013915,9261,33283
ZCTA5 18976,8178,11863,-3685,22325,46.1,19170,1852,237,0.010615901,28170,-5845
ZCTA5 18977,1758,23155,-21397,4595,54.2,4119,203,78,0.016974973,74763,-70168
ZCTA5 18980,71,12659,-12588,176,56.9,172,0,4,0.022727273,34418,-34242
ZCTA5 19001,6407,6150,257,17690,38.7,12813,560,2203,0.124533635,19343,-1653
ZCTA5 19002,11486,5588,5898,30952,44.9,24826,3204,1531,0.049463686,12267,18685
ZCTA5 19003,5985,21644,-15659,14146,37.4,11106,679,1576,0.111409586,63222,-49076
ZCTA5 19004,3971,9092,-5121,9942,42.2,7817,711,1036,0.104204385,22472,-12530
ZCTA5 19006,8472,6105,2367,23337,44.8,18569,2544,997,0.042721858,16531,6806
ZCTA5 19007,8963,2370,6593,22290,38.3,15168,852,4058,0.182054733,5094,17196
ZCTA5 19008,7006,14950,-7944,20585,44.2,17125,2456,371,0.018022832,35041,-14456
ZCTA5 19009,355,4597,-4242,1090,44.4,1032,0,13,0.011926606,11125,-10035
ZCTA5 19010,7728,12122,-4394,21629,39.4,17274,2199,890,0.041148458,24219,-2590
ZCTA5 19012,2219,18171,-15952,6842,41.7,3151,1109,2230,0.325928091,43660,-36818
ZCTA5 19013,12551,13315,-764,34084,32.4,5885,262,24573,0.720954113,35903,-1819
ZCTA5 19014,7771,8611,-840,21093,40.1,18316,489,1686,0.079931731,24615,-3522
ZCTA5 19015,6773,19330,-12557,16663,39.1,11240,231,4181,0.250915201,58914,-42251
ZCTA5 19017,74,11786,-11712,261,42.6,227,9,5,0.019157088,33731,-33470
ZCTA5 19018,9603,12587,-2984,23336,38.4,14078,1595,6460,0.276825506,39587,-16251
ZCTA5 19020,22290,3132,19158,56866,40.5,39036,7516,4584,0.080610558,8316,48550
ZCTA5 19021,3777,11759,-7982,9832,38.2,7828,367,815,0.082892596,33955,-24123
ZCTA5 19022,1499,16553,-15054,3934,33.2,2923,34,579,0.147178444,43181,-39247
ZCTA5 19023,7809,18885,-11076,22459,33.3,3929,222,17288,0.769758226,54687,-32228
ZCTA5 19025,2346,12279,-9933,6459,45,5504,572,76,0.011766527,32876,-26417
ZCTA5 19026,12387,9451,2936,31073,36.9,22008,1506,5298,0.170501722,29332,1741
ZCTA5 19027,8075,25225,-17150,19281,40.8,8499,1363,8035,0.416731497,66969,-47688
ZCTA5 19029,1569,18140,-16571,3984,37.2,3617,75,63,0.015813253,44803,-40819
ZCTA5 19030,4709,18395,-13686,12621,42.5,10923,545,464,0.036764123,47857,-35236
ZCTA5 19031,1858,15103,-13245,4748,46.7,4185,155,264,0.055602359,34095,-29347
ZCTA5 19032,2489,16290,-13801,6738,33.6,2923,230,3195,0.474176313,33845,-27107
ZCTA5 19033,2772,18757,-15985,7674,37.5,6897,219,324,0.042220485,49088,-41414
ZCTA5 19034,2418,18677,-16259,6960,41.9,5793,659,134,0.019252874,53857,-46897
ZCTA5 19035,1455,9887,-8432,3956,45.5,3544,226,110,0.027805865,23370,-19414
ZCTA5 19036,5016,11909,-6893,13082,38.6,10355,80,2024,0.154716404,32381,-19299
ZCTA5 19038,11544,12591,-1047,32697,40.5,26320,834,4153,0.127014711,33832,-1135
ZCTA5 19040,8045,5189,2856,21927,40.1,19377,282,655,0.029871847,12020,9907
ZCTA5 19041,2569,12316,-9747,6535,51,5637,310,155,0.023718439,34006,-27471
ZCTA5 19043,1031,2695,-1664,2535,52,2477,0,41,0.01617357,6294,-3759
ZCTA5 19044,6618,985,5633,17064,34.2,13710,1902,666,0.039029536,3310,13754
ZCTA5 19046,7640,2511,5129,18716,47.2,15715,773,1101,0.058826672,8805,9911
ZCTA5 19047,12462,4151,8311,33699,44,28694,1211,1636,0.048547435,11442,22257
ZCTA5 19050,12082,86,11996,28680,41.5,6810,772,19177,0.668654114,236,28444
ZCTA5 19052,284,3803,-3519,602,62.6,602,0,0,0,9405,-8803
ZCTA5 19053,10521,71,10450,27718,44.3,23359,1670,951,0.034309835,1119,26599
ZCTA5 19054,6521,19101,-12580,17872,38,15868,594,577,0.032285139,52093,-34221
ZCTA5 19055,4755,1908,2847,13766,38.8,12011,103,879,0.063852971,5483,8283
ZCTA5 19056,5909,2984,2925,16115,40.8,12956,615,1194,0.07409246,7076,9039
ZCTA5 19057,6008,17659,-11651,17916,38.8,13862,749,1163,0.064914043,46766,-28850
ZCTA5 19060,3657,6907,-3250,11007,48.1,9500,1170,249,0.022621968,16846,-5839
ZCTA5 19061,7731,7241,490,20101,38.2,15833,1064,2059,0.102432715,18338,1763
ZCTA5 19063,15221,2761,12460,37386,45.7,31964,2490,1466,0.039212539,8486,28900
ZCTA5 19064,8563,4025,4538,25067,43,22307,1030,539,0.021502374,11840,13227
ZCTA5 19066,1689,0,1689,5409,44.4,4682,311,218,0.040303198,717,4692
ZCTA5 19067,20503,8080,12423,52862,43.6,44892,2163,3475,0.065737203,22240,30622
ZCTA5 19070,2885,3724,-839,6714,39.7,5484,201,781,0.116324099,11235,-4521
ZCTA5 19072,4357,2600,1757,10782,44.3,9007,740,380,0.035243925,10122,660
ZCTA5 19073,8302,8984,-682,20756,44.9,19327,564,207,0.00997302,24261,-3505
ZCTA5 19074,2251,187,2064,5920,41,5377,331,111,0.01875,407,5513
ZCTA5 19075,2860,2112,748,7693,41,6656,168,361,0.046925777,6245,1448
ZCTA5 19076,2581,5456,-2875,6474,37.6,5086,233,576,0.08897127,17026,-10552
ZCTA5 19078,4593,2395,2198,11553,39.9,10505,78,510,0.044144378,6781,4772
ZCTA5 19079,3477,65,3412,9292,33.6,1623,82,7115,0.765712441,135,9157
ZCTA5 19081,3767,629,3138,10712,38,9100,556,605,0.056478715,1311,9401
ZCTA5 19082,15894,871,15023,43270,33.5,10855,8405,19239,0.444626762,4431,38839
ZCTA5 19083,13330,349,12981,36901,39.9,32247,1823,1334,0.036150782,1358,35543
ZCTA5 19085,1870,24,1846,10333,20.6,8376,790,433,0.041904578,24,10309
ZCTA5 19086,4721,19399,-14678,12729,43.4,10186,1346,709,0.055699584,49708,-36979
ZCTA5 19087,12157,19836,-7679,33717,40.3,26667,3750,1258,0.037310556,53265,-19548
ZCTA5 19090,7602,0,7602,20031,37.4,14189,993,2672,0.13339324,3068,16963
ZCTA5 19094,1821,4871,-3050,4771,36.9,3809,14,679,0.142318172,13212,-8441
ZCTA5 19095,3316,16041,-12725,7691,45.5,4418,520,2329,0.30282148,41617,-33926
ZCTA5 19096,5805,17517,-11712,15107,44,11584,1640,805,0.053286556,44465,-29358
ZCTA5 19102,3425,2315,1110,5108,31.5,3894,868,161,0.031519186,5176,-68
ZCTA5 19103,16337,10274,6063,25368,35.8,18535,3536,1313,0.05175812,23454,1914
ZCTA5 19104,18053,7410,10643,52126,23,19254,7681,21207,0.406841116,18409,33717
ZCTA5 19106,8155,4586,3569,14211,38.9,11713,1016,925,0.065090423,13791,420
ZCTA5 19107,8459,11521,-3062,14984,31.4,7871,3976,1831,0.12219701,38980,-23996
ZCTA5 19108,57,7426,-7369,77,34.8,59,0,0,0,16421,-16344
ZCTA5 19109,0,90,-90,0,-,0,0,0,#DIV/0!,158,-158
ZCTA5 19111,25828,412,25416,68452,37.7,33477,6882,17544,0.256296383,601,67851
ZCTA5 19112,0,220,-220,0,-,0,0,0,#DIV/0!,511,-511
ZCTA5 19113,0,8589,-8589,0,-,0,0,0,#DIV/0!,23616,-23616
ZCTA5 19114,13553,6988,6565,31815,40.9,24019,1417,3233,0.101618733,17750,14065
ZCTA5 19115,14642,0,14642,35901,43.8,23441,6008,4089,0.113896549,0,35901
ZCTA5 19116,13402,4041,9361,33573,43.9,24036,5698,1735,0.051678432,10357,23216
ZCTA5 19118,4875,21784,-16909,10743,46.9,7744,354,2104,0.195848459,54718,-43975
ZCTA5 19119,12564,711,11853,29206,42,9934,426,16934,0.579812367,1423,27783
ZCTA5 19120,24592,11034,13558,73896,33,9125,7663,37108,0.502165205,28484,45412
ZCTA5 19121,14597,223,14374,34702,28.5,6428,1417,24630,0.709757363,618,34084
ZCTA5 19122,7814,56,7758,22080,28.9,8782,1467,7710,0.349184783,165,21915
ZCTA5 19123,8978,15852,-6874,18071,33.4,10523,1634,4417,0.244424769,39619,-21548
ZCTA5 19124,24377,5728,18649,71496,32.6,20630,3099,24232,0.338928052,15063,56433
ZCTA5 19125,11422,18194,-6772,24948,34,19630,1703,1367,0.054793971,45498,-20550
ZCTA5 19126,6704,6403,301,18269,39.5,1438,456,15376,0.841644316,17079,1190
ZCTA5 19127,2830,10019,-7189,5522,28.8,4798,174,324,0.058674393,25174,-19652
ZCTA5 19128,18018,0,18018,38840,36.4,29535,1168,5197,0.133805355,0,38840
ZCTA5 19129,5149,5706,-557,11551,34.8,6850,348,3362,0.291057051,15975,-4424
ZCTA5 19130,15446,193,15253,29378,33.5,20897,1867,4333,0.14749132,407,28971
ZCTA5 19131,18164,4475,13689,44791,33.7,4958,1610,36508,0.815074457,11425,33366
ZCTA5 19132,14384,20,14364,32802,40.1,1244,200,29726,0.90622523,157,32645
ZCTA5 19133,9461,168,9293,25893,35.3,4239,904,9912,0.382806164,431,25462
ZCTA5 19134,21942,399,21543,59590,32.1,23261,1179,9951,0.166991106,1009,58581
ZCTA5 19135,13379,495,12884,36304,32.5,17336,2268,8199,0.225842882,1371,34933
ZCTA5 19136,13124,1790,11334,37193,34.9,22903,1989,6910,0.185787648,5325,31868
ZCTA5 19137,3236,1224,2012,8470,40.9,7474,72,286,0.033766234,3116,5354
ZCTA5 19138,12492,2671,9821,33197,36.5,825,44,30790,0.927493448,7736,25461
ZCTA5 19139,18957,1234,17723,45642,33,3377,851,38762,0.849261645,3597,42045
ZCTA5 19140,20384,5685,14699,54831,35.5,7787,962,29117,0.531031716,15312,39519
ZCTA5 19141,14413,2534,11879,33641,36.9,1478,1290,29560,0.878689694,7527,26114
ZCTA5 19142,10908,198,10710,29993,32.7,1730,1405,25243,0.841629714,358,29635
ZCTA5 19143,26259,6969,19290,63861,33.1,8776,1427,48885,0.765490675,17256,46605
ZCTA5 19144,19792,5058,14734,46854,33.5,8325,915,34885,0.74454689,14568,32286
ZCTA5 19145,18976,39,18937,45101,37.9,23620,6379,12536,0.277953926,104,44997
ZCTA5 19146,18101,2287,15814,40983,33.3,21835,2637,13225,0.322694776,5596,35387
ZCTA5 19147,18970,5731,13239,39335,36.1,28139,4139,3804,0.096707767,14933,24402
ZCTA5 19148,20449,80,20369,51010,37,30760,11169,2048,0.04014899,295,50715
ZCTA5 19149,19381,4749,14632,59899,33.1,20741,10980,14479,0.241723568,13964,45935
ZCTA5 19150,10003,4334,5669,22760,44.5,798,106,21113,0.927636204,11326,11434
ZCTA5 19151,12766,1225,11541,31815,34.9,2228,292,28326,0.890334748,3121,28694
ZCTA5 19152,13456,4864,8592,35528,40.4,20012,6768,5952,0.167529836,15947,19581
ZCTA5 19153,5682,2193,3489,12810,38.6,1401,369,10006,0.781108509,7567,5243
ZCTA5 19154,12760,803,11957,34803,38.3,28743,1484,2718,0.078096716,2127,32676
ZCTA5 19301,2913,16,2897,7617,47.1,5776,1277,168,0.022055928,43,7574
ZCTA5 19310,934,177,757,3163,28.5,2826,5,172,0.054378754,404,2759
ZCTA5 19311,3414,47,3367,11001,34.6,9327,333,233,0.021179893,112,10889
ZCTA5 19312,4318,1738,2580,11745,45.9,9621,1598,120,0.010217114,4690,7055
ZCTA5 19316,13,4531,-4518,21,67.4,21,0,0,0,12257,-12236
ZCTA5 19317,4012,1512,2500,10813,44.6,8747,1366,112,0.010357903,4085,6728
ZCTA5 19319,76,0,76,439,24.7,331,23,78,0.177676538,0,439
ZCTA5 19320,19960,2050,17910,54644,40.5,38284,483,9820,0.17970866,5992,48652
ZCTA5 19330,2005,75,1930,5453,47.2,4941,74,71,0.013020356,187,5266
ZCTA5 19333,3055,221,2834,7953,40.9,6065,1448,215,0.027033824,520,7433
ZCTA5 19335,19489,1634,17855,51247,41.3,43076,3768,2103,0.041036548,4344,46903
ZCTA5 19341,8182,93,8089,19965,38.2,15416,3011,579,0.029000751,253,19712
ZCTA5 19342,7833,128,7705,22006,45.2,17197,2068,1617,0.07347996,597,21409
ZCTA5 19343,2832,1872,960,7902,45,7098,170,252,0.031890661,5062,2840
ZCTA5 19344,4576,177,4399,12104,44.5,11317,61,578,0.047752809,339,11765
ZCTA5 19345,0,1439,-1439,657,20.8,481,25,95,0.144596651,3343,-2686
ZCTA5 19348,8939,129,8810,23075,45.4,19616,569,804,0.034842904,306,22769
ZCTA5 19350,3853,3176,677,10907,44,9536,379,33,0.00302558,7656,3251
ZCTA5 19352,3028,871,2157,11159,31.8,9232,148,1274,0.114167936,2304,8855
ZCTA5 19355,10707,51,10656,28188,40.5,20374,4826,1077,0.038207748,101,28087
ZCTA5 19358,129,3283,-3154,422,31.1,345,0,52,0.123222749,8650,-8228
ZCTA5 19362,2068,1986,82,5624,41.5,5290,0,88,0.015647226,5264,360
ZCTA5 19363,5783,12158,-6375,17516,37.3,14544,116,430,0.024548984,33403,-15887
ZCTA5 19365,2729,7030,-4301,7556,37,6031,76,547,0.0723928,18190,-10634
ZCTA5 19367,22,8613,-8591,71,53.2,71,0,0,0,26703,-26632
ZCTA5 19369,52,7444,-7392,80,41.2,22,14,44,0.55,19094,-19014
ZCTA5 19372,865,13251,-12386,2578,43.4,1592,128,630,0.244375485,34275,-31697
ZCTA5 19373,683,9668,-8985,1944,50,1832,4,0,0,21482,-19538
ZCTA5 19374,244,8186,-7942,663,52.6,510,0,16,0.02413273,21838,-21175
ZCTA5 19375,64,4201,-4137,138,66.1,138,0,0,0,10402,-10264
ZCTA5 19380,20741,6461,14280,50510,43.1,43137,2548,2108,0.04173431,15246,35264
ZCTA5 19382,20216,4019,16197,52447,39.5,44614,2503,2655,0.050622533,10985,41462
ZCTA5 19383,126,14406,-14280,4559,19.6,3337,99,825,0.180960737,40443,-35884
ZCTA5 19390,4652,18558,-13906,13050,42.4,11082,217,290,0.022222222,52656,-39606
ZCTA5 19401,16862,5844,11018,42546,35.7,19660,1450,12814,0.301179899,14227,28319
ZCTA5 19403,18542,652,17890,43898,45.4,34450,3948,3616,0.082372773,1917,41981
ZCTA5 19405,2022,5674,-3652,4749,35.3,4190,135,101,0.021267635,15768,-11019
ZCTA5 19406,12322,11456,866,28470,36.4,19022,6161,1844,0.064769933,35438,-6968
ZCTA5 19422,7698,0,7698,19928,44.4,15245,2143,1808,0.090726616,0,19928
ZCTA5 19425,5718,19301,-13583,17394,40.2,12618,3511,368,0.021156721,50327,-32933
ZCTA5 19426,12968,11926,1042,42866,40.9,33176,3436,4413,0.102948724,30517,12349
ZCTA5 19428,9270,0,9270,20128,33.3,17167,1097,1039,0.051619634,1337,18791
ZCTA5 19435,45,219,-174,148,28.4,148,0,0,0,4091,-3943
ZCTA5 19436,369,21290,-20921,614,78.6,614,0,0,0,61095,-60481
ZCTA5 19437,379,186,193,1359,44.1,1085,118,52,0.038263429,471,888
ZCTA5 19438,9236,86,9150,24829,44.6,21562,1175,1075,0.043296146,153,24676
ZCTA5 19440,7524,42,7482,20165,39.7,14517,3324,1056,0.052367964,117,20048
ZCTA5 19442,0,55,-55,0,-,0,0,0,#DIV/0!,147,-147
ZCTA5 19444,4764,3525,1239,11154,44.8,9875,804,211,0.01891698,10536,618
ZCTA5 19446,23608,0,23608,60657,43.6,45441,8675,4623,0.076215441,0,60657
ZCTA5 19453,722,0,722,1448,44.3,1421,0,27,0.018646409,0,1448
ZCTA5 19454,11178,6312,4866,27959,45.1,20318,4867,1536,0.054937587,15355,12604
ZCTA5 19456,71,10176,-10105,166,39,148,0,0,0,25385,-25219
ZCTA5 19457,49,8545,-8496,99,52.9,80,19,0,0,21154,-21055
ZCTA5 19460,17208,7178,10030,42783,37.7,35950,2138,2350,0.054928359,18446,24337
ZCTA5 19462,6347,15019,-8672,15928,41.9,12238,1181,1346,0.084505274,41422,-25494
ZCTA5 19464,18586,5387,13199,48135,37.9,36338,573,7048,0.146421523,9867,38268
ZCTA5 19465,7244,2989,4255,18689,44.4,17354,309,204,0.010915512,7337,11352
ZCTA5 19468,10572,15062,-4490,26801,39.9,22571,1846,1318,0.04917727,36866,-10065
ZCTA5 19472,39,5923,-5884,79,68.2,79,0,0,0,14080,-14001
ZCTA5 19473,6424,9950,-3526,17580,42.1,15831,670,611,0.034755404,25553,-7973
ZCTA5 19474,215,12600,-12385,337,57.4,306,0,31,0.091988131,35333,-34996
ZCTA5 19475,4814,0,4814,11601,39.2,9431,387,1144,0.098612189,125,11476
ZCTA5 19477,26,11399,-11373,39,71.3,39,0,0,0,33183,-33144
ZCTA5 19490,115,1034,-919,273,49.8,260,0,0,0,1940,-1667
ZCTA5 19492,409,117,292,585,80.5,576,0,0,0,232,353
ZCTA5 19501,438,2904,-2466,1178,33.1,1106,0,54,0.045840407,8495,-7317
ZCTA5 19503,452,4606,-4154,1154,41.6,1042,13,13,0.011265165,13231,-12077
ZCTA5 19504,1921,128,1793,4886,51.5,4565,198,12,0.002455997,421,4465
ZCTA5 19505,1522,2806,-1284,3341,55.7,3245,0,72,0.021550434,8705,-5364
ZCTA5 19506,2478,2748,-270,6716,45.7,6340,70,92,0.01369863,7296,-580
ZCTA5 19507,1191,1704,-513,3567,35.5,3536,17,0,0,5224,-1657
ZCTA5 19508,6084,815,5269,15352,41.8,14265,108,131,0.00853309,3012,12340
ZCTA5 19510,3320,4496,-1176,8389,42.5,7830,285,118,0.014066039,12105,-3716
ZCTA5 19511,54,291,-237,173,44.3,173,0,0,0,497,-324
ZCTA5 19512,6876,3303,3573,16617,46.8,16119,55,153,0.009207438,8819,7798
ZCTA5 19516,92,1519,-1427,180,40.5,170,0,0,0,4263,-4083
ZCTA5 19518,5810,5573,237,16354,41.4,14162,146,579,0.035404182,18267,-1913
ZCTA5 19520,2484,2324,160,6276,51.1,5965,28,36,0.005736138,6481,-205
ZCTA5 19522,5560,675,4885,14005,46.9,13217,101,125,0.008925384,1922,12083
ZCTA5 19523,0,3780,-3780,0,-,0,0,0,#DIV/0!,10021,-10021
ZCTA5 19525,5598,1615,3983,16812,39.5,15776,310,150,0.008922198,4065,12747
ZCTA5 19526,4728,516,4212,11203,44.4,10790,54,164,0.014638936,1511,9692
ZCTA5 19529,1183,23,1160,3510,48.1,3224,0,3,0.000854701,80,3430
ZCTA5 19530,4748,5413,-665,15119,27.6,13630,80,693,0.045836365,14906,213
ZCTA5 19533,2410,8706,-6296,7920,46,6913,228,349,0.044065657,19356,-11436
ZCTA5 19534,761,2313,-1552,1736,51.2,1646,0,0,0,7398,-5662
ZCTA5 19535,19,3359,-3340,61,52.5,61,0,0,0,10086,-10025
ZCTA5 19536,248,7246,-6998,523,47.3,510,0,3,0.005736138,18304,-17781
ZCTA5 19538,33,498,-465,81,50.1,81,0,0,0,1550,-1469
ZCTA5 19539,1581,10793,-9212,4071,43.8,4032,0,32,0.007860477,26916,-22845
ZCTA5 19540,4246,211,4035,11226,44,10678,105,10,0.000890789,415,10811
ZCTA5 19541,1610,3378,-1768,4359,46.5,3994,0,33,0.007570544,9139,-4780
ZCTA5 19543,2023,2917,-894,6166,40.5,5939,97,51,0.008271164,6678,-512
ZCTA5 19544,60,5327,-5267,157,50.8,157,0,0,0,11224,-11067
ZCTA5 19545,212,8140,-7928,720,28.5,555,0,0,0,21540,-20820
ZCTA5 19547,1904,3462,-1558,4557,41,4394,0,0,0,8862,-4305
ZCTA5 19549,125,7392,-7267,361,37.5,336,5,0,0,23273,-22912
ZCTA5 19550,158,184,-26,588,38.2,499,0,22,0.037414966,551,37
ZCTA5 19551,1757,16069,-14312,4586,46.5,4285,21,75,0.016354121,38570,-33984
ZCTA5 19554,156,22890,-22734,371,49.5,306,0,0,0,55023,-54652
ZCTA5 19555,1393,11095,-9702,3374,47,3247,12,0,0,27231,-23857
ZCTA5 19559,115,1102,-987,295,36,287,0,0,0,1589,-1294
ZCTA5 19560,3806,7891,-4085,8993,43.9,7182,55,241,0.026798621,12062,-3069
ZCTA5 19562,1283,737,546,2804,48.2,2668,0,28,0.009985735,2941,-137
ZCTA5 19564,59,12284,-12225,148,32.9,148,0,0,0,25249,-25101
ZCTA5 19565,3388,15522,-12134,8139,43.8,7564,43,280,0.034402261,27527,-19388
ZCTA5 19567,2089,26131,-24042,5817,36.3,5555,26,81,0.013924703,47537,-41720
ZCTA5 19601,12390,12267,123,35845,30.8,14157,566,4836,0.134914214,31139,4706
ZCTA5 19602,6805,22818,-16013,17568,33.9,8359,176,2134,0.121470856,59379,-41811
ZCTA5 19604,9581,5796,3785,31238,28.7,13307,160,3630,0.116204623,14640,16598
ZCTA5 19605,7702,6363,1339,20532,42.1,15415,324,1517,0.073884668,15796,4736
ZCTA5 19606,13771,13418,353,36052,40.9,29422,770,1527,0.042355487,33991,2061
ZCTA5 19607,9592,7155,2437,24095,40.3,18565,373,1302,0.054036107,18336,5759
ZCTA5 19608,8662,7232,1430,23620,44,19692,845,1774,0.075105843,17367,6253
ZCTA5 19609,4114,21097,-16983,10756,37.6,8007,98,963,0.089531424,52103,-41347
ZCTA5 19610,6783,20338,-13555,16003,46.9,13623,524,385,0.024057989,51213,-35210
ZCTA5 19611,4270,7074,-2804,10849,36.9,5849,497,1226,0.113005807,11713,-864
ZCTA5 19701,16192,12913,3279,43767,41.2,25356,4141,10947,0.250119953,35349,8418
ZCTA5 19702,20724,3974,16750,55745,34.6,25943,6050,18085,0.324423715,5672,50073
ZCTA5 19703,6622,6743,-121,15771,36.7,8492,1344,4877,0.309238476,14304,1467
ZCTA5 19706,679,0,679,1936,39.9,1533,0,216,0.111570248,0,1936
ZCTA5 19707,6261,51,6210,16631,45.5,13463,1899,485,0.029162408,555,16076
ZCTA5 19709,16880,0,16880,46773,41.1,31235,3251,9319,0.199238877,0,46773
ZCTA5 19710,17,0,17,27,58.6,27,0,0,0,4074,-4047
ZCTA5 19711,19358,0,19358,50045,35.3,37335,3556,4585,0.091617544,1684,48361
ZCTA5 19713,11809,3684,8125,29632,38.5,19121,1940,5436,0.183450324,11420,18212
ZCTA5 19716,0,1869,-1869,0,-,0,0,0,#DIV/0!,5416,-5416
ZCTA5 19717,0,12326,-12326,6692,19.4,5436,267,748,0.111775254,34256,-27564
ZCTA5 19720,22685,13428,9257,60599,40.2,26417,1619,24926,0.41132692,43640,16959
ZCTA5 19730,168,9352,-9184,456,42.8,423,0,29,0.063596491,31106,-30650
ZCTA5 19731,114,7819,-7705,273,54.7,273,0,0,0,25777,-25504
ZCTA5 19732,132,2379,-2247,264,68.1,264,0,0,0,6261,-5997
ZCTA5 19733,76,1073,-997,160,51.1,79,0,0,0,2576,-2416
ZCTA5 19734,4271,2,4269,13741,40.7,9571,195,2766,0.201295393,9,13732
ZCTA5 19735,0,1366,-1366,0,-,0,0,0,#DIV/0!,3988,-3988
ZCTA5 19736,13,13754,-13741,13,-,13,0,0,0,41318,-41305
ZCTA5 19801,7463,9825,-2362,16061,34.5,3066,489,11549,0.719071042,28381,-12320
ZCTA5 19802,10740,4887,5853,27363,36.8,5121,195,20546,0.75086796,16032,11331
ZCTA5 19803,8523,208,8315,21550,46.3,18825,802,1044,0.048445476,643,20907
ZCTA5 19804,7443,123,7320,18123,39.7,13511,274,2301,0.126965734,330,17793
ZCTA5 19805,16059,5144,10915,39500,35.8,20892,366,13568,0.343493671,16503,22997
ZCTA5 19806,5932,1312,4620,10044,44,7892,162,1414,0.140780566,2970,7074
ZCTA5 19807,3379,8285,-4906,7628,52,6637,644,178,0.023335081,29346,-21718
ZCTA5 19808,15263,546,14717,39016,42.7,30054,3043,3329,0.08532397,1415,37601
ZCTA5 19809,6198,84,6114,15111,37.9,10540,879,2747,0.181788101,271,14840
ZCTA5 19810,10266,2097,8169,25968,46.6,20660,1741,2498,0.096195317,6558,19410
ZCTA5 19901,14103,370,13733,38634,32.4,20984,1059,12607,0.326318787,1213,37421
ZCTA5 19902,0,532,-532,239,20.9,171,5,56,0.234309623,1389,-1150
ZCTA5 19904,14513,19006,-4493,37940,40.5,20825,928,12186,0.321191355,55759,-17819
ZCTA5 19930,1405,8978,-7573,2799,66.7,2494,47,42,0.015005359,28440,-25641
ZCTA5 19931,162,6594,-6432,348,58.4,282,0,13,0.037356322,21715,-21367
ZCTA5 19933,3712,7670,-3958,10427,38.5,6686,31,2408,0.230938909,25621,-15194
ZCTA5 19934,4745,9794,-5049,14099,39.4,8497,421,3834,0.27193418,29738,-15639
ZCTA5 19936,115,1556,-1441,290,48.9,171,0,52,0.179310345,4395,-4105
ZCTA5 19938,3001,11872,-8871,9467,37.3,6963,214,1572,0.166050491,36201,-26734
ZCTA5 19939,3078,11315,-8237,7968,52.9,7251,12,420,0.052710843,32377,-24409
ZCTA5 19940,2144,3353,-1209,6146,45.9,4580,38,820,0.133420111,9465,-3319
ZCTA5 19941,1014,6526,-5512,2855,32.3,1666,3,722,0.252889667,19702,-16847
ZCTA5 19943,5032,13426,-8394,12581,46,9722,95,2281,0.181305143,41152,-28571
ZCTA5 19944,298,16206,-15908,657,71.1,572,0,0,0,46201,-45544
ZCTA5 19945,3324,9673,-6349,8080,55.9,6050,138,911,0.112747525,28263,-20183
ZCTA5 19946,2010,15022,-13012,5248,45.8,4064,38,872,0.166158537,46270,-41022
ZCTA5 19947,6629,2134,4495,20128,37.4,14511,557,2396,0.119038156,6135,13993
ZCTA5 19950,3016,2500,516,7139,46.7,5917,24,770,0.107858243,7505,-366
ZCTA5 19951,814,279,535,2237,53.5,1980,58,169,0.075547608,807,1430
ZCTA5 19952,3854,5444,-1590,10184,36.4,8229,218,1428,0.140219953,14365,-4181
ZCTA5 19953,1731,5246,-3515,5089,39.3,3714,12,585,0.114953822,15862,-10773
ZCTA5 19954,599,8599,-8000,1556,41.2,1310,0,217,0.139460154,17638,-16082
ZCTA5 19955,97,11406,-11309,412,14.3,372,0,8,0.019417476,28574,-28162
ZCTA5 19956,5625,5829,-204,15349,37.7,11226,52,3000,0.195452472,13436,1913
ZCTA5 19958,13249,611,12638,27944,61.2,25381,460,818,0.029272831,1743,26201
ZCTA5 19960,2489,882,1607,7019,37.9,4853,0,1740,0.247898561,2116,4903
ZCTA5 19962,4142,0,4142,11683,40.7,8823,463,1483,0.126936575,0,11683
ZCTA5 19963,8432,0,8432,21155,42.4,15175,374,3369,0.159253132,0,21155
ZCTA5 19964,541,0,541,1200,43,1200,0,0,0,0,1200
ZCTA5 19966,13797,0,13797,31427,52.5,25394,363,2838,0.090304515,0,31427
ZCTA5 19967,924,0,924,1706,64.8,1650,6,6,0.003516999,0,1706
ZCTA5 19968,5547,0,5547,13829,50,11957,294,1052,0.076072023,0,13829
ZCTA5 19970,3666,0,3666,7484,63.1,7156,86,69,0.009219669,0,7484
ZCTA5 19971,7240,0,7240,14132,61.1,12344,255,927,0.065595811,108,14024
ZCTA5 19973,9659,232,9427,25619,43,16798,324,5843,0.228072915,348,25271
ZCTA5 19975,4395,0,4395,9610,58.7,8773,28,233,0.024245578,106,9504
ZCTA5 19977,8546,0,8546,25907,38.9,15120,224,8375,0.323271703,38,25869
ZCTA5 19979,269,0,269,641,42.5,624,0,0,0,115,526
ZCTA5 19980,100,0,100,168,54.2,135,0,32,0.19047619,0,168
ZCTA5 20001,22974,0,22974,45551,32.9,22822,3985,14109,0.30974073,0,45551
ZCTA5 20002,31832,0,31832,68201,33.5,30310,1903,29894,0.438322019,0,68201
ZCTA5 20003,15993,0,15993,34535,34.5,22741,1373,8291,0.240075286,0,34535
ZCTA5 20004,1270,0,1270,1685,42.3,1429,118,41,0.024332344,0,1685
ZCTA5 20005,8802,0,8802,13444,34.7,8215,864,2500,0.185956561,0,13444
ZCTA5 20006,637,0,637,1072,25.6,587,289,120,0.111940299,0,1072
ZCTA5 20007,11668,0,11668,24311,36.9,19722,1456,1112,0.045740611,0,24311
ZCTA5 20008,16989,0,16989,30461,38.2,22451,2102,3066,0.100653294,0,30461
ZCTA5 20009,28382,0,28382,51288,33.8,32298,3121,9313,0.181582436,0,51288
ZCTA5 20010,14255,0,14255,33656,32.6,15036,1744,8128,0.241502258,0,33656
ZCTA5 20011,26989,0,26989,67386,37.7,14333,1457,37206,0.55213249,0,67386
ZCTA5 20012,6784,0,6784,17526,40.6,4413,128,9530,0.543763551,0,17526
ZCTA5 20015,6072,0,6072,15677,45.1,11446,994,1546,0.098615807,0,15677
ZCTA5 20016,14092,8298,5794,34422,39.8,26406,2590,2846,0.082679682,24801,9621
ZCTA5 20017,8108,8894,-786,20221,36.1,6201,809,11492,0.568320063,25225,-5004
ZCTA5 20018,8858,10443,-1585,20084,40.6,3393,349,14050,0.69956184,30628,-10544
ZCTA5 20019,26184,153,26031,64031,33.2,1383,112,59456,0.928550233,335,63696
ZCTA5 20020,23071,3222,19849,54812,33,1722,449,49410,0.901444939,9560,45252
ZCTA5 20024,8939,310,8629,14525,36.1,7034,520,5638,0.388158348,813,13712
ZCTA5 20032,17796,412,17384,40716,31.8,3682,215,34389,0.844606543,1066,39650
ZCTA5 20036,3664,373,3291,4669,33.8,3680,645,122,0.026129792,878,3791
ZCTA5 20037,6696,141,6555,13037,28.4,9793,1370,705,0.054076858,259,12778
ZCTA5 20045,0,4405,-4405,0,-,0,0,0,#DIV/0!,13446,-13446
ZCTA5 20052,0,100,-100,3581,19.6,2643,346,358,0.099972075,244,3337
ZCTA5 20057,0,2206,-2206,3914,19.9,2304,810,299,0.076392437,6369,-2455
ZCTA5 20059,0,264,-264,1518,18.9,348,45,1086,0.71541502,878,640
ZCTA5 20064,0,264,-264,1873,19.8,1383,137,197,0.105178857,705,1168
ZCTA5 20105,9366,3808,5558,30927,36,16586,8114,3351,0.108351926,9817,21110
ZCTA5 20106,1631,601,1030,4476,47.8,4073,18,74,0.016532618,1586,2890
ZCTA5 20109,14582,469,14113,44512,32.8,25328,4040,7123,0.160024263,1180,43332
ZCTA5 20110,15263,1512,13751,49993,35.1,28559,2616,6711,0.134238793,4651,45342
ZCTA5 20111,11025,843,10182,36331,35.2,21793,3258,4250,0.11697999,3016,33315
ZCTA5 20112,8894,469,8425,27677,42,19710,1986,3142,0.113523865,1164,26513
ZCTA5 20115,2713,274,2439,7898,41.1,6793,33,504,0.063813624,644,7254
ZCTA5 20117,1407,168,1239,2959,52.1,2614,3,224,0.07570125,359,2600
ZCTA5 20119,1208,142,1066,3819,43.2,3400,141,64,0.016758314,305,3514
ZCTA5 20120,14167,143,14024,43649,37,22383,12323,3024,0.069279938,227,43422
ZCTA5 20121,9458,69,9389,27432,34.9,12648,7734,2260,0.082385535,187,27245
ZCTA5 20124,5052,148,4904,15439,46,9987,3779,504,0.032644601,331,15108
ZCTA5 20129,213,2300,-2087,615,54.7,516,23,0,0,6252,-5637
ZCTA5 20130,107,3782,-3675,255,42.8,255,0,0,0,10435,-10180
ZCTA5 20132,5710,1625,4085,18765,38.1,15534,347,1105,0.058886224,4856,13909
ZCTA5 20135,1417,4542,-3125,3341,46.2,3020,27,148,0.044298114,14442,-11101
ZCTA5 20136,8977,3426,5551,31074,37.1,20504,3648,3530,0.113599794,9945,21129
ZCTA5 20137,718,312,406,1981,53.8,1827,20,9,0.00454316,862,1119
ZCTA5 20141,2555,6667,-4112,8281,36.3,7032,287,421,0.050839271,18866,-10585
ZCTA5 20143,231,4687,-4456,594,49.7,422,77,0,0,13569,-12975
ZCTA5 20144,610,9299,-8689,1397,58.7,1309,4,84,0.060128848,26057,-24660
ZCTA5 20147,23624,7145,16479,65927,37.8,40495,14431,4157,0.063054591,20538,45389
ZCTA5 20148,18902,354,18548,59843,36.2,27327,22334,4457,0.074478218,990,58853
ZCTA5 20151,6681,7533,-852,22181,40.2,10017,8299,1040,0.046886975,23320,-1139
ZCTA5 20152,10964,20,10944,36082,36.9,15602,12802,3719,0.103070783,44,36038
ZCTA5 20155,12052,894,11158,36989,37.8,22815,4664,4496,0.12154965,2752,34237
ZCTA5 20158,1484,1093,391,4929,40.6,4311,131,87,0.017650639,2636,2293
ZCTA5 20164,12583,141,12442,42630,34.5,20171,6546,2912,0.068308703,416,42214
ZCTA5 20165,11926,252,11674,33828,37.5,22507,4391,2166,0.064029798,1203,32625
ZCTA5 20166,4672,418,4254,13148,32.7,4855,4227,1486,0.113020992,925,12223
ZCTA5 20169,8820,647,8173,28087,40,20268,3010,2364,0.084167052,1663,26424
ZCTA5 20170,13764,1298,12466,43028,36,23155,6790,2820,0.065538719,3775,39253
ZCTA5 20171,17812,829,16983,50005,35.8,25304,17407,3510,0.070192981,2802,47203
ZCTA5 20175,11500,3968,7532,33343,38.1,25294,2161,2474,0.074198482,11168,22175
ZCTA5 20176,16563,505,16058,50070,37.8,34356,6135,4570,0.091272219,1148,48922
ZCTA5 20180,2573,378,2195,7494,45.2,6285,384,374,0.049906592,959,6535
ZCTA5 20181,2978,2277,701,9431,39.6,8053,267,442,0.046866716,6818,2613
ZCTA5 20184,209,22,187,329,59.9,238,0,91,0.276595745,754,-425
ZCTA5 20186,5889,197,5692,15396,41.9,12160,244,1570,0.101974539,368,15028
ZCTA5 20187,6241,987,5254,19110,39.5,16560,496,1182,0.061852433,1645,17465
ZCTA5 20190,10301,522,9779,21219,39.4,14315,2462,2178,0.102643857,1865,19354
ZCTA5 20191,11898,213,11685,30185,39.1,19073,3788,3044,0.10084479,394,29791
ZCTA5 20194,5638,538,5100,12313,42.4,9061,1383,515,0.041825713,1312,11001
ZCTA5 20197,915,331,584,2569,45.1,2350,28,2,0.000778513,926,1643
ZCTA5 20198,760,2143,-1383,2095,46.1,1934,1,37,0.017661098,5770,-3675
ZCTA5 20204,0,0,0,0,-,0,0,0,#DIV/0!,122,-122
ZCTA5 20220,0,8673,-8673,0,-,0,0,0,#DIV/0!,25222,-25222
ZCTA5 20230,0,12182,-12182,0,-,0,0,0,#DIV/0!,37358,-37358
ZCTA5 20240,0,11959,-11959,0,-,0,0,0,#DIV/0!,31459,-31459
ZCTA5 20245,0,9976,-9976,0,-,0,0,0,#DIV/0!,25206,-25206
ZCTA5 20250,0,3803,-3803,0,-,0,0,0,#DIV/0!,9323,-9323
ZCTA5 20260,0,2473,-2473,0,-,0,0,0,#DIV/0!,6462,-6462
ZCTA5 20317,0,3684,-3684,0,-,0,0,0,#DIV/0!,8965,-8965
ZCTA5 20319,0,1766,-1766,50,22.7,27,8,3,0.06,4077,-4027
ZCTA5 20373,49,8707,-8658,437,21.1,274,25,110,0.251716247,27011,-26574
ZCTA5 20388,0,7849,-7849,0,-,0,0,0,#DIV/0!,20485,-20485
ZCTA5 20390,0,6867,-6867,404,21.6,288,24,34,0.084158416,21356,-20952
ZCTA5 20408,0,9135,-9135,0,-,0,0,0,#DIV/0!,26134,-26134
ZCTA5 20415,0,1676,-1676,0,-,0,0,0,#DIV/0!,5571,-5571
ZCTA5 20418,0,10067,-10067,0,-,0,0,0,#DIV/0!,28739,-28739
ZCTA5 20422,0,6276,-6276,67,73.5,9,0,58,0.865671642,15177,-15110
ZCTA5 20427,0,3382,-3382,0,-,0,0,0,#DIV/0!,9616,-9616
ZCTA5 20431,0,970,-970,0,-,0,0,0,#DIV/0!,2708,-2708
ZCTA5 20510,0,12109,-12109,0,-,0,0,0,#DIV/0!,35555,-35555
ZCTA5 20515,0,3052,-3052,0,-,0,0,0,#DIV/0!,9264,-9264
ZCTA5 20520,0,6234,-6234,0,-,0,0,0,#DIV/0!,20195,-20195
ZCTA5 20530,0,9061,-9061,0,-,0,0,0,#DIV/0!,27776,-27776
ZCTA5 20535,0,0,0,0,-,0,0,0,#DIV/0!,8822,-8822
ZCTA5 20540,0,14015,-14015,0,-,0,0,0,#DIV/0!,36099,-36099
ZCTA5 20542,0,18210,-18210,0,-,0,0,0,#DIV/0!,51088,-51088
ZCTA5 20551,0,10254,-10254,0,-,0,0,0,#DIV/0!,28626,-28626
ZCTA5 20560,0,11370,-11370,0,-,0,0,0,#DIV/0!,28009,-28009
ZCTA5 20565,0,15288,-15288,0,-,0,0,0,#DIV/0!,39879,-39879
ZCTA5 20566,0,15536,-15536,0,-,0,0,0,#DIV/0!,39490,-39490
ZCTA5 20591,0,938,-938,0,-,0,0,0,#DIV/0!,2127,-2127
ZCTA5 20601,9544,2359,7185,26740,36.8,7942,831,15473,0.578646223,6978,19762
ZCTA5 20602,10426,2890,7536,28277,34.4,7403,641,17499,0.618842169,10712,17565
ZCTA5 20603,10944,225,10719,31897,38.5,8045,1796,18827,0.590243597,668,31229
ZCTA5 20606,52,1042,-990,101,59.2,101,0,0,0,3437,-3336
ZCTA5 20607,3932,905,3027,11122,45.1,2616,618,6761,0.607894264,3210,7912
ZCTA5 20608,264,901,-637,734,51.1,172,8,362,0.493188011,2347,-1613
ZCTA5 20609,508,1645,-1137,1611,48.5,1075,34,416,0.258224705,4590,-2979
ZCTA5 20611,429,189,240,1111,49.1,793,7,80,0.072007201,420,691
ZCTA5 20612,69,2084,-2015,132,91.1,132,0,0,0,6244,-6112
ZCTA5 20613,5058,10433,-5375,14595,44.2,3530,419,9318,0.638437821,24816,-10221
ZCTA5 20615,223,15671,-15448,583,43.8,583,0,0,0,43925,-43342
ZCTA5 20616,2468,15726,-13258,6934,34.3,1303,173,5028,0.725122584,42351,-35417
ZCTA5 20617,198,1166,-968,521,46.4,428,0,56,0.107485605,3607,-3086
ZCTA5 20618,389,1028,-639,941,63.3,440,7,483,0.513283741,3199,-2258
ZCTA5 20619,5160,736,4424,13244,34.3,10273,206,1745,0.131757777,2152,11092
ZCTA5 20620,520,509,11,1488,46.4,870,44,150,0.100806452,1192,296
ZCTA5 20621,396,3979,-3583,786,51.7,705,0,81,0.103053435,11920,-11134
ZCTA5 20622,1609,11017,-9408,6005,40.3,4554,216,526,0.087593672,33769,-27764
ZCTA5 20623,830,12595,-11765,2534,49.8,360,35,2045,0.807024467,46389,-43855
ZCTA5 20624,306,9655,-9349,859,47.5,853,0,0,0,29515,-28656
ZCTA5 20625,444,13012,-12568,1065,51.4,1001,0,0,0,35771,-34706
ZCTA5 20626,109,2929,-2820,224,56.6,218,0,6,0.026785714,14682,-14458
ZCTA5 20628,257,100,157,586,55.6,406,0,95,0.162116041,232,354
ZCTA5 20629,332,12572,-12240,864,52.6,594,177,43,0.049768519,26998,-26134
ZCTA5 20630,167,13524,-13357,305,57.2,275,0,18,0.059016393,30323,-30018
ZCTA5 20632,131,6006,-5875,656,39.2,281,291,56,0.085365854,15904,-15248
ZCTA5 20634,2915,13174,-10259,8198,31.8,5085,225,2333,0.284581605,36222,-28024
ZCTA5 20636,3349,775,2574,10421,39.3,9454,35,155,0.014873812,2057,8364
ZCTA5 20637,2035,8419,-6384,6223,43.5,3672,122,1773,0.284910815,24919,-18696
ZCTA5 20639,4705,2689,2016,14853,38.7,11631,375,1583,0.106577796,7698,7155
ZCTA5 20640,4042,1904,2138,10853,37.2,4203,348,5727,0.527688197,5657,5196
ZCTA5 20645,268,97,171,711,50.1,637,0,0,0,267,444
ZCTA5 20646,7001,99,6902,20608,43.3,15000,583,4119,0.199873835,195,20413
ZCTA5 20650,5158,2795,2363,14852,38.3,11761,493,825,0.055548074,10637,4215
ZCTA5 20653,10367,614,9753,26480,34.2,15877,1417,6422,0.242522659,1622,24858
ZCTA5 20656,50,18180,-18130,84,59.9,0,0,84,1,45464,-45380
ZCTA5 20657,7253,4932,2321,20420,35.8,16817,151,2477,0.121302644,13665,6755
ZCTA5 20658,394,18771,-18377,929,46.3,619,11,247,0.265877287,40725,-39796
ZCTA5 20659,7984,9581,-1597,23990,38.1,20665,96,2146,0.089453939,29548,-5558
ZCTA5 20660,0,16610,-16610,0,-,0,0,0,#DIV/0!,49714,-49714
ZCTA5 20661,0,4750,-4750,0,-,0,0,0,#DIV/0!,14377,-14377
ZCTA5 20662,923,805,118,2437,49.7,1471,29,690,0.283135002,2375,62
ZCTA5 20664,1254,653,601,3327,36.4,2457,6,705,0.211902615,1596,1731
ZCTA5 20667,180,75,105,347,65,230,0,117,0.337175793,175,172
ZCTA5 20670,298,4434,-4136,1451,22,1042,20,208,0.143349414,12557,-11106
ZCTA5 20674,297,354,-57,1102,35.8,824,18,104,0.094373866,1335,-233
ZCTA5 20675,694,4105,-3411,1772,54.8,875,31,699,0.394469526,12953,-11181
ZCTA5 20676,1175,4324,-3149,3036,41.9,2514,0,310,0.102108037,13264,-10228
ZCTA5 20677,786,21631,-20845,2165,50,1752,55,338,0.156120092,57883,-55718
ZCTA5 20678,4506,8612,-4106,12415,38.2,9039,466,2149,0.17309706,25895,-13480
ZCTA5 20680,225,11647,-11422,671,34.4,485,0,72,0.107302534,33519,-32848
ZCTA5 20684,339,22517,-22178,775,54.8,711,0,38,0.049032258,62983,-62208
ZCTA5 20685,2460,8077,-5617,6874,47.3,5579,21,986,0.143439046,24630,-17756
ZCTA5 20686,0,233,-233,1135,20.3,884,93,122,0.107488987,489,646
ZCTA5 20687,208,4468,-4260,417,56.5,275,52,62,0.148681055,14294,-13877
ZCTA5 20688,716,12089,-11373,1390,68.6,1383,0,6,0.004316547,33725,-32335
ZCTA5 20689,629,6979,-6350,2331,43.2,1435,54,628,0.269412269,18711,-16380
ZCTA5 20690,329,330,-1,886,52.9,819,35,23,0.025959368,973,-87
ZCTA5 20692,216,130,86,612,54.2,536,0,1,0.001633987,130,482
ZCTA5 20693,350,12241,-11891,1300,36.1,751,0,217,0.166923077,35135,-33835
ZCTA5 20695,4073,16411,-12338,11822,41.2,3468,397,6804,0.575537134,49458,-37636
ZCTA5 20701,260,7287,-7027,787,30.3,357,0,421,0.534942821,25445,-24658
ZCTA5 20705,8958,20447,-11489,27914,36,5475,3548,9712,0.347925772,55956,-28042
ZCTA5 20706,13111,5712,7399,44305,37.9,4079,2118,28592,0.645344769,17489,26816
ZCTA5 20707,13525,23890,-10365,36020,38,9032,4022,16392,0.455080511,64936,-28916
ZCTA5 20708,10279,17892,-7613,27262,35.6,5032,774,17352,0.636490353,37510,-10248
ZCTA5 20710,3497,9629,-6132,9699,32.3,466,94,6130,0.63202392,24857,-15158
ZCTA5 20711,2272,8341,-6069,7299,37.8,4538,32,948,0.129880806,21213,-13914
ZCTA5 20712,4592,484,4108,9784,39,1944,107,4488,0.458708095,1889,7895
ZCTA5 20714,1660,11000,-9340,4678,32,3415,162,796,0.170158187,29322,-24644
ZCTA5 20715,8996,56,8940,26880,41.2,12653,1350,10210,0.37983631,294,26586
ZCTA5 20716,8805,7701,1104,22390,41.7,4398,841,15253,0.681241626,20784,1606
ZCTA5 20720,8147,1684,6463,26042,40.2,3683,1835,17972,0.690115967,5093,20949
ZCTA5 20721,10364,13132,-2768,30771,46.4,2032,645,26020,0.845601378,34468,-3697
ZCTA5 20722,2135,9713,-7578,6116,37.7,1027,274,1990,0.325376063,28286,-22170
ZCTA5 20723,11878,2697,9181,35342,36.3,15094,6054,10120,0.286344859,7335,28007
ZCTA5 20724,6962,1216,5746,18059,34.4,6020,963,8674,0.480314525,3565,14494
ZCTA5 20732,4069,3379,690,10447,42.8,8435,352,1168,0.111802431,11236,-789
ZCTA5 20733,1085,10285,-9200,2938,46.4,2521,38,281,0.095643295,23754,-20816
ZCTA5 20735,13117,0,13117,39181,43.8,3619,965,30966,0.790332049,35,39146
ZCTA5 20736,3363,3109,254,9393,43.9,7691,58,830,0.088363675,8626,767
ZCTA5 20737,6492,1173,5319,23562,31.8,5081,1103,6270,0.266106443,3283,20279
ZCTA5 20740,11182,2523,8659,37168,24.8,17165,5328,7856,0.211364615,7991,29177
ZCTA5 20742,0,639,-639,4188,18.8,2463,705,837,0.199856734,2187,2001
ZCTA5 20743,15013,7659,7354,38742,39.4,1797,203,32442,0.837385783,20525,18217
ZCTA5 20744,19724,9018,10706,56185,43.8,5151,2749,38717,0.689098514,24282,31903
ZCTA5 20745,11674,13368,-1694,29736,38.9,2142,1051,19398,0.652340597,39556,-9820
ZCTA5 20746,12447,15297,-2850,27669,40.2,1648,494,23263,0.840760418,41498,-13829
ZCTA5 20747,16493,17415,-922,41445,36.7,1370,373,36149,0.87221619,40854,591
ZCTA5 20748,16075,15039,1036,40644,39.5,1676,218,34780,0.855722862,40367,277
ZCTA5 20751,928,6363,-5435,2055,50.4,1835,0,2,0.000973236,15569,-13514
ZCTA5 20754,2277,4096,-1819,7108,39.4,5981,172,516,0.07259426,12014,-4906
ZCTA5 20755,2943,3762,-819,11253,25.1,5846,849,3031,0.269350395,10712,541
ZCTA5 20758,240,6311,-6071,633,52.6,591,0,42,0.066350711,18954,-18321
ZCTA5 20759,1903,96,1807,5935,37.9,3394,1292,698,0.117607414,227,5708
ZCTA5 20762,841,86,755,3419,22.6,1919,134,815,0.238373794,227,3192
ZCTA5 20763,1093,1157,-64,2518,40.2,1352,202,899,0.357029388,3300,-782
ZCTA5 20764,1444,3488,-2044,3371,51.6,2530,75,543,0.161079798,9441,-6070
ZCTA5 20765,188,57,131,548,53.2,415,0,133,0.24270073,141,407
ZCTA5 20769,2173,1549,624,6831,42.8,1680,1133,3346,0.489825794,3993,2838
ZCTA5 20770,12019,11149,870,28820,35,6615,2438,14569,0.505517002,28848,-28
ZCTA5 20771,0,21322,-21322,0,-,0,0,0,#DIV/0!,52784,-52784
ZCTA5 20772,18915,155,18760,53161,42.2,6932,362,42088,0.791708207,275,52886
ZCTA5 20774,20011,5311,14700,50483,42.3,2926,1021,43898,0.86956005,14220,36263
ZCTA5 20776,1121,9678,-8557,2921,48.2,2646,0,239,0.081821294,26220,-23299
ZCTA5 20777,1156,4710,-3554,3312,49.1,2384,662,175,0.052838164,13205,-9893
ZCTA5 20778,809,65,744,2287,48.1,2140,0,29,0.012680367,117,2170
ZCTA5 20779,514,7583,-7069,1041,59.6,1015,0,26,0.024975985,18441,-17400
ZCTA5 20781,4291,271,4020,12940,32.4,4652,194,3247,0.250927357,543,12397
ZCTA5 20782,12286,2712,9574,34492,36.4,6680,1516,12891,0.373738838,7548,26944
ZCTA5 20783,13533,6376,7157,49648,31.6,4861,1386,12460,0.250966806,16581,33067
ZCTA5 20784,10120,1883,8237,32355,35.5,3688,475,17179,0.530953485,5391,26964
ZCTA5 20785,15401,3733,11668,41655,36.2,3522,1517,31306,0.751554435,10273,31382
ZCTA5 20794,3963,15836,-11873,17062,37.9,6889,552,8001,0.468936819,36282,-19220
ZCTA5 20812,99,4191,-4092,291,48.2,247,3,4,0.013745704,11218,-10927
ZCTA5 20814,13429,1608,11821,29685,39.8,21692,3364,1788,0.060232441,5018,24667
ZCTA5 20815,13233,12,13221,31235,46.8,24801,2163,2476,0.07927005,25,31210
ZCTA5 20816,6373,6339,34,17433,44.2,14597,1010,390,0.022371365,18074,-641
ZCTA5 20817,13619,1658,11961,38286,45.3,26101,5730,2399,0.06265998,4624,33662
ZCTA5 20818,755,12128,-11373,1934,49.8,1384,242,63,0.032574974,30570,-28636
ZCTA5 20832,8485,9707,-1222,25852,41.3,15612,3416,3688,0.142658208,26196,-344
ZCTA5 20833,2615,22312,-19697,8054,47.3,5503,702,852,0.105785945,55580,-47526
ZCTA5 20837,2229,2372,-143,6604,44.2,5662,205,418,0.063294973,6732,-128
ZCTA5 20838,90,21308,-21218,362,34.6,324,0,0,0,60168,-59806
ZCTA5 20839,62,4878,-4816,161,37.6,161,0,0,0,13449,-13288
ZCTA5 20841,2920,83,2837,9760,46.2,3610,4547,1082,0.110860656,282,9478
ZCTA5 20842,661,2396,-1735,1824,50,1458,5,195,0.106907895,7073,-5249
ZCTA5 20850,20766,838,19928,51707,40.3,26290,12905,6244,0.120757344,2311,49396
ZCTA5 20851,5168,10965,-5797,14840,37.8,5848,2306,1849,0.124595687,29896,-15056
ZCTA5 20852,21414,12310,9104,48194,38.3,27906,8609,5165,0.107171017,34471,13723
ZCTA5 20853,9794,1294,8500,31670,40.3,18855,3790,3575,0.112882854,3479,28191
ZCTA5 20854,17030,10872,6158,49684,47.7,32444,10490,2884,0.058046856,31928,17756
ZCTA5 20855,6140,9307,-3167,17123,41.7,10001,2842,1977,0.11545874,26521,-9398
ZCTA5 20860,746,2576,-1830,2237,43.4,1013,135,602,0.269110416,6324,-4087
ZCTA5 20861,1135,114,1021,3195,54.9,1731,403,411,0.128638498,344,2851
ZCTA5 20862,155,2300,-2145,444,58.6,318,0,78,0.175675676,6843,-6399
ZCTA5 20866,5006,922,4084,16791,38.8,3516,4060,7570,0.450836758,2236,14555
ZCTA5 20868,156,147,9,624,35,315,47,12,0.019230769,388,236
ZCTA5 20871,8185,13735,-5550,26366,36.4,9510,9672,4023,0.152582872,37990,-11624
ZCTA5 20872,4510,7130,-2620,12835,41.9,9243,703,1484,0.115621348,19673,-6838
ZCTA5 20874,22011,856,21155,62270,36.8,25330,10833,13904,0.223285691,2210,60060
ZCTA5 20876,8598,2069,6529,25963,35.9,8082,5962,8127,0.313022378,6278,19685
ZCTA5 20877,12496,1171,11325,37094,37.6,12769,5799,7154,0.192861379,3351,33743
ZCTA5 20878,24477,2441,22036,65999,40.7,32750,17886,6912,0.10472886,7373,58626
ZCTA5 20879,8836,8723,113,27244,35.9,11053,4147,5535,0.203163999,15547,11697
ZCTA5 20880,319,8211,-7892,700,55.5,550,16,75,0.107142857,22054,-21354
ZCTA5 20882,4657,7076,-2419,14301,45.8,10832,1085,862,0.060275505,19930,-5629
ZCTA5 20886,12305,5414,6891,34436,38,13127,4610,8302,0.241084911,17042,17394
ZCTA5 20889,0,19514,-19514,407,21.8,265,0,34,0.083538084,50147,-49740
ZCTA5 20892,0,19135,-19135,0,-,0,0,0,#DIV/0!,49520,-49520
ZCTA5 20894,0,14312,-14312,0,-,0,0,0,#DIV/0!,32488,-32488
ZCTA5 20895,7082,11738,-4656,19051,42.1,14073,1000,1051,0.055167708,28202,-9151
ZCTA5 20896,336,5448,-5112,892,52.2,796,51,10,0.011210762,14971,-14079
ZCTA5 20899,217,7929,-7712,322,45,58,0,252,0.782608696,16927,-16605
ZCTA5 20901,13012,13342,-330,36493,38.8,17090,2834,10508,0.287945633,33408,3085
ZCTA5 20902,17776,11153,6623,53476,36.9,20749,4355,9090,0.169982796,30391,23085
ZCTA5 20903,7211,7767,-556,26728,31.8,4041,2539,7219,0.27009129,19589,7139
ZCTA5 20904,20706,23008,-2302,55912,40.9,15259,7365,26156,0.467806553,63515,-7603
ZCTA5 20905,5564,10362,-4798,17984,41.1,8108,2514,4585,0.254948843,25946,-7962
ZCTA5 20906,25547,15048,10499,70985,39.8,24048,7949,17145,0.241529901,39788,31197
ZCTA5 20910,21332,19242,2090,44812,35,22296,3524,13157,0.293604392,51290,-6478
ZCTA5 20912,9738,3588,6150,26120,36.4,9370,1135,9715,0.371937213,9266,16854
ZCTA5 21001,10275,14922,-4647,25708,36.5,15544,893,6534,0.254162129,39313,-13605
ZCTA5 21005,758,16221,-15463,2862,29.3,1328,45,1156,0.403913347,41575,-38713
ZCTA5 21009,12367,21621,-9254,31964,37,23663,1597,5047,0.157896383,55163,-23199
ZCTA5 21010,103,9294,-9191,272,21.2,206,0,51,0.1875,25270,-24998
ZCTA5 21012,8136,18120,-9984,23536,38.1,19593,824,1211,0.051453093,47784,-24248
ZCTA5 21013,1855,12218,-10363,5297,46.7,4945,42,108,0.020388899,35401,-30104
ZCTA5 21014,14270,2764,11506,36247,41.7,30410,1064,1946,0.053687202,6795,29452
ZCTA5 21015,10916,12986,-2070,30781,40.4,25822,1199,2407,0.078197589,34624,-3843
ZCTA5 21017,2384,18953,-16569,5816,36.7,3939,119,1302,0.223865199,48191,-42375
ZCTA5 21023,30,17266,-17236,58,60.9,58,0,0,0,45438,-45380
ZCTA5 21028,965,14086,-13121,2562,49.9,2337,76,30,0.011709602,33364,-30802
ZCTA5 21029,3964,7520,-3556,13507,43.3,5866,5624,1195,0.088472644,16367,-2860
ZCTA5 21030,10843,28656,-17813,25900,36.6,16471,2549,3950,0.152509653,68256,-42356
ZCTA5 21031,18,15226,-15208,26,-,0,0,26,1,37599,-37573
ZCTA5 21032,2902,11481,-8579,7594,51.4,6770,79,538,0.070845404,29728,-22134
ZCTA5 21034,1203,11142,-9939,2988,51,2854,4,21,0.007028112,29726,-26738
ZCTA5 21035,2897,0,2897,8404,45,7903,52,168,0.019990481,0,8404
ZCTA5 21036,744,14050,-13306,1995,48.4,1636,165,70,0.035087719,36875,-34880
ZCTA5 21037,7981,0,7981,21420,40.3,19472,214,1199,0.055975724,3351,18069
ZCTA5 21040,9162,0,9162,24811,35.4,9900,575,11737,0.473056306,801,24010
ZCTA5 21042,14748,0,14748,42952,44,25252,12705,2202,0.05126653,2675,40277
ZCTA5 21043,17098,8098,9000,47358,38.5,25823,11786,4938,0.104269606,19506,27852
ZCTA5 21044,18237,16286,1951,44662,39.7,21638,5432,12593,0.281962295,37112,7550
ZCTA5 21045,15307,336,14971,40522,38.1,19273,5038,12051,0.297394008,6121,34401
ZCTA5 21046,6189,12997,-6808,15484,37.7,8692,1124,4652,0.300439163,30044,-14560
ZCTA5 21047,4643,139,4504,13279,43.6,11583,678,261,0.019655095,435,12844
ZCTA5 21048,3715,7145,-3430,10084,47.1,9025,392,308,0.030543435,19563,-9479
ZCTA5 21050,6399,16488,-10089,18193,42.9,17153,234,299,0.016434893,43549,-25356
ZCTA5 21051,63,764,-701,149,54.4,149,0,0,0,1924,-1775
ZCTA5 21052,249,536,-287,670,33.4,654,16,0,0,1498,-828
ZCTA5 21053,1123,46,1077,3126,41.8,2829,0,79,0.025271913,101,3025
ZCTA5 21054,4946,104,4842,14479,41,9694,1083,1699,0.117342358,299,14180
ZCTA5 21056,127,245,-118,274,66.4,274,0,0,0,731,-457
ZCTA5 21057,1614,184,1430,4485,47.2,4258,35,123,0.027424749,414,4071
ZCTA5 21060,15007,652,14355,37038,38.4,23662,1470,7996,0.215886387,1597,35441
ZCTA5 21061,22311,1027,21284,55960,36.1,31923,2684,15217,0.271926376,2239,53721
ZCTA5 21071,158,6223,-6065,463,47.6,397,0,0,0,15883,-15420
ZCTA5 21074,6005,1635,4370,14887,40.9,13538,442,412,0.027675153,4370,10517
ZCTA5 21075,12322,236,12086,35516,33.9,16400,7029,9091,0.255969141,718,34798
ZCTA5 21076,7932,1031,6901,19684,35.7,9905,2205,5409,0.274791709,2738,16946
ZCTA5 21077,43,42,1,76,48.6,64,0,12,0.157894737,109,-33
ZCTA5 21078,8004,620,7384,19760,45.1,14629,472,2807,0.142054656,1222,18538
ZCTA5 21082,272,172,100,740,46.3,699,11,0,0,484,256
ZCTA5 21084,2675,52,2623,7254,49.7,6627,228,168,0.023159636,113,7141
ZCTA5 21085,6451,751,5700,16350,43.2,13149,249,2171,0.132782875,1897,14453
ZCTA5 21087,2197,5971,-3774,5740,51.7,5542,29,60,0.010452962,14423,-8683
ZCTA5 21090,3703,586,3117,9921,38.5,8967,189,423,0.042636831,1590,8331
ZCTA5 21093,15769,862,14907,39817,46,32108,3968,1895,0.047592737,2168,37649
ZCTA5 21102,4342,1132,3210,12193,42.3,11422,87,234,0.019191339,2731,9462
ZCTA5 21104,2030,1212,818,6212,46.1,4859,713,221,0.035576304,3247,2965
ZCTA5 21105,0,9684,-9684,0,-,0,0,0,#DIV/0!,23633,-23633
ZCTA5 21108,6092,205,5887,17133,41.1,13871,835,909,0.053055507,652,16481
ZCTA5 21111,1854,170,1684,5155,45.1,5050,2,40,0.007759457,460,4695
ZCTA5 21113,14974,136,14838,35242,36.3,19288,2108,9440,0.26786221,306,34936
ZCTA5 21114,9334,7517,1817,25955,35.5,17867,1843,3967,0.152841456,17618,8337
ZCTA5 21117,23142,3533,19609,59321,36.3,20638,3818,30190,0.508926013,9616,49705
ZCTA5 21120,2427,2310,117,7243,43.7,6401,230,187,0.025818031,5949,1294
ZCTA5 21122,22734,4858,17876,61212,40.1,50946,1421,3952,0.064562504,12415,48797
ZCTA5 21128,5437,254,5183,14987,41.8,10269,2151,1810,0.120771335,667,14320
ZCTA5 21130,21,563,-542,66,49.5,66,0,0,0,2021,-1955
ZCTA5 21131,2696,58,2638,7678,46.9,7137,128,23,0.002995572,122,7556
ZCTA5 21132,1007,978,29,3115,38.9,3109,0,0,0,2562,553
ZCTA5 21133,11674,52,11622,31383,42.4,3518,508,24958,0.795271325,102,31281
ZCTA5 21136,13746,7,13739,35306,43.9,20944,2881,8751,0.247861553,15,35291
ZCTA5 21140,1474,173,1301,4063,46,3934,9,10,0.002461236,324,3739
ZCTA5 21144,12781,3221,9560,36625,36,18270,2837,11531,0.31483959,9575,27050
ZCTA5 21146,9990,1149,8841,28410,42.4,25316,682,745,0.026223161,2681,25729
ZCTA5 21152,2651,2455,196,6420,42.8,5756,252,168,0.026168224,5861,559
ZCTA5 21153,318,143,175,684,61.8,653,23,8,0.011695906,410,274
ZCTA5 21154,2429,810,1619,7002,49.8,6602,43,252,0.035989717,2204,4798
ZCTA5 21155,978,548,430,2803,40.4,2628,40,49,0.01748127,1460,1343
ZCTA5 21156,126,1766,-1640,381,37.6,346,10,0,0,4881,-4500
ZCTA5 21157,14410,1661,12749,39978,41,36314,309,1551,0.038796338,4647,35331
ZCTA5 21158,8355,527,7828,22221,42.1,19685,544,624,0.028081544,1367,20854
ZCTA5 21160,984,17,967,2809,44,2670,89,38,0.013527946,53,2756
ZCTA5 21161,2125,2106,19,5965,46.8,5843,17,14,0.002347024,5298,667
ZCTA5 21162,1423,25,1398,4640,37.5,3588,82,702,0.151293103,90,4550
ZCTA5 21163,2535,442,2093,6891,46,3219,1530,1578,0.22899434,1292,5599
ZCTA5 21201,10068,160,9908,17773,31.7,5834,964,9509,0.535025038,341,17432
ZCTA5 21202,10095,128,9967,21314,33.6,7485,942,11807,0.553955147,308,21006
ZCTA5 21204,8363,517,7846,21378,33.9,15099,1295,3845,0.179857798,1906,19472
ZCTA5 21205,5265,88,5177,15319,31.4,2538,492,10101,0.659377244,266,15053
ZCTA5 21206,20047,1027,19020,51643,36.2,10909,775,37915,0.734175009,3193,48450
ZCTA5 21207,19360,73,19287,51927,37.7,4849,1092,43077,0.829568433,117,51810
ZCTA5 21208,15289,66,15223,36447,46.2,18512,716,15675,0.43007655,106,36341
ZCTA5 21209,11511,510,11001,30146,34.9,20786,1835,6348,0.210575201,1003,29143
ZCTA5 21210,5337,1764,3573,15942,28,10446,1470,2435,0.152741187,4945,10997
ZCTA5 21211,8333,262,8071,16420,36.3,12943,875,1726,0.105115713,908,15512
ZCTA5 21212,12679,1469,11210,34525,38.1,17601,1277,13151,0.380912382,4009,30516
ZCTA5 21213,11288,635,10653,29579,37.2,2180,23,26288,0.888738632,1724,27855
ZCTA5 21214,8381,1425,6956,21924,41.3,7917,134,12667,0.577768655,4108,17816
ZCTA5 21215,21287,1155,20132,52550,44.2,9017,670,40534,0.771341579,2708,49842
ZCTA5 21216,11196,261,10935,27643,36.7,388,91,26366,0.953803856,808,26835
ZCTA5 21217,14392,1664,12728,31694,40.8,4055,357,26457,0.834763678,3375,28319
ZCTA5 21218,18180,264,17916,47081,33.3,13823,2135,28317,0.601452815,763,46318
ZCTA5 21219,3449,135,3314,9278,46,8143,599,304,0.032765682,329,8949
ZCTA5 21220,15970,4411,11559,41627,39.2,25065,1973,11222,0.269584645,12498,29129
ZCTA5 21221,16827,109,16718,43576,39.9,26763,730,12771,0.293074169,194,43382
ZCTA5 21222,22322,580,21742,59622,37.4,41908,1501,9944,0.166784073,1713,57909
ZCTA5 21223,8292,65,8227,20531,39,3660,311,15059,0.733476207,137,20394
ZCTA5 21224,19254,322,18932,46110,34.1,31132,1620,6953,0.150791585,757,45353
ZCTA5 21225,12648,173,12475,34362,34.7,13236,671,14764,0.429660672,216,34146
ZCTA5 21226,2369,1331,1038,6210,33.3,3701,342,1411,0.227214171,3240,2970
ZCTA5 21227,13731,41,13690,34471,37.6,23901,1400,5772,0.167445099,56,34415
ZCTA5 21228,19582,234,19348,50781,41.8,30133,7046,9866,0.194285264,425,50356
ZCTA5 21229,17811,177,17634,43933,37.3,7519,1158,33049,0.752259122,494,43439
ZCTA5 21230,15308,894,14414,33995,33,20349,1001,8782,0.258332108,2382,31613
ZCTA5 21231,7975,232,7743,15746,32.4,9205,954,4485,0.284834244,593,15153
ZCTA5 21233,0,14855,-14855,0,-,0,0,0,#DIV/0!,36648,-36648
ZCTA5 21234,27842,14697,13145,66011,40.9,40734,3493,18724,0.283649695,37423,28588
ZCTA5 21236,15504,11860,3644,39876,37.8,23985,5680,8087,0.202803691,32376,7500
ZCTA5 21237,11946,4460,7486,30895,40.5,15546,2105,11277,0.36501052,13407,17488
ZCTA5 21239,11617,0,11617,29619,35.1,3881,727,22882,0.77254465,2,29617
ZCTA5 21240,0,1720,-1720,0,-,0,0,0,#DIV/0!,4791,-4791
ZCTA5 21244,13934,344,13590,38266,35,4341,2643,28507,0.744969425,1029,37237
ZCTA5 21250,0,3598,-3598,3022,19.8,1516,176,1024,0.338848445,9165,-6143
ZCTA5 21251,0,6,-6,354,20,94,5,234,0.661016949,11,343
ZCTA5 21252,0,1846,-1846,4478,19.6,2639,178,1318,0.294327825,4881,-403
ZCTA5 21285,0,0,0,12,-,12,0,0,0,0,12
ZCTA5 21286,9270,54,9216,21119,41.1,15924,1109,2772,0.131256215,148,20971
ZCTA5 21287,0,552,-552,0,-,0,0,0,#DIV/0!,1357,-1357
ZCTA5 21401,17347,1899,15448,39517,45.6,29411,1196,6123,0.154945973,5346,34171
ZCTA5 21402,363,247,116,5576,21.4,3631,261,730,0.130918221,745,4831
ZCTA5 21403,14138,1621,12517,32655,43.6,21731,420,5228,0.160097994,5977,26678
ZCTA5 21405,179,353,-174,450,58.2,450,0,0,0,1036,-586
ZCTA5 21409,7466,416,7050,19878,44.2,17121,498,837,0.042106852,913,18965
ZCTA5 21502,16681,375,16306,42049,43,35663,307,4632,0.110157198,1066,40983
ZCTA5 21520,865,1024,-159,2048,40,2009,1,31,0.015136719,3266,-1218
ZCTA5 21521,640,23225,-22585,1449,52.2,1444,0,0,0,60838,-59389
ZCTA5 21523,99,12736,-12637,201,53.7,161,31,0,0,32585,-32384
ZCTA5 21524,289,0,289,741,40.2,693,0,0,0,2584,-1843
ZCTA5 21529,261,1596,-1335,557,56.8,552,0,0,0,3919,-3362
ZCTA5 21530,806,1982,-1176,1898,45.2,1867,0,19,0.010010537,5900,-4002
ZCTA5 21531,954,2070,-1116,1880,50.6,1821,1,10,0.005319149,5549,-3669
ZCTA5 21532,4867,1148,3719,13184,30.7,11421,238,1151,0.087302791,3333,9851
ZCTA5 21536,1470,1023,447,3855,43.2,3790,18,33,0.008560311,2829,1026
ZCTA5 21538,310,1738,-1428,587,41.8,568,0,0,0,5005,-4418
ZCTA5 21539,992,40,952,2396,42.4,2299,59,3,0.001252087,88,2308
ZCTA5 21540,25,320,-295,71,31.1,69,0,1,0.014084507,679,-608
ZCTA5 21541,800,394,406,1500,48.9,1223,3,180,0.12,1112,388
ZCTA5 21542,62,3971,-3909,154,21.7,142,0,0,0,11025,-10871
ZCTA5 21543,202,1886,-1684,335,66.5,329,0,6,0.017910448,5923,-5588
ZCTA5 21545,770,9800,-9030,1625,50.9,1590,0,16,0.009846154,29101,-27476
ZCTA5 21550,5908,1920,3988,14160,46.9,13745,74,77,0.005437853,5768,8392
ZCTA5 21555,636,4045,-3409,1455,51.4,1427,0,4,0.002749141,11625,-10170
ZCTA5 21557,764,1893,-1129,1516,35.6,1516,0,0,0,5243,-3727
ZCTA5 21560,8,543,-535,8,-,8,0,0,0,1432,-1424
ZCTA5 21561,1061,482,579,2355,58.1,2210,0,47,0.019957537,1345,1010
ZCTA5 21562,1195,402,793,3093,40.3,3035,11,13,0.004203039,1019,2074
ZCTA5 21601,10094,663,9431,23373,49.3,18148,307,3041,0.130107389,2027,21346
ZCTA5 21607,200,0,200,640,45.2,453,0,20,0.03125,54,586
ZCTA5 21610,170,1882,-1712,410,46.6,371,0,20,0.048780488,4811,-4401
ZCTA5 21612,283,3271,-2988,716,63.5,658,0,0,0,9073,-8357
ZCTA5 21613,7439,13352,-5913,17688,43.3,9481,322,5826,0.329375848,39401,-21713
ZCTA5 21617,3560,4173,-613,10270,42.2,9058,140,834,0.0812074,11194,-924
ZCTA5 21619,2362,4466,-2104,5765,50,4986,31,350,0.060711188,11452,-5687
ZCTA5 21620,5369,25,5344,13083,41.9,10497,178,1752,0.13391424,25,13058
ZCTA5 21622,234,1985,-1751,645,46.1,610,0,34,0.052713178,5678,-5033
ZCTA5 21623,939,3541,-2602,2478,37.3,2011,34,200,0.08071025,10194,-7716
ZCTA5 21624,116,701,-585,217,59.7,201,0,16,0.073732719,2251,-2034
ZCTA5 21625,796,3620,-2824,2479,43.3,2045,45,205,0.082694635,8943,-6464
ZCTA5 21626,34,2663,-2629,66,54.2,66,0,0,0,8124,-8058
ZCTA5 21627,15,951,-936,23,70.3,23,0,0,0,2601,-2578
ZCTA5 21628,189,10403,-10214,402,48.9,389,0,0,0,30990,-30588
ZCTA5 21629,3413,0,3413,9999,39.7,7796,38,1562,0.156215622,35,9964
ZCTA5 21631,1033,14389,-13356,2770,46.8,2341,0,108,0.03898917,36461,-33691
ZCTA5 21632,2493,190,2303,6090,41,4056,14,1610,0.264367816,439,5651
ZCTA5 21634,190,8694,-8504,372,62.2,369,0,0,0,20834,-20462
ZCTA5 21635,874,1060,-186,1871,50.4,1606,3,58,0.030999466,3104,-1233
ZCTA5 21636,348,256,92,912,49.5,801,0,14,0.015350877,489,423
ZCTA5 21638,1955,2103,-148,5125,44.9,4201,0,374,0.07297561,4945,180
ZCTA5 21639,1723,416,1307,4881,35.8,4280,4,260,0.053267773,842,4039
ZCTA5 21640,539,751,-212,1627,38.5,1272,0,0,0,1676,-49
ZCTA5 21641,56,64,-8,122,44.9,121,0,1,0.008196721,134,-12
ZCTA5 21643,2009,1885,124,5332,38.9,3295,55,1553,0.291260315,4727,605
ZCTA5 21644,7,321,-314,15,68.4,15,0,0,0,924,-909
ZCTA5 21645,478,1287,-809,1319,42.8,1274,0,33,0.025018954,3608,-2289
ZCTA5 21647,183,305,-122,447,49.4,438,0,5,0.011185682,698,-251
ZCTA5 21648,44,967,-923,116,28.8,89,11,13,0.112068966,2697,-2581
ZCTA5 21649,570,684,-114,2276,34.3,1581,48,44,0.019332162,1710,566
ZCTA5 21650,92,178,-86,238,41.8,99,0,0,0,458,-220
ZCTA5 21651,1056,389,667,2488,49.3,1972,10,337,0.135450161,1038,1450
ZCTA5 21652,103,5389,-5286,156,68.2,156,0,0,0,11360,-11204
ZCTA5 21653,50,1381,-1331,100,64.2,100,0,0,0,4121,-4021
ZCTA5 21654,616,1117,-501,1183,65.7,1058,9,40,0.033812342,2640,-1457
ZCTA5 21655,1854,2849,-995,4679,42.6,3888,29,422,0.090190212,7582,-2903
ZCTA5 21657,435,3677,-3242,1226,51.5,958,39,47,0.038336052,10775,-9549
ZCTA5 21658,1456,379,1077,3678,51.7,2913,39,291,0.079119086,1185,2493
ZCTA5 21659,393,393,0,1163,50.8,883,27,246,0.211521926,1118,45
ZCTA5 21660,1502,92,1410,3942,39.2,2865,67,747,0.189497717,280,3662
ZCTA5 21661,1222,2038,-816,2667,55.3,2241,1,191,0.071616048,5379,-2712
ZCTA5 21662,275,258,17,641,56,538,28,75,0.11700468,624,17
ZCTA5 21663,1630,275,1355,3512,57.4,2904,28,373,0.106207289,608,2904
ZCTA5 21664,221,22,199,648,33.4,464,0,1,0.00154321,38,610
ZCTA5 21665,58,14,44,151,59.5,151,0,0,0,48,103
ZCTA5 21666,5315,307,5008,13738,45,12038,270,557,0.040544475,740,12998
ZCTA5 21667,89,779,-690,226,55.2,195,0,17,0.075221239,3163,-2937
ZCTA5 21668,599,242,357,1645,47.8,1482,0,77,0.046808511,611,1034
ZCTA5 21669,73,818,-745,149,63.1,130,0,16,0.10738255,2168,-2019
ZCTA5 21671,368,2446,-2078,816,53.7,809,7,0,0,6802,-5986
ZCTA5 21672,82,0,82,162,60.9,162,0,0,0,3127,-2965
ZCTA5 21673,1197,5677,-4480,2875,46.7,2221,0,454,0.157913043,16428,-13553
ZCTA5 21675,35,0,35,62,66.7,62,0,0,0,150,-88
ZCTA5 21676,238,2206,-1968,347,70.9,289,46,0,0,5788,-5441
ZCTA5 21677,201,2649,-2448,570,48.5,569,0,0,0,7734,-7164
ZCTA5 21678,817,3999,-3182,1704,51.7,1240,9,449,0.263497653,11109,-9405
ZCTA5 21679,151,385,-234,261,56.7,261,0,0,0,1100,-839
ZCTA5 21701,17029,209,16820,40203,39,31963,918,4444,0.110539015,602,39601
ZCTA5 21702,17018,223,16795,44783,37.7,29144,1914,7227,0.161378202,594,44189
ZCTA5 21703,14415,1182,13233,39438,35.6,24468,3328,6412,0.16258431,2820,36618
ZCTA5 21704,5381,0,5381,17372,37.1,10819,2499,1848,0.10637808,29,17343
ZCTA5 21705,0,756,-756,6,-,3,0,3,0.5,2455,-2449
ZCTA5 21710,1740,1436,304,4960,48.4,4321,123,298,0.060080645,4253,707
ZCTA5 21711,497,1456,-959,1087,53,1087,0,0,0,3669,-2582
ZCTA5 21713,3799,80,3719,9630,45,8834,201,341,0.035410177,124,9506
ZCTA5 21714,109,15595,-15486,292,36.2,268,24,0,0,44090,-43798
ZCTA5 21715,11,89,-78,34,59.4,34,0,0,0,164,-130
ZCTA5 21716,2535,19018,-16483,6594,36.9,5016,40,613,0.0929633,55524,-48930
ZCTA5 21717,89,14820,-14731,181,51.9,181,0,0,0,43442,-43261
ZCTA5 21718,61,5994,-5933,131,53.6,124,0,0,0,17849,-17718
ZCTA5 21719,358,4787,-4429,971,39.5,953,9,9,0.009268795,14704,-13733
ZCTA5 21722,2202,816,1386,6296,44.4,6041,61,12,0.001905972,2523,3773
ZCTA5 21723,251,18602,-18351,725,46.3,487,223,15,0.020689655,54047,-53322
ZCTA5 21727,1882,11700,-9818,6873,28.9,5725,35,546,0.079441292,31342,-24469
ZCTA5 21733,361,9845,-9484,914,47.5,789,0,0,0,29389,-28475
ZCTA5 21734,506,14914,-14408,889,58.3,872,5,9,0.010123735,36786,-35897
ZCTA5 21737,705,0,705,2353,38.6,2117,189,4,0.001699958,0,2353
ZCTA5 21738,1316,6179,-4863,4185,44.4,3845,81,83,0.019832736,19356,-15171
ZCTA5 21740,24763,10495,14268,63413,38.7,45772,1100,10383,0.163736142,27234,36179
ZCTA5 21742,13341,11736,1605,34190,41.3,26783,1000,3201,0.093623867,31961,2229
ZCTA5 21746,0,9231,-9231,3399,36.2,1002,20,2192,0.644895558,24656,-21257
ZCTA5 21750,1567,5702,-4135,3782,44.4,3621,33,10,0.002644104,13343,-9561
ZCTA5 21754,2218,6120,-3902,6847,40.4,4835,439,829,0.121074923,16231,-9384
ZCTA5 21755,2017,2720,-703,5697,41.7,4653,106,103,0.018079691,9420,-3723
ZCTA5 21756,1192,5975,-4783,3069,45.6,2994,9,6,0.001955034,19295,-16226
ZCTA5 21757,1000,10649,-9649,2604,47,2440,39,57,0.021889401,32225,-29621
ZCTA5 21758,1691,10862,-9171,4454,41.3,3831,150,263,0.059048047,30381,-25927
ZCTA5 21762,79,9506,-9427,184,52.2,58,0,0,0,21920,-21736
ZCTA5 21766,290,6464,-6174,522,57.6,503,0,0,0,17915,-17393
ZCTA5 21767,416,347,69,592,53.6,580,0,0,0,659,-67
ZCTA5 21769,4211,1366,2845,12486,41.7,10739,635,242,0.019381708,8948,3538
ZCTA5 21770,2220,9061,-6841,7291,41.6,5762,503,546,0.074886847,28052,-20761
ZCTA5 21771,10602,5830,4772,31755,41.7,28617,548,946,0.029790584,17678,14077
ZCTA5 21773,1875,10331,-8456,5357,42.7,4936,129,27,0.005040134,28704,-23347
ZCTA5 21774,4929,10627,-5698,14450,36.8,12604,447,540,0.037370242,31979,-17529
ZCTA5 21776,2366,3155,-789,6146,40.1,5800,46,136,0.022128213,8330,-2184
ZCTA5 21777,734,8210,-7476,2277,37.8,1759,146,185,0.081247255,23717,-21440
ZCTA5 21778,322,5189,-4867,681,58.5,681,0,0,0,14359,-13678
ZCTA5 21779,583,8824,-8241,1759,27.9,1648,30,0,0,26208,-24449
ZCTA5 21780,769,0,769,2024,48.5,1960,3,58,0.028656126,0,2024
ZCTA5 21781,0,19169,-19169,43,18,28,9,3,0.069767442,59665,-59622
ZCTA5 21782,1699,18805,-17106,4358,43.8,4282,9,5,0.001147315,52691,-48333
ZCTA5 21783,3491,22011,-18520,9793,43.8,9253,138,141,0.014398039,73467,-63674
ZCTA5 21784,13094,16504,-3410,36809,41,31153,1411,1989,0.054035698,32980,3829
ZCTA5 21787,4141,11217,-7076,10697,41.8,9788,123,601,0.056183977,20265,-9568
ZCTA5 21788,4699,10439,-5740,11598,47.7,11031,27,105,0.009053285,21593,-9995
ZCTA5 21790,5,19784,-19779,11,-,11,0,0,0,49348,-49337
ZCTA5 21791,1924,6356,-4432,4794,43.7,4499,111,78,0.016270338,17413,-12619
ZCTA5 21793,3994,9942,-5948,10862,42.1,8737,368,885,0.081476708,19474,-8612
ZCTA5 21794,717,11274,-10557,2162,43.5,1278,654,86,0.039777983,31884,-29722
ZCTA5 21795,3638,6344,-2706,9292,40.7,8068,82,461,0.04961257,11977,-2685
ZCTA5 21797,2859,67,2792,8755,44.8,7841,348,169,0.019303255,922,7833
ZCTA5 21798,875,1293,-418,2627,43.6,2141,6,326,0.124095927,3478,-851
ZCTA5 21801,11285,0,11285,30692,36.5,17231,1003,10885,0.354652678,115,30577
ZCTA5 21804,15264,4838,10426,38566,31.8,23568,1514,10820,0.280558004,11524,27042
ZCTA5 21810,150,8336,-8186,433,61.7,426,0,0,0,17567,-17134
ZCTA5 21811,10235,6360,3875,24187,53.2,20750,416,1852,0.076570058,12395,11792
ZCTA5 21813,1095,20838,-19743,2662,47.5,2400,1,147,0.055221638,45359,-42697
ZCTA5 21814,55,5992,-5937,180,43.5,180,0,0,0,14424,-14244
ZCTA5 21817,1794,11644,-9850,4146,41.8,3035,35,803,0.193680656,31225,-27079
ZCTA5 21821,369,4514,-4145,732,57.6,659,0,48,0.06557377,10489,-9757
ZCTA5 21822,953,4683,-3730,2364,38.3,1725,0,462,0.195431472,13178,-10814
ZCTA5 21824,86,10917,-10831,143,70.5,143,0,0,0,31685,-31542
ZCTA5 21826,1923,11318,-9395,5460,28.1,3151,163,1829,0.334981685,28908,-23448
ZCTA5 21829,163,7418,-7255,365,64.6,353,12,0,0,17406,-17041
ZCTA5 21830,1711,10659,-8948,4529,41.5,3843,3,510,0.11260764,29133,-24604
ZCTA5 21835,150,14931,-14781,328,47.5,293,0,27,0.082317073,28946,-28618
ZCTA5 21837,1188,10361,-9173,3164,39.3,2133,24,807,0.25505689,26044,-22880
ZCTA5 21838,766,9705,-8939,1931,48.6,1531,8,263,0.136198861,24932,-23001
ZCTA5 21840,165,9892,-9727,465,47,373,0,18,0.038709677,29164,-28699
ZCTA5 21841,427,7265,-6838,1085,45.9,759,0,257,0.236866359,20869,-19784
ZCTA5 21842,5498,18840,-13342,10960,53.5,10161,56,358,0.032664234,56718,-45758
ZCTA5 21849,1423,9224,-7801,3794,42.8,3204,0,365,0.096204533,26224,-22430
ZCTA5 21850,1364,1160,204,3405,40.7,2954,23,148,0.043465492,3674,-269
ZCTA5 21851,3027,177,2850,7364,44.2,4355,83,2574,0.349538294,502,6862
ZCTA5 21853,3649,97,3552,10510,27.7,4065,108,5687,0.541103711,180,10330
ZCTA5 21856,349,833,-484,1145,40.7,813,0,216,0.188646288,2053,-908
ZCTA5 21861,283,294,-11,738,35.5,679,0,46,0.062330623,729,9
ZCTA5 21862,0,325,-325,0,-,0,0,0,#DIV/0!,789,-789
ZCTA5 21863,1836,121,1715,4904,39.8,3235,141,1212,0.247145188,362,4542
ZCTA5 21864,253,3498,-3245,640,46.5,470,0,157,0.2453125,8552,-7912
ZCTA5 21865,172,201,-29,358,61.4,226,67,65,0.181564246,957,-599
ZCTA5 21866,56,790,-734,95,61,95,0,0,0,1932,-1837
ZCTA5 21867,0,596,-596,0,-,0,0,0,#DIV/0!,1754,-1754
ZCTA5 21869,362,720,-358,990,46.9,630,0,275,0.277777778,1736,-746
ZCTA5 21871,704,2199,-1495,1799,56.4,1255,69,393,0.218454697,5319,-3520
ZCTA5 21872,212,197,15,573,31.6,573,0,0,0,471,102
ZCTA5 21874,744,407,337,2239,30.4,1793,4,38,0.016971862,869,1370
ZCTA5 21875,2939,1412,1527,7052,44.5,4502,216,1129,0.160096427,2958,4094
ZCTA5 21890,0,7965,-7965,3699,36,933,9,2487,0.672343877,22782,-19083
ZCTA5 21901,6633,370,6263,18635,38,16367,335,1258,0.067507379,1123,17512
ZCTA5 21902,73,2084,-2011,216,54.8,127,0,89,0.412037037,4398,-4182
ZCTA5 21903,2196,118,2078,5658,45.1,5049,18,450,0.079533404,242,5416
ZCTA5 21904,2442,5082,-2640,6386,44.4,5616,2,497,0.077826495,13714,-7328
ZCTA5 21911,4074,0,4074,11108,41.8,10054,329,37,0.003330933,0,11108
ZCTA5 21912,553,594,-41,1393,46.9,1361,0,32,0.022972003,1244,149
ZCTA5 21913,382,916,-534,935,31.5,837,0,92,0.098395722,2436,-1501
ZCTA5 21914,353,2230,-1877,725,51.1,670,0,10,0.013793103,5334,-4609
ZCTA5 21915,1225,175,1050,2776,52.8,2641,0,13,0.004682997,384,2392
ZCTA5 21917,617,105,512,1983,40.7,1836,0,47,0.023701462,161,1822
ZCTA5 21918,1611,858,753,4428,44.5,4096,0,48,0.010840108,2872,1556
ZCTA5 21919,1398,190,1208,3400,51.9,3383,0,17,0.005,327,3073
ZCTA5 21920,278,141,137,910,45.4,691,0,0,0,459,451
ZCTA5 21921,16825,1197,15628,44793,39,36357,770,4307,0.096153417,2341,42452
ZCTA5 21930,12,514,-502,24,-,24,0,0,0,1332,-1308
ZCTA5 22003,19077,5851,13226,58952,38.9,29448,12851,4749,0.080557063,15986,42966
ZCTA5 22015,15023,25,14998,45325,39.4,28719,8145,3073,0.067799228,25,45300
ZCTA5 22025,6453,6215,238,19540,38.3,12013,1142,4192,0.214534289,17883,1657
ZCTA5 22026,5644,4459,1185,18878,30.8,6308,1859,8189,0.433785359,13617,5261
ZCTA5 22027,665,15902,-15237,2081,44.9,1169,808,6,0.002883229,51396,-49315
ZCTA5 22030,21246,8145,13101,60915,34.2,35749,12763,6076,0.099745547,25859,35056
ZCTA5 22031,14272,2471,11801,35494,35.4,19207,10511,2442,0.068800361,6472,29022
ZCTA5 22032,9911,1083,8828,30293,40.9,20991,5651,1376,0.045423035,3518,26775
ZCTA5 22033,15389,2172,13217,38692,37.8,21269,11561,2248,0.058099866,7688,31004
ZCTA5 22035,0,820,-820,0,-,0,0,0,#DIV/0!,1761,-1761
ZCTA5 22039,5718,1098,4620,17674,47.5,13241,2470,670,0.037908793,2125,15549
ZCTA5 22041,11098,71,11027,28718,35.2,11402,3757,5001,0.174141653,135,28583
ZCTA5 22042,12180,1950,10230,34935,38,17571,6563,1470,0.042078145,4981,29954
ZCTA5 22043,9467,10994,-1527,24877,37.8,14102,6480,1089,0.043775375,27843,-2966
ZCTA5 22044,5275,10628,-5353,13896,36,8713,1803,650,0.046776051,29208,-15312
ZCTA5 22046,6886,5279,1607,18426,40.3,13697,1878,626,0.033973733,13760,4666
ZCTA5 22060,2542,727,1815,9467,23,5611,577,1924,0.203232281,1589,7878
ZCTA5 22066,5587,3124,2463,16791,48.2,11690,4173,134,0.007980466,8378,8413
ZCTA5 22079,11933,1006,10927,37686,37.9,15062,6395,10213,0.271002494,2350,35336
ZCTA5 22101,10656,239,10417,30788,46.4,22080,6177,577,0.018741068,693,30095
ZCTA5 22102,12387,957,11430,27722,38.1,15972,8215,1457,0.052557536,2635,25087
ZCTA5 22124,6553,1453,5100,18152,41.2,12354,3869,268,0.014764213,4115,14037
ZCTA5 22125,462,387,75,875,50,649,116,42,0.048,779,96
ZCTA5 22134,1316,11840,-10524,7709,22.7,5055,246,1250,0.162148139,30781,-23072
ZCTA5 22150,9540,613,8927,28283,40.5,13301,7984,3144,0.111162182,1381,26902
ZCTA5 22151,5548,161,5387,17343,40,9636,5289,572,0.032981606,272,17071
ZCTA5 22152,9817,285,9532,30055,38.7,17311,5182,3904,0.129895192,837,29218
ZCTA5 22153,10817,205,10612,32366,39.1,20535,4714,3053,0.094327381,663,31703
ZCTA5 22172,3624,1461,2163,11994,33.7,3819,1565,4319,0.360096715,3880,8114
ZCTA5 22180,9295,39,9256,25766,37.8,17693,4745,863,0.033493751,52,25714
ZCTA5 22181,5736,927,4809,15633,42.9,10677,2606,523,0.033454871,2449,13184
ZCTA5 22182,9729,1515,8214,27151,43.2,17162,6325,1380,0.050826857,3776,23375
ZCTA5 22191,24324,102,24222,72613,34.3,25066,6875,24211,0.333425144,214,72399
ZCTA5 22192,20229,544,19685,59637,36.9,32161,5753,13575,0.227627144,1463,58174
ZCTA5 22193,24613,526,24087,83687,35.8,35096,8211,20525,0.24525912,1243,82444
ZCTA5 22201,19946,238,19708,39240,31.6,29461,4200,1559,0.039729867,608,38632
ZCTA5 22202,15178,7107,8071,26813,35.6,17136,3828,2886,0.107634356,19481,7332
ZCTA5 22203,12946,802,12144,24775,33.6,16574,2733,1911,0.077134208,2144,22631
ZCTA5 22204,22847,4573,18274,53451,35.4,27494,6360,9455,0.176890984,11024,42427
ZCTA5 22205,6835,753,6082,18754,41,14718,1337,637,0.033966087,2034,16720
ZCTA5 22206,10794,505,10289,21085,35.5,14560,1250,2969,0.140811003,1521,19564
ZCTA5 22207,12014,3592,8422,33726,41.7,26655,2077,1635,0.048478918,8438,25288
ZCTA5 22209,7584,11056,-3472,12627,33.3,8139,2084,777,0.061534806,31755,-19128
ZCTA5 22211,47,422,-375,1606,22.4,1080,0,206,0.128268991,938,668
ZCTA5 22213,1719,0,1719,4336,39.1,3039,360,101,0.023293358,0,4336
ZCTA5 22214,0,2472,-2472,0,-,0,0,0,#DIV/0!,7731,-7731
ZCTA5 22301,6242,541,5701,14410,36.2,11844,480,849,0.058917418,1329,13081
ZCTA5 22302,8661,444,8217,18084,38.7,13055,778,1975,0.109212564,1291,16793
ZCTA5 22303,7950,531,7419,16427,36.5,9340,1894,2285,0.139100262,1634,14793
ZCTA5 22304,23148,417,22731,49916,37.3,23284,4232,15824,0.317012581,873,49043
ZCTA5 22305,7444,161,7283,17394,34.4,10315,944,2517,0.144705071,422,16972
ZCTA5 22306,11305,198,11107,33554,34.4,15431,3288,8028,0.239256124,458,33096
ZCTA5 22307,4533,389,4144,10126,46.7,7975,478,924,0.091250247,1108,9018
ZCTA5 22308,4675,86,4589,13197,43.4,11865,392,304,0.023035538,221,12976
ZCTA5 22309,12560,26,12534,36297,37.2,16452,2530,10074,0.277543599,122,36175
ZCTA5 22310,10751,655,10096,29325,37.9,17592,4185,4103,0.139914749,1525,27800
ZCTA5 22311,8354,210,8144,19419,35.1,7734,1820,6418,0.330501056,637,18782
ZCTA5 22312,10482,1854,8628,27326,38.4,11022,4114,7132,0.260996853,4815,22511
ZCTA5 22314,18846,1123,17723,35435,39,25977,1278,5134,0.144885001,3425,32010
ZCTA5 22315,11514,36,11478,30129,39.6,16846,4101,6724,0.223173686,1307,28822
ZCTA5 22401,11154,25,11129,27944,30.7,17314,965,5771,0.206520183,38,27906
ZCTA5 22405,11665,62,11603,34705,36.9,25920,754,4463,0.128598185,131,34574
ZCTA5 22406,9151,55,9096,25393,41.6,17354,623,4859,0.191351947,183,25210
ZCTA5 22407,20866,532,20334,61175,37.7,39891,2181,11777,0.192513282,1641,59534
ZCTA5 22408,11548,1118,10430,30489,37.8,20575,932,5427,0.177998622,3584,26905
ZCTA5 22427,1387,683,704,5157,26.6,3432,84,1143,0.221640489,2163,2994
ZCTA5 22432,87,256,-169,118,71.5,58,0,0,0,868,-750
ZCTA5 22433,78,1019,-941,196,41.5,152,0,0,0,2880,-2684
ZCTA5 22435,888,467,421,2327,47.1,1691,0,464,0.199398367,1239,1088
ZCTA5 22436,313,529,-216,803,54.7,219,44,540,0.672478207,1147,-344
ZCTA5 22437,278,96,182,796,55.9,642,0,0,0,331,465
ZCTA5 22438,107,643,-536,305,42.6,177,0,128,0.419672131,2080,-1775
ZCTA5 22443,4296,82,4214,10044,45.4,7403,164,1389,0.138291517,203,9841
ZCTA5 22448,181,471,-290,727,23.7,493,21,113,0.155433287,1102,-375
ZCTA5 22454,745,194,551,1950,49.3,1756,0,97,0.04974359,398,1552
ZCTA5 22460,674,12099,-11425,1563,54.4,1160,0,375,0.239923225,37495,-35932
ZCTA5 22469,1050,10466,-9416,2369,54.5,1152,0,1137,0.479949346,28238,-25869
ZCTA5 22472,0,8,-8,960,38.7,313,0,540,0.5625,2351,-1391
ZCTA5 22473,2224,296,1928,5423,59.8,3445,39,1491,0.27494007,662,4761
ZCTA5 22476,105,249,-144,136,49.4,48,0,88,0.647058824,538,-402
ZCTA5 22480,420,3020,-2600,750,74.5,735,2,0,0,8985,-8235
ZCTA5 22482,1591,3371,-1780,3152,60.8,2405,47,660,0.209390863,8149,-4997
ZCTA5 22485,9264,68,9196,25870,38.8,19510,292,4320,0.16698879,132,25738
ZCTA5 22488,200,2136,-1936,511,50.5,269,0,222,0.43444227,5876,-5365
ZCTA5 22503,1751,2458,-707,3898,52.4,2087,51,1666,0.427398666,5762,-1864
ZCTA5 22504,112,3995,-3883,289,59.4,140,0,55,0.190311419,9619,-9330
ZCTA5 22508,5723,755,4968,14898,42.6,12047,506,1443,0.096858639,1889,13009
ZCTA5 22509,50,367,-317,81,59.1,47,0,34,0.419753086,892,-811
ZCTA5 22511,543,483,60,1084,63.4,817,0,211,0.194649446,1336,-252
ZCTA5 22514,898,470,428,2268,47.1,1597,0,398,0.175485009,1258,1010
ZCTA5 22520,1919,4589,-2670,4457,50.6,2574,24,1521,0.341260938,11467,-7010
ZCTA5 22529,12,1692,-1680,38,55.5,38,0,0,0,4832,-4794
ZCTA5 22534,974,1163,-189,3358,32.2,2697,50,276,0.082191781,2773,585
ZCTA5 22535,188,2127,-1939,421,55.1,265,0,75,0.178147268,5485,-5064
ZCTA5 22538,92,1069,-977,165,55.4,0,0,165,1,2520,-2355
ZCTA5 22539,926,1831,-905,2222,59.8,1805,0,268,0.120612061,4370,-2148
ZCTA5 22542,808,0,808,2085,49.8,1836,0,161,0.077218225,0,2085
ZCTA5 22546,6021,663,5358,16454,37.9,10442,84,4738,0.287954297,1710,14744
ZCTA5 22548,38,346,-308,38,-,38,0,0,0,1030,-992
ZCTA5 22551,7022,1821,5201,20690,41.4,16328,296,2034,0.098308362,4700,15990
ZCTA5 22553,5462,319,5143,16842,37.8,12493,270,2551,0.151466572,937,15905
ZCTA5 22554,18963,2378,16585,59590,35.2,33670,2353,13065,0.219248196,6015,53575
ZCTA5 22556,9750,1905,7845,32577,34.7,19468,1311,5355,0.164379777,4554,28023
ZCTA5 22560,2690,13629,-10939,6526,44.7,3101,17,3135,0.480386148,32698,-26172
ZCTA5 22567,1055,9101,-8046,3046,38,2676,0,216,0.070912672,20609,-17563
ZCTA5 22572,2388,14833,-12445,6872,42.2,4157,4,1902,0.27677532,39363,-32491
ZCTA5 22576,751,51,700,1596,55.7,1153,0,400,0.250626566,4387,-2791
ZCTA5 22578,1250,6436,-5186,2685,59.9,1972,0,626,0.233147114,16982,-14297
ZCTA5 22580,2108,1811,297,5631,46.2,3945,159,1003,0.178121115,4271,1360
ZCTA5 22601,11474,1000,10474,29030,37.2,21604,657,2890,0.099552187,2358,26672
ZCTA5 22602,10993,1652,9341,31307,37.8,27423,599,1290,0.041204842,4062,27245
ZCTA5 22603,6360,149,6211,16574,46.6,14807,256,401,0.024194522,309,16265
ZCTA5 22610,706,2727,-2021,1720,45.2,1692,21,0,0,7666,-5946
ZCTA5 22611,3345,289,3056,9184,46.5,8265,136,454,0.049433798,629,8555
ZCTA5 22620,969,1590,-621,2601,48,2276,13,66,0.025374856,4560,-1959
ZCTA5 22623,267,695,-428,885,35.1,742,1,122,0.137853107,2061,-1176
ZCTA5 22624,1001,577,424,3259,33.1,3102,7,109,0.033445842,1369,1890
ZCTA5 22625,1307,1830,-523,3525,47.4,3402,0,62,0.017588652,4770,-1245
ZCTA5 22627,281,371,-90,762,52.8,656,14,15,0.019685039,1060,-298
ZCTA5 22630,12843,3204,9639,34024,42.2,28905,553,1738,0.051081589,7747,26277
ZCTA5 22637,935,116,819,2357,45.7,2150,19,110,0.046669495,259,2098
ZCTA5 22639,249,83,166,626,51.4,529,0,0,0,183,443
ZCTA5 22640,176,1745,-1569,483,56.3,450,0,0,0,4129,-3646
ZCTA5 22641,101,63,38,217,52.9,217,0,0,0,165,52
ZCTA5 22642,1692,478,1214,4407,42.9,3823,24,166,0.037667347,987,3420
ZCTA5 22643,117,811,-694,208,65.5,157,0,51,0.245192308,2044,-1836
ZCTA5 22644,1023,798,225,2475,50.8,2444,6,4,0.001616162,1633,842
ZCTA5 22645,1672,599,1073,4441,45.5,4143,36,86,0.019365008,1439,3002
ZCTA5 22646,13,4162,-4149,27,-,0,0,27,1,11113,-11086
ZCTA5 22650,346,5946,-5600,709,60.2,703,6,0,0,15656,-14947
ZCTA5 22652,575,80,495,1372,52,1331,0,0,0,140,1232
ZCTA5 22654,395,658,-263,904,59.4,904,0,0,0,1590,-686
ZCTA5 22655,7835,3539,4296,22487,37.4,18947,213,1032,0.045893183,10117,12370
ZCTA5 22656,1644,564,1080,4453,40.9,3787,266,259,0.058163036,1502,2951
ZCTA5 22657,4220,656,3564,11132,37.8,10105,109,229,0.020571326,1744,9388
ZCTA5 22660,640,123,517,1615,50.2,1584,0,17,0.010526316,337,1278
ZCTA5 22663,403,2638,-2235,938,55.3,862,0,55,0.058635394,6636,-5698
ZCTA5 22664,3677,1678,1999,9768,39.6,7979,330,203,0.020782146,5512,4256
ZCTA5 22701,12505,79,12426,35235,38.5,24116,459,5508,0.156321839,173,35062
ZCTA5 22709,433,12950,-12517,1323,38.4,1109,0,205,0.154950869,31903,-30580
ZCTA5 22711,15,39,-24,15,-,15,0,0,0,117,-102
ZCTA5 22712,2893,4099,-1206,8875,35.7,6962,214,817,0.092056338,11263,-2388
ZCTA5 22713,607,371,236,1770,44.1,1650,14,73,0.041242938,652,1118
ZCTA5 22714,320,5659,-5339,968,39.9,826,0,71,0.073347107,15069,-14101
ZCTA5 22715,586,2250,-1664,1576,52.2,1435,5,0,0,6344,-4768
ZCTA5 22716,449,308,141,1027,56.9,928,0,0,0,1285,-258
ZCTA5 22718,293,1445,-1152,725,52.6,637,0,0,0,3830,-3105
ZCTA5 22719,79,174,-95,144,58.4,144,0,0,0,485,-341
ZCTA5 22720,296,316,-20,1029,44.5,995,0,0,0,663,366
ZCTA5 22722,199,140,59,526,39.9,483,0,0,0,255,271
ZCTA5 22723,71,3049,-2978,89,78.2,89,0,0,0,7706,-7617
ZCTA5 22724,764,72,692,2292,47.4,1966,0,214,0.093368237,183,2109
ZCTA5 22725,16,558,-542,70,63.2,70,0,0,0,1234,-1164
ZCTA5 22726,352,1949,-1597,954,37.9,759,0,126,0.132075472,5063,-4109
ZCTA5 22727,2205,141,2064,5796,48,5020,0,291,0.050207039,339,5457
ZCTA5 22728,1178,516,662,3093,46.9,2665,8,211,0.068218558,1277,1816
ZCTA5 22729,80,665,-585,1213,42.2,575,21,449,0.370156636,1258,-45
ZCTA5 22730,27,388,-361,103,55.4,75,0,28,0.27184466,1092,-989
ZCTA5 22731,78,1500,-1422,336,30,30,0,244,0.726190476,4381,-4045
ZCTA5 22732,86,731,-645,186,54,186,0,0,0,1499,-1313
ZCTA5 22733,511,21,490,1501,48.1,1077,0,303,0.201865423,42,1459
ZCTA5 22734,1286,778,508,3857,31.4,2955,4,403,0.104485351,1833,2024
ZCTA5 22735,792,240,552,2343,37.3,1743,0,281,0.119931711,553,1790
ZCTA5 22736,241,342,-101,735,33.3,430,0,0,0,1011,-276
ZCTA5 22737,1080,145,935,3446,39.6,3028,18,219,0.063551944,340,3106
ZCTA5 22738,472,11736,-11264,1315,37.7,1087,92,129,0.098098859,33363,-32048
ZCTA5 22740,358,12791,-12433,756,51,756,0,0,0,33569,-32813
ZCTA5 22741,77,7570,-7493,232,42.5,218,0,0,0,20129,-19897
ZCTA5 22742,529,998,-469,1318,51.7,1202,0,41,0.031107739,2528,-1210
ZCTA5 22743,96,1888,-1792,292,71.1,292,0,0,0,5675,-5383
ZCTA5 22746,102,33,69,626,21.7,226,0,43,0.068690096,66,560
ZCTA5 22747,481,681,-200,1183,58.7,1088,0,70,0.059171598,1906,-723
ZCTA5 22749,80,290,-210,175,40.1,160,0,4,0.022857143,599,-424
ZCTA5 22801,13938,216,13722,37653,28.3,30060,936,2276,0.060446711,390,37263
ZCTA5 22802,11031,1072,9959,30149,36.4,21965,508,2180,0.072307539,3432,26717
ZCTA5 22807,1,344,-343,5618,18.9,4407,423,306,0.054467782,895,4723
ZCTA5 22810,279,711,-432,605,69.2,475,0,16,0.026446281,1428,-823
ZCTA5 22811,222,4655,-4433,538,51.3,538,0,0,0,12561,-12023
ZCTA5 22812,3200,3889,-689,9432,34.5,8634,41,357,0.037849873,10495,-1063
ZCTA5 22815,3392,276,3116,9078,39,8746,12,62,0.006829698,691,8387
ZCTA5 22820,100,105,-5,248,37.9,248,0,0,0,346,-98
ZCTA5 22821,2190,475,1715,5762,40.2,5268,48,101,0.017528636,1079,4683
ZCTA5 22824,2551,695,1856,6423,45.3,6093,4,168,0.026156002,1525,4898
ZCTA5 22827,4376,150,4226,10402,45.1,9790,35,252,0.02422611,343,10059
ZCTA5 22830,741,1098,-357,2080,38,2000,0,0,0,2810,-730
ZCTA5 22831,304,1847,-1543,849,40.5,839,0,10,0.011778563,5003,-4154
ZCTA5 22832,390,85,305,1049,44.4,1002,0,0,0,212,837
ZCTA5 22834,452,198,254,1391,39.5,1360,27,0,0,605,786
ZCTA5 22835,4986,4995,-9,11886,48,10986,55,213,0.017920242,12887,-1001
ZCTA5 22840,1867,957,910,4692,49,3933,276,190,0.040494459,3184,1508
ZCTA5 22841,1240,1836,-596,3286,39.6,3079,12,108,0.032866707,4301,-1015
ZCTA5 22842,2102,397,1705,5706,45.7,5130,39,115,0.020154224,1144,4562
ZCTA5 22843,987,78,909,2573,41.2,2540,0,0,0,213,2360
ZCTA5 22844,2171,905,1266,4828,53.3,4615,16,106,0.021955261,2357,2471
ZCTA5 22845,58,327,-269,58,-,58,0,0,0,554,-496
ZCTA5 22846,643,13810,-13167,2066,43.1,1867,17,35,0.016940949,36509,-34443
ZCTA5 22847,265,17141,-16876,613,45.2,598,0,0,0,48386,-47773
ZCTA5 22849,1833,8904,-7071,5154,37.8,4673,10,65,0.012611564,23672,-18518
ZCTA5 22850,472,6397,-5925,1431,45.5,1406,0,13,0.009084556,18559,-17128
ZCTA5 22851,2098,66,2032,5792,42.1,5651,30,6,0.001035912,196,5596
ZCTA5 22853,1792,9474,-7682,5158,43.3,4915,12,15,0.002908104,27917,-22759
ZCTA5 22901,15900,3984,11916,35901,42.2,27547,2119,4084,0.113757277,10056,25845
ZCTA5 22902,11099,86,11013,25318,38.4,19449,1047,3271,0.129196619,155,25163
ZCTA5 22903,15466,1757,13709,39859,29,28109,3640,6016,0.150932035,5753,34106
ZCTA5 22904,26,694,-668,6500,19.3,4332,1130,617,0.094923077,1360,5140
ZCTA5 22908,0,1169,-1169,0,-,0,0,0,#DIV/0!,3234,-3234
ZCTA5 22911,7377,45,7332,18284,39.5,14399,1097,1556,0.085101728,93,18191
ZCTA5 22920,1727,196,1531,3780,51.3,3453,42,85,0.022486772,420,3360
ZCTA5 22922,892,421,471,2324,43.5,1450,0,843,0.362736661,1190,1134
ZCTA5 22923,2581,99,2482,6303,35.7,5746,103,369,0.058543551,278,6025
ZCTA5 22931,93,128,-35,236,38.6,224,1,0,0,303,-67
ZCTA5 22932,2979,278,2701,7587,44.2,6995,171,97,0.012785027,545,7042
ZCTA5 22935,285,8838,-8553,662,58.1,622,0,37,0.055891239,23170,-22508
ZCTA5 22936,2185,2044,141,6318,44.7,5492,62,179,0.028331751,5573,745
ZCTA5 22937,832,2397,-1565,2223,49,1130,7,1025,0.461088619,6223,-4000
ZCTA5 22938,383,1134,-751,941,51.2,864,0,55,0.058448459,3040,-2099
ZCTA5 22939,2411,796,1615,6115,40.8,5243,26,321,0.052493868,2024,4091
ZCTA5 22940,371,981,-610,1132,46.4,1076,0,15,0.013250883,2630,-1498
ZCTA5 22942,3905,5039,-1134,9814,44.6,7429,18,1655,0.168636642,11928,-2114
ZCTA5 22943,222,492,-270,593,34.3,467,0,126,0.212478921,1136,-543
ZCTA5 22946,55,777,-722,171,48.8,120,0,46,0.269005848,1944,-1773
ZCTA5 22947,2101,0,2101,4688,50.8,4105,134,253,0.053967577,3818,870
ZCTA5 22948,62,38,24,126,73.1,126,0,0,0,64,62
ZCTA5 22949,576,166,410,1065,54.8,711,0,347,0.325821596,345,720
ZCTA5 22952,609,2170,-1561,1557,46.4,1449,101,7,0.004495825,6480,-4923
ZCTA5 22957,0,578,-578,0,-,0,0,0,#DIV/0!,1572,-1572
ZCTA5 22958,965,17,948,1913,65.2,1724,0,178,0.093047569,2342,-429
ZCTA5 22959,680,652,28,1720,50.1,1484,0,206,0.119767442,1455,265
ZCTA5 22960,3821,242,3579,10573,38.7,7827,7,1880,0.177811406,639,9934
ZCTA5 22963,6334,306,6028,16210,43,13208,295,1775,0.109500308,830,15380
ZCTA5 22964,138,232,-94,399,50.8,309,0,90,0.22556391,647,-248
ZCTA5 22967,873,2206,-1333,2452,40.3,2122,8,169,0.068923328,5389,-2937
ZCTA5 22968,3678,16962,-13284,10801,41.1,8421,312,636,0.058883437,45675,-34874
ZCTA5 22969,636,0,636,2073,38.1,2020,0,40,0.019295707,148,1925
ZCTA5 22971,736,15540,-14804,2326,34.3,2120,0,143,0.061478934,39005,-36679
ZCTA5 22972,189,2690,-2501,359,53.6,253,0,106,0.295264624,6907,-6548
ZCTA5 22973,2570,1501,1069,6271,47.8,5222,42,351,0.055971934,3295,2976
ZCTA5 22974,1282,13617,-12335,4719,43.7,3594,13,828,0.175460903,34996,-30277
ZCTA5 22976,116,7159,-7043,349,56.8,338,0,11,0.031518625,14199,-13850
ZCTA5 22980,13645,9498,4147,32462,41.7,27175,350,2661,0.081972768,25911,6551
ZCTA5 22989,29,19189,-19160,67,31.9,67,0,0,0,47951,-47884
ZCTA5 23002,4172,12230,-8058,10530,44.4,8011,0,2376,0.225641026,35356,-24826
ZCTA5 23004,466,17377,-16911,1116,51.4,411,0,696,0.623655914,38296,-37180
ZCTA5 23005,6540,6739,-199,18465,37.1,14122,132,2957,0.160140807,14987,3478
ZCTA5 23009,2763,11478,-8715,7641,37,6471,31,1036,0.135584348,24844,-17203
ZCTA5 23011,390,14549,-14159,1364,44.7,829,0,387,0.28372434,33710,-32346
ZCTA5 23015,1639,12726,-11087,4570,50,3975,17,350,0.076586433,32637,-28067
ZCTA5 23021,12,2430,-2418,38,43.4,38,0,0,0,5546,-5508
ZCTA5 23022,461,13280,-12819,1253,32,568,0,465,0.371109338,34384,-33131
ZCTA5 23023,115,11240,-11125,315,43.4,237,0,78,0.247619048,28612,-28297
ZCTA5 23024,3897,15427,-11530,9700,47.3,8324,93,787,0.081134021,42265,-32565
ZCTA5 23025,382,12474,-12092,761,59.8,599,0,162,0.212877792,30251,-29490
ZCTA5 23027,500,9862,-9362,1595,40.5,1139,0,427,0.267711599,26509,-24914
ZCTA5 23030,1896,7578,-5682,4430,51.1,1993,13,2039,0.46027088,21326,-16896
ZCTA5 23032,97,10955,-10858,175,59.5,156,0,11,0.062857143,25251,-25076
ZCTA5 23035,605,0,605,1481,55.4,1414,0,0,0,0,1481
ZCTA5 23038,763,7752,-6989,1726,52.6,1486,50,155,0.089803013,17163,-15437
ZCTA5 23039,499,636,-137,1238,52.4,1003,0,208,0.168012924,1698,-460
ZCTA5 23040,1776,27,1749,3964,48.4,2072,29,1837,0.463420787,46,3918
ZCTA5 23043,737,343,394,1644,52.2,1212,101,55,0.033454988,775,869
ZCTA5 23045,33,76,-43,68,67.9,68,0,0,0,141,-73
ZCTA5 23047,684,368,316,1687,55.5,1151,0,366,0.216953171,943,744
ZCTA5 23050,246,305,-59,497,48.8,368,0,100,0.201207243,782,-285
ZCTA5 23055,413,799,-386,854,54.6,675,0,128,0.149882904,2177,-1323
ZCTA5 23056,56,1923,-1867,110,58,81,0,0,0,4760,-4650
ZCTA5 23059,14897,81,14816,40982,38.9,25424,9458,3669,0.089527109,146,40836
ZCTA5 23060,13655,2694,10961,35844,40.6,21825,4891,6224,0.173641335,7043,28801
ZCTA5 23061,8502,632,7870,22445,44.5,19127,105,2349,0.104655825,1583,20862
ZCTA5 23062,953,100,853,2552,49.2,2239,0,179,0.070141066,182,2370
ZCTA5 23063,1637,20762,-19125,4782,47.1,2915,15,1378,0.288163948,51650,-46868
ZCTA5 23065,590,12362,-11772,1475,49.5,1039,0,397,0.269152542,34777,-33302
ZCTA5 23066,348,19195,-18847,717,53.2,675,0,0,0,61369,-60652
ZCTA5 23068,109,11623,-11514,135,50.3,135,0,0,0,34489,-34354
ZCTA5 23069,1115,8660,-7545,2904,48.9,2085,6,650,0.223829201,23502,-20598
ZCTA5 23070,345,6786,-6441,671,61.9,661,0,0,0,17492,-16821
ZCTA5 23071,774,1506,-732,1823,54.7,1693,15,115,0.06308283,3017,-1194
ZCTA5 23072,4879,162,4717,12387,42,10548,185,760,0.061354646,289,12098
ZCTA5 23075,3680,216,3464,8800,36.5,2737,0,5540,0.629545455,619,8181
ZCTA5 23076,181,1563,-1382,336,71.5,333,0,3,0.008928571,3547,-3211
ZCTA5 23079,151,48,103,458,48.7,313,0,114,0.248908297,196,262
ZCTA5 23081,0,340,-340,0,-,0,0,0,#DIV/0!,806,-806
ZCTA5 23083,850,280,570,2343,42.1,1810,1,360,0.153649168,765,1578
ZCTA5 23084,600,12,588,1379,51.5,707,0,606,0.439448876,28,1351
ZCTA5 23085,176,374,-198,583,37,552,0,31,0.053173242,1123,-540
ZCTA5 23086,1323,46,1277,3448,43.4,2367,51,846,0.245359629,85,3363
ZCTA5 23089,2227,155,2072,5092,51.5,4214,32,711,0.139630793,267,4825
ZCTA5 23091,195,9,186,488,45.2,410,0,21,0.043032787,18,470
ZCTA5 23092,370,38,332,659,56.9,389,0,270,0.409711684,117,542
ZCTA5 23093,5197,398,4799,13796,41.5,10002,71,2583,0.187228182,1145,12651
ZCTA5 23102,1246,201,1045,3764,44.2,2942,191,426,0.113177471,436,3328
ZCTA5 23103,2570,17,2553,6346,53.7,5281,289,640,0.10085093,36,6310
ZCTA5 23106,473,13,460,1246,41,1067,0,127,0.101926164,20,1226
ZCTA5 23108,31,905,-874,56,70.4,56,0,0,0,2239,-2183
ZCTA5 23109,937,323,614,2893,44.7,2491,0,284,0.098167992,809,2084
ZCTA5 23110,409,118,291,845,57.4,720,0,98,0.115976331,241,604
ZCTA5 23111,14693,737,13956,37160,42.4,30936,495,3442,0.09262648,1677,35483
ZCTA5 23112,20264,199,20065,54453,38,41429,1889,6869,0.126145483,456,53997
ZCTA5 23113,9761,1970,7791,25768,46.1,22840,1033,1159,0.044978268,4411,21357
ZCTA5 23114,7999,315,7684,21347,40.9,15809,1360,2863,0.134117206,890,20457
ZCTA5 23116,11283,1228,10055,32855,41.7,29036,669,1652,0.05028154,2917,29938
ZCTA5 23117,3843,1798,2045,10474,47.4,8617,0,1093,0.104353638,4614,5860
ZCTA5 23119,39,135,-96,106,70.9,106,0,0,0,215,-109
ZCTA5 23120,4460,113,4347,13947,36.1,10905,485,1949,0.139743314,260,13687
ZCTA5 23123,656,62,594,1948,38.2,897,0,821,0.421457906,187,1761
ZCTA5 23124,1804,139,1665,4927,40.4,3980,8,816,0.165618023,254,4673
ZCTA5 23126,214,6618,-6404,546,43.4,216,0,195,0.357142857,16920,-16374
ZCTA5 23128,161,544,-383,301,60.1,238,0,60,0.199335548,1269,-968
ZCTA5 23129,182,375,-193,400,39,345,0,55,0.1375,868,-468
ZCTA5 23130,62,17290,-17228,117,63.8,117,0,0,0,47448,-47331
ZCTA5 23138,397,9431,-9034,922,53,687,0,214,0.232104121,26688,-25766
ZCTA5 23139,9802,417,9385,26084,45.4,23087,20,1822,0.06985125,1149,24935
ZCTA5 23140,2698,1646,1052,7165,44.2,4569,132,1609,0.224563852,4765,2400
ZCTA5 23141,2583,791,1792,6970,43.5,5999,79,453,0.064992826,1983,4987
ZCTA5 23146,1203,223,980,3344,48.5,3044,90,107,0.031997608,520,2824
ZCTA5 23147,0,72,-72,0,-,0,0,0,#DIV/0!,187,-187
ZCTA5 23148,599,709,-110,1326,53.2,852,0,432,0.325791855,1405,-79
ZCTA5 23149,1041,19609,-18568,2625,51.3,2097,12,309,0.117714286,42293,-39668
ZCTA5 23150,5218,22274,-17056,12425,45.3,8578,147,3100,0.249496982,59180,-46755
ZCTA5 23153,516,11898,-11382,1357,41.9,878,0,449,0.330876934,35244,-33887
ZCTA5 23156,572,22853,-22281,1387,52.6,705,0,406,0.292718097,63520,-62133
ZCTA5 23160,0,18935,-18935,1823,43.3,660,37,958,0.525507405,47678,-45855
ZCTA5 23161,38,16462,-16424,99,29.8,18,0,81,0.818181818,51483,-51384
ZCTA5 23163,46,1582,-1536,152,-,152,0,0,0,4188,-4036
ZCTA5 23168,3028,265,2763,8477,40.8,6246,239,1462,0.172466675,1052,7425
ZCTA5 23169,426,0,426,1067,49.7,836,15,216,0.202436739,678,389
ZCTA5 23173,0,0,0,2220,19.4,1247,337,444,0.2,152,2068
ZCTA5 23175,812,24310,-23498,1781,56.9,1388,6,347,0.194834363,60583,-58802
ZCTA5 23176,160,26038,-25878,357,56.6,259,0,98,0.274509804,73477,-73120
ZCTA5 23177,316,143,173,707,45,406,0,287,0.405940594,264,443
ZCTA5 23180,236,42,194,688,46.1,528,0,152,0.220930233,168,520
ZCTA5 23181,2134,2452,-318,5303,42,4267,158,417,0.078634735,6499,-1196
ZCTA5 23185,18682,120,18562,52313,41.3,39506,1962,6549,0.125188768,125,52188
ZCTA5 23188,17190,8066,9124,43847,47.9,34284,1128,5818,0.132688667,23363,20484
ZCTA5 23192,2404,13373,-10969,6661,42.6,5563,88,616,0.092478607,36357,-29696
ZCTA5 23219,3003,7042,-4039,4202,31.1,2141,218,1444,0.343645883,22914,-18712
ZCTA5 23220,14099,12004,2095,33965,27.2,19536,1253,11022,0.324510526,30925,3040
ZCTA5 23221,7419,3437,3982,14363,35,12707,395,623,0.043375339,7495,6868
ZCTA5 23222,10789,6191,4598,28375,34.4,5265,341,21550,0.759471366,20170,8205
ZCTA5 23223,23486,4955,18531,54634,34.9,10462,551,40611,0.74332833,12725,41909
ZCTA5 23224,15987,3071,12916,38830,34.7,9535,175,24698,0.636054597,6987,31843
ZCTA5 23225,18722,129,18593,41862,36.9,18877,956,19019,0.454326119,8331,33531
ZCTA5 23226,7328,11285,-3957,15925,40.3,14129,573,468,0.029387755,31343,-15418
ZCTA5 23227,11870,2084,9786,26071,42.6,11138,380,12424,0.47654482,4299,21772
ZCTA5 23228,14990,11215,3775,35744,37.4,19577,2683,9539,0.266869964,30487,5257
ZCTA5 23229,13451,2395,11056,35550,38.5,27178,2460,2476,0.069648383,7264,28286
ZCTA5 23230,3794,0,3794,7395,38.2,4938,531,1144,0.154699121,396,6999
ZCTA5 23231,15307,10414,4893,36674,43.2,12506,205,21974,0.599171075,24140,12534
ZCTA5 23233,12401,15701,-3300,30959,39.4,22070,5267,2056,0.066410414,40345,-9386
ZCTA5 23234,16124,1326,14798,45435,35.6,12384,1294,22959,0.505315286,3901,41534
ZCTA5 23235,13977,942,13035,33571,44.1,24243,1340,5953,0.177325668,7279,26292
ZCTA5 23236,10247,6074,4173,25924,41.2,17496,692,5579,0.215205987,13687,12237
ZCTA5 23237,9091,10693,-1602,27942,33.8,14673,364,7789,0.278755995,27710,232
ZCTA5 23238,11388,9203,2185,26964,43.4,19954,646,4213,0.156245364,23988,2976
ZCTA5 23250,0,16520,-16520,0,-,0,0,0,#DIV/0!,43791,-43791
ZCTA5 23284,7,186,-179,960,19.2,490,83,281,0.292708333,540,420
ZCTA5 23294,8260,5651,2609,19203,32.1,9372,3786,3583,0.186585429,13709,5494
ZCTA5 23298,0,4592,-4592,371,19.6,159,56,137,0.369272237,12110,-11739
ZCTA5 23301,753,5632,-4879,2207,33.1,1186,7,471,0.213411871,16844,-14637
ZCTA5 23302,0,3788,-3788,0,-,0,0,0,#DIV/0!,8526,-8526
ZCTA5 23303,163,1127,-964,470,46.6,403,0,67,0.142553191,5262,-4792
ZCTA5 23304,0,19773,-19773,0,-,0,0,0,#DIV/0!,49149,-49149
ZCTA5 23306,442,15819,-15377,941,42.8,597,0,295,0.313496281,43230,-42289
ZCTA5 23307,236,1190,-954,498,59.4,231,0,267,0.536144578,3437,-2939
ZCTA5 23308,831,50,781,2369,41.3,1538,11,617,0.260447446,189,2180
ZCTA5 23310,2323,7393,-5070,5304,52.3,3550,20,1512,0.285067873,18546,-13242
ZCTA5 23314,3629,8688,-5059,9615,38.9,6689,163,2018,0.209880395,23807,-14192
ZCTA5 23315,617,1402,-785,1317,52.7,1227,0,33,0.025056948,3733,-2416
ZCTA5 23316,32,9227,-9195,76,57.3,39,0,13,0.171052632,23018,-22942
ZCTA5 23320,24387,4463,19924,60180,37,33096,2938,17396,0.289066135,11356,48824
ZCTA5 23321,13815,9921,3894,38325,37.1,20370,1395,13437,0.350606654,27751,10574
ZCTA5 23322,21294,7225,14069,65520,40.2,52656,2176,6752,0.103052503,18353,47167
ZCTA5 23323,14236,5952,8284,41681,35.8,22794,1185,13432,0.322257144,14939,26742
ZCTA5 23324,8492,0,8492,23266,31.7,7132,356,14050,0.603885498,332,22934
ZCTA5 23325,7297,0,7297,18479,35.8,8165,585,8309,0.449645544,37,18442
ZCTA5 23336,1908,994,914,3309,58.4,3152,0,0,0,5346,-2037
ZCTA5 23337,284,14882,-14598,618,31.3,564,0,54,0.087378641,40988,-40370
ZCTA5 23347,274,7303,-7029,782,40.4,582,41,157,0.200767263,19228,-18446
ZCTA5 23350,1485,0,1485,3391,47.8,1589,67,1395,0.411383073,2109,1282
ZCTA5 23354,100,642,-542,230,54.7,230,0,0,0,1413,-1183
ZCTA5 23356,541,2837,-2296,1485,43.7,1485,0,0,0,7599,-6114
ZCTA5 23357,186,584,-398,625,21.6,321,8,80,0.128,1500,-875
ZCTA5 23358,54,149,-95,125,56,104,0,0,0,452,-327
ZCTA5 23359,344,421,-77,1105,35.8,900,46,152,0.137556561,2375,-1270
ZCTA5 23389,58,481,-423,202,36.3,202,0,0,0,1149,-947
ZCTA5 23395,215,12174,-11959,438,69.3,348,0,90,0.205479452,32354,-31916
ZCTA5 23398,12,10672,-10660,30,76.3,30,0,0,0,32830,-32800
ZCTA5 23401,114,794,-680,272,32.9,155,0,106,0.389705882,2361,-2089
ZCTA5 23405,445,9816,-9371,986,54.3,678,0,271,0.27484787,25573,-24587
ZCTA5 23407,193,4169,-3976,719,46.3,428,0,262,0.364394993,11376,-10657
ZCTA5 23408,10,1594,-1584,10,-,10,0,0,0,4373,-4363
ZCTA5 23409,60,5198,-5138,140,36.7,140,0,0,0,15453,-15313
ZCTA5 23410,712,326,386,1815,39,1318,39,431,0.237465565,759,1056
ZCTA5 23413,347,551,-204,871,46.8,341,3,314,0.360505166,1734,-863
ZCTA5 23414,57,1341,-1284,93,-,0,0,93,1,3974,-3881
ZCTA5 23415,757,2492,-1735,1983,51,1017,113,844,0.425617751,7219,-5236
ZCTA5 23416,42,225,-183,45,65.1,0,0,45,1,544,-499
ZCTA5 23417,1850,356,1494,3489,57.8,1918,1,1382,0.396102035,812,2677
ZCTA5 23418,381,188,193,877,40.1,670,6,55,0.062713797,422,455
ZCTA5 23420,1106,254,852,3028,31.8,905,0,2081,0.687252312,529,2499
ZCTA5 23421,1699,5251,-3552,4054,47.5,2040,3,1619,0.399358658,16087,-12033
ZCTA5 23422,107,246,-139,231,73.2,218,0,0,0,623,-392
ZCTA5 23423,116,5459,-5343,299,39.8,299,0,0,0,13820,-13521
ZCTA5 23426,27,348,-321,50,72.1,50,0,0,0,965,-915
ZCTA5 23427,116,200,-84,252,61.3,236,0,0,0,546,-294
ZCTA5 23430,7088,10311,-3223,17803,48.8,12436,117,4568,0.256585969,30583,-12780
ZCTA5 23432,533,859,-326,1277,49.7,965,0,292,0.228660924,2172,-895
ZCTA5 23433,501,956,-455,1254,57,1096,12,112,0.089314195,2874,-1620
ZCTA5 23434,18960,2034,16926,50306,37.8,22788,364,24087,0.478809685,7347,42959
ZCTA5 23435,12175,947,11228,32845,37.1,16435,1298,12072,0.367544527,2345,30500
ZCTA5 23436,355,426,-71,996,50.9,599,11,347,0.348393574,1029,-33
ZCTA5 23437,1938,3726,-1788,4614,44.7,3189,19,1167,0.252925878,10779,-6165
ZCTA5 23438,679,239,440,1697,40.2,1308,49,258,0.152032999,549,1148
ZCTA5 23440,216,429,-213,411,57.6,411,0,0,0,1121,-710
ZCTA5 23441,0,316,-316,0,-,0,0,0,#DIV/0!,1027,-1027
ZCTA5 23442,447,812,-365,1036,56.2,650,21,365,0.352316602,1975,-939
ZCTA5 23451,20835,887,19948,43885,38.5,35658,1211,3883,0.088481258,2348,41537
ZCTA5 23452,22182,960,21222,56854,36.2,37241,2545,10372,0.182432195,2987,53867
ZCTA5 23453,12647,16,12631,35199,34.8,17857,4176,7542,0.214267451,64,35135
ZCTA5 23454,23165,996,22169,57942,38,42670,2751,7883,0.136049843,2531,55411
ZCTA5 23455,20801,273,20528,49826,38.6,36689,2754,6829,0.137056958,410,49416
ZCTA5 23456,19965,746,19219,60158,39,39108,6760,8534,0.141859769,2152,58006
ZCTA5 23457,1635,230,1405,4689,39.9,3978,30,477,0.101727447,485,4204
ZCTA5 23459,0,1616,-1616,1766,22.8,1213,13,327,0.185164213,5074,-3308
ZCTA5 23460,0,4,-4,2211,21,1512,44,439,0.198552691,1401,810
ZCTA5 23461,0,111,-111,1040,20.8,667,49,198,0.190384615,156,884
ZCTA5 23462,27278,191,27087,66949,34.4,33952,3200,21425,0.320019717,499,66450
ZCTA5 23464,28538,223,28315,77139,37.3,41983,8536,19004,0.246360466,373,76766
ZCTA5 23480,156,785,-629,294,66.5,277,0,17,0.057823129,2132,-1838
ZCTA5 23486,28,156,-128,48,55.3,48,0,0,0,357,-309
ZCTA5 23487,2330,5605,-3275,6051,42.9,4617,88,978,0.161626177,16788,-10737
ZCTA5 23488,217,0,217,406,45.4,5,0,401,0.987684729,1627,-1221
ZCTA5 23502,8280,202,8078,19871,36.8,7312,648,9868,0.49660309,818,19053
ZCTA5 23503,13999,1147,12852,30770,34.2,19920,1080,6638,0.215729607,3859,26911
ZCTA5 23504,8379,1112,7267,23417,27.8,2570,132,19486,0.832130503,2198,21219
ZCTA5 23505,12286,1354,10932,28289,30.6,13829,1334,9893,0.349711902,3871,24418
ZCTA5 23507,3313,711,2602,6405,34.3,5316,396,275,0.042935207,1305,5100
ZCTA5 23508,6691,591,6100,21182,22.8,10885,717,7773,0.366962515,1998,19184
ZCTA5 23509,5241,1050,4191,12715,37.8,5542,331,6027,0.474007078,2701,10014
ZCTA5 23510,4633,2558,2075,9211,31.4,4632,372,3391,0.368146781,7335,1876
ZCTA5 23511,326,1900,-1574,15536,22.1,9974,552,2633,0.169477343,3897,11639
ZCTA5 23513,12009,2241,9768,30139,34.8,7498,1326,17393,0.577092803,6598,23541
ZCTA5 23517,2414,317,2097,4243,36.5,2857,211,918,0.216356352,850,3393
ZCTA5 23518,12542,2395,10147,28602,38.1,17861,1505,6179,0.216033844,9628,18974
ZCTA5 23523,2764,795,1969,6848,30.2,268,16,6367,0.929760514,2171,4677
ZCTA5 23551,0,134,-134,1328,22.2,812,65,280,0.210843373,306,1022
ZCTA5 23601,11663,553,11110,26017,39.1,14418,678,9053,0.347964792,1078,24939
ZCTA5 23602,17737,23,17714,41330,36,20821,2202,13726,0.332107428,295,41035
ZCTA5 23603,1439,1777,-338,3676,35.7,1853,15,1346,0.366158868,4610,-934
ZCTA5 23604,773,1481,-708,5872,22.3,3246,224,1591,0.270946866,3760,2112
ZCTA5 23605,6393,1319,5074,13920,34.4,4399,80,8172,0.587068966,3967,9953
ZCTA5 23606,11873,59,11814,29464,32.5,18304,783,7252,0.246130872,147,29317
ZCTA5 23607,9521,873,8648,24317,32.5,3585,244,18720,0.769831805,2112,22205
ZCTA5 23608,16889,1184,15705,43346,32.7,18401,2145,17686,0.408019194,3022,40324
ZCTA5 23651,242,477,-235,440,57.2,404,0,29,0.065909091,1219,-779
ZCTA5 23661,5868,700,5168,13813,41.9,4498,50,8604,0.622891479,2000,11813
ZCTA5 23662,4617,136,4481,12382,43,11533,229,181,0.014617994,277,12105
ZCTA5 23663,5424,140,5284,13807,35.4,5384,118,7117,0.515463171,411,13396
ZCTA5 23664,4550,493,4057,10088,41.5,6933,23,2312,0.229183188,1280,8808
ZCTA5 23665,1610,898,712,6737,21.5,4155,260,1112,0.165058631,1998,4739
ZCTA5 23666,23074,333,22741,53406,36.4,16776,1956,29280,0.548253005,925,52481
ZCTA5 23667,0,279,-279,0,-,0,0,0,#DIV/0!,659,-659
ZCTA5 23668,0,3513,-3513,741,18.9,125,5,563,0.759784076,8639,-7898
ZCTA5 23669,16342,1539,14803,39558,35.5,17568,645,17736,0.448354315,5079,34479
ZCTA5 23681,0,84,-84,0,-,0,0,0,#DIV/0!,152,-152
ZCTA5 23690,1535,66,1469,5094,29.1,3161,104,884,0.173537495,149,4945
ZCTA5 23691,15,13006,-12991,577,22.5,416,23,75,0.129982669,29604,-29027
ZCTA5 23692,7303,3104,4199,18625,44.7,14825,787,1791,0.096161074,8484,10141
ZCTA5 23693,8791,7648,1143,23609,41.4,15436,2479,3772,0.159769579,16586,7023
ZCTA5 23696,1321,7431,-6110,3967,40.6,3779,19,38,0.009579027,15594,-11627
ZCTA5 23701,9518,3773,5745,25021,37.5,9321,106,13209,0.52791655,8549,16472
ZCTA5 23702,4832,9294,-4462,12220,31.3,4546,230,6194,0.506873977,23323,-11103
ZCTA5 23703,9836,16211,-6375,26680,36.1,11157,508,12843,0.481371814,37339,-10659
ZCTA5 23704,8037,10674,-2637,18344,35.3,4573,323,12384,0.675098125,26840,-8496
ZCTA5 23707,6325,24,6301,14038,38.3,6999,297,5960,0.424561903,389,13649
ZCTA5 23708,5,1116,-1111,471,22.3,184,0,129,0.27388535,2951,-2480
ZCTA5 23709,0,2611,-2611,680,22.1,393,16,159,0.233823529,6645,-5965
ZCTA5 23801,1470,5581,-4111,6271,22.8,2438,157,2335,0.372348908,13399,-7128
ZCTA5 23803,16379,201,16178,41300,37.8,14319,228,24632,0.596416465,357,40943
ZCTA5 23805,8282,276,8006,21507,38.8,7313,332,12512,0.581764077,723,20784
ZCTA5 23821,722,17893,-17171,2207,39.7,983,0,1129,0.511554146,53205,-50998
ZCTA5 23824,2583,1770,813,6707,41.9,3401,43,2993,0.446250186,4418,2289
ZCTA5 23827,441,2537,-2096,1191,40.3,443,0,615,0.516372796,5828,-4637
ZCTA5 23828,261,1878,-1617,711,54.5,284,0,276,0.388185654,4749,-4038
ZCTA5 23829,500,1004,-504,2287,52,1421,12,677,0.296020988,2594,-307
ZCTA5 23830,533,753,-220,1407,41.6,1023,24,257,0.182658138,1858,-451
ZCTA5 23831,13744,541,13203,36024,40.8,22032,1025,9347,0.259465912,1566,34458
ZCTA5 23832,13025,481,12544,39273,38.1,24554,1596,9800,0.249535304,1217,38056
ZCTA5 23833,835,11974,-11139,2120,46.3,1917,0,114,0.053773585,28598,-26478
ZCTA5 23834,10925,430,10495,27480,38.8,18170,891,6701,0.243850073,1220,26260
ZCTA5 23836,5272,589,4683,13875,40.1,8156,453,3618,0.260756757,1292,12583
ZCTA5 23837,1773,3393,-1620,4676,49.2,2742,2,1791,0.383019675,7543,-2867
ZCTA5 23838,5777,725,5052,16511,47.3,12790,588,1758,0.106474472,1534,14977
ZCTA5 23839,314,152,162,922,45.5,403,0,504,0.546637744,390,532
ZCTA5 23840,755,809,-54,1988,48.4,1482,18,488,0.245472837,2208,-220
ZCTA5 23841,1328,4687,-3359,3579,37.5,1930,19,1287,0.359597653,11754,-8175
ZCTA5 23842,2664,822,1842,7410,47.9,5381,11,1600,0.215924426,2044,5366
ZCTA5 23843,258,75,183,420,68.8,212,5,193,0.45952381,171,249
ZCTA5 23844,201,1951,-1750,611,36.1,199,0,373,0.610474632,4837,-4226
ZCTA5 23845,166,1728,-1562,272,66.9,272,0,0,0,5070,-4798
ZCTA5 23846,340,998,-658,739,55.3,624,0,115,0.155615697,2765,-2026
ZCTA5 23847,5094,1748,3346,13891,40.4,4109,0,8415,0.60578792,4691,9200
ZCTA5 23850,510,2713,-2203,1254,55.1,1029,0,225,0.179425837,7334,-6080
ZCTA5 23851,5350,1218,4132,12956,41.8,5867,227,6302,0.48641556,2738,10218
ZCTA5 23856,404,52,352,865,51.1,190,0,599,0.692485549,160,705
ZCTA5 23857,140,1617,-1477,380,41.7,378,0,0,0,4085,-3705
ZCTA5 23860,10877,2662,8215,32407,38.3,15555,344,14002,0.432067146,6496,25911
ZCTA5 23866,744,721,23,1822,39.9,1342,0,327,0.179473106,1916,-94
ZCTA5 23867,857,1375,-518,4709,41.2,1845,11,2531,0.537481419,3491,1218
ZCTA5 23868,1948,353,1595,6929,36.7,2101,3,4589,0.662288931,881,6048
ZCTA5 23870,0,13917,-13917,0,-,0,0,0,#DIV/0!,32610,-32610
ZCTA5 23872,943,990,-47,2498,44.3,1562,0,920,0.368294636,2006,492
ZCTA5 23874,402,4106,-3704,775,55,497,0,272,0.350967742,9676,-8901
ZCTA5 23875,4711,746,3965,13043,37,7877,281,3993,0.306141225,1721,11322
ZCTA5 23876,86,1830,-1744,174,50.9,106,0,68,0.390804598,4602,-4428
ZCTA5 23878,646,1740,-1094,1629,39.6,1455,0,152,0.093308778,4331,-2702
ZCTA5 23879,253,693,-440,525,34.5,281,0,167,0.318095238,1573,-1048
ZCTA5 23881,867,0,867,2028,48.7,1136,0,882,0.434911243,0,2028
ZCTA5 23882,688,12,676,1648,48.6,782,1,838,0.508495146,27,1621
ZCTA5 23883,790,199,591,1947,54.1,1060,0,865,0.444273241,404,1543
ZCTA5 23884,0,1024,-1024,29,26.4,6,0,19,0.655172414,2687,-2658
ZCTA5 23885,1033,2337,-1304,2532,49.8,1989,39,436,0.172195893,5603,-3071
ZCTA5 23887,269,1447,-1178,442,59.7,387,0,30,0.067873303,3607,-3165
ZCTA5 23888,867,1172,-305,2330,42.6,1001,49,1195,0.512875536,2565,-235
ZCTA5 23889,229,548,-319,457,56.5,27,0,357,0.781181619,1626,-1169
ZCTA5 23890,1645,315,1330,4850,37.2,1962,0,2763,0.569690722,666,4184
ZCTA5 23891,0,8821,-8821,1365,36.5,341,6,891,0.652747253,20925,-19560
ZCTA5 23893,182,0,182,468,35.6,264,0,179,0.382478632,2967,-2499
ZCTA5 23894,143,491,-348,403,45.9,274,0,124,0.307692308,1164,-761
ZCTA5 23897,325,3430,-3105,763,45.2,288,2,468,0.613368283,7689,-6926
ZCTA5 23898,1078,1470,-392,2853,45.5,2287,1,366,0.128286015,3667,-814
ZCTA5 23899,204,368,-164,403,60.5,318,7,65,0.161290323,815,-412
ZCTA5 23901,5634,8378,-2744,15761,34.1,10493,122,3991,0.253219973,19756,-3995
ZCTA5 23909,0,14543,-14543,1400,19,1148,24,182,0.13,36110,-34710
ZCTA5 23915,402,114,288,1715,38,972,0,723,0.421574344,224,1491
ZCTA5 23917,1068,929,139,2910,51.2,1536,9,1260,0.432989691,2043,867
ZCTA5 23919,865,565,300,1855,60.7,1394,0,420,0.226415094,1324,531
ZCTA5 23920,1285,115,1170,2936,49.5,1636,0,1244,0.423705722,179,2757
ZCTA5 23921,813,92,721,2062,46.4,1649,1,337,0.16343356,242,1820
ZCTA5 23922,808,3248,-2440,4281,39.9,2812,26,1325,0.309507125,7567,-3286
ZCTA5 23923,1009,1069,-60,2436,48.4,1909,14,466,0.191297209,2541,-105
ZCTA5 23924,2520,3777,-1257,5980,47.3,3642,0,2153,0.360033445,9915,-3935
ZCTA5 23927,1983,724,1259,4317,58.2,3413,10,838,0.194116284,1823,2494
ZCTA5 23930,2193,7808,-5615,5450,38.7,3448,0,1960,0.359633028,18773,-13323
ZCTA5 23934,243,2092,-1849,553,37.4,460,0,93,0.168173599,4845,-4292
ZCTA5 23936,2015,383,1632,6663,45.3,3768,6,2482,0.372504878,1204,5459
ZCTA5 23937,805,7410,-6605,2219,47.9,1535,0,657,0.296079315,16897,-14678
ZCTA5 23938,102,5286,-5184,178,56.9,123,0,53,0.297752809,13140,-12962
ZCTA5 23942,521,7154,-6633,1355,38.8,927,0,395,0.291512915,16195,-14840
ZCTA5 23943,0,4452,-4452,1017,20.4,787,32,111,0.109144543,10217,-9200
ZCTA5 23944,1315,1218,97,3509,41.3,1440,0,1641,0.467654602,3110,399
ZCTA5 23947,1486,222,1264,3634,45.7,2784,23,600,0.16510732,519,3115
ZCTA5 23950,1303,4136,-2833,3481,45.1,2182,0,1234,0.354495835,11682,-8201
ZCTA5 23952,65,274,-209,199,49.7,199,0,0,0,805,-606
ZCTA5 23954,925,372,553,2424,39.4,897,0,1527,0.629950495,1064,1360
ZCTA5 23955,9,2589,-2580,16,-,16,0,0,0,7234,-7218
ZCTA5 23958,996,752,244,2663,45.2,1658,37,812,0.304919264,1732,931
ZCTA5 23959,489,566,-77,1290,41.7,970,5,278,0.215503876,1443,-153
ZCTA5 23960,764,2990,-2226,1884,39.1,1092,0,710,0.376857749,6863,-4979
ZCTA5 23962,180,3590,-3410,444,55.5,384,0,60,0.135135135,8859,-8415
ZCTA5 23963,101,1392,-1291,286,35.8,164,0,122,0.426573427,3093,-2807
ZCTA5 23964,484,380,104,1098,49.3,595,10,452,0.411657559,1121,-23
ZCTA5 23966,831,60,771,1832,48.7,1267,25,374,0.204148472,119,1713
ZCTA5 23967,391,947,-556,1206,39.1,818,0,388,0.32172471,2343,-1137
ZCTA5 23968,351,2116,-1765,710,51.7,418,11,268,0.377464789,5393,-4683
ZCTA5 23970,3447,480,2967,7936,41.7,4500,249,2939,0.370337702,1262,6674
ZCTA5 23974,1511,207,1304,4959,43.4,2785,31,1922,0.387578141,398,4561
ZCTA5 23976,64,1115,-1051,64,73.3,56,0,8,0.125,2696,-2632
ZCTA5 24011,475,487,-12,734,31.5,559,23,67,0.091280654,1135,-401
ZCTA5 24012,12427,3654,8773,29770,39.5,18803,1155,6418,0.215586161,8747,21023
ZCTA5 24013,2662,1403,1259,8248,35.4,5668,0,1992,0.241513094,3685,4563
ZCTA5 24014,7615,757,6858,16434,46.1,14334,226,1094,0.066569308,1654,14780
ZCTA5 24015,6866,2445,4421,15824,37.2,13716,476,874,0.055232558,6437,9387
ZCTA5 24016,4556,2573,1983,9428,33.9,4323,399,4225,0.44813322,6364,3064
ZCTA5 24017,9477,409,9068,23333,38.4,7248,784,14221,0.609480135,1134,22199
ZCTA5 24018,15958,3444,12514,38232,44,33029,2613,1552,0.040594267,8711,29521
ZCTA5 24019,11808,240,11568,28480,43.9,22224,711,3745,0.131495787,599,27881
ZCTA5 24020,28,330,-302,664,19.7,524,28,81,0.121987952,703,-39
ZCTA5 24022,0,1082,-1082,0,-,0,0,0,#DIV/0!,2481,-2481
ZCTA5 24053,1095,151,944,2398,48.8,2198,36,112,0.046705588,407,1991
ZCTA5 24054,2143,2695,-552,5699,45.4,3743,0,1698,0.297947008,6596,-897
ZCTA5 24055,4948,2373,2575,11503,50.2,9705,0,1343,0.116752152,6978,4525
ZCTA5 24058,92,2049,-1957,202,62.6,202,0,0,0,5946,-5744
ZCTA5 24059,477,361,116,986,58.7,956,0,0,0,756,230
ZCTA5 24060,18160,1072,17088,48296,26.7,39596,4835,2052,0.042487991,2498,45798
ZCTA5 24061,0,263,-263,8764,19,6996,641,628,0.071656778,589,8175
ZCTA5 24064,1814,1037,777,5264,42.9,4731,57,147,0.027925532,2406,2858
ZCTA5 24065,2698,1024,1674,6367,50.1,6086,0,67,0.010523009,2325,4042
ZCTA5 24066,2045,259,1786,5112,48.9,4845,0,53,0.010367762,540,4572
ZCTA5 24067,842,3815,-2973,2234,41.7,2211,0,14,0.006266786,9916,-7682
ZCTA5 24069,691,5999,-5308,1599,48.6,797,0,600,0.375234522,13802,-12203
ZCTA5 24070,580,722,-142,1666,47,1551,0,106,0.06362545,2002,-336
ZCTA5 24072,450,1044,-594,1073,36.5,1015,12,17,0.01584343,2539,-1466
ZCTA5 24073,12661,345,12316,30043,40.5,26309,885,1409,0.046899444,1035,29008
ZCTA5 24076,478,576,-98,1211,36.9,1211,0,0,0,1718,-507
ZCTA5 24077,452,1238,-786,940,46.1,799,0,141,0.15,3661,-2721
ZCTA5 24078,2852,12,2840,7337,39,5775,89,781,0.106446777,23,7314
ZCTA5 24079,772,1631,-859,2058,41.9,2058,0,0,0,4391,-2333
ZCTA5 24082,217,293,-76,557,28.8,442,0,115,0.206463196,632,-75
ZCTA5 24083,1370,2848,-1478,4096,46.6,3700,11,55,0.013427734,7593,-3497
ZCTA5 24084,4402,138,4264,10922,49.9,10217,8,483,0.04422267,222,10700
ZCTA5 24085,1087,321,766,2192,53.1,2084,0,96,0.04379562,681,1511
ZCTA5 24086,80,878,-798,188,31.5,176,0,12,0.063829787,1975,-1787
ZCTA5 24087,1610,496,1114,4207,34.7,3568,0,112,0.026622296,1199,3008
ZCTA5 24088,1635,434,1201,4975,36,4310,0,586,0.117788945,897,4078
ZCTA5 24089,1291,846,445,2814,57.4,1984,0,830,0.294953802,1687,1127
ZCTA5 24090,1974,1536,438,4967,46,4570,22,158,0.031809946,3817,1150
ZCTA5 24091,3387,8033,-4646,7552,51.8,6808,17,418,0.055349576,17540,-9988
ZCTA5 24092,1263,2238,-975,3816,33.2,3159,13,426,0.11163522,5693,-1877
ZCTA5 24093,39,3667,-3628,100,47.5,100,0,0,0,8898,-8798
ZCTA5 24095,1741,658,1083,3548,48.4,3336,0,55,0.015501691,1826,1722
ZCTA5 24101,2382,1843,539,6132,51.7,5782,117,15,0.002446184,4294,1838
ZCTA5 24102,630,517,113,1685,37.6,1647,0,18,0.010682493,1189,496
ZCTA5 24104,1301,239,1062,2565,62,2482,0,26,0.010136452,599,1966
ZCTA5 24105,211,443,-232,420,46.4,420,0,0,0,944,-524
ZCTA5 24112,12697,5971,6726,30395,47,16675,268,11731,0.385951637,15304,15091
ZCTA5 24120,815,2492,-1677,1703,60.3,1676,0,3,0.001761597,6626,-4923
ZCTA5 24121,4711,1801,2910,10920,54.3,10356,26,341,0.031227106,5146,5774
ZCTA5 24122,595,504,91,1407,51,1391,1,2,0.001421464,1182,225
ZCTA5 24124,1834,255,1579,4682,37.9,4539,0,33,0.00704827,567,4115
ZCTA5 24127,1576,1827,-251,4060,49.6,3937,0,2,0.000492611,4640,-580
ZCTA5 24128,842,2540,-1698,1981,44.9,1947,0,0,0,6072,-4091
ZCTA5 24129,102,410,-308,120,66.5,0,0,120,1,1182,-1062
ZCTA5 24131,45,687,-642,71,74,16,0,0,0,1571,-1500
ZCTA5 24132,209,139,70,253,54.3,218,26,9,0.035573123,361,-108
ZCTA5 24133,924,636,288,2436,44.7,2332,9,76,0.031198686,1364,1072
ZCTA5 24134,2230,951,1279,5728,44.7,5527,0,121,0.021124302,2260,3468
ZCTA5 24136,1267,1496,-229,2805,51.9,2549,0,134,0.047771836,3294,-489
ZCTA5 24137,1356,5483,-4127,2970,57.2,2556,118,153,0.051515152,13303,-10333
ZCTA5 24138,568,15436,-14868,1605,38.1,1575,7,0,0,35403,-33798
ZCTA5 24139,392,29,363,634,72.6,513,0,115,0.181388013,116,518
ZCTA5 24141,8747,67,8680,21170,36.3,19412,310,970,0.045819556,155,21015
ZCTA5 24142,0,92,-92,2708,19.5,1670,13,707,0.261078287,170,2538
ZCTA5 24147,421,22,399,1245,40.3,1182,3,15,0.012048193,94,1151
ZCTA5 24148,3143,3604,-461,8794,43.7,6661,49,1624,0.184671367,8809,-15
ZCTA5 24149,1446,1485,-39,3658,44.6,3658,0,0,0,3664,-6
ZCTA5 24150,310,2697,-2387,686,54.6,686,0,0,0,6566,-5880
ZCTA5 24151,7580,6077,1503,18580,46,15130,86,2634,0.141765339,14140,4440
ZCTA5 24153,14924,789,14135,38178,42.3,33888,589,2141,0.056079417,4788,33390
ZCTA5 24161,128,1182,-1054,444,27.7,367,0,57,0.128378378,2713,-2269
ZCTA5 24162,886,121,765,2068,46.6,1911,52,31,0.014990329,300,1768
ZCTA5 24165,573,33,540,1312,49.3,1093,10,147,0.112042683,46,1266
ZCTA5 24167,65,927,-862,112,59.3,92,0,0,0,2457,-2345
ZCTA5 24168,97,393,-296,256,26.5,256,0,0,0,1026,-770
ZCTA5 24171,3710,553,3157,8460,51.2,7460,31,654,0.077304965,1203,7257
ZCTA5 24174,1155,919,236,3035,34,2931,0,0,0,2548,487
ZCTA5 24175,2980,2542,438,7555,51.3,7306,42,51,0.006750496,6575,980
ZCTA5 24176,547,57,490,1195,58.8,1096,9,54,0.045188285,175,1020
ZCTA5 24179,8052,1044,7008,19154,42.2,17841,181,329,0.017176569,2229,16925
ZCTA5 24184,1629,168,1461,3860,53.9,3578,21,194,0.050259067,434,3426
ZCTA5 24185,326,5751,-5425,705,59.1,693,0,12,0.017021277,16467,-15762
ZCTA5 24201,6806,132,6674,15863,43.7,13991,27,925,0.058311795,293,15570
ZCTA5 24202,5212,194,5018,12282,49.8,11596,146,224,0.018238072,387,11895
ZCTA5 24210,7299,369,6930,17114,45,16138,82,440,0.025709945,929,16185
ZCTA5 24211,4204,552,3652,9856,51,9557,48,44,0.004464286,1292,8564
ZCTA5 24216,1019,128,891,2576,42.8,2331,0,59,0.022903727,281,2295
ZCTA5 24217,122,649,-527,270,59.4,270,0,0,0,1458,-1188
ZCTA5 24219,4018,844,3174,11218,42,9813,126,985,0.087805313,1972,9246
ZCTA5 24220,301,475,-174,833,43.8,813,0,0,0,971,-138
ZCTA5 24221,275,740,-465,679,48.5,605,0,0,0,1395,-716
ZCTA5 24224,2194,383,1811,5445,44.3,5300,0,0,0,988,4457
ZCTA5 24225,911,236,675,2276,46.6,2017,0,0,0,669,1607
ZCTA5 24226,613,165,448,1529,38,1506,0,3,0.001962067,288,1241
ZCTA5 24228,2424,3835,-1411,5842,47,5691,0,63,0.010783978,9687,-3845
ZCTA5 24230,2914,597,2317,7615,38.1,7225,21,270,0.035456336,1323,6292
ZCTA5 24236,1228,1839,-611,3095,40.7,3065,0,0,0,4695,-1600
ZCTA5 24237,388,300,88,821,61.3,734,0,87,0.105968331,1089,-268
ZCTA5 24239,24,486,-462,118,24.7,118,0,0,0,1236,-1118
ZCTA5 24243,637,141,496,1557,39.1,1557,0,0,0,407,1150
ZCTA5 24244,1947,1204,743,5880,40.5,5684,0,87,0.014795918,3217,2663
ZCTA5 24245,341,116,225,802,46.8,776,8,2,0.002493766,277,525
ZCTA5 24246,103,10511,-10408,263,54.4,263,0,0,0,26458,-26195
ZCTA5 24248,1072,16039,-14967,2292,48.3,2260,0,0,0,44312,-42020
ZCTA5 24250,467,7877,-7410,1015,52,1000,0,0,0,19394,-18379
ZCTA5 24251,3324,3971,-647,7786,47.6,7679,0,74,0.009504238,10864,-3078
ZCTA5 24256,1336,2367,-1031,3531,47.8,3458,19,32,0.009062589,5615,-2084
ZCTA5 24258,559,935,-376,1261,54.7,1261,0,0,0,2057,-796
ZCTA5 24260,2082,4153,-2071,5115,44.6,5039,0,58,0.011339198,10499,-5384
ZCTA5 24263,2356,3806,-1450,5556,47.3,5517,0,3,0.000539957,9729,-4173
ZCTA5 24265,354,7909,-7555,1274,59.3,1274,0,0,0,18527,-17253
ZCTA5 24266,3551,552,2999,8784,47.5,8508,11,259,0.029485428,1240,7544
ZCTA5 24269,139,1193,-1054,435,39.4,412,0,23,0.052873563,2902,-2467
ZCTA5 24270,160,1284,-1124,503,46.6,498,0,0,0,3291,-2788
ZCTA5 24271,1140,600,540,2516,53.5,2500,0,0,0,1381,1135
ZCTA5 24272,291,498,-207,642,65.1,642,0,0,0,1174,-532
ZCTA5 24273,2354,3737,-1383,5898,43.5,5715,2,88,0.014920312,9468,-3570
ZCTA5 24277,1883,692,1191,6234,39.5,5094,27,888,0.142444658,1546,4688
ZCTA5 24279,1656,57,1599,4784,41.8,4188,28,521,0.108904682,150,4634
ZCTA5 24280,272,1741,-1469,1082,26.5,1076,0,6,0.005545287,4409,-3327
ZCTA5 24281,795,25,770,2416,47.7,2396,20,0,0,39,2377
ZCTA5 24282,228,13324,-13096,780,48.2,772,0,0,0,31329,-30549
ZCTA5 24283,843,12636,-11793,1999,45.6,1974,0,0,0,28936,-26937
ZCTA5 24290,775,1905,-1130,2280,41.3,2182,2,30,0.013157895,4818,-2538
ZCTA5 24292,173,2593,-2420,389,42.9,362,0,22,0.05655527,7391,-7002
ZCTA5 24293,3710,7929,-4219,8942,41.1,8546,39,195,0.021807202,21439,-12497
ZCTA5 24301,5903,817,5086,13909,42.3,12549,165,672,0.048314041,2516,11393
ZCTA5 24311,692,1312,-620,1425,47.6,1336,0,40,0.028070175,3515,-2090
ZCTA5 24312,701,922,-221,1650,53,1621,0,29,0.017575758,2365,-715
ZCTA5 24313,282,1360,-1078,729,38.7,693,0,0,0,3537,-2808
ZCTA5 24314,588,3499,-2911,1329,57.3,1314,0,10,0.007524454,7744,-6415
ZCTA5 24315,1235,2797,-1562,3684,38.8,3350,5,258,0.070032573,7255,-3571
ZCTA5 24316,13,220,-207,39,59.5,39,0,0,0,560,-521
ZCTA5 24317,1530,2381,-851,3612,43.9,3504,0,33,0.009136213,5404,-1792
ZCTA5 24318,199,464,-265,551,43.5,543,0,0,0,1186,-635
ZCTA5 24319,2547,627,1920,6302,47.9,6042,5,112,0.017772136,1547,4755
ZCTA5 24322,23,410,-387,23,-,23,0,0,0,1204,-1181
ZCTA5 24323,417,0,417,1074,35.5,960,0,21,0.019553073,0,1074
ZCTA5 24324,976,824,152,2199,49.2,1946,0,206,0.093678945,1744,455
ZCTA5 24325,579,6541,-5962,1115,48.9,1079,0,0,0,15643,-14528
ZCTA5 24326,427,1509,-1082,847,63.8,845,0,2,0.002361275,3996,-3149
ZCTA5 24327,0,1940,-1940,540,20.6,410,11,85,0.157407407,4988,-4448
ZCTA5 24328,947,369,578,1794,61.4,1759,0,0,0,767,1027
ZCTA5 24330,1180,566,614,2792,42.8,2741,0,3,0.001074499,1459,1333
ZCTA5 24333,7281,192,7089,18402,45.2,16270,137,656,0.035648299,619,17783
ZCTA5 24340,2201,0,2201,6262,45.1,5973,2,137,0.021877994,0,6262
ZCTA5 24343,3420,2261,1159,8241,51.2,8034,0,14,0.001698823,5560,2681
ZCTA5 24347,752,3648,-2896,1597,48.1,1577,0,0,0,9016,-7419
ZCTA5 24348,1649,929,720,4750,44.4,3877,154,651,0.137052632,2172,2578
ZCTA5 24350,602,3114,-2512,1606,47.8,1452,0,0,0,8046,-6440
ZCTA5 24351,255,5897,-5642,389,66,355,0,0,0,14313,-13924
ZCTA5 24352,429,730,-301,1239,43.4,1158,0,0,0,1827,-588
ZCTA5 24354,6112,607,5505,14252,46.2,13401,91,450,0.031574516,1400,12852
ZCTA5 24360,2352,56,2296,5698,49.1,5595,32,26,0.004563005,787,4911
ZCTA5 24361,1832,386,1446,4824,43.1,4757,4,31,0.006426202,1036,3788
ZCTA5 24363,553,813,-260,1126,53.1,1098,14,14,0.012433393,2004,-878
ZCTA5 24366,187,152,35,439,60.6,417,0,22,0.050113895,402,37
ZCTA5 24368,1945,14,1931,5034,40.9,4802,0,13,0.002582439,47,4987
ZCTA5 24370,2504,360,2144,6137,43,6103,0,0,0,968,5169
ZCTA5 24374,299,490,-191,589,58.7,515,0,28,0.0475382,1202,-613
ZCTA5 24375,725,168,557,1743,46,1616,83,7,0.004016064,447,1296
ZCTA5 24377,159,3576,-3417,544,42.3,544,0,0,0,8622,-8078
ZCTA5 24378,417,152,265,856,58.8,830,3,4,0.004672897,391,465
ZCTA5 24380,1179,135,1044,2480,58.5,2443,37,0,0,395,2085
ZCTA5 24381,1247,2892,-1645,3297,39.9,3206,0,12,0.003639672,6695,-3398
ZCTA5 24382,6532,46,6486,14541,47.3,13590,187,526,0.036173578,104,14437
ZCTA5 24401,16220,302,15918,36632,46,30837,407,3474,0.094835117,535,36097
ZCTA5 24411,3,3052,-3049,3,-,0,0,0,0,7751,-7748
ZCTA5 24412,106,1267,-1161,173,42.6,173,0,0,0,3606,-3433
ZCTA5 24413,114,384,-270,276,45.4,272,0,0,0,1139,-863
ZCTA5 24415,13,76,-63,26,-,26,0,0,0,139,-113
ZCTA5 24416,3612,2980,632,9622,39.4,8441,56,676,0.070255664,7427,2195
ZCTA5 24421,1485,771,714,3683,46.6,3636,20,23,0.006244909,2040,1643
ZCTA5 24422,2377,235,2142,5913,46.3,5136,4,568,0.09605953,679,5234
ZCTA5 24426,5839,272,5567,13386,45.3,12090,69,915,0.068354998,1112,12274
ZCTA5 24430,694,1419,-725,3900,40.6,2481,14,1203,0.308461538,3941,-41
ZCTA5 24431,1039,1740,-701,2563,32.8,2460,83,20,0.007803355,4615,-2052
ZCTA5 24432,170,2418,-2248,281,48.3,249,0,0,0,5966,-5685
ZCTA5 24433,30,248,-218,82,52.3,82,0,0,0,641,-559
ZCTA5 24435,783,1175,-392,1537,59.8,1431,0,0,0,2821,-1284
ZCTA5 24437,581,2522,-1941,1514,52.8,1342,0,0,0,5702,-4188
ZCTA5 24439,532,1379,-847,1131,57.6,1122,4,0,0,3278,-2147
ZCTA5 24440,1046,184,862,2899,38.1,2764,0,128,0.044153156,404,2495
ZCTA5 24441,2557,8982,-6425,6134,41,5739,2,101,0.016465602,20815,-14681
ZCTA5 24442,36,492,-456,82,45.7,82,0,0,0,1818,-1736
ZCTA5 24445,1071,70,1001,2516,51.1,2389,12,115,0.045707472,227,2289
ZCTA5 24448,177,255,-78,379,44.3,352,0,19,0.050131926,641,-262
ZCTA5 24450,5689,140,5549,16789,35.3,14964,431,752,0.044791232,321,16468
ZCTA5 24457,138,110,28,388,51.7,353,0,35,0.090206186,393,-5
ZCTA5 24458,152,34,118,296,54.8,237,0,0,0,104,192
ZCTA5 24459,257,110,147,582,46.9,533,36,0,0,329,253
ZCTA5 24460,506,77,429,1159,52.7,1125,0,16,0.013805004,138,1021
ZCTA5 24464,107,74,33,221,79.4,221,0,0,0,254,-33
ZCTA5 24465,585,247,338,1331,62,1223,69,0,0,573,758
ZCTA5 24467,975,346,629,2662,40.4,2453,15,0,0,1008,1654
ZCTA5 24469,0,74,-74,0,-,0,0,0,#DIV/0!,137,-137
ZCTA5 24471,698,147,551,1474,45.5,1443,0,0,0,282,1192
ZCTA5 24472,873,13021,-12148,2113,56.2,2020,17,0,0,31143,-29030
ZCTA5 24473,300,962,-662,755,53.3,744,0,0,0,2764,-2009
ZCTA5 24474,170,1502,-1332,464,30.6,449,0,4,0.00862069,4239,-3775
ZCTA5 24476,99,235,-136,214,56.9,214,0,0,0,731,-517
ZCTA5 24477,4541,157,4384,11656,43.3,10781,98,519,0.044526424,325,11331
ZCTA5 24479,746,178,568,1785,41.5,1785,0,0,0,484,1301
ZCTA5 24482,1846,210,1636,5405,40.4,5068,0,299,0.055319149,530,4875
ZCTA5 24483,365,33,332,881,49.2,881,0,0,0,70,811
ZCTA5 24484,242,334,-92,598,50.7,574,0,24,0.040133779,960,-362
ZCTA5 24485,180,577,-397,415,51.8,415,0,0,0,1816,-1401
ZCTA5 24486,1144,261,883,3467,36.2,3279,0,3,0.000865301,675,2792
ZCTA5 24487,171,235,-64,419,54.9,419,0,0,0,535,-116
ZCTA5 24501,10063,146,9917,27488,29.2,15235,290,10332,0.375873108,351,27137
ZCTA5 24502,16688,571,16117,40420,32.1,29892,1295,6606,0.163433944,1529,38891
ZCTA5 24503,7922,416,7506,19384,41.1,16503,301,1969,0.101578622,942,18442
ZCTA5 24504,3977,66,3911,9814,37.6,5109,53,4423,0.450682698,109,9705
ZCTA5 24515,0,75,-75,5296,19.9,3877,221,769,0.145203927,161,5135
ZCTA5 24517,2004,164,1840,5067,44.7,3451,11,1571,0.310045392,535,4532
ZCTA5 24520,990,261,729,2218,55.5,1471,0,471,0.212353472,734,1484
ZCTA5 24521,3920,553,3367,9253,48.6,7518,27,1142,0.123419432,1180,8073
ZCTA5 24522,3698,62,3636,9560,42.3,7538,28,1645,0.17207113,137,9423
ZCTA5 24523,8358,637,7721,21064,45.7,17078,219,2591,0.123006077,1778,19286
ZCTA5 24526,624,67,557,1424,44.8,1279,0,113,0.079353933,164,1260
ZCTA5 24527,1128,72,1056,3199,39.5,2041,0,1025,0.320412629,151,3048
ZCTA5 24528,1471,86,1385,3594,52.7,2317,0,1012,0.281580412,262,3332
ZCTA5 24529,623,54,569,1429,55.8,1079,0,320,0.22393282,138,1291
ZCTA5 24530,462,155,307,906,60.9,664,0,213,0.235099338,362,544
ZCTA5 24531,3297,295,3002,9259,46.2,6505,55,2358,0.254671131,824,8435
ZCTA5 24534,649,141,508,1618,52.6,955,0,595,0.367737948,343,1275
ZCTA5 24536,77,338,-261,204,44.2,133,0,0,0,897,-693
ZCTA5 24538,1971,154,1817,4874,48.9,3923,0,851,0.174599918,549,4325
ZCTA5 24539,170,336,-166,360,31,330,0,30,0.083333333,667,-307
ZCTA5 24540,13311,219,13092,31048,44,16872,190,12541,0.403922958,515,30533
ZCTA5 24541,12350,133,12217,28751,40.8,15148,545,11239,0.390908142,364,28387
ZCTA5 24549,1589,204,1385,4102,45.6,3244,10,388,0.094588006,529,3573
ZCTA5 24550,2825,40,2785,7724,41,6494,188,837,0.108363542,72,7652
ZCTA5 24551,10155,81,10074,26376,42.9,22215,593,1841,0.069798301,341,26035
ZCTA5 24553,867,725,142,2224,38.9,2055,0,142,0.063848921,2012,212
ZCTA5 24554,1430,191,1239,3333,52.3,2447,0,735,0.220522052,443,2890
ZCTA5 24555,984,1232,-248,2495,43.5,1973,0,371,0.148697395,3372,-877
ZCTA5 24556,1138,112,1026,2802,52.4,2373,157,141,0.050321199,188,2614
ZCTA5 24557,3477,271,3206,7507,51.9,5797,3,1488,0.198214999,699,6808
ZCTA5 24558,2547,243,2304,6345,50.2,3951,10,2189,0.34499606,502,5843
ZCTA5 24562,226,1094,-868,532,62.2,403,0,118,0.221804511,2458,-1926
ZCTA5 24563,2240,145,2095,5379,51.1,4268,0,903,0.16787507,488,4891
ZCTA5 24565,402,265,137,1099,47,385,0,658,0.598726115,704,395
ZCTA5 24566,531,61,470,1330,48.1,1058,24,124,0.093233083,166,1164
ZCTA5 24569,295,221,74,760,49.7,347,0,407,0.535526316,576,184
ZCTA5 24570,0,197,-197,0,-,0,0,0,#DIV/0!,649,-649
ZCTA5 24571,851,152,699,2127,51.9,1711,0,229,0.107663376,389,1738
ZCTA5 24572,6488,37,6451,15467,45,10914,123,3576,0.231201914,155,15312
ZCTA5 24574,1602,87,1515,4483,46.8,3494,54,868,0.193620344,251,4232
ZCTA5 24577,1909,662,1247,4390,46.7,2552,0,1636,0.372665148,1548,2842
ZCTA5 24578,345,92,253,851,47.1,810,37,0,0,182,669
ZCTA5 24579,436,53,383,902,56.1,887,0,13,0.014412417,124,778
ZCTA5 24580,309,4101,-3792,631,50.9,478,6,133,0.210776545,8896,-8265
ZCTA5 24581,0,1742,-1742,0,-,0,0,0,#DIV/0!,4948,-4948
ZCTA5 24586,1911,192,1719,4534,48.1,3635,0,657,0.144905161,398,4136
ZCTA5 24588,3873,280,3593,9674,41.9,7722,118,1432,0.148025636,721,8953
ZCTA5 24589,892,677,215,2354,39.7,1472,0,569,0.241716228,1602,752
ZCTA5 24590,2997,191,2806,7700,44.8,5947,41,1378,0.178961039,398,7302
ZCTA5 24592,5246,136,5110,14076,44,7960,46,5806,0.412475135,268,13808
ZCTA5 24593,951,346,605,2682,35.6,1975,0,627,0.233780761,860,1822
ZCTA5 24594,661,131,530,1965,28.8,1649,0,275,0.139949109,308,1657
ZCTA5 24595,64,609,-545,614,20.6,434,15,137,0.223127036,1511,-897
ZCTA5 24597,342,186,156,897,43.6,569,0,304,0.338907469,379,518
ZCTA5 24598,517,305,212,1438,42.6,1246,9,121,0.084144645,655,783
ZCTA5 24599,280,582,-302,655,47.5,576,0,79,0.120610687,1494,-839
ZCTA5 24601,0,590,-590,0,-,0,0,0,#DIV/0!,1459,-1459
ZCTA5 24602,281,220,61,969,59,969,0,0,0,610,359
ZCTA5 24603,282,180,102,609,58.1,609,0,0,0,555,54
ZCTA5 24604,104,626,-522,243,53.5,231,0,12,0.049382716,1660,-1417
ZCTA5 24605,3585,478,3107,8086,47.5,7464,47,422,0.052188969,1383,6703
ZCTA5 24606,59,1665,-1606,153,42.2,153,0,0,0,3786,-3633
ZCTA5 24607,116,102,14,264,58.9,264,0,0,0,296,-32
ZCTA5 24609,2484,44,2440,6178,44.9,6149,0,29,0.004694076,101,6077
ZCTA5 24612,98,1473,-1375,291,37.8,291,0,0,0,3340,-3049
ZCTA5 24613,234,520,-286,538,54.7,538,0,0,0,1064,-526
ZCTA5 24614,2760,2057,703,7176,48.6,6644,21,178,0.024804905,4833,2343
ZCTA5 24620,730,75,655,2632,44,2469,0,0,0,261,2371
ZCTA5 24622,284,485,-201,649,56.9,638,0,0,0,1403,-754
ZCTA5 24630,2481,189,2292,6652,41.7,6060,48,449,0.067498497,436,6216
ZCTA5 24631,628,344,284,2136,40.6,1764,7,301,0.140917603,807,1329
ZCTA5 24634,166,1235,-1069,426,45.7,426,0,0,0,2630,-2204
ZCTA5 24635,187,82,105,1275,42.9,949,6,213,0.167058824,139,1136
ZCTA5 24637,1302,2368,-1066,3611,37.8,3373,142,19,0.0052617,5672,-2061
ZCTA5 24639,1302,321,981,3748,43.4,3648,11,2,0.000533618,773,2975
ZCTA5 24641,2317,84,2233,5491,47.2,5210,0,198,0.036059006,222,5269
ZCTA5 24646,394,1062,-668,764,61.6,764,0,0,0,2364,-1600
ZCTA5 24649,782,103,679,1952,57.3,1952,0,0,0,202,1750
ZCTA5 24651,2105,95,2010,5559,44.6,5213,47,198,0.035617917,366,5193
ZCTA5 24656,987,85,902,2721,44.9,2704,0,0,0,252,2469
ZCTA5 24657,135,516,-381,336,37.5,336,0,0,0,1186,-850
ZCTA5 24701,7826,432,7394,17772,47.5,14274,30,2465,0.138701328,1044,16728
ZCTA5 24712,672,1981,-1309,2712,22.8,2522,22,132,0.048672566,4538,-1826
ZCTA5 24714,119,244,-125,379,58.8,379,0,0,0,545,-166
ZCTA5 24715,117,130,-13,332,53.7,292,0,24,0.072289157,342,-10
ZCTA5 24716,144,29,115,284,66.6,284,0,0,0,59,225
ZCTA5 24719,27,337,-310,83,35.5,83,0,0,0,805,-722
ZCTA5 24724,53,66,-13,108,59,96,0,12,0.111111111,166,-58
ZCTA5 24726,171,127,44,504,50.5,504,0,0,0,262,242
ZCTA5 24729,45,193,-148,60,60.6,60,0,0,0,421,-361
ZCTA5 24731,40,397,-357,119,37.6,119,0,0,0,1089,-970
ZCTA5 24733,98,713,-615,184,56.5,184,0,0,0,1835,-1651
ZCTA5 24736,279,582,-303,698,51,683,1,0,0,1082,-384
ZCTA5 24737,442,180,262,1339,41.5,1280,0,0,0,993,346
ZCTA5 24738,0,502,-502,0,-,0,0,0,#DIV/0!,1346,-1346
ZCTA5 24739,5700,186,5514,13511,42.9,12846,13,299,0.022130116,570,12941
ZCTA5 24740,6838,658,6180,16240,40.4,14855,87,601,0.037007389,1749,14491
ZCTA5 24747,1382,152,1230,3700,44.6,3664,0,0,0,404,3296
ZCTA5 24801,1274,2352,-1078,4750,43.3,3967,0,682,0.143578947,6016,-1266
ZCTA5 24808,217,134,83,609,53.7,567,0,6,0.009852217,440,169
ZCTA5 24811,234,13,221,501,53,501,0,0,0,13,488
ZCTA5 24813,0,242,-242,0,-,0,0,0,#DIV/0!,725,-725
ZCTA5 24815,158,52,106,482,58.8,482,0,0,0,78,404
ZCTA5 24816,0,1773,-1773,0,-,0,0,0,#DIV/0!,4674,-4674
ZCTA5 24817,543,114,429,1655,32.2,1634,0,0,0,282,1373
ZCTA5 24818,366,97,269,979,43.1,979,0,0,0,183,796
ZCTA5 24822,492,198,294,1053,37.7,1053,0,0,0,524,529
ZCTA5 24823,203,248,-45,538,37.4,538,0,0,0,616,-78
ZCTA5 24826,8,174,-166,8,-,8,0,0,0,279,-271
ZCTA5 24827,496,76,420,1320,54.9,1320,0,0,0,143,1177
ZCTA5 24828,248,654,-406,765,35.4,718,0,0,0,1707,-942
ZCTA5 24830,51,4101,-4050,102,35,101,0,0,0,9542,-9440
ZCTA5 24831,96,508,-412,391,36.9,291,10,57,0.145780051,1362,-971
ZCTA5 24834,298,857,-559,908,41.5,908,0,0,0,2216,-1308
ZCTA5 24836,232,4821,-4589,703,55.9,435,0,201,0.285917496,11457,-10754
ZCTA5 24839,356,259,97,996,45.9,996,0,0,0,659,337
ZCTA5 24843,31,108,-77,72,49.5,72,0,0,0,257,-185
ZCTA5 24844,394,473,-79,1061,53.9,1061,0,0,0,1376,-315
ZCTA5 24845,116,615,-499,372,29.6,372,0,0,0,1763,-1391
ZCTA5 24846,104,187,-83,316,31.4,316,0,0,0,714,-398
ZCTA5 24847,51,383,-332,163,39.9,163,0,0,0,968,-805
ZCTA5 24848,47,250,-203,91,53.5,82,0,9,0.098901099,808,-717
ZCTA5 24849,142,34,108,276,60.5,276,0,0,0,88,188
ZCTA5 24850,0,48,-48,0,-,0,0,0,#DIV/0!,142,-142
ZCTA5 24851,183,91,92,474,45.3,474,0,0,0,191,283
ZCTA5 24853,150,130,20,331,56.8,176,0,155,0.468277946,329,2
ZCTA5 24854,263,93,170,732,39.9,582,0,21,0.028688525,173,559
ZCTA5 24855,53,185,-132,140,48.3,0,0,140,1,600,-460
ZCTA5 24857,347,223,124,1082,34,1064,0,0,0,431,651
ZCTA5 24860,48,217,-169,71,45.2,71,0,0,0,433,-362
ZCTA5 24861,48,195,-147,187,58.5,171,0,16,0.085561497,496,-309
ZCTA5 24862,219,290,-71,521,37.9,521,0,0,0,774,-253
ZCTA5 24866,258,213,45,702,41.6,678,0,0,0,701,1
ZCTA5 24867,58,0,58,389,44.2,389,0,0,0,93,296
ZCTA5 24868,464,310,154,1144,53.4,872,0,272,0.237762238,896,248
ZCTA5 24869,161,238,-77,292,50.5,266,26,0,0,529,-237
ZCTA5 24870,564,77,487,1338,49.7,1338,0,0,0,211,1127
ZCTA5 24871,177,495,-318,742,45.1,742,0,0,0,1237,-495
ZCTA5 24872,292,189,103,622,59.4,622,0,0,0,631,-9
ZCTA5 24873,197,294,-97,666,37.9,615,0,0,0,778,-112
ZCTA5 24874,915,1386,-471,2687,43,2436,0,230,0.08559732,3478,-791
ZCTA5 24878,113,417,-304,297,46.2,297,0,0,0,1201,-904
ZCTA5 24879,181,351,-170,521,58,521,0,0,0,878,-357
ZCTA5 24880,102,10,92,283,25.9,283,0,0,0,10,273
ZCTA5 24881,110,1561,-1451,236,62.1,236,0,0,0,3469,-3233
ZCTA5 24882,386,222,164,1076,52.4,1076,0,0,0,657,419
ZCTA5 24884,12,311,-299,28,50.5,28,0,0,0,883,-855
ZCTA5 24887,0,206,-206,0,-,0,0,0,#DIV/0!,419,-419
ZCTA5 24888,32,874,-842,47,65.5,47,0,0,0,2463,-2416
ZCTA5 24892,448,147,301,1470,36.9,1463,0,7,0.004761905,305,1165
ZCTA5 24894,119,447,-328,406,40.7,393,0,4,0.009852217,1127,-721
ZCTA5 24895,29,132,-103,72,47.9,49,0,23,0.319444444,342,-270
ZCTA5 24898,83,172,-89,288,56.3,288,0,0,0,400,-112
ZCTA5 24901,4225,3496,729,9475,42.5,8675,243,204,0.021530343,8614,861
ZCTA5 24910,1665,50,1615,4624,50.1,4146,0,185,0.040008651,103,4521
ZCTA5 24915,192,131,61,450,51.4,410,0,0,0,298,152
ZCTA5 24916,261,115,146,565,63.9,565,0,0,0,326,239
ZCTA5 24918,534,308,226,1441,25.7,1430,0,11,0.007633588,804,637
ZCTA5 24920,83,57,26,282,50,267,12,3,0.010638298,147,135
ZCTA5 24924,278,2092,-1814,565,61.3,565,0,0,0,5311,-4746
ZCTA5 24925,276,72,204,629,44.6,622,0,7,0.011128776,187,442
ZCTA5 24927,133,137,-4,367,30.8,367,0,0,0,347,20
ZCTA5 24931,473,176,297,1179,43.5,1179,0,0,0,489,690
ZCTA5 24934,156,578,-422,297,67.3,297,0,0,0,1311,-1014
ZCTA5 24935,170,198,-28,307,65.2,307,0,0,0,479,-172
ZCTA5 24938,609,992,-383,1720,44.1,1645,0,0,0,2603,-883
ZCTA5 24941,382,171,211,1022,51,879,0,40,0.039138943,461,561
ZCTA5 24943,39,125,-86,99,59.3,99,0,0,0,327,-228
ZCTA5 24944,153,149,4,410,53.9,410,0,0,0,543,-133
ZCTA5 24945,124,10358,-10234,236,68.4,168,0,0,0,24830,-24594
ZCTA5 24946,362,59,303,1040,53.6,1029,0,10,0.009615385,165,875
ZCTA5 24951,630,777,-147,1558,56.5,1508,0,0,0,2253,-695
ZCTA5 24954,1142,0,1142,3464,43.4,3439,3,3,0.000866051,0,3464
ZCTA5 24957,213,0,213,442,49.6,437,0,3,0.00678733,517,-75
ZCTA5 24962,34,446,-412,57,-,57,0,0,0,1068,-1011
ZCTA5 24963,1279,265,1014,3613,41,3536,0,16,0.004428453,699,2914
ZCTA5 24966,512,239,273,1069,51.9,1014,0,0,0,631,438
ZCTA5 24970,1897,16,1881,4089,47,3891,0,121,0.029591587,31,4058
ZCTA5 24974,101,443,-342,382,42.9,382,0,0,0,1043,-661
ZCTA5 24976,407,60,347,965,47.4,953,0,0,0,90,875
ZCTA5 24977,193,113,80,461,49.9,461,0,0,0,384,77
ZCTA5 24981,249,72,177,627,60.6,588,0,39,0.062200957,185,442
ZCTA5 24983,814,191,623,2098,55.3,2069,0,3,0.001429933,474,1624
ZCTA5 24984,50,317,-267,154,46.5,154,0,0,0,909,-755
ZCTA5 24985,115,506,-391,378,44.9,378,0,0,0,1290,-912
ZCTA5 24986,2165,47,2118,5056,43.7,4651,5,225,0.044501582,147,4909
ZCTA5 24991,282,2079,-1797,505,58,462,0,0,0,5519,-5014
ZCTA5 24993,28,227,-199,64,8.8,64,0,0,0,559,-495
ZCTA5 25002,0,663,-663,0,-,0,0,0,#DIV/0!,1724,-1724
ZCTA5 25003,901,278,623,1883,50.9,1792,0,91,0.048327138,785,1098
ZCTA5 25005,78,752,-674,133,67.9,133,0,0,0,1798,-1665
ZCTA5 25007,168,621,-453,503,51.9,503,0,0,0,1429,-926
ZCTA5 25008,86,326,-240,234,40.4,234,0,0,0,805,-571
ZCTA5 25009,389,210,179,1351,41,1351,0,0,0,595,756
ZCTA5 25011,251,298,-47,541,34.2,537,0,0,0,696,-155
ZCTA5 25015,1502,241,1261,3194,47.7,3134,10,0,0,698,2496
ZCTA5 25019,150,1218,-1068,372,49.4,372,0,0,0,3580,-3208
ZCTA5 25021,182,164,18,309,60.5,309,0,0,0,588,-279
ZCTA5 25022,53,333,-280,171,45.4,171,0,0,0,985,-814
ZCTA5 25024,205,683,-478,482,41.3,400,0,0,0,2093,-1611
ZCTA5 25025,5,248,-243,11,-,11,0,0,0,742,-731
ZCTA5 25028,161,696,-535,269,72.3,269,0,0,0,1841,-1572
ZCTA5 25030,96,128,-32,326,42.8,326,0,0,0,317,9
ZCTA5 25031,427,479,-52,900,43.6,556,0,334,0.371111111,1316,-416
ZCTA5 25033,681,137,544,1745,49.2,1702,15,0,0,382,1363
ZCTA5 25035,229,669,-440,817,30.4,766,0,0,0,1558,-741
ZCTA5 25036,67,390,-323,179,61.8,88,0,91,0.508379888,1054,-875
ZCTA5 25039,244,234,10,667,46.7,667,0,0,0,495,172
ZCTA5 25040,219,333,-114,659,36.5,624,0,0,0,714,-55
ZCTA5 25043,504,343,161,1546,36.1,1543,0,3,0.001940492,1030,516
ZCTA5 25044,74,3706,-3632,167,28.5,167,0,0,0,9381,-9214
ZCTA5 25045,1480,781,699,4271,38.6,4201,0,44,0.010302037,2248,2023
ZCTA5 25047,56,2955,-2899,160,41.8,160,0,0,0,7120,-6960
ZCTA5 25048,64,165,-101,177,49.4,172,0,0,0,473,-296
ZCTA5 25049,123,599,-476,335,55.5,335,0,0,0,1638,-1303
ZCTA5 25051,73,227,-154,259,40.7,259,0,0,0,1065,-806
ZCTA5 25053,1496,1589,-93,3940,47.3,3844,17,25,0.006345178,2439,1501
ZCTA5 25054,48,7009,-6961,174,47.1,174,0,0,0,14932,-14758
ZCTA5 25057,66,3274,-3208,240,44.6,226,0,14,0.058333333,7200,-6960
ZCTA5 25059,95,4104,-4009,221,53.6,221,0,0,0,9216,-8995
ZCTA5 25060,91,0,91,220,41.2,220,0,0,0,0,220
ZCTA5 25061,200,2764,-2564,541,28.9,513,0,0,0,6425,-5884
ZCTA5 25062,108,5377,-5269,162,58.4,162,0,0,0,12275,-12113
ZCTA5 25063,659,4868,-4209,1890,49.7,1747,0,0,0,9980,-8090
ZCTA5 25064,4358,5988,-1630,9292,45.9,6657,87,1972,0.21222557,14630,-5338
ZCTA5 25067,340,5460,-5120,937,41.7,851,0,0,0,13127,-12190
ZCTA5 25070,665,6826,-6161,1648,41.3,1636,0,0,0,16250,-14602
ZCTA5 25071,4406,1465,2941,11166,49.3,10701,0,31,0.002776285,3454,7712
ZCTA5 25075,335,2795,-2460,997,35.8,987,0,0,0,7230,-6233
ZCTA5 25076,71,6162,-6091,206,45.9,195,0,0,0,14970,-14764
ZCTA5 25081,541,4584,-4043,1461,46,1453,0,0,0,13051,-11590
ZCTA5 25082,686,7968,-7282,1766,46.4,1766,0,0,0,20504,-18738
ZCTA5 25083,150,4099,-3949,464,42.9,438,0,3,0.006465517,11424,-10960
ZCTA5 25085,290,5225,-4935,760,44.1,745,0,0,0,12281,-11521
ZCTA5 25086,302,2899,-2597,803,54.8,788,1,9,0.01120797,7617,-6814
ZCTA5 25088,93,6649,-6556,157,61.1,150,0,0,0,17581,-17424
ZCTA5 25090,99,3681,-3582,218,40.7,218,0,0,0,9669,-9451
ZCTA5 25093,56,1547,-1491,177,47.6,177,0,0,0,4012,-3835
ZCTA5 25102,116,817,-701,483,26.3,396,0,21,0.043478261,1914,-1431
ZCTA5 25103,53,4678,-4625,97,61.5,97,0,0,0,12184,-12087
ZCTA5 25106,312,5277,-4965,696,40.4,676,0,0,0,13699,-13003
ZCTA5 25107,183,3902,-3719,415,56,415,0,0,0,9615,-9200
ZCTA5 25108,146,3123,-2977,396,38.5,396,0,0,0,8721,-8325
ZCTA5 25109,258,158,100,752,56.1,752,0,0,0,301,451
ZCTA5 25110,240,61,179,617,38.4,617,0,0,0,225,392
ZCTA5 25111,163,1273,-1110,428,51.8,428,0,0,0,2805,-2377
ZCTA5 25112,0,203,-203,106,23,87,0,19,0.179245283,282,-176
ZCTA5 25113,185,2543,-2358,422,59.8,421,0,1,0.002369668,6295,-5873
ZCTA5 25114,92,654,-562,280,53,280,0,0,0,1714,-1434
ZCTA5 25115,57,2342,-2285,166,43.5,145,0,0,0,7024,-6858
ZCTA5 25118,206,202,4,545,41.6,439,0,24,0.044036697,250,295
ZCTA5 25119,143,513,-370,426,24,402,0,22,0.051643192,1754,-1328
ZCTA5 25121,367,466,-99,1157,45.8,1157,0,0,0,1442,-285
ZCTA5 25123,1128,452,676,2741,40.5,2715,0,26,0.009485589,1226,1515
ZCTA5 25124,608,200,408,1416,50.9,1398,0,0,0,438,978
ZCTA5 25125,343,5224,-4881,1262,41.2,1258,0,0,0,13156,-11894
ZCTA5 25126,194,144,50,346,59.8,256,0,90,0.260115607,397,-51
ZCTA5 25130,1204,1780,-576,3440,45,3306,0,82,0.023837209,4893,-1453
ZCTA5 25132,137,519,-382,366,40.4,366,0,0,0,1094,-728
ZCTA5 25133,284,3808,-3524,762,46.8,762,0,0,0,9567,-8805
ZCTA5 25134,104,1964,-1860,125,68.7,125,0,0,0,5162,-5037
ZCTA5 25136,670,427,243,1691,38.9,1287,0,122,0.072146659,1078,613
ZCTA5 25139,66,533,-467,270,35.5,270,0,0,0,1319,-1049
ZCTA5 25140,392,1455,-1063,1180,42.5,1180,0,0,0,3744,-2564
ZCTA5 25141,70,930,-860,168,62.8,168,0,0,0,2633,-2465
ZCTA5 25142,98,747,-649,468,50.7,468,0,0,0,2467,-1999
ZCTA5 25143,3744,578,3166,9548,44,8862,5,232,0.024298282,1397,8151
ZCTA5 25148,145,314,-169,400,59.1,400,0,0,0,1012,-612
ZCTA5 25149,56,1131,-1075,91,66.2,91,0,0,0,2626,-2535
ZCTA5 25152,186,1339,-1153,506,60.7,473,0,33,0.065217391,3267,-2761
ZCTA5 25154,252,8082,-7830,865,45.1,865,0,0,0,21926,-21061
ZCTA5 25156,12,482,-470,12,-,12,0,0,0,1357,-1345
ZCTA5 25159,1571,2445,-874,4137,42.9,4015,0,28,0.00676819,5550,-1413
ZCTA5 25160,170,143,27,437,52.6,433,0,2,0.004576659,231,206
ZCTA5 25161,154,1193,-1039,358,42.9,358,0,0,0,2852,-2494
ZCTA5 25162,131,655,-524,338,53.1,328,0,3,0.00887574,1512,-1174
ZCTA5 25164,395,76,319,958,47.5,939,0,0,0,183,775
ZCTA5 25165,284,3692,-3408,970,49.4,970,0,0,0,8785,-7815
ZCTA5 25168,1372,1772,-400,3650,41.8,3532,0,0,0,4758,-1108
ZCTA5 25169,144,484,-340,378,44.7,378,0,0,0,1238,-860
ZCTA5 25173,99,3679,-3580,175,66.5,120,0,55,0.314285714,9154,-8979
ZCTA5 25174,96,746,-650,182,56.3,129,0,0,0,2065,-1883
ZCTA5 25177,9604,630,8974,23868,39.6,22123,57,745,0.03121334,1415,22453
ZCTA5 25180,109,828,-719,321,42.8,321,0,0,0,2132,-1811
ZCTA5 25181,461,3158,-2697,1209,44.3,1170,0,0,0,8080,-6871
ZCTA5 25183,35,522,-487,78,63.2,78,0,0,0,1287,-1209
ZCTA5 25185,0,218,-218,803,47.9,641,0,158,0.196762142,465,338
ZCTA5 25186,404,480,-76,1025,54.9,823,0,106,0.103414634,1304,-279
ZCTA5 25187,350,2731,-2381,849,42.3,817,0,32,0.037691402,7043,-6194
ZCTA5 25193,184,1000,-816,678,23.7,678,0,0,0,2462,-1784
ZCTA5 25201,32,365,-333,69,45.3,62,0,0,0,932,-863
ZCTA5 25202,455,2540,-2085,1258,45.1,1255,3,0,0,5554,-4296
ZCTA5 25203,24,320,-296,112,47.3,112,0,0,0,816,-704
ZCTA5 25204,27,404,-377,76,46,76,0,0,0,1077,-1001
ZCTA5 25205,49,469,-420,94,64.5,94,0,0,0,1124,-1030
ZCTA5 25206,60,217,-157,122,56.5,94,0,12,0.098360656,562,-440
ZCTA5 25208,274,330,-56,923,27.5,923,0,0,0,683,240
ZCTA5 25209,278,1123,-845,657,35.1,634,0,0,0,2483,-1826
ZCTA5 25211,21,99,-78,77,61.1,77,0,0,0,210,-133
ZCTA5 25213,2445,518,1927,6453,37.9,6037,133,134,0.020765535,1616,4837
ZCTA5 25214,238,185,53,866,46.5,866,0,0,0,396,470
ZCTA5 25231,0,328,-328,0,-,0,0,0,#DIV/0!,964,-964
ZCTA5 25234,351,427,-76,926,52.7,914,0,0,0,1127,-201
ZCTA5 25235,411,404,7,1141,41.8,1141,0,0,0,897,244
ZCTA5 25239,580,661,-81,1929,34.6,1902,0,0,0,1397,532
ZCTA5 25241,603,388,215,1817,36.6,1807,0,0,0,982,835
ZCTA5 25243,252,538,-286,624,55.4,600,0,0,0,1435,-811
ZCTA5 25244,198,218,-20,606,46.6,593,13,0,0,574,32
ZCTA5 25245,350,119,231,579,54.4,579,0,0,0,389,190
ZCTA5 25247,196,402,-206,485,56.3,474,0,0,0,1025,-540
ZCTA5 25248,1456,343,1113,3775,51.1,3529,27,0,0,767,3008
ZCTA5 25251,214,381,-167,823,18.8,823,0,0,0,813,10
ZCTA5 25252,460,305,155,1075,62.3,1063,0,0,0,789,286
ZCTA5 25253,803,236,567,2189,34.8,2070,0,0,0,470,1719
ZCTA5 25259,258,557,-299,815,52.3,752,0,0,0,1550,-735
ZCTA5 25260,614,265,349,1336,49.5,1295,1,16,0.011976048,600,736
ZCTA5 25261,27,57,-30,48,54.5,44,0,0,0,189,-141
ZCTA5 25262,444,2498,-2054,1275,37.3,1275,0,0,0,6118,-4843
ZCTA5 25264,194,316,-122,521,63,521,0,0,0,855,-334
ZCTA5 25265,665,321,344,1558,50,1558,0,0,0,865,693
ZCTA5 25266,230,2724,-2494,737,45.8,737,0,0,0,7242,-6505
ZCTA5 25267,241,501,-260,472,63.7,472,0,0,0,1090,-618
ZCTA5 25268,239,83,156,662,53.4,662,0,0,0,218,444
ZCTA5 25270,312,918,-606,820,43.8,809,0,0,0,2269,-1449
ZCTA5 25271,3528,370,3158,8388,40.4,7974,70,71,0.008464473,924,7464
ZCTA5 25275,664,798,-134,1569,40.5,1545,0,0,0,2039,-470
ZCTA5 25276,3087,175,2912,7574,46.7,7223,38,12,0.001584368,337,7237
ZCTA5 25285,215,79,136,628,36.8,628,0,0,0,175,453
ZCTA5 25286,570,389,181,1356,50.7,1356,0,0,0,883,473
ZCTA5 25287,271,20,251,1171,42.6,1153,0,7,0.005977797,88,1083
ZCTA5 25301,1365,36,1329,2428,49.7,1597,26,653,0.268945634,58,2370
ZCTA5 25302,6343,10831,-4488,13206,45.5,10018,138,2111,0.159851583,23903,-10697
ZCTA5 25303,3178,3500,-322,7370,38.2,5770,272,449,0.060922659,8048,-678
ZCTA5 25304,3508,2155,1353,9146,40.8,7268,339,1173,0.128252788,6396,2750
ZCTA5 25305,0,6654,-6654,0,-,0,0,0,#DIV/0!,16280,-16280
ZCTA5 25306,2812,9100,-6288,6382,44.5,5569,214,361,0.05656534,20684,-14302
ZCTA5 25309,5527,14185,-8658,12841,48.1,11365,160,640,0.049840355,33458,-20617
ZCTA5 25311,4836,50,4786,10391,42.4,8532,60,1210,0.116446925,80,10311
ZCTA5 25312,3979,65,3914,11013,42.3,10815,0,131,0.011895033,225,10788
ZCTA5 25313,5051,869,4182,11164,42.8,10310,173,358,0.032067359,2149,9015
ZCTA5 25314,6539,2377,4162,14905,45,13278,549,682,0.045756458,8414,6491
ZCTA5 25315,1438,180,1258,3559,39.2,3218,0,118,0.033155381,564,2995
ZCTA5 25320,1968,224,1744,5257,38.6,5197,0,0,0,611,4646
ZCTA5 25387,2210,209,2001,5043,40.7,3697,28,1156,0.229228634,513,4530
ZCTA5 25401,6095,836,5259,15233,37,11773,16,2103,0.138055537,2284,12949
ZCTA5 25403,5565,976,4589,13718,37.9,11035,378,840,0.061233416,2414,11304
ZCTA5 25404,8821,76,8745,21910,36.3,17481,301,2256,0.102966682,185,21725
ZCTA5 25405,5446,1150,4296,15275,41.7,13605,96,544,0.035613748,2596,12679
ZCTA5 25411,4892,502,4390,11882,48.6,11265,20,16,0.001346575,1256,10626
ZCTA5 25413,2951,1643,1308,7921,38.2,6554,18,764,0.096452468,4159,3762
ZCTA5 25414,7437,154,7283,19731,41.7,16587,301,1502,0.076123866,239,19492
ZCTA5 25419,4748,135,4613,11993,40.7,10577,269,786,0.065538231,314,11679
ZCTA5 25420,2018,221,1797,4939,47.1,4414,0,53,0.010730917,550,4389
ZCTA5 25421,34,2974,-2940,118,33.3,118,0,0,0,7117,-6999
ZCTA5 25422,660,306,354,1547,53.4,1520,0,0,0,675,872
ZCTA5 25425,5247,351,4896,13535,42.7,11977,184,236,0.017436276,882,12653
ZCTA5 25427,6110,619,5491,15616,44.6,14661,88,360,0.023053279,1969,13647
ZCTA5 25428,5288,212,5076,14270,36.6,12728,108,660,0.046250876,466,13804
ZCTA5 25430,2791,144,2647,7851,42.5,6882,10,423,0.053878487,521,7330
ZCTA5 25431,155,176,-21,665,24.4,665,0,0,0,548,117
ZCTA5 25432,38,230,-192,124,42.5,117,4,0,0,484,-360
ZCTA5 25434,923,57,866,3184,39.7,2948,11,26,0.008165829,126,3058
ZCTA5 25437,110,365,-255,220,63.8,220,0,0,0,1063,-843
ZCTA5 25438,2558,28,2530,6997,35,5386,212,527,0.075317993,206,6791
ZCTA5 25442,841,196,645,2736,38.3,2509,5,10,0.003654971,719,2017
ZCTA5 25443,2625,114,2511,7591,38.4,6309,134,490,0.064550125,208,7383
ZCTA5 25444,91,103,-12,227,51.2,227,0,0,0,192,35
ZCTA5 25446,331,545,-214,921,50.6,876,35,10,0.010857763,1419,-498
ZCTA5 25501,543,195,348,1238,54.7,1148,0,0,0,496,742
ZCTA5 25502,240,54,186,680,47.1,627,0,0,0,110,570
ZCTA5 25503,274,254,20,824,28.9,824,0,0,0,554,270
ZCTA5 25504,5105,480,4625,13642,37.7,13006,147,178,0.01304794,904,12738
ZCTA5 25505,139,168,-29,493,50,493,0,0,0,494,-1
ZCTA5 25506,1904,87,1817,4842,41.3,4658,83,1,0.000206526,199,4643
ZCTA5 25507,402,335,67,1014,57.7,907,0,6,0.00591716,800,214
ZCTA5 25508,3639,178,3461,9441,44.1,9333,9,0,0,494,8947
ZCTA5 25510,2026,2640,-614,5395,38.9,4970,72,19,0.003521779,6842,-1447
ZCTA5 25511,229,1094,-865,606,54.8,600,0,0,0,2799,-2193
ZCTA5 25512,408,4642,-4234,1035,47,931,0,0,0,11303,-10268
ZCTA5 25514,1480,189,1291,4072,44,3850,0,0,0,533,3539
ZCTA5 25515,639,112,527,1730,44.6,1542,60,0,0,252,1478
ZCTA5 25517,642,175,467,1406,46.6,1406,0,0,0,354,1052
ZCTA5 25520,744,78,666,1785,51.7,1737,0,0,0,178,1607
ZCTA5 25521,347,18,329,991,46.6,961,0,30,0.030272452,18,973
ZCTA5 25523,1006,37,969,3090,40.3,3072,1,0,0,135,2955
ZCTA5 25524,1016,188,828,2786,42.8,2710,0,0,0,487,2299
ZCTA5 25526,8802,109,8693,22822,41.3,21623,234,222,0.009727456,249,22573
ZCTA5 25529,336,52,284,855,54,838,0,17,0.019883041,123,732
ZCTA5 25530,2655,763,1892,6665,43.5,6462,0,8,0.0012003,1922,4743
ZCTA5 25534,98,1834,-1736,178,53.8,178,0,0,0,3741,-3563
ZCTA5 25535,866,121,745,2991,39.4,2938,0,8,0.002674691,320,2671
ZCTA5 25537,607,829,-222,1092,52.3,1044,0,0,0,1996,-904
ZCTA5 25540,156,83,73,348,39.8,348,0,0,0,209,139
ZCTA5 25541,4503,181,4322,10586,47.3,10238,53,11,0.001039108,429,10157
ZCTA5 25544,31,51,-20,119,19.8,119,0,0,0,101,18
ZCTA5 25545,1550,9,1541,4572,38.2,4404,0,82,0.017935258,48,4524
ZCTA5 25547,168,460,-292,471,44.7,471,0,0,0,1264,-793
ZCTA5 25550,3775,50,3725,9248,43.4,8833,187,12,0.001297578,87,9161
ZCTA5 25555,716,2574,-1858,2518,34.2,2518,0,0,0,6155,-3637
ZCTA5 25557,691,278,413,1537,46.8,1537,0,0,0,704,833
ZCTA5 25559,696,1659,-963,1675,43.6,1675,0,0,0,4001,-2326
ZCTA5 25560,2979,549,2430,7374,44.9,6899,108,134,0.018171956,1327,6047
ZCTA5 25564,393,432,-39,1261,36.6,1261,0,0,0,953,308
ZCTA5 25565,291,132,159,680,48.6,675,0,0,0,212,468
ZCTA5 25567,295,929,-634,795,45.1,795,0,0,0,2224,-1429
ZCTA5 25570,1654,60,1594,4887,50.3,4833,6,17,0.003478617,120,4767
ZCTA5 25571,752,244,508,2361,33.9,2335,0,0,0,615,1746
ZCTA5 25573,165,265,-100,497,40.6,497,0,0,0,746,-249
ZCTA5 25601,1964,438,1526,5001,45.5,4718,30,179,0.035792841,1196,3805
ZCTA5 25606,398,788,-390,1086,33.7,1015,0,71,0.065377532,2092,-1006
ZCTA5 25607,345,178,167,994,45.5,994,0,0,0,325,669
ZCTA5 25608,309,124,185,731,56.9,702,29,0,0,219,512
ZCTA5 25611,406,18417,-18011,1032,31.8,904,0,0,0,43671,-42639
ZCTA5 25612,197,186,11,415,49.9,415,0,0,0,488,-73
ZCTA5 25617,63,763,-700,180,45.5,180,0,0,0,1657,-1477
ZCTA5 25621,724,283,441,1723,52.1,1723,0,0,0,1389,334
ZCTA5 25624,212,1147,-935,319,84.6,170,149,0,0,2673,-2354
ZCTA5 25625,350,2066,-1716,1141,42.7,991,0,120,0.105170903,5040,-3899
ZCTA5 25628,200,1017,-817,342,40.6,276,0,45,0.131578947,2694,-2352
ZCTA5 25630,124,170,-46,274,61.3,274,0,0,0,435,-161
ZCTA5 25632,192,3012,-2820,797,26.8,787,0,0,0,7013,-6216
ZCTA5 25634,566,1253,-687,1237,43.4,1220,0,0,0,2980,-1743
ZCTA5 25635,465,388,77,1579,28.7,1565,0,8,0.005066498,1090,489
ZCTA5 25637,530,861,-331,1314,48.5,1288,0,26,0.01978691,1723,-409
ZCTA5 25638,227,7116,-6889,669,44.3,571,0,0,0,16243,-15574
ZCTA5 25639,174,2747,-2573,443,40.6,374,0,0,0,6540,-6097
ZCTA5 25644,191,462,-271,544,41.6,544,0,0,0,1046,-502
ZCTA5 25646,284,747,-463,1008,42.5,933,0,14,0.013888889,1725,-717
ZCTA5 25647,114,36,78,219,52.2,219,0,0,0,107,112
ZCTA5 25649,523,1123,-600,1342,38.7,1342,0,0,0,2610,-1268
ZCTA5 25650,15,634,-619,27,-,27,0,0,0,1780,-1753
ZCTA5 25651,244,9415,-9171,522,52.3,508,0,0,0,21586,-21064
ZCTA5 25652,469,3430,-2961,1230,49.8,1174,0,0,0,8122,-6892
ZCTA5 25653,54,192,-138,175,36.7,175,0,0,0,1100,-925
ZCTA5 25654,37,184,-147,151,48.2,151,0,0,0,441,-290
ZCTA5 25661,2150,12334,-10184,4854,43.7,4167,0,521,0.107334157,29858,-25004
ZCTA5 25666,71,7633,-7562,212,41.2,212,0,0,0,17682,-17470
ZCTA5 25667,195,5228,-5033,742,31.9,741,0,0,0,12132,-11390
ZCTA5 25669,359,560,-201,1115,46.2,1115,0,0,0,1316,-201
ZCTA5 25670,1378,404,974,3595,46.6,3551,0,0,0,1021,2574
ZCTA5 25671,528,246,282,1913,34.1,1913,0,0,0,534,1379
ZCTA5 25672,171,351,-180,362,58.7,362,0,0,0,734,-372
ZCTA5 25674,734,38,696,1771,49.5,1770,0,0,0,109,1662
ZCTA5 25676,397,67,330,1028,41,1028,0,0,0,84,944
ZCTA5 25678,577,957,-380,1287,46.8,1211,0,17,0.013209013,2806,-1519
ZCTA5 25685,179,1801,-1622,724,30.4,724,0,0,0,4389,-3665
ZCTA5 25688,111,314,-203,236,46.9,236,0,0,0,800,-564
ZCTA5 25690,198,912,-714,925,44.2,925,0,0,0,2032,-1107
ZCTA5 25692,542,89,453,1764,37,1656,0,108,0.06122449,219,1545
ZCTA5 25696,512,1025,-513,1238,49.3,1213,1,0,0,2700,-1462
ZCTA5 25699,24,2366,-2342,75,31.7,75,0,0,0,6179,-6104
ZCTA5 25701,9710,304,9406,21375,40.6,17881,460,1780,0.083274854,784,20591
ZCTA5 25702,3222,14,3208,7586,44.4,7048,151,184,0.024255207,41,7545
ZCTA5 25703,2148,3551,-1403,5097,23,3876,97,884,0.173435354,8875,-3778
ZCTA5 25704,6154,1228,4926,15240,45.4,14141,63,460,0.030183727,2691,12549
ZCTA5 25705,8939,447,8492,20722,37.8,18761,226,862,0.041598301,1087,19635
ZCTA5 25755,6,181,-175,1508,19.5,1322,0,121,0.080238727,285,1223
ZCTA5 25801,12688,3327,9361,31632,41.3,25544,468,4038,0.127655539,8110,23522
ZCTA5 25810,28,527,-499,28,-,0,0,28,1,1051,-1023
ZCTA5 25811,15,338,-323,29,-,29,0,0,0,946,-917
ZCTA5 25812,563,2144,-1581,1482,42.7,1469,0,0,0,6034,-4552
ZCTA5 25813,2652,1415,1237,7965,40.7,6653,0,1009,0.126679222,3536,4429
ZCTA5 25817,140,163,-23,296,68.3,228,0,0,0,284,12
ZCTA5 25818,196,709,-513,492,30.5,492,0,0,0,1791,-1299
ZCTA5 25820,187,2347,-2160,454,40.2,454,0,0,0,5991,-5537
ZCTA5 25823,245,786,-541,416,54.8,416,0,0,0,2190,-1774
ZCTA5 25825,1057,2514,-1457,2682,46.7,2682,0,0,0,6064,-3382
ZCTA5 25826,122,7484,-7362,468,56.2,468,0,0,0,20064,-19596
ZCTA5 25827,776,246,530,1900,39.5,1810,47,22,0.011578947,641,1259
ZCTA5 25831,626,71,555,1710,47.2,1706,0,0,0,195,1515
ZCTA5 25832,1757,1419,338,4060,47,3729,15,71,0.017487685,3406,654
ZCTA5 25836,434,1277,-843,1249,41.1,1249,0,0,0,2719,-1470
ZCTA5 25837,140,371,-231,303,50.5,303,0,0,0,885,-582
ZCTA5 25839,305,63,242,611,53.5,611,0,0,0,74,537
ZCTA5 25840,2989,72,2917,7338,42,7033,0,160,0.021804306,273,7065
ZCTA5 25841,152,186,-34,622,25.7,622,0,0,0,429,193
ZCTA5 25843,397,911,-514,828,48.1,828,0,0,0,2360,-1532
ZCTA5 25844,524,186,338,1224,41.2,1224,0,0,0,361,863
ZCTA5 25845,131,82,49,394,32.4,394,0,0,0,239,155
ZCTA5 25846,41,37,4,77,70.1,49,0,28,0.363636364,75,2
ZCTA5 25848,35,60,-25,114,42.7,114,0,0,0,151,-37
ZCTA5 25849,262,611,-349,274,39.9,120,0,0,0,1575,-1301
ZCTA5 25851,0,11,-11,0,-,0,0,0,#DIV/0!,11,-11
ZCTA5 25853,42,116,-74,66,59.3,66,0,0,0,287,-221
ZCTA5 25854,431,162,269,1095,27.8,1095,0,0,0,404,691
ZCTA5 25855,46,5735,-5689,269,50.9,256,0,0,0,14068,-13799
ZCTA5 25857,15,1897,-1882,29,-,29,0,0,0,5336,-5307
ZCTA5 25862,85,1328,-1243,120,74.6,120,0,0,0,3136,-3016
ZCTA5 25864,0,214,-214,0,-,0,0,0,#DIV/0!,484,-484
ZCTA5 25865,548,376,172,1428,61.3,1220,0,106,0.074229692,998,430
ZCTA5 25866,121,46,75,357,36.7,338,0,19,0.053221289,119,238
ZCTA5 25868,178,572,-394,441,49.2,441,0,0,0,1218,-777
ZCTA5 25870,52,1216,-1164,98,48.1,98,0,0,0,3114,-3016
ZCTA5 25871,429,92,337,1030,36.3,971,13,39,0.037864078,190,840
ZCTA5 25873,434,301,133,761,64.3,692,0,0,0,730,31
ZCTA5 25875,266,67,199,1137,37.2,1137,0,0,0,207,930
ZCTA5 25876,26,125,-99,63,51.9,63,0,0,0,296,-233
ZCTA5 25878,539,36,503,1162,48.2,1162,0,0,0,69,1093
ZCTA5 25879,40,406,-366,138,51.4,138,0,0,0,1003,-865
ZCTA5 25880,2093,345,1748,5640,37.8,5136,10,202,0.035815603,689,4951
ZCTA5 25882,745,165,580,2353,39.1,2296,0,23,0.009774756,381,1972
ZCTA5 25901,4312,348,3964,10728,41.8,9847,0,729,0.06795302,1515,9213
ZCTA5 25902,102,254,-152,199,65.6,199,0,0,0,643,-444
ZCTA5 25904,281,193,88,548,51.8,541,7,0,0,493,55
ZCTA5 25907,21,248,-227,166,16.5,166,0,0,0,798,-632
ZCTA5 25908,20,752,-732,34,-,34,0,0,0,2617,-2583
ZCTA5 25909,248,15,233,630,60.9,630,0,0,0,56,574
ZCTA5 25911,96,703,-607,190,52.2,70,0,120,0.631578947,2003,-1813
ZCTA5 25913,121,154,-33,241,62.2,241,0,0,0,255,-14
ZCTA5 25915,84,1445,-1361,180,62.2,178,0,2,0.011111111,3272,-3092
ZCTA5 25916,61,1791,-1730,210,67,210,0,0,0,3906,-3696
ZCTA5 25917,627,58,569,1635,43.7,1431,7,192,0.117431193,94,1541
ZCTA5 25918,1896,339,1557,4641,42.2,4438,0,120,0.025856496,723,3918
ZCTA5 25920,82,207,-125,491,35.1,491,0,0,0,691,-200
ZCTA5 25921,1242,418,824,2690,45.3,2588,0,102,0.037918216,1046,1644
ZCTA5 25922,68,81,-13,145,22.8,145,0,0,0,321,-176
ZCTA5 25928,196,13,183,339,62.5,339,0,0,0,24,315
ZCTA5 25932,113,12333,-12220,399,24.1,399,0,0,0,29735,-29336
ZCTA5 25936,4,307,-303,4,-,4,0,0,0,828,-824
ZCTA5 25938,545,279,266,1368,49.3,1368,0,0,0,844,524
ZCTA5 25942,53,245,-192,185,28.4,185,0,0,0,671,-486
ZCTA5 25943,0,167,-167,0,-,0,0,0,#DIV/0!,392,-392
ZCTA5 25951,2443,32,2411,5637,45.4,5192,0,239,0.042398439,146,5491
ZCTA5 25958,251,5609,-5358,760,27.7,738,0,0,0,14053,-13293
ZCTA5 25962,1369,541,828,2786,48.4,2673,0,0,0,1412,1374
ZCTA5 25966,35,542,-507,122,63.6,122,0,0,0,1383,-1261
ZCTA5 25969,564,229,335,1348,46.2,1348,0,0,0,557,791
ZCTA5 25971,598,59,539,1440,58.2,1411,0,2,0.001388889,213,1227
ZCTA5 25972,101,198,-97,288,28.7,288,0,0,0,491,-203
ZCTA5 25976,997,161,836,2232,55.3,2154,0,0,0,481,1751
ZCTA5 25977,0,340,-340,0,-,0,0,0,#DIV/0!,955,-955
ZCTA5 25978,174,825,-651,497,54,465,0,25,0.050301811,2022,-1525
ZCTA5 25979,285,63,222,565,53.8,551,0,0,0,140,425
ZCTA5 25981,254,43,211,523,56.1,523,0,0,0,119,404
ZCTA5 25984,665,1166,-501,1780,33.7,1404,0,41,0.023033708,5000,-3220
ZCTA5 25985,154,4346,-4192,478,52.3,451,0,0,0,11027,-10549
ZCTA5 25986,113,88,25,290,59.2,290,0,0,0,108,182
ZCTA5 25989,62,1298,-1236,255,18.8,255,0,0,0,3405,-3150
ZCTA5 26003,17383,58,17325,40984,43.9,37747,290,1290,0.031475698,279,40705
ZCTA5 26030,249,227,22,591,47.9,566,3,3,0.005076142,593,-2
ZCTA5 26031,727,269,458,1750,51.5,1693,0,32,0.018285714,700,1050
ZCTA5 26032,207,594,-387,1113,19.9,831,3,219,0.196765499,1651,-538
ZCTA5 26033,695,283,412,1723,54.8,1711,0,0,0,716,1007
ZCTA5 26034,2206,294,1912,4442,54.1,4254,12,0,0,765,3677
ZCTA5 26035,726,1636,-910,1564,50.6,1517,13,2,0.001278772,4197,-2633
ZCTA5 26036,117,227,-110,622,32.8,622,0,0,0,503,119
ZCTA5 26037,2712,1518,1194,6106,46.4,5933,1,34,0.005568293,3953,2153
ZCTA5 26038,1281,1062,219,3597,44.3,3433,1,38,0.010564359,2666,931
ZCTA5 26039,182,155,27,459,54.1,453,0,0,0,329,130
ZCTA5 26040,628,550,78,1753,34.4,1567,6,3,0.001711352,1237,516
ZCTA5 26041,5989,1019,4970,15487,45.1,14802,6,119,0.007683864,2559,12928
ZCTA5 26047,2390,515,1875,5598,48.4,5237,5,14,0.002500893,1253,4345
ZCTA5 26050,691,256,435,1406,51.4,1386,7,7,0.004978663,637,769
ZCTA5 26055,463,165,298,1104,48.1,1075,0,0,0,310,794
ZCTA5 26056,109,1390,-1281,361,44.1,361,0,0,0,3913,-3552
ZCTA5 26058,28,2816,-2788,148,49,148,0,0,0,7409,-7261
ZCTA5 26059,1115,352,763,2720,52.1,2627,10,17,0.00625,1019,1701
ZCTA5 26060,652,108,544,2056,42.4,2020,29,0,0,281,1775
ZCTA5 26062,9382,219,9163,21280,44.7,19704,176,673,0.03162594,607,20673
ZCTA5 26070,3669,203,3466,8481,49.8,8255,16,9,0.001061196,536,7945
ZCTA5 26074,180,525,-345,1501,20.7,1356,3,47,0.031312458,1345,156
ZCTA5 26075,275,2496,-2221,691,47.4,687,0,0,0,6796,-6105
ZCTA5 26101,11914,135,11779,28469,39.7,26821,38,664,0.023323615,677,27792
ZCTA5 26104,7488,2570,4918,16392,46.2,15766,53,161,0.009821864,6019,10373
ZCTA5 26105,5168,75,5093,12259,44,11622,242,55,0.0044865,161,12098
ZCTA5 26133,457,28,429,1256,44.6,1230,0,0,0,56,1200
ZCTA5 26134,271,300,-29,709,49.6,705,0,0,0,583,126
ZCTA5 26136,134,114,20,341,51.9,336,0,0,0,198,143
ZCTA5 26137,248,376,-128,717,48.2,671,0,0,0,955,-238
ZCTA5 26138,91,84,7,124,54.3,85,0,39,0.314516129,232,-108
ZCTA5 26141,117,1392,-1275,395,59.4,388,0,0,0,3486,-3091
ZCTA5 26142,914,419,495,2382,44.1,2374,0,0,0,1014,1368
ZCTA5 26143,1574,596,978,4084,46.8,4053,6,20,0.00489716,1831,2253
ZCTA5 26146,344,351,-7,977,53.9,950,0,3,0.003070624,915,62
ZCTA5 26147,701,3723,-3022,1742,46.7,1724,3,1,0.000574053,9281,-7539
ZCTA5 26148,88,1595,-1507,211,55.1,184,0,0,0,4432,-4221
ZCTA5 26149,735,7556,-6821,1928,47.2,1924,0,0,0,19176,-17248
ZCTA5 26150,2353,14053,-11700,6049,39.4,5630,0,33,0.005455447,37257,-31208
ZCTA5 26151,281,11095,-10814,744,44.4,744,0,0,0,31318,-30574
ZCTA5 26152,16,601,-585,16,-,16,0,0,0,1374,-1358
ZCTA5 26155,2809,308,2501,7595,45.6,7384,0,0,0,744,6851
ZCTA5 26159,946,102,844,2466,41.8,2398,0,7,0.002838605,217,2249
ZCTA5 26160,396,1987,-1591,893,47.3,791,0,0,0,6613,-5720
ZCTA5 26161,221,265,-44,652,53.1,652,0,0,0,661,-9
ZCTA5 26162,0,2425,-2425,0,-,0,0,0,#DIV/0!,5683,-5683
ZCTA5 26164,2997,1160,1837,7371,42.7,7286,0,0,0,3259,4112
ZCTA5 26167,395,1090,-695,969,51.4,969,0,0,0,2802,-1833
ZCTA5 26169,303,109,194,792,40,778,14,0,0,245,547
ZCTA5 26170,2185,1024,1161,6374,42.9,6113,0,59,0.009256354,2707,3667
ZCTA5 26175,1198,16999,-15801,3454,48.1,3272,24,40,0.011580776,40919,-37465
ZCTA5 26178,86,539,-453,227,57.1,227,0,0,0,1302,-1075
ZCTA5 26180,791,36,755,2029,50.2,1998,0,7,0.003449975,66,1963
ZCTA5 26181,2473,282,2191,6571,51.3,6483,0,20,0.003043677,734,5837
ZCTA5 26184,862,141,721,2841,34.1,2814,0,14,0.004927842,461,2380
ZCTA5 26187,2590,242,2348,5992,47.1,5852,0,38,0.006341789,732,5260
ZCTA5 26201,7777,1151,6626,19319,42.4,18130,23,401,0.020756768,3289,16030
ZCTA5 26202,174,772,-598,422,70.1,422,0,0,0,1955,-1533
ZCTA5 26203,190,59,131,657,29.6,657,0,0,0,85,572
ZCTA5 26205,1289,219,1070,3329,44.9,3058,23,0,0,560,2769
ZCTA5 26206,928,378,550,2871,46.9,2834,0,0,0,877,1994
ZCTA5 26208,308,108,200,784,49.2,712,0,0,0,285,499
ZCTA5 26209,79,428,-349,201,47,201,0,0,0,1100,-899
ZCTA5 26210,0,1925,-1925,0,-,0,0,0,#DIV/0!,5173,-5173
ZCTA5 26215,44,268,-224,88,54.9,88,0,0,0,596,-508
ZCTA5 26217,36,0,36,112,61.7,112,0,0,0,0,112
ZCTA5 26218,1065,206,859,3043,35.7,3019,0,14,0.004600723,531,2512
ZCTA5 26222,71,1072,-1001,91,67.1,90,0,0,0,2930,-2839
ZCTA5 26224,107,275,-168,198,57.5,198,0,0,0,937,-739
ZCTA5 26228,0,657,-657,0,-,0,0,0,#DIV/0!,1820,-1820
ZCTA5 26230,59,2132,-2073,59,86.1,59,0,0,0,5633,-5574
ZCTA5 26234,565,403,162,1074,60.5,1074,0,0,0,871,203
ZCTA5 26236,8,85,-77,15,-,15,0,0,0,141,-126
ZCTA5 26237,205,104,101,448,51.5,429,0,0,0,317,131
ZCTA5 26238,468,38,430,1055,55.4,856,0,0,0,104,951
ZCTA5 26241,5252,260,4992,13887,45.5,12361,125,265,0.019082595,732,13155
ZCTA5 26250,1694,249,1445,5572,39.9,5234,0,39,0.006999282,680,4892
ZCTA5 26253,1268,450,818,3794,37.2,3608,1,1,0.000263574,1050,2744
ZCTA5 26254,56,1255,-1199,138,62.4,123,0,0,0,2582,-2444
ZCTA5 26257,298,235,63,934,47.3,884,1,49,0.052462527,484,450
ZCTA5 26259,51,104,-53,109,63.6,109,0,0,0,329,-220
ZCTA5 26260,588,126,462,1378,52.1,1332,0,9,0.006531205,260,1118
ZCTA5 26261,1183,213,970,3138,46.5,3060,1,34,0.010834927,499,2639
ZCTA5 26263,99,81,18,191,63.2,191,0,0,0,223,-32
ZCTA5 26264,241,4093,-3852,640,44.4,640,0,0,0,10022,-9382
ZCTA5 26266,0,153,-153,0,-,0,0,0,#DIV/0!,404,-404
ZCTA5 26267,195,118,77,770,29.4,770,0,0,0,321,449
ZCTA5 26268,18,393,-375,58,34,58,0,0,0,958,-900
ZCTA5 26269,436,229,207,1044,54.5,1038,5,0,0,689,355
ZCTA5 26270,217,384,-167,430,52.8,390,0,0,0,1315,-885
ZCTA5 26271,186,700,-514,469,49.1,469,0,0,0,1777,-1308
ZCTA5 26273,277,127,150,1820,38.7,1692,0,107,0.058791209,181,1639
ZCTA5 26275,222,598,-376,611,47.1,593,0,5,0.008183306,1421,-810
ZCTA5 26276,260,0,260,926,41.7,873,0,0,0,0,926
ZCTA5 26278,299,226,73,601,57.1,580,0,0,0,670,-69
ZCTA5 26280,560,160,400,1381,46.1,1259,0,0,0,469,912
ZCTA5 26282,61,2182,-2121,134,63.1,134,0,0,0,5935,-5801
ZCTA5 26283,618,453,165,1566,47.7,1545,0,0,0,1385,181
ZCTA5 26285,106,180,-74,184,57.9,184,0,0,0,434,-250
ZCTA5 26287,1122,827,295,2923,46.3,2787,0,5,0.001710571,2115,808
ZCTA5 26288,1337,1075,262,3651,46.6,3619,0,0,0,2357,1294
ZCTA5 26289,42,274,-232,85,45,82,0,0,0,379,-294
ZCTA5 26291,45,267,-222,98,61.6,98,0,0,0,649,-551
ZCTA5 26292,255,504,-249,633,60.5,632,1,0,0,1204,-571
ZCTA5 26293,193,1074,-881,513,56.2,513,0,0,0,2645,-2132
ZCTA5 26294,244,64,180,458,59.9,458,0,0,0,190,268
ZCTA5 26296,36,353,-317,79,-,79,0,0,0,739,-660
ZCTA5 26298,34,5525,-5491,101,53.4,101,0,0,0,13229,-13128
ZCTA5 26301,11588,95,11493,28986,40.7,27231,87,482,0.016628717,276,28710
ZCTA5 26320,253,342,-89,631,47.6,606,0,0,0,1132,-501
ZCTA5 26321,100,501,-401,164,57.6,164,0,0,0,1544,-1380
ZCTA5 26323,231,317,-86,383,48.7,377,0,0,0,990,-607
ZCTA5 26325,86,2423,-2337,170,60.5,170,0,0,0,6329,-6159
ZCTA5 26327,42,410,-368,95,34.6,95,0,0,0,922,-827
ZCTA5 26330,6108,2776,3332,15320,41.4,14368,204,201,0.013120104,6928,8392
ZCTA5 26335,579,311,268,1448,43,1443,0,0,0,511,937
ZCTA5 26337,368,713,-345,1061,43.4,1007,0,0,0,1594,-533
ZCTA5 26338,235,1758,-1523,831,48.3,782,0,0,0,4298,-3467
ZCTA5 26339,42,240,-198,114,42.2,114,0,0,0,506,-392
ZCTA5 26342,179,415,-236,509,40.2,509,0,0,0,1060,-551
ZCTA5 26343,186,564,-378,400,57.5,374,0,0,0,1405,-1005
ZCTA5 26346,205,280,-75,603,48.1,599,0,0,0,566,37
ZCTA5 26347,759,1224,-465,2253,34.3,2213,0,16,0.007101642,2886,-633
ZCTA5 26348,159,360,-201,326,62.1,326,0,0,0,705,-379
ZCTA5 26349,58,77,-19,164,27.6,164,0,0,0,192,-28
ZCTA5 26351,1026,745,281,3324,29,2754,73,261,0.078519856,1973,1351
ZCTA5 26354,3965,212,3753,10323,45.3,9967,23,116,0.011237043,471,9852
ZCTA5 26361,11,320,-309,11,-,11,0,0,0,618,-607
ZCTA5 26362,1080,205,875,2851,50,2742,51,6,0.002104525,405,2446
ZCTA5 26366,24,261,-237,58,37.3,58,0,0,0,1183,-1125
ZCTA5 26369,259,98,161,688,32.5,538,0,71,0.103197674,143,545
ZCTA5 26372,326,891,-565,816,44,699,0,0,0,2393,-1577
ZCTA5 26374,673,2210,-1537,1877,42.1,1844,0,9,0.004794885,6544,-4667
ZCTA5 26376,168,222,-54,494,29,494,0,0,0,728,-234
ZCTA5 26377,297,2645,-2348,837,52.8,759,0,9,0.010752688,6393,-5556
ZCTA5 26378,1676,661,1015,4062,48.8,3848,80,0,0,1843,2219
ZCTA5 26384,194,417,-223,534,58.2,521,0,0,0,911,-377
ZCTA5 26385,1297,255,1042,3223,44.6,3145,0,3,0.00093081,714,2509
ZCTA5 26386,1041,115,926,2908,38.8,2762,0,0,0,125,2783
ZCTA5 26404,120,423,-303,233,46.5,233,0,0,0,956,-723
ZCTA5 26405,392,293,99,1155,53.4,1030,0,25,0.021645022,675,480
ZCTA5 26408,888,5627,-4739,2367,45.4,2321,1,6,0.002534854,13802,-11435
ZCTA5 26410,324,744,-420,796,43.5,763,6,0,0,2101,-1305
ZCTA5 26411,233,1178,-945,791,40.4,751,0,0,0,2997,-2206
ZCTA5 26412,159,2193,-2034,435,48.6,419,0,0,0,5232,-4797
ZCTA5 26415,946,9815,-8869,3558,40.5,3381,7,125,0.035132097,25957,-22399
ZCTA5 26416,2915,2414,501,7108,40.5,6696,44,148,0.020821609,6053,1055
ZCTA5 26419,223,315,-92,542,39.5,539,0,0,0,786,-244
ZCTA5 26421,65,722,-657,186,38.5,176,0,0,0,1956,-1770
ZCTA5 26422,173,3839,-3666,397,39.4,397,0,0,0,9794,-9397
ZCTA5 26424,13,3063,-3050,13,-,13,0,0,0,7856,-7843
ZCTA5 26425,403,1498,-1095,973,47.9,953,0,0,0,3305,-2332
ZCTA5 26426,2388,2447,-59,7054,46.6,6706,88,106,0.015026935,6753,301
ZCTA5 26430,115,7180,-7065,1369,40.6,655,9,617,0.450693937,17622,-16253
ZCTA5 26431,2268,828,1440,6040,40.4,5606,65,21,0.003476821,1948,4092
ZCTA5 26435,32,4378,-4346,130,31.8,130,0,0,0,11159,-11029
ZCTA5 26436,82,1068,-986,236,77.1,227,0,0,0,2689,-2453
ZCTA5 26437,170,4348,-4178,543,28.6,540,0,0,0,11541,-10998
ZCTA5 26438,63,1800,-1737,75,86,75,0,0,0,4305,-4230
ZCTA5 26440,472,10088,-9616,1291,40.9,1223,0,0,0,25805,-24514
ZCTA5 26443,101,15843,-15742,442,24.6,442,0,0,0,37914,-37472
ZCTA5 26444,1383,4252,-2869,3540,47.2,3466,0,30,0.008474576,11409,-7869
ZCTA5 26447,502,3175,-2673,1217,43.8,1060,0,0,0,7444,-6227
ZCTA5 26448,463,250,213,1335,41.8,1242,0,0,0,615,720
ZCTA5 26451,194,2491,-2297,456,41.3,445,0,0,0,6300,-5844
ZCTA5 26452,3772,3675,97,9803,40.5,9430,23,36,0.003672345,8661,1142
ZCTA5 26456,1130,1010,120,3317,50.5,3307,0,3,0.000904432,2354,963
ZCTA5 26463,105,376,-271,267,48,267,0,0,0,1079,-812
ZCTA5 26501,8846,3435,5411,20206,38.6,17837,126,1271,0.062902108,8476,11730
ZCTA5 26505,15859,1602,14257,36066,25.7,30583,2439,1340,0.037154106,4495,31571
ZCTA5 26506,0,2768,-2768,1367,19.1,1212,6,79,0.057790783,7092,-5725
ZCTA5 26508,15203,4370,10833,38898,37,35317,1110,992,0.025502597,10700,28198
ZCTA5 26519,708,1317,-609,1790,42.6,1767,0,0,0,3346,-1556
ZCTA5 26520,281,1052,-771,803,51.1,745,0,0,0,2363,-1560
ZCTA5 26521,60,5227,-5167,118,52.5,118,0,0,0,13589,-13471
ZCTA5 26524,72,7912,-7840,208,54.6,208,0,0,0,17758,-17550
ZCTA5 26525,2017,14877,-12860,7315,41.6,5611,3,1437,0.19644566,33713,-26398
ZCTA5 26534,420,12837,-12417,863,37.3,743,0,26,0.030127462,28056,-27193
ZCTA5 26537,2409,15143,-12734,5760,46.9,5523,77,72,0.0125,41083,-35323
ZCTA5 26541,1571,18218,-16647,3752,42.7,3657,0,54,0.014392324,45540,-41788
ZCTA5 26542,821,16793,-15972,1947,49.1,1892,0,0,0,46962,-45015
ZCTA5 26543,108,0,108,200,46.2,130,0,70,0.35,2525,-2325
ZCTA5 26544,20,0,20,20,-,20,0,0,0,1606,-1586
ZCTA5 26546,12,13767,-13755,24,-,24,0,0,0,33831,-33807
ZCTA5 26547,1107,22,1085,3115,35,3073,0,0,0,45,3070
ZCTA5 26554,17687,8420,9267,41914,39.1,38394,187,1625,0.038769862,20917,20997
ZCTA5 26559,628,12436,-11808,1568,41.4,1517,4,22,0.014030612,33252,-31684
ZCTA5 26560,40,1411,-1371,150,23.4,150,0,0,0,3622,-3472
ZCTA5 26562,226,739,-513,694,36.9,694,0,0,0,1827,-1133
ZCTA5 26563,110,1259,-1149,277,33.7,214,0,15,0.054151625,4369,-4092
ZCTA5 26568,239,595,-356,676,52,676,0,0,0,2535,-1859
ZCTA5 26570,1217,4047,-2830,3183,43,3150,0,0,0,11587,-8404
ZCTA5 26571,634,17675,-17041,1723,44.2,1637,0,86,0.049912943,39630,-37907
ZCTA5 26572,111,13709,-13598,491,27.6,479,0,0,0,35155,-34664
ZCTA5 26574,164,1521,-1357,417,36.7,349,0,20,0.047961631,4399,-3982
ZCTA5 26575,319,730,-411,640,59.2,640,0,0,0,1892,-1252
ZCTA5 26576,394,1333,-939,791,61.1,791,0,0,0,3447,-2656
ZCTA5 26581,372,1691,-1319,887,57.3,887,0,0,0,4476,-3589
ZCTA5 26582,1597,3814,-2217,3898,48.9,3866,0,5,0.001282709,9471,-5573
ZCTA5 26585,197,720,-523,588,57.8,588,0,0,0,1882,-1294
ZCTA5 26586,37,1604,-1567,58,66.7,58,0,0,0,4130,-4072
ZCTA5 26587,121,4339,-4218,335,40.1,335,0,0,0,13967,-13632
ZCTA5 26588,1286,1771,-485,3091,47.7,2970,0,0,0,4570,-1479
ZCTA5 26590,298,4980,-4682,683,53.3,683,0,0,0,11897,-11214
ZCTA5 26591,610,756,-146,1891,41.1,1872,0,0,0,1872,19
ZCTA5 26601,1211,11411,-10200,3793,47.3,3193,0,52,0.013709465,29069,-25276
ZCTA5 26610,276,2470,-2194,595,58.7,515,0,28,0.047058824,6534,-5939
ZCTA5 26611,48,8480,-8432,161,55.2,161,0,0,0,23795,-23634
ZCTA5 26615,15,9361,-9346,15,-,15,0,0,0,24534,-24519
ZCTA5 26617,40,8566,-8526,132,42.4,132,0,0,0,21636,-21504
ZCTA5 26619,156,18273,-18117,451,32.2,342,0,0,0,45688,-45237
ZCTA5 26621,263,9310,-9047,826,32.2,826,0,0,0,23505,-22679
ZCTA5 26623,412,939,-527,1229,42.3,1229,0,0,0,2432,-1203
ZCTA5 26624,1108,6336,-5228,2534,52.6,2301,0,59,0.023283346,16332,-13798
ZCTA5 26627,100,1341,-1241,360,36,360,0,0,0,3326,-2966
ZCTA5 26629,118,20708,-20590,344,48.9,344,0,0,0,51114,-50770
ZCTA5 26631,88,9964,-9876,176,35.7,176,0,0,0,23633,-23457
ZCTA5 26636,173,676,-503,493,45.5,369,0,0,0,1821,-1328
ZCTA5 26638,65,15614,-15549,173,59.2,173,0,0,0,38548,-38375
ZCTA5 26651,3631,14836,-11205,9300,44.7,9262,33,2,0.000215054,37680,-28380
ZCTA5 26656,121,3962,-3841,310,28,310,0,0,0,8896,-8586
ZCTA5 26660,175,1911,-1736,411,47.3,411,0,0,0,5388,-4977
ZCTA5 26662,220,3528,-3308,524,56.5,524,0,0,0,9982,-9458
ZCTA5 26667,29,10699,-10670,43,69.7,43,0,0,0,26889,-26846
ZCTA5 26671,198,673,-475,381,50.5,381,0,0,0,1693,-1312
ZCTA5 26676,128,2598,-2470,385,65.2,385,0,0,0,6398,-6013
ZCTA5 26678,510,2233,-1723,1506,48.3,1307,1,0,0,6738,-5232
ZCTA5 26679,564,1361,-797,1455,39.3,1424,0,0,0,3470,-2015
ZCTA5 26680,156,8181,-8025,494,40.4,494,0,0,0,18500,-18006
ZCTA5 26681,561,2673,-2112,1201,47.1,1201,0,0,0,6876,-5675
ZCTA5 26684,134,504,-370,473,28.1,473,0,0,0,1373,-900
ZCTA5 26690,260,813,-553,925,33.6,925,0,0,0,2001,-1076
ZCTA5 26691,144,2572,-2428,423,39.7,383,0,0,0,6817,-6394
ZCTA5 26704,1761,6601,-4840,4961,53.7,4831,0,112,0.022576094,17005,-12044
ZCTA5 26705,252,15799,-15547,671,41.6,671,0,0,0,39080,-38409
ZCTA5 26707,93,2557,-2464,254,38.7,241,0,13,0.051181102,6838,-6584
ZCTA5 26710,824,1621,-797,2538,45.4,2521,2,13,0.005122143,3953,-1415
ZCTA5 26711,943,14300,-13357,2639,45.7,2538,0,0,0,38982,-36343
ZCTA5 26714,167,10591,-10424,609,48.2,609,0,0,0,29402,-28793
ZCTA5 26716,318,26,292,881,37.4,881,0,0,0,26,855
ZCTA5 26717,357,2196,-1839,1389,29.1,1386,0,0,0,6105,-4716
ZCTA5 26719,960,646,314,2288,45.7,2249,15,0,0,1644,644
ZCTA5 26720,46,6447,-6401,212,11.5,212,0,0,0,18552,-18340
ZCTA5 26722,119,2356,-2237,271,64.5,271,0,0,0,6232,-5961
ZCTA5 26726,5039,2586,2453,12771,43.8,11700,69,453,0.035470989,6328,6443
ZCTA5 26731,137,901,-764,216,55.8,216,0,0,0,2376,-2160
ZCTA5 26739,330,1193,-863,916,45.7,818,0,87,0.094978166,2749,-1833
ZCTA5 26743,645,2867,-2222,1624,47.5,1514,0,0,0,7434,-5810
ZCTA5 26750,296,5203,-4907,873,45.2,557,0,273,0.312714777,15048,-14175
ZCTA5 26753,2233,18368,-16135,5548,46,5405,0,56,0.010093727,47157,-41609
ZCTA5 26755,170,5585,-5415,422,40.1,414,0,0,0,14754,-14332
ZCTA5 26757,2442,2979,-537,7020,41.7,6507,0,57,0.008119658,8225,-1205
ZCTA5 26761,325,4088,-3763,748,59.9,742,0,0,0,9873,-9125
ZCTA5 26763,439,3041,-2602,1325,43.7,1142,23,0,0,7332,-6007
ZCTA5 26764,1781,1804,-23,4564,45.3,4230,0,21,0.004601227,4882,-318
ZCTA5 26767,200,7793,-7593,601,45.2,601,0,0,0,20643,-20042
ZCTA5 26801,456,7508,-7052,1065,62.6,1065,0,0,0,21602,-20537
ZCTA5 26802,390,17794,-17404,789,55.4,789,0,0,0,43758,-42969
ZCTA5 26804,169,21620,-21451,533,49.1,514,0,19,0.03564728,54292,-53759
ZCTA5 26807,845,18941,-18096,2310,51.3,1999,0,159,0.068831169,47955,-45645
ZCTA5 26808,232,7999,-7767,534,41.8,534,0,0,0,18291,-17757
ZCTA5 26810,227,7433,-7206,576,53.2,540,0,0,0,15240,-14664
ZCTA5 26812,681,22557,-21876,1846,48.1,1846,0,0,0,51890,-50044
ZCTA5 26814,168,11757,-11589,511,45.1,511,0,0,0,28989,-28478
ZCTA5 26815,259,6282,-6023,640,54.1,595,0,45,0.0703125,16741,-16101
ZCTA5 26817,196,10220,-10024,649,40.7,649,0,0,0,31178,-30529
ZCTA5 26818,428,1219,-791,1477,28.5,1324,0,153,0.103588355,6389,-4912
ZCTA5 26823,58,5681,-5623,87,66.5,87,0,0,0,14983,-14896
ZCTA5 26833,888,1919,-1031,2284,51.7,2258,0,26,0.011383538,5213,-2929
ZCTA5 26836,2629,603,2026,6221,44.3,5182,74,413,0.066388041,1466,4755
ZCTA5 26838,20,668,-648,82,18.7,82,0,0,0,2441,-2359
ZCTA5 26845,280,1319,-1039,697,44,697,0,0,0,5084,-4387
ZCTA5 26847,2249,7082,-4833,5825,46.7,5622,0,66,0.011330472,14762,-8937
ZCTA5 26851,825,12719,-11894,1672,52,1662,0,3,0.001794258,33341,-31669
ZCTA5 26852,358,15902,-15544,1088,47.4,1084,0,1,0.000919118,40296,-39208
ZCTA5 26855,257,10616,-10359,758,48.2,758,0,0,0,31576,-30818
ZCTA5 26865,143,13420,-13277,483,21.2,483,0,0,0,37212,-36729
ZCTA5 26866,262,10540,-10278,796,55.5,785,0,11,0.013819095,23701,-22905
ZCTA5 26884,98,7659,-7561,276,39.3,271,0,0,0,20030,-19754
ZCTA5 26886,84,12967,-12883,166,61.6,165,0,1,0.006024096,38661,-38495
ZCTA5 27006,6176,13852,-7676,15760,48.4,14423,226,351,0.022271574,36657,-20897
ZCTA5 27007,819,2274,-1455,2304,43.9,2062,0,12,0.005208333,5967,-3663
ZCTA5 27009,1191,4319,-3128,3528,42.9,3225,0,163,0.046201814,12132,-8604
ZCTA5 27011,2273,3610,-1337,5025,48.6,4369,9,377,0.075024876,9390,-4365
ZCTA5 27012,11171,4277,6894,27631,45.7,23885,810,1426,0.0516087,11372,16259
ZCTA5 27013,2307,5365,-3058,6010,35.4,4842,139,940,0.15640599,12972,-6962
ZCTA5 27014,301,14328,-14027,741,37.3,478,34,89,0.120107962,40323,-39582
ZCTA5 27016,761,5749,-4988,1723,46.4,1651,0,32,0.018572258,17799,-16076
ZCTA5 27017,3328,15511,-12183,9040,37.8,7414,86,173,0.019137168,42161,-33121
ZCTA5 27018,3018,15858,-12840,7825,46.8,7483,0,46,0.005878594,41043,-33218
ZCTA5 27019,1668,0,1668,3888,54.5,3798,0,40,0.010288066,479,3409
ZCTA5 27020,2373,12903,-10530,6094,40.7,5768,3,8,0.001312767,31762,-25668
ZCTA5 27021,7243,6118,1125,16776,46.5,16002,10,237,0.014127325,15968,808
ZCTA5 27022,473,9002,-8529,1130,49.6,1123,0,0,0,26282,-25152
ZCTA5 27023,4766,6688,-1922,13220,40.5,10779,249,1689,0.127760968,18614,-5394
ZCTA5 27024,1085,9455,-8370,2741,47.3,2538,0,14,0.005107625,28604,-25863
ZCTA5 27025,4357,1573,2784,10851,46,8815,61,1061,0.097779007,3818,7033
ZCTA5 27027,1872,3188,-1316,4175,50.7,3490,126,318,0.076167665,8404,-4229
ZCTA5 27028,9757,1472,8285,25639,43.3,21745,0,1431,0.055813409,4158,21481
ZCTA5 27030,14784,8408,6376,35577,45.6,31423,270,1997,0.056131771,23302,12275
ZCTA5 27040,4653,6377,-1724,12630,43.5,9950,155,1838,0.145526524,20091,-7461
ZCTA5 27041,3294,9525,-6231,8116,46.2,7493,18,215,0.026490882,24942,-16826
ZCTA5 27042,96,832,-736,187,64.3,187,0,0,0,2316,-2129
ZCTA5 27043,2532,703,1829,6700,46.3,6203,0,161,0.024029851,2231,4469
ZCTA5 27045,4102,177,3925,9950,44.2,7363,0,2146,0.215678392,338,9612
ZCTA5 27046,1148,136,1012,2266,52.3,2142,0,56,0.024713151,349,1917
ZCTA5 27047,459,2184,-1725,1481,29.1,1481,0,0,0,5736,-4255
ZCTA5 27048,3227,900,2327,8244,45.1,6976,9,843,0.102256186,2208,6036
ZCTA5 27050,1609,9331,-7722,3849,49.2,3477,0,207,0.053780203,22148,-18299
ZCTA5 27051,3021,703,2318,7392,41.3,5901,18,1196,0.161796537,1770,5622
ZCTA5 27052,4110,1669,2441,10700,43.5,9002,193,981,0.091682243,4312,6388
ZCTA5 27053,1365,9713,-8348,3103,52.9,2903,0,141,0.045439897,28253,-25150
ZCTA5 27054,876,204,672,2093,51.7,1836,0,198,0.094601051,384,1709
ZCTA5 27055,5223,2600,2623,14098,43.1,12154,0,284,0.020144701,7211,6887
ZCTA5 27101,9266,1281,7985,20634,33,8850,349,10138,0.491324998,3975,16659
ZCTA5 27103,16075,2625,13450,35350,37.3,24125,1665,6627,0.187468175,6805,28545
ZCTA5 27104,13310,4240,9070,29324,44.7,23065,1240,2975,0.101452735,11078,18246
ZCTA5 27105,14900,5784,9116,40703,35.8,12006,107,23813,0.585042872,14806,25897
ZCTA5 27106,19076,6300,12776,46688,40.2,28298,1954,11745,0.251563571,16391,30297
ZCTA5 27107,18438,8519,9919,49835,37.6,27382,459,15727,0.315581419,24664,25171
ZCTA5 27109,0,1177,-1177,2592,19.6,1787,248,462,0.178240741,5254,-2662
ZCTA5 27110,0,43,-43,2897,20,884,115,1761,0.607870211,111,2786
ZCTA5 27127,16190,2773,13417,42914,34.8,24134,802,11386,0.26532134,6920,35994
ZCTA5 27201,39,18526,-18487,101,47.2,97,4,0,0,52521,-52420
ZCTA5 27202,26,3174,-3148,26,-,26,0,0,0,9350,-9324
ZCTA5 27203,9025,7600,1425,22036,34.2,14213,279,3277,0.1487112,20492,1544
ZCTA5 27205,13886,5238,8648,35768,43.6,30795,381,1711,0.047836055,14956,20812
ZCTA5 27207,1338,5677,-4339,3749,47.4,2986,30,721,0.192317951,15059,-11310
ZCTA5 27208,612,8511,-7899,1620,49.9,1574,0,23,0.014197531,23154,-21534
ZCTA5 27209,1386,3153,-1767,4735,26.5,2698,24,494,0.104329461,9514,-4779
ZCTA5 27212,459,17538,-17079,1932,43.7,814,0,1038,0.537267081,45416,-43484
ZCTA5 27213,52,16550,-16498,80,59,80,0,0,0,40644,-40564
ZCTA5 27214,5042,2592,2450,14420,37,8176,0,4855,0.33668516,4472,9948
ZCTA5 27215,19186,17035,2151,45191,40.6,31492,1210,8987,0.198867031,44058,1133
ZCTA5 27217,14131,8086,6045,38575,36.7,19714,181,12079,0.313130266,27912,10663
ZCTA5 27229,918,4726,-3808,3122,37.1,2324,0,493,0.157911595,10451,-7329
ZCTA5 27231,992,14370,-13378,2274,46.5,1518,32,507,0.222955145,32260,-29986
ZCTA5 27233,1193,22475,-21282,3356,39.9,3203,0,64,0.019070322,67170,-63814
ZCTA5 27235,1894,16153,-14259,4587,49.8,4086,136,301,0.065620231,34825,-30238
ZCTA5 27239,3362,17431,-14069,8041,51.5,7873,95,0,0,42944,-34903
ZCTA5 27242,611,11519,-10908,1376,42.7,1079,0,296,0.215116279,31881,-30505
ZCTA5 27243,2042,17276,-15234,5448,41.7,4371,15,658,0.120778267,41266,-35818
ZCTA5 27244,4942,15746,-10804,15914,27.7,13154,568,1640,0.103053915,45028,-29114
ZCTA5 27247,64,6617,-6553,192,48.9,192,0,0,0,14571,-14379
ZCTA5 27248,1197,8956,-7759,3513,41.7,3100,0,46,0.013094221,20222,-16709
ZCTA5 27249,5173,15875,-10702,12761,47.1,10511,82,1526,0.119583105,42845,-30084
ZCTA5 27252,644,13285,-12641,1507,39.9,1140,1,346,0.229595222,34058,-32551
ZCTA5 27253,13127,18429,-5302,31609,40.5,22091,156,5042,0.159511532,46833,-15224
ZCTA5 27256,67,19120,-19053,67,-,67,0,0,0,45528,-45461
ZCTA5 27258,2713,238,2475,7356,38.4,5167,54,1203,0.163539967,658,6698
ZCTA5 27259,35,7629,-7594,158,13.6,158,0,0,0,20133,-19975
ZCTA5 27260,9407,20596,-11189,24550,37.9,5866,1539,13705,0.558248473,46540,-21990
ZCTA5 27262,9010,8197,813,24549,37,14370,658,6917,0.281763005,21658,2891
ZCTA5 27263,8580,8692,-112,22334,41.1,15789,2039,3161,0.141533089,20824,1510
ZCTA5 27265,20559,12103,8456,51426,40,30857,4019,13147,0.255648894,29033,22393
ZCTA5 27268,0,1441,-1441,1560,19.1,979,14,474,0.303846154,3580,-2020
ZCTA5 27278,11338,976,10362,27437,47.1,21971,546,2816,0.102635128,2543,24894
ZCTA5 27281,1303,2369,-1066,3421,44.2,2337,95,624,0.182402806,6646,-3225
ZCTA5 27282,6089,1034,5055,15020,42.2,10905,857,2597,0.172902796,2209,12811
ZCTA5 27283,1212,1704,-492,3113,41.5,2407,0,74,0.023771282,4405,-1292
ZCTA5 27284,22910,1737,21173,56398,42.4,43993,1426,7189,0.127469059,3943,52455
ZCTA5 27288,9866,1064,8802,23991,42.8,17178,306,5108,0.212913176,2565,21426
ZCTA5 27291,628,255,373,1514,52.3,1084,0,399,0.263540291,695,819
ZCTA5 27292,16550,705,15845,41035,41,32095,458,6464,0.157524065,1277,39758
ZCTA5 27295,15647,912,14735,38894,44.3,34398,1347,1391,0.035763871,2549,36345
ZCTA5 27298,4094,2948,1146,11079,43,9323,28,711,0.064175467,7335,3744
ZCTA5 27299,1706,715,991,5059,36.6,4736,0,190,0.037556829,1735,3324
ZCTA5 27301,3811,188,3623,10306,40.8,6365,215,3022,0.293227246,428,9878
ZCTA5 27302,12915,1100,11815,33364,39.7,22814,1085,5839,0.175008992,2544,30820
ZCTA5 27305,779,110,669,1919,46.2,721,0,1193,0.621677957,434,1485
ZCTA5 27306,2304,3292,-988,5597,50.4,3720,416,1406,0.251206003,8429,-2832
ZCTA5 27310,2824,2729,95,8388,44.6,6898,586,366,0.043633763,7371,1017
ZCTA5 27311,1261,663,598,3069,47.4,2331,23,505,0.164548713,1954,1115
ZCTA5 27312,9505,23,9482,22794,49.2,18461,352,2602,0.114152847,71,22723
ZCTA5 27313,2582,298,2284,6496,46.6,5770,142,307,0.047259852,885,5611
ZCTA5 27314,304,31,273,808,32.4,744,0,30,0.037128713,51,757
ZCTA5 27315,751,3354,-2603,1883,47.3,1501,30,284,0.150823155,8035,-6152
ZCTA5 27316,2738,860,1878,7703,38.7,6204,0,502,0.065169415,1972,5731
ZCTA5 27317,6686,1984,4702,18233,41,14773,228,818,0.044863709,5312,12921
ZCTA5 27320,16033,1480,14553,37366,46.1,25226,42,9387,0.251217685,3590,33776
ZCTA5 27325,2538,1156,1382,7402,37.8,4840,15,585,0.079032694,2969,4433
ZCTA5 27326,1311,21469,-20158,3422,38.6,2058,26,1006,0.293980129,54429,-51007
ZCTA5 27330,15002,2212,12790,40063,38.3,27185,664,8648,0.21586002,6254,33809
ZCTA5 27332,12181,1299,10882,33935,37.5,23744,424,5613,0.16540445,4387,29548
ZCTA5 27340,15,157,-142,20,55.3,15,0,0,0,437,-417
ZCTA5 27341,1764,27,1737,3929,42.4,3540,0,175,0.044540596,54,3875
ZCTA5 27342,22,620,-598,69,40.4,0,0,69,1,1358,-1289
ZCTA5 27343,549,506,43,1411,49.9,891,0,365,0.258681786,1335,76
ZCTA5 27344,6718,1215,5503,18468,39.3,10471,45,3287,0.177983539,3233,15235
ZCTA5 27349,2492,941,1551,6201,47,5369,0,585,0.094339623,2736,3465
ZCTA5 27350,2424,1145,1279,5975,38.6,5773,44,58,0.009707113,3067,2908
ZCTA5 27351,68,308,-240,210,41.6,210,0,0,0,983,-773
ZCTA5 27355,886,684,202,2261,40.2,1790,1,184,0.08137992,1643,618
ZCTA5 27356,875,3042,-2167,2857,35.6,2045,7,500,0.17500875,6899,-4042
ZCTA5 27357,3551,2106,1445,9597,39,7627,81,640,0.066687507,5093,4504
ZCTA5 27358,5328,1016,4312,15379,44.3,13826,544,596,0.038754145,2449,12930
ZCTA5 27360,18108,234,17874,46349,39.9,37191,407,4795,0.103454228,726,45623
ZCTA5 27370,5392,2300,3092,14148,47.4,13340,148,331,0.023395533,6139,8009
ZCTA5 27371,2873,6067,-3194,7740,45.6,6065,31,1315,0.169896641,16597,-8857
ZCTA5 27374,115,566,-451,205,54.3,205,0,0,0,1436,-1231
ZCTA5 27376,3480,21251,-17771,8395,54.9,6330,90,1264,0.150565813,55793,-47398
ZCTA5 27377,3738,1035,2703,9473,42,6039,243,2891,0.305183152,3176,6297
ZCTA5 27379,1887,48,1839,4744,48.1,2521,18,1978,0.416947723,96,4648
ZCTA5 27401,7590,367,7223,21947,30,6009,157,14452,0.658495466,857,21090
ZCTA5 27403,7815,4367,3448,19556,31.4,11187,883,5139,0.2627838,11736,7820
ZCTA5 27405,19497,1828,17669,51645,32.6,12766,2206,30420,0.589021202,4902,46743
ZCTA5 27406,24710,678,24032,62882,36.3,19973,1336,35824,0.569701981,1780,61102
ZCTA5 27407,21662,322,21340,52745,35.8,21282,6095,20252,0.383960565,743,52002
ZCTA5 27408,7575,823,6752,16930,43.9,14304,425,1517,0.089604253,2558,14372
ZCTA5 27409,8076,11340,-3264,16131,37.4,8058,1340,6002,0.372078606,27352,-11221
ZCTA5 27410,24349,1654,22695,57115,40.6,42454,3013,8703,0.152376784,4178,52937
ZCTA5 27411,0,126,-126,1416,19.3,255,0,1113,0.786016949,317,1099
ZCTA5 27412,0,153,-153,3810,19.4,1666,54,1801,0.472703412,424,3386
ZCTA5 27455,11726,1852,9874,28598,44,18677,1455,6951,0.243058955,4841,23757
ZCTA5 27501,8076,204,7872,22190,39.1,15763,225,2061,0.092879676,500,21690
ZCTA5 27502,15795,661,15134,45233,37.5,35102,4019,2904,0.064200915,1606,43627
ZCTA5 27503,1385,724,661,6032,47.2,4152,9,1675,0.277685676,1898,4134
ZCTA5 27504,5867,107,5760,14683,42.3,10737,0,2261,0.153987605,279,14404
ZCTA5 27505,2915,1237,1678,7414,35.7,5628,25,906,0.122201241,3084,4330
ZCTA5 27506,0,26,-26,1217,19.2,1053,4,71,0.058340181,79,1138
ZCTA5 27507,689,3016,-2327,1774,53.8,1267,0,461,0.259864713,8121,-6347
ZCTA5 27508,864,1334,-470,2343,47.1,1160,77,802,0.342296201,3474,-1131
ZCTA5 27509,1547,379,1168,7096,43.6,3201,8,3151,0.444052988,842,6254
ZCTA5 27510,6571,415,6156,14296,31.7,9399,787,2758,0.192921097,1449,12847
ZCTA5 27511,13201,8376,4825,32903,42,23682,1851,3266,0.099261466,22263,10640
ZCTA5 27513,19076,807,18269,47671,39.5,33269,6189,3806,0.079838896,2534,45137
ZCTA5 27514,9883,11174,-1291,33255,23.2,23221,4870,3002,0.09027214,26911,6344
ZCTA5 27516,16400,974,15426,44587,35.6,32853,4298,3846,0.086258326,2646,41941
ZCTA5 27517,11222,2081,9141,26352,43.9,20346,1718,2551,0.096804797,5583,20769
ZCTA5 27518,8245,5932,2313,19674,45.4,15528,1858,1213,0.061654976,14854,4820
ZCTA5 27519,21393,15850,5543,62612,38,30334,22770,4901,0.07827573,40667,21945
ZCTA5 27520,16241,7808,8433,45166,39.9,30812,442,10143,0.22457158,19778,25388
ZCTA5 27521,2581,767,1814,6606,38.2,5054,11,613,0.092794429,2151,4455
ZCTA5 27522,4768,14533,-9765,12643,42.1,7747,67,3442,0.272245511,40605,-27962
ZCTA5 27523,5509,4437,1072,14777,38.2,9478,2896,1233,0.083440482,11839,2938
ZCTA5 27524,5027,351,4676,13753,36.2,10825,84,1720,0.125063622,577,13176
ZCTA5 27525,5512,163,5349,14078,41.9,9259,23,3581,0.254368518,316,13762
ZCTA5 27526,19654,427,19227,54878,38.5,41773,622,7263,0.132348118,1171,53707
ZCTA5 27527,10959,362,10597,30923,35.4,23539,188,3722,0.120363483,1016,29907
ZCTA5 27529,19786,414,19372,52306,37.9,33881,450,12781,0.244350553,882,51424
ZCTA5 27530,15530,1782,13748,37275,39.2,19371,500,15149,0.406411804,5004,32271
ZCTA5 27531,42,379,-337,771,20.8,292,73,263,0.341115435,958,-187
ZCTA5 27533,0,149,-149,447,38.4,263,6,131,0.293064877,262,185
ZCTA5 27534,13130,1125,12005,29591,39.4,17261,586,9363,0.316413774,2649,26942
ZCTA5 27536,5923,1601,4322,15674,33.8,4066,241,9571,0.610629067,4185,11489
ZCTA5 27537,8662,676,7986,23268,42.8,11847,115,9038,0.388430462,1556,21712
ZCTA5 27539,8801,372,8429,26340,36.5,20147,1378,2411,0.091533789,639,25701
ZCTA5 27540,13875,863,13012,42883,35.6,34126,1795,4310,0.100506028,2389,40494
ZCTA5 27541,1475,492,983,3577,47.7,2970,90,422,0.117975958,1261,2316
ZCTA5 27542,3883,5119,-1236,9937,38.4,7774,78,1175,0.118244943,12970,-3033
ZCTA5 27544,1725,565,1160,4475,40.5,2761,0,1440,0.321787709,1338,3137
ZCTA5 27545,11911,502,11409,32171,36,12469,529,13007,0.404308228,1046,31125
ZCTA5 27546,6880,1465,5415,20525,35.9,13634,383,4491,0.218806334,4248,16277
ZCTA5 27549,9258,553,8705,23996,42.8,15072,78,6987,0.291173529,1495,22501
ZCTA5 27551,837,1133,-296,1962,55.2,1324,1,440,0.224260958,2810,-848
ZCTA5 27553,640,231,409,1667,47.2,688,0,957,0.574085183,601,1066
ZCTA5 27555,216,335,-119,526,42,395,5,46,0.087452471,837,-311
ZCTA5 27556,87,248,-161,238,33.6,42,0,188,0.789915966,543,-305
ZCTA5 27557,2595,4907,-2312,7941,38,4934,34,1314,0.165470344,11998,-4057
ZCTA5 27559,1183,652,531,2732,55.2,2165,87,396,0.144948755,1683,1049
ZCTA5 27560,14806,474,14332,36804,33.7,14777,14130,5290,0.143734377,1291,35513
ZCTA5 27562,1287,4857,-3570,3925,36.2,3193,32,380,0.096815287,10423,-6498
ZCTA5 27563,2119,3214,-1095,5571,43,1727,0,3638,0.653024592,6996,-1425
ZCTA5 27565,9308,853,8455,25673,44.4,12794,161,9763,0.380282787,2196,23477
ZCTA5 27568,560,456,104,1506,34.6,1309,0,118,0.078353254,1273,233
ZCTA5 27569,3342,2760,582,8890,40.9,7156,0,876,0.098537683,6864,2026
ZCTA5 27570,30,123,-93,30,-,30,0,0,0,277,-247
ZCTA5 27571,2751,551,2200,8425,37.1,5352,96,1850,0.21958457,1535,6890
ZCTA5 27572,2876,3420,-544,6896,46,5502,38,929,0.134715777,9738,-2842
ZCTA5 27573,4627,1226,3401,11008,40.2,4806,41,4419,0.40143532,2802,8206
ZCTA5 27574,5945,286,5659,14586,47.9,10637,36,3661,0.250994104,591,13995
ZCTA5 27576,7017,2779,4238,19365,37.2,12980,68,4137,0.213632843,6999,12366
ZCTA5 27577,9333,236,9097,25950,40.9,17505,252,4821,0.185780347,449,25501
ZCTA5 27581,1244,271,973,3667,36.1,2729,0,600,0.163621489,626,3041
ZCTA5 27582,101,450,-349,252,39.6,130,0,109,0.432539683,1064,-812
ZCTA5 27583,2767,110,2657,7004,39.4,5747,29,907,0.12949743,270,6734
ZCTA5 27584,100,163,-63,237,60.1,85,0,152,0.641350211,339,-102
ZCTA5 27587,27840,1431,26409,77957,40.4,58545,1711,10491,0.134574188,3661,74296
ZCTA5 27589,2628,26,2602,6352,46.1,1590,69,3466,0.545654912,52,6300
ZCTA5 27591,8378,465,7913,23856,39.1,13485,101,5712,0.23943662,1255,22601
ZCTA5 27592,6017,471,5546,18321,38,15657,148,1373,0.074941324,1446,16875
ZCTA5 27593,0,1199,-1199,0,-,0,0,0,#DIV/0!,3182,-3182
ZCTA5 27594,55,85,-30,104,-,104,0,0,0,221,-117
ZCTA5 27596,6978,652,6326,18685,41.8,14267,227,2702,0.144607974,1930,16755
ZCTA5 27597,9981,665,9316,28095,39.3,17334,65,6431,0.22890194,1811,26284
ZCTA5 27599,0,736,-736,0,-,0,0,0,#DIV/0!,1934,-1934
ZCTA5 27601,4371,38,4333,11127,31.3,4443,485,5052,0.454030736,67,11060
ZCTA5 27603,21127,3676,17451,54079,34.1,36072,1349,10042,0.185691303,10848,43231
ZCTA5 27604,18100,108,17992,44856,36.9,19492,3297,15292,0.340913144,263,44593
ZCTA5 27605,3624,546,3078,5680,34.1,4646,170,458,0.080633803,2538,3142
ZCTA5 27606,18835,10345,8490,45499,30,30308,4557,6996,0.153761621,26339,19160
ZCTA5 27607,8861,435,8426,27128,24.3,21407,1057,3138,0.115673843,1242,25886
ZCTA5 27608,5113,270,4843,12069,39.6,11306,35,286,0.023697075,667,11402
ZCTA5 27609,16399,458,15941,35377,37.5,24615,533,5685,0.160697628,897,34480
ZCTA5 27610,26086,8270,17816,79445,34.2,17584,844,50588,0.636767575,20920,58525
ZCTA5 27612,18460,4988,13472,39249,38.9,29200,1892,5346,0.136207292,13138,26111
ZCTA5 27613,17505,0,17505,43950,40.5,34795,1894,4272,0.097201365,693,43257
ZCTA5 27614,12785,2605,10180,32371,43.9,25621,1206,3192,0.098606778,6179,26192
ZCTA5 27615,18865,38,18827,45047,42.8,34446,1321,6214,0.137944813,75,44972
ZCTA5 27616,20907,980,19927,56238,34,20426,3777,22282,0.396208969,2333,53905
ZCTA5 27617,9500,5099,4401,19661,37.2,13545,1728,3452,0.175576013,12610,7051
ZCTA5 27695,0,5471,-5471,2365,19.1,1948,134,127,0.053699789,13691,-11326
ZCTA5 27697,0,17738,-17738,0,-,0,0,0,#DIV/0!,49494,-49494
ZCTA5 27701,10712,20190,-9478,23876,33.4,11809,799,8363,0.350268052,55688,-31812
ZCTA5 27703,23944,9895,14049,58962,35.7,22103,2749,24989,0.423815339,23960,35002
ZCTA5 27704,15865,1306,14559,41315,35.7,13880,537,20732,0.501803219,2926,38389
ZCTA5 27705,21130,916,20214,47527,34.7,30238,3780,9442,0.198666021,2473,45054
ZCTA5 27707,21279,6572,14707,51791,34.4,24619,2154,19399,0.374563148,17068,34723
ZCTA5 27708,0,5027,-5027,3408,20.2,2090,386,776,0.227699531,14837,-11429
ZCTA5 27709,0,7055,-7055,0,-,0,0,0,#DIV/0!,17754,-17754
ZCTA5 27712,9103,45,9058,22402,45.1,15684,513,4713,0.210383002,96,22306
ZCTA5 27713,23585,2951,20634,55627,35.7,26268,3772,20226,0.36360041,7694,47933
ZCTA5 27801,6893,8980,-2087,19627,38.8,4875,26,14119,0.719366179,21846,-2219
ZCTA5 27803,8534,12221,-3687,18857,48.1,9779,53,8302,0.440260911,34924,-16067
ZCTA5 27804,12195,14111,-1916,29658,41,12162,512,14874,0.501517297,34956,-5298
ZCTA5 27805,1354,11958,-10604,3307,45,1441,0,1756,0.530994859,32637,-29330
ZCTA5 27806,933,1252,-319,2333,44.1,1176,29,994,0.426060866,3310,-977
ZCTA5 27807,2194,457,1737,6144,37.8,3988,35,700,0.113932292,1347,4797
ZCTA5 27808,934,1975,-1041,2042,54.1,1939,20,31,0.015181195,4975,-2933
ZCTA5 27809,1781,5416,-3635,4274,47.4,2234,128,1751,0.409686476,16050,-11776
ZCTA5 27810,1693,332,1361,3794,49.6,2636,0,1130,0.297838693,1003,2791
ZCTA5 27812,1146,137,1009,2599,46.9,962,0,1473,0.566756445,291,2308
ZCTA5 27813,301,19520,-19219,815,40.3,650,0,130,0.159509202,51715,-50900
ZCTA5 27814,613,10748,-10135,1502,50.4,1006,0,418,0.278295606,31918,-30416
ZCTA5 27815,0,2866,-2866,0,-,0,0,0,#DIV/0!,7907,-7907
ZCTA5 27816,1298,9410,-8112,3206,49,1572,17,1279,0.398939488,25359,-22153
ZCTA5 27817,3023,9337,-6314,7283,49.8,5333,0,1613,0.221474667,23161,-15878
ZCTA5 27818,559,10208,-9649,1300,53.3,455,0,762,0.586153846,26308,-25008
ZCTA5 27819,128,1341,-1213,579,18.8,24,0,527,0.910189983,2809,-2230
ZCTA5 27820,859,30,829,2114,37.3,1434,0,524,0.247871334,222,1892
ZCTA5 27821,64,3135,-3071,104,46.4,68,0,36,0.346153846,8291,-8187
ZCTA5 27822,3259,1021,2238,8134,43.6,5624,32,2058,0.253012048,2320,5814
ZCTA5 27823,2651,14698,-12047,6651,43.2,854,5,5144,0.773417531,38145,-31494
ZCTA5 27824,537,2282,-1745,1324,45.6,629,0,511,0.385951662,5901,-4577
ZCTA5 27825,33,1539,-1506,81,28.1,57,0,4,0.049382716,3701,-3620
ZCTA5 27826,232,254,-22,923,45.6,437,0,459,0.497291441,551,372
ZCTA5 27827,81,32,49,171,49.9,112,0,59,0.34502924,101,70
ZCTA5 27828,3697,3781,-84,9100,38,4522,0,3892,0.427692308,9890,-790
ZCTA5 27829,758,9674,-8916,1330,61.7,980,0,315,0.236842105,28752,-27422
ZCTA5 27830,1730,14900,-13170,4144,45.5,3150,0,658,0.158783784,39354,-35210
ZCTA5 27831,1423,2539,-1116,2931,53.5,506,0,2256,0.769703173,6940,-4009
ZCTA5 27832,919,13,906,2317,54.3,815,2,1316,0.567975831,40,2277
ZCTA5 27834,24304,57,24247,55864,32.5,21037,1005,29466,0.527459545,290,55574
ZCTA5 27837,2379,17415,-15036,6178,43.3,4327,204,1007,0.162997734,50264,-44086
ZCTA5 27839,1420,9126,-7706,3718,47.3,1810,68,1701,0.457504034,26263,-22545
ZCTA5 27840,125,2705,-2580,262,56.6,85,0,177,0.675572519,6823,-6561
ZCTA5 27841,15,11985,-11970,24,71.8,0,0,24,1,33493,-33469
ZCTA5 27842,790,12965,-12175,1742,58.2,1354,0,354,0.203214696,34878,-33136
ZCTA5 27843,324,1054,-730,864,46.5,208,0,567,0.65625,2883,-2019
ZCTA5 27844,1269,8077,-6808,3136,43,460,66,1076,0.343112245,20200,-17064
ZCTA5 27845,838,2348,-1510,2581,42.2,924,0,1536,0.595118171,5922,-3341
ZCTA5 27846,1162,962,200,2797,40,1963,2,778,0.278155166,2544,253
ZCTA5 27847,355,2719,-2364,1013,37,109,1,888,0.876604146,8005,-6992
ZCTA5 27849,506,2697,-2191,1082,48.3,344,8,710,0.656192237,6658,-5576
ZCTA5 27850,3040,2286,754,7237,52.2,3980,35,2670,0.368937405,5538,1699
ZCTA5 27851,1857,1156,701,4454,45.5,3118,0,972,0.218230804,2980,1474
ZCTA5 27852,1148,3845,-2697,2541,46.8,1734,60,713,0.28059819,9255,-6714
ZCTA5 27853,185,1547,-1362,649,25.2,291,0,268,0.412942989,5872,-5223
ZCTA5 27855,2136,1122,1014,5533,40.8,1976,4,3266,0.590276523,3052,2481
ZCTA5 27856,6104,3834,2270,17001,40.1,9624,41,6378,0.375154403,10587,6414
ZCTA5 27857,545,7783,-7238,1131,52.3,541,0,590,0.521662246,19715,-18584
ZCTA5 27858,22504,9433,13071,56361,25.3,39358,899,11465,0.203420805,25159,31202
ZCTA5 27860,493,10733,-10240,1620,35.5,906,0,426,0.262962963,26597,-24977
ZCTA5 27861,44,8941,-8897,106,55.1,40,0,66,0.622641509,25923,-25817
ZCTA5 27862,319,11122,-10803,658,54.2,361,0,263,0.399696049,28173,-27515
ZCTA5 27863,4512,9550,-5038,12676,36.4,10495,48,1795,0.141606185,25668,-12992
ZCTA5 27864,1834,1091,743,4686,43.4,2631,0,1859,0.396713615,3202,1484
ZCTA5 27865,805,1522,-717,2297,47.2,2202,6,87,0.03787549,3681,-1384
ZCTA5 27866,229,1988,-1759,675,36.9,301,0,374,0.554074074,5689,-5014
ZCTA5 27869,716,5102,-4386,1690,59.3,375,8,1280,0.75739645,13153,-11463
ZCTA5 27870,10227,3275,6952,25166,41.4,12243,216,10699,0.42513709,8772,16394
ZCTA5 27871,1766,977,789,3979,53.9,1706,22,2154,0.541342046,2498,1481
ZCTA5 27872,147,4099,-3952,290,48,70,0,210,0.724137931,10989,-10699
ZCTA5 27873,135,67,68,284,54.5,127,0,116,0.408450704,207,77
ZCTA5 27874,1861,4546,-2685,3946,56.3,1062,7,2861,0.725038013,11888,-7942
ZCTA5 27875,105,13978,-13873,147,55,56,0,59,0.401360544,45304,-45157
ZCTA5 27876,527,2612,-2085,1071,54.4,238,12,782,0.73015873,8371,-7300
ZCTA5 27877,5,5498,-5493,12,-,0,0,12,1,9565,-9553
ZCTA5 27878,497,6027,-5530,1054,40.2,308,0,717,0.680265655,11921,-10867
ZCTA5 27879,125,2486,-2361,287,48.6,100,0,160,0.557491289,5235,-4948
ZCTA5 27880,1591,18528,-16937,3962,38.7,2435,72,698,0.17617365,43299,-39337
ZCTA5 27881,8,3969,-3961,17,66.9,15,0,2,0.117647059,11354,-11337
ZCTA5 27882,3081,3550,-469,8205,43.4,3642,22,3280,0.399756246,9178,-973
ZCTA5 27883,1304,13041,-11737,3461,38.2,1801,0,959,0.277087547,35156,-31695
ZCTA5 27884,412,9997,-9585,1340,23.1,509,0,676,0.504477612,21224,-19884
ZCTA5 27885,518,19483,-18965,987,51.9,590,0,261,0.26443769,42313,-41326
ZCTA5 27886,7799,12002,-4203,18599,45.1,8581,31,8976,0.482606592,28349,-9750
ZCTA5 27888,749,14919,-14170,2098,36.4,1255,0,681,0.324594852,38553,-36455
ZCTA5 27889,10532,13809,-3277,24661,46.8,16466,92,6731,0.272941081,36484,-11823
ZCTA5 27890,883,12437,-11554,2341,30.6,349,0,1966,0.839812046,34146,-31805
ZCTA5 27891,1754,19380,-17626,4901,42.5,1277,0,3493,0.712711691,54362,-49461
ZCTA5 27892,5494,17653,-12159,13624,43.3,7574,119,5293,0.388505578,47086,-33462
ZCTA5 27893,15756,9492,6264,39681,36.9,13244,312,20402,0.514150349,26723,12958
ZCTA5 27896,8042,15546,-7504,19123,42.9,12038,395,5563,0.290906239,36844,-17721
ZCTA5 27897,565,18527,-17962,1566,40.4,674,0,726,0.463601533,50574,-49008
ZCTA5 27909,15079,0,15079,40284,39,23020,490,14593,0.362253004,0,40284
ZCTA5 27910,4526,13979,-9453,11428,42.3,3275,180,7406,0.648057403,39905,-28477
ZCTA5 27915,299,27112,-26813,361,58,361,0,0,0,72749,-72388
ZCTA5 27916,400,12247,-11847,936,30.5,898,0,0,0,32131,-31195
ZCTA5 27917,236,12016,-11780,533,51.2,256,0,187,0.350844278,31113,-30580
ZCTA5 27919,392,23589,-23197,855,50.2,735,0,120,0.140350877,59365,-58510
ZCTA5 27920,603,7465,-6862,1551,46.3,1459,0,0,0,20905,-19354
ZCTA5 27921,1852,0,1852,4616,39.2,3929,57,326,0.070623917,0,4616
ZCTA5 27922,285,0,285,703,48.8,217,4,329,0.46799431,0,703
ZCTA5 27923,274,6601,-6327,491,53,391,6,21,0.042769857,17903,-17412
ZCTA5 27924,1171,12636,-11465,2962,48.7,1398,1,1557,0.525658339,29486,-26524
ZCTA5 27925,1281,15038,-13757,3192,46.6,1792,16,1207,0.378132832,38048,-34856
ZCTA5 27926,621,2857,-2236,1673,50.5,1268,0,405,0.242080096,5931,-4258
ZCTA5 27927,609,14409,-13800,1219,60,1187,0,0,0,40524,-39305
ZCTA5 27928,813,4919,-4106,1722,56,1096,36,440,0.255516841,19690,-17968
ZCTA5 27929,1055,14,1041,2773,48.3,2276,5,334,0.120447169,298,2475
ZCTA5 27932,5583,0,5583,12472,45.5,7256,56,4538,0.363855035,5024,7448
ZCTA5 27935,643,13021,-12378,1789,43.4,1546,0,151,0.084404695,32851,-31062
ZCTA5 27936,381,6937,-6556,692,53.3,692,0,0,0,17471,-16779
ZCTA5 27937,1239,21121,-19882,3468,40.9,1648,124,1378,0.397347174,52612,-49144
ZCTA5 27938,651,4887,-4236,1653,54.2,678,4,781,0.472474289,11601,-9948
ZCTA5 27939,1168,1848,-680,2666,48.3,2474,26,73,0.027381845,4856,-2190
ZCTA5 27941,243,3778,-3535,388,62.3,365,0,19,0.048969072,9866,-9478
ZCTA5 27942,259,1059,-800,537,57.6,270,0,253,0.47113594,3463,-2926
ZCTA5 27943,243,213,30,552,53.2,541,0,0,0,557,-5
ZCTA5 27944,5059,5384,-325,11293,50.8,8021,79,2700,0.23908616,16999,-5706
ZCTA5 27946,630,5742,-5112,1250,52.2,979,0,254,0.2032,14701,-13451
ZCTA5 27947,445,10139,-9694,1262,44,1150,0,37,0.029318542,27095,-25833
ZCTA5 27948,5365,156,5209,12154,47.5,10807,66,219,0.018018759,349,11805
ZCTA5 27949,3288,144,3144,7887,55,7205,32,80,0.010143274,450,7437
ZCTA5 27950,817,4403,-3586,1899,39.8,1861,4,0,0,11493,-9594
ZCTA5 27953,385,9704,-9319,742,47.6,705,0,0,0,25118,-24376
ZCTA5 27954,2742,4146,-1404,7079,39.9,5533,48,978,0.138155107,9851,-2772
ZCTA5 27956,47,1889,-1842,124,35.5,73,0,29,0.233870968,4713,-4589
ZCTA5 27957,555,2639,-2084,1070,58.2,514,0,530,0.495327103,6945,-5875
ZCTA5 27958,4106,3902,204,11912,38.6,10531,145,749,0.06287777,10901,1011
ZCTA5 27959,1521,1684,-163,3102,55.6,2921,33,25,0.008059317,4373,-1271
ZCTA5 27960,352,68,284,810,46.4,709,0,2,0.002469136,369,441
ZCTA5 27962,3018,630,2388,7053,42.1,3413,0,3511,0.497802354,1666,5387
ZCTA5 27964,283,1014,-731,772,41.5,615,0,0,0,2895,-2123
ZCTA5 27965,221,4728,-4507,555,37.2,378,0,54,0.097297297,12629,-12074
ZCTA5 27966,361,300,61,1041,29.8,831,0,0,0,1478,-437
ZCTA5 27967,268,12018,-11750,538,71.2,145,0,382,0.710037175,32928,-32390
ZCTA5 27968,99,1234,-1135,135,59.7,76,0,46,0.340740741,3779,-3644
ZCTA5 27969,69,71,-2,175,28.8,88,0,87,0.497142857,316,-141
ZCTA5 27970,1320,1524,-204,2962,48.8,1016,0,1568,0.529372046,3866,-904
ZCTA5 27972,76,9391,-9315,192,35.7,192,0,0,0,26233,-26041
ZCTA5 27973,520,1776,-1256,1169,48.5,1030,0,91,0.077844311,5036,-3867
ZCTA5 27974,320,1110,-790,814,43.8,532,100,123,0.151105651,3079,-2265
ZCTA5 27976,1519,13588,-12069,4714,42.7,3738,36,644,0.13661434,39058,-34344
ZCTA5 27978,98,4766,-4668,298,42.8,259,0,0,0,16183,-15885
ZCTA5 27979,333,474,-141,703,52.4,568,0,120,0.170697013,1516,-813
ZCTA5 27980,827,5401,-4574,1800,51.1,1503,3,265,0.147222222,15767,-13967
ZCTA5 27981,719,6523,-5804,1936,37.2,1841,0,0,0,16839,-14903
ZCTA5 27982,13,1800,-1787,37,57.7,37,0,0,0,5226,-5189
ZCTA5 27983,2987,58,2929,8303,45.2,2789,127,5055,0.608816091,135,8168
ZCTA5 27985,95,803,-708,251,40.3,70,0,130,0.517928287,2418,-2167
ZCTA5 27986,442,2264,-1822,2134,41.1,800,22,1142,0.535145267,6602,-4468
ZCTA5 28001,10512,4045,6467,25941,42.3,20190,441,4081,0.157318531,12586,13355
ZCTA5 28006,483,891,-408,1146,47.8,1040,35,41,0.035776614,2431,-1285
ZCTA5 28007,337,6781,-6444,897,49.9,250,0,647,0.7212932,15382,-14485
ZCTA5 28009,410,36,374,1107,43.3,724,0,341,0.308039747,92,1015
ZCTA5 28012,9973,12455,-2482,25605,38.6,21068,828,2248,0.087795352,38377,-12772
ZCTA5 28016,5100,4259,841,13481,43.8,11624,112,963,0.07143387,13660,-179
ZCTA5 28017,0,10367,-10367,602,19.9,520,8,48,0.079734219,26181,-25579
ZCTA5 28018,1855,2799,-944,4243,50.3,4116,6,83,0.019561631,7548,-3305
ZCTA5 28019,0,2559,-2559,0,-,0,0,0,#DIV/0!,6828,-6828
ZCTA5 28020,754,4113,-3359,2693,32,2493,112,60,0.022279985,12060,-9367
ZCTA5 28021,5501,1108,4393,14267,39.9,12959,167,746,0.052288498,2613,11654
ZCTA5 28023,6097,1798,4299,15927,38.6,13280,54,1061,0.066616437,5984,9943
ZCTA5 28024,0,6546,-6546,0,-,0,0,0,#DIV/0!,14750,-14750
ZCTA5 28025,19802,7897,11905,55265,39.2,37364,470,12289,0.222364969,21122,34143
ZCTA5 28027,26077,1994,24083,76653,37.3,48515,5769,14509,0.189281568,5602,71051
ZCTA5 28031,12479,531,11948,29698,44.6,25049,661,1956,0.065863021,988,28710
ZCTA5 28032,1407,588,819,3073,41.6,2559,130,204,0.06638464,1607,1466
ZCTA5 28033,1239,2275,-1036,2710,42.6,2604,0,84,0.03099631,5653,-2943
ZCTA5 28034,7011,869,6142,18436,40.8,14100,157,2856,0.154914298,2230,16206
ZCTA5 28036,7435,1018,6417,21458,39.5,18075,422,1416,0.065989375,2951,18507
ZCTA5 28037,9315,2795,6520,22995,46.5,21856,129,368,0.016003479,7024,15971
ZCTA5 28039,11,779,-768,17,65.8,0,0,17,1,2172,-2155
ZCTA5 28040,2876,9915,-7039,6924,46.5,6221,27,285,0.041161179,22661,-15737
ZCTA5 28041,0,15520,-15520,0,-,0,0,0,#DIV/0!,37161,-37161
ZCTA5 28042,110,11863,-11753,349,32.8,334,0,12,0.034383954,28214,-27865
ZCTA5 28043,7944,12140,-4196,20796,39.1,15765,223,2782,0.133775726,30813,-10017
ZCTA5 28052,13267,13374,-107,36012,34.7,20258,78,12132,0.336887704,31821,4191
ZCTA5 28054,16468,15358,1110,38875,38.4,24438,571,10342,0.266032154,35002,3873
ZCTA5 28056,13321,1366,11955,35032,42.4,27326,1111,4213,0.120261475,3878,31154
ZCTA5 28071,1193,550,643,2942,45.8,2867,0,6,0.002039429,1252,1690
ZCTA5 28072,271,2350,-2079,833,35.5,715,0,98,0.117647059,6490,-5657
ZCTA5 28073,2301,863,1438,6604,36.6,5903,23,595,0.090096911,2474,4130
ZCTA5 28074,0,29,-29,0,-,0,0,0,#DIV/0!,74,-74
ZCTA5 28075,6247,3921,2326,21431,37.2,14443,1997,3472,0.162008306,11807,9624
ZCTA5 28076,54,2603,-2549,175,26,0,0,175,1,6044,-5869
ZCTA5 28077,187,3267,-3080,452,30,363,23,48,0.10619469,9019,-8567
ZCTA5 28078,24667,653,24014,67234,38.8,51984,2758,7872,0.117083618,1721,65513
ZCTA5 28079,13265,2542,10723,40013,37,32032,1101,3578,0.089420938,6081,33932
ZCTA5 28080,2805,759,2046,7464,44.2,6464,214,296,0.03965702,1992,5472
ZCTA5 28081,10269,2090,8179,28874,36.7,21432,268,5464,0.189235991,4732,24142
ZCTA5 28083,9129,565,8564,25652,37.8,15254,475,6540,0.254950881,1326,24326
ZCTA5 28086,9923,1060,8863,27478,41.9,20692,248,5056,0.184001747,2505,24973
ZCTA5 28088,943,849,94,2817,39,1681,410,583,0.206957756,2210,607
ZCTA5 28089,19,674,-655,167,21,167,0,0,0,1578,-1411
ZCTA5 28090,2631,653,1978,7588,43.3,5798,56,1537,0.202556668,1587,6001
ZCTA5 28091,758,1347,-589,1787,48.1,1002,0,645,0.360940123,3341,-1554
ZCTA5 28092,16008,494,15514,40772,41.1,33355,223,3447,0.084543314,1146,39626
ZCTA5 28097,2801,6672,-3871,7066,43,6884,0,93,0.013161619,16703,-9637
ZCTA5 28098,1546,1063,483,3636,40.6,2733,54,527,0.144939494,2932,704
ZCTA5 28101,437,2569,-2132,951,41.4,898,0,53,0.05573081,6384,-5433
ZCTA5 28102,27,555,-528,65,52.9,65,0,0,0,1544,-1479
ZCTA5 28103,3994,517,3477,10490,43.6,8136,67,2065,0.196854147,1104,9386
ZCTA5 28104,11445,783,10662,33962,40.9,27302,1554,2901,0.085418998,1627,32335
ZCTA5 28105,16483,876,15607,44377,39.4,31911,3305,5476,0.123397255,2379,41998
ZCTA5 28107,2795,11739,-8944,8473,38.8,7870,119,239,0.028207247,27841,-19368
ZCTA5 28108,40,398,-358,75,57.9,35,0,40,0.533333333,982,-907
ZCTA5 28109,155,1588,-1433,665,19.7,519,0,116,0.17443609,5001,-4336
ZCTA5 28110,17949,817,17132,53631,36.6,41002,350,6390,0.119147508,1913,51718
ZCTA5 28112,9940,754,9186,27754,40,19891,159,4049,0.145888881,2118,25636
ZCTA5 28114,2821,1276,1545,8180,42.4,7440,16,233,0.028484108,3511,4669
ZCTA5 28115,15567,3537,12030,41633,38.4,34465,1157,3361,0.080729229,9719,31914
ZCTA5 28117,17736,2190,15546,45346,42.9,37933,1972,2408,0.05310281,5577,39769
ZCTA5 28119,933,3175,-2242,2160,41.1,819,0,1246,0.576851852,8180,-6020
ZCTA5 28120,9291,6904,2387,23126,41.4,17720,744,3482,0.150566462,14842,8284
ZCTA5 28124,2087,5427,-3340,6313,42.4,5215,450,459,0.072707112,11844,-5531
ZCTA5 28125,991,3754,-2763,2858,40,2773,15,0,0,10915,-8057
ZCTA5 28127,2644,839,1805,7518,47.3,5933,326,920,0.122372972,2615,4903
ZCTA5 28128,2694,3395,-701,7355,41.1,5645,322,1250,0.169952413,6927,428
ZCTA5 28129,2311,4437,-2126,5738,43.6,5261,6,294,0.051237365,11296,-5558
ZCTA5 28133,929,4222,-3293,2306,35,1913,0,347,0.150477016,8798,-6492
ZCTA5 28134,4781,2072,2709,12315,37,7112,768,2732,0.221843281,4435,7880
ZCTA5 28135,1213,2933,-1720,4668,40.6,2464,27,1774,0.380034276,6393,-1725
ZCTA5 28136,24,4085,-4061,63,53.3,63,0,0,0,9694,-9631
ZCTA5 28137,1074,7421,-6347,2975,40.6,2825,54,61,0.020504202,20387,-17412
ZCTA5 28138,3819,1874,1945,9814,42.9,9465,4,67,0.006826982,4517,5297
ZCTA5 28139,7851,2179,5672,19271,48.3,17614,11,1006,0.052202792,5458,13813
ZCTA5 28144,10254,1004,9250,26376,40.4,13632,121,10815,0.410031847,2504,23872
ZCTA5 28146,12498,8820,3678,31865,41.9,27697,254,2513,0.078863957,20797,11068
ZCTA5 28147,9032,8341,691,24648,40.8,17052,372,4238,0.171940928,21468,3180
ZCTA5 28150,10975,831,10144,26274,47.7,16878,74,7953,0.302694679,2573,23701
ZCTA5 28152,9381,626,8755,25256,39.4,18150,234,5150,0.203911942,1614,23642
ZCTA5 28159,1086,302,784,2963,37.5,1980,0,859,0.289908876,587,2376
ZCTA5 28160,1887,1686,201,3866,46.8,2497,0,1145,0.296171754,3315,551
ZCTA5 28163,1913,3878,-1965,5679,36.7,5203,0,171,0.030110935,9644,-3965
ZCTA5 28164,5875,884,4991,15371,43,13988,150,568,0.036952703,2703,12668
ZCTA5 28166,3800,5097,-1297,10536,39.3,8169,59,1973,0.187262718,11491,-955
ZCTA5 28167,955,3094,-2139,2443,54.5,1981,34,360,0.147359804,8089,-5646
ZCTA5 28168,3991,112,3879,10940,45,9861,8,359,0.032815356,251,10689
ZCTA5 28169,70,161,-91,187,44.5,180,0,7,0.037433155,365,-178
ZCTA5 28170,4279,1003,3276,10701,41,4060,178,6298,0.588543127,2312,8389
ZCTA5 28173,18899,1051,17848,60070,40.6,46138,4668,5558,0.092525387,2441,57629
ZCTA5 28174,2666,162,2504,8820,29.7,5293,131,2410,0.27324263,429,8391
ZCTA5 28202,8231,935,7296,14359,29.7,8732,938,3162,0.220210321,2686,11673
ZCTA5 28203,9821,957,8864,17358,29.6,13794,472,2165,0.124726351,2432,14926
ZCTA5 28204,5070,567,4503,8649,30.7,5768,320,2014,0.23285929,1380,7269
ZCTA5 28205,21826,194,21632,51418,33.1,25083,1997,14810,0.288031429,388,51030
ZCTA5 28206,5690,971,4719,12812,34.5,2292,221,8532,0.665938183,2411,10401
ZCTA5 28207,4134,3054,1080,9733,45.4,9286,50,132,0.013562108,7203,2530
ZCTA5 28208,15641,485,15156,40885,32.7,6681,1924,27341,0.668729363,1244,39641
ZCTA5 28209,11339,8963,2376,23339,33.8,19469,631,1305,0.055914992,25002,-1663
ZCTA5 28210,20838,0,20838,48214,34.7,33914,1429,7189,0.149106069,1851,46363
ZCTA5 28211,13019,95,12924,31581,38.2,23746,2044,4399,0.139292613,240,31341
ZCTA5 28212,16443,861,15582,45180,32.3,11180,3721,18815,0.41644533,2238,42942
ZCTA5 28213,17674,5513,12161,44553,32.9,10116,1439,22036,0.494601935,14977,29576
ZCTA5 28214,14430,17824,-3394,40619,36.7,14719,2118,18391,0.452768409,50280,-9661
ZCTA5 28215,21754,1467,20287,63548,34.3,16921,2100,33713,0.530512369,4602,58946
ZCTA5 28216,22067,2180,19887,51477,36.1,11477,2026,32437,0.630126076,5773,45704
ZCTA5 28217,11513,16365,-4852,31338,31.6,9803,2692,12831,0.40943902,43723,-12385
ZCTA5 28223,0,1532,-1532,3626,19.6,2327,239,798,0.22007722,19363,-15737
ZCTA5 28226,15871,5284,10587,38347,41.9,30835,1222,2464,0.064255352,13632,24715
ZCTA5 28227,21672,104,21568,58524,38.5,29909,2248,17965,0.306968081,164,58360
ZCTA5 28244,0,147,-147,0,-,0,0,0,#DIV/0!,338,-338
ZCTA5 28262,19395,94,19301,43664,30.1,13739,6559,19622,0.449386222,231,43433
ZCTA5 28269,29853,1867,27986,78353,36.2,25531,3134,38416,0.490293926,4969,73384
ZCTA5 28270,12623,364,12259,34583,39.4,23679,4203,4165,0.120434896,905,33678
ZCTA5 28273,16199,6519,9680,44048,32.8,15354,3062,17725,0.402401925,14149,29899
ZCTA5 28274,0,11563,-11563,636,20.1,455,12,102,0.160377358,29022,-28386
ZCTA5 28277,27899,15279,12620,71321,39.9,47325,11581,6164,0.086426158,35509,35812
ZCTA5 28278,11695,8319,3376,34272,35.8,15370,3161,11601,0.338497899,21801,12471
ZCTA5 28280,0,1289,-1289,0,-,0,0,0,#DIV/0!,2671,-2671
ZCTA5 28282,0,2443,-2443,0,-,0,0,0,#DIV/0!,6233,-6233
ZCTA5 28301,7082,1006,6076,16365,33.7,3011,144,11517,0.70375802,2733,13632
ZCTA5 28303,13628,5165,8463,29842,33.9,12844,1523,11378,0.381274713,14226,15616
ZCTA5 28304,14405,117,14288,35829,35.8,16225,974,13922,0.38856792,210,35619
ZCTA5 28305,2908,170,2738,5843,42.6,3981,138,1323,0.226424782,513,5330
ZCTA5 28306,15767,1974,13793,44230,33.7,21722,1290,14493,0.327673525,5652,38578
ZCTA5 28307,4253,169,4084,14721,23,9024,298,2534,0.172135045,404,14317
ZCTA5 28308,0,4287,-4287,505,21.9,242,12,142,0.281188119,13148,-12643
ZCTA5 28310,0,76,-76,8737,22.1,5393,109,1526,0.174659494,163,8574
ZCTA5 28311,14139,674,13465,34367,32.8,15014,837,14439,0.420141415,1688,32679
ZCTA5 28312,7670,91,7579,19654,42,11902,97,5709,0.290475221,282,19372
ZCTA5 28314,22089,4644,17445,58218,30.3,18604,2101,29401,0.505015631,11444,46774
ZCTA5 28315,5072,1494,3578,13254,36.9,9557,54,2316,0.174739701,3642,9612
ZCTA5 28318,1547,2627,-1080,3676,44.5,2945,35,257,0.069912949,7101,-3425
ZCTA5 28320,3348,151,3197,9163,44.5,7275,0,1705,0.18607443,346,8817
ZCTA5 28323,1539,140,1399,4199,36.6,2949,0,919,0.218861634,347,3852
ZCTA5 28325,183,9105,-8922,401,39.3,239,0,110,0.274314214,23896,-23495
ZCTA5 28326,7987,1669,6318,24998,29.9,15899,558,6057,0.242299384,3649,21349
ZCTA5 28327,7079,19472,-12393,18514,40.1,16032,317,1143,0.061737064,49304,-30790
ZCTA5 28328,9072,11218,-2146,25323,40,13716,224,7218,0.285037318,28895,-3572
ZCTA5 28330,139,2801,-2662,550,48.5,317,0,0,0,6743,-6193
ZCTA5 28331,16,1792,-1776,32,53,29,0,3,0.09375,3670,-3638
ZCTA5 28332,243,657,-414,745,47.7,376,33,336,0.451006711,1577,-832
ZCTA5 28333,3674,13066,-9392,10301,31.1,4471,67,4544,0.441122221,33255,-22954
ZCTA5 28334,8669,2189,6480,21745,42.2,14418,72,5033,0.231455507,5749,15996
ZCTA5 28337,3524,3548,-24,8643,41.6,4470,25,3430,0.396852945,9762,-1119
ZCTA5 28338,1566,415,1151,3914,44.7,2444,0,832,0.212570261,1045,2869
ZCTA5 28339,2620,4574,-1954,6571,43.6,4290,15,1734,0.263886775,12846,-6275
ZCTA5 28340,3561,8446,-4885,9373,44.6,2563,0,3249,0.346633949,23755,-14382
ZCTA5 28341,1181,822,359,3954,35.9,2436,0,787,0.199038948,1876,2078
ZCTA5 28342,26,178,-152,147,19,121,0,8,0.054421769,344,-197
ZCTA5 28343,602,1078,-476,1758,33.7,530,0,939,0.534129693,2581,-823
ZCTA5 28344,1379,760,619,4897,36.2,2873,2,1100,0.224627323,1795,3102
ZCTA5 28345,4387,453,3934,11336,40.7,6170,65,3982,0.351270289,1217,10119
ZCTA5 28347,431,4347,-3916,2057,30.7,732,2,1049,0.50996597,10987,-8930
ZCTA5 28348,13126,1121,12005,38367,34,21538,378,10881,0.283603096,2427,35940
ZCTA5 28349,1350,610,740,3564,44.5,2438,46,774,0.217171717,1413,2151
ZCTA5 28350,107,690,-583,299,49.8,294,0,3,0.010033445,1551,-1252
ZCTA5 28351,1727,13965,-12238,4593,40.3,2723,0,1130,0.246026562,36639,-32046
ZCTA5 28352,8453,893,7560,24497,38.4,9675,331,9880,0.403314692,1950,22547
ZCTA5 28355,0,596,-596,0,-,0,0,0,#DIV/0!,1523,-1523
ZCTA5 28356,2085,142,1943,5110,44.7,3498,75,1001,0.195890411,389,4721
ZCTA5 28357,1025,53,972,2398,40.2,1161,0,408,0.170141785,99,2299
ZCTA5 28358,12576,7326,5250,34419,35.8,13450,446,10898,0.316627444,20232,14187
ZCTA5 28359,0,290,-290,852,39.8,290,7,448,0.525821596,583,269
ZCTA5 28360,4696,2054,2642,14426,35.2,2399,56,1360,0.094274227,5996,8430
ZCTA5 28362,20,1388,-1368,43,63.8,6,0,33,0.76744186,3704,-3661
ZCTA5 28363,389,2211,-1822,977,44.8,572,0,348,0.356192426,5950,-4973
ZCTA5 28364,4860,603,4257,13504,37,1064,101,2700,0.199940758,1493,12011
ZCTA5 28365,5868,4365,1503,14844,41,10498,166,2907,0.195836702,12019,2825
ZCTA5 28366,1942,1966,-24,5195,40.2,3828,83,709,0.136477382,5020,175
ZCTA5 28367,50,2445,-2395,190,33.1,117,0,33,0.173684211,6090,-5900
ZCTA5 28368,42,1516,-1474,132,56.7,132,0,0,0,3165,-3033
ZCTA5 28369,845,578,267,2193,43.7,963,0,750,0.341997264,1266,927
ZCTA5 28371,2044,18886,-16842,5253,37.3,2812,17,1296,0.246716162,47037,-41784
ZCTA5 28372,3909,291,3618,12553,28.1,1113,80,1718,0.136859715,647,11906
ZCTA5 28373,1043,59,984,2544,40.2,1961,0,365,0.143474843,140,2404
ZCTA5 28374,8517,363,8154,18642,57.7,16888,376,452,0.024246326,1082,17560
ZCTA5 28375,64,4370,-4306,217,34.4,139,0,21,0.096774194,11941,-11724
ZCTA5 28376,14450,2641,11809,43520,32.6,19411,724,15833,0.363809743,6730,36790
ZCTA5 28377,4133,37,4096,11670,35.6,2022,62,2635,0.225792631,98,11572
ZCTA5 28378,40,1716,-1676,62,63.4,0,0,41,0.661290323,4072,-4010
ZCTA5 28379,9524,21144,-11620,24624,40.1,15111,232,7860,0.31920078,55894,-31270
ZCTA5 28382,2652,4239,-1587,7480,40.7,4755,9,1399,0.187032086,9275,-1795
ZCTA5 28383,2658,10130,-7472,6839,40.3,749,8,1559,0.227957304,26406,-19567
ZCTA5 28384,3376,8469,-5093,9605,39.7,4710,0,1785,0.185840708,21065,-11460
ZCTA5 28385,803,707,96,1923,50.9,940,0,649,0.3374935,2170,-247
ZCTA5 28386,1954,13,1941,5234,36.9,820,3,497,0.094956057,13,5221
ZCTA5 28387,7120,252,6868,15158,40,11110,169,2652,0.174957118,542,14616
ZCTA5 28390,8774,1048,7726,24726,29.8,11394,480,8940,0.361562727,2744,21982
ZCTA5 28391,2256,83,2173,6289,37.4,4689,34,1096,0.174272539,285,6004
ZCTA5 28392,778,179,599,1829,49.4,1138,0,689,0.376708584,567,1262
ZCTA5 28393,751,191,560,2024,45.3,1085,1,639,0.315711462,407,1617
ZCTA5 28394,1906,1382,524,5065,37,3687,0,605,0.119447187,3482,1583
ZCTA5 28395,822,1225,-403,2091,42.8,1645,3,255,0.12195122,3148,-1057
ZCTA5 28396,890,206,684,2277,49.7,1213,23,747,0.328063241,658,1619
ZCTA5 28398,2620,12,2608,6663,38.1,3156,3,2682,0.402521387,35,6628
ZCTA5 28399,642,2200,-1558,1645,45.8,814,0,503,0.305775076,5440,-3795
ZCTA5 28401,10529,2782,7747,22167,40,12521,155,7455,0.336310732,6312,15855
ZCTA5 28403,18092,1528,16564,39745,30.2,31876,781,5287,0.133023022,3338,36407
ZCTA5 28405,14638,12884,1754,34044,39.3,24782,220,6807,0.199947127,33547,497
ZCTA5 28409,13476,1906,11570,34273,42.4,30604,453,1264,0.036880343,5307,28966
ZCTA5 28411,15156,916,14240,35903,41.4,30527,930,2451,0.068267276,2277,33626
ZCTA5 28412,17972,9447,8525,40407,39.6,33195,373,3366,0.083302398,25679,14728
ZCTA5 28420,1197,490,707,3182,44.7,2529,68,306,0.096165933,1115,2067
ZCTA5 28421,599,772,-173,2020,47.2,1203,0,393,0.194554455,1788,232
ZCTA5 28422,3082,1155,1927,8002,56.7,6353,61,1172,0.146463384,2753,5249
ZCTA5 28423,889,677,212,2631,46,709,6,692,0.263017864,1561,1070
ZCTA5 28424,28,725,-697,41,73.4,16,0,25,0.609756098,1806,-1765
ZCTA5 28425,3821,3872,-51,10424,43.6,6419,4,2838,0.272256332,9172,1252
ZCTA5 28428,3092,1626,1466,6754,50.8,6550,10,8,0.001184483,3671,3083
ZCTA5 28429,3366,638,2728,8509,45.1,5912,20,1693,0.198965801,1508,7001
ZCTA5 28430,807,3710,-2903,1961,40,1628,0,301,0.153493116,8163,-6202
ZCTA5 28431,2716,5292,-2576,6002,48.2,3779,65,1890,0.314895035,12790,-6788
ZCTA5 28432,534,981,-447,1370,45.7,1190,0,180,0.131386861,2340,-970
ZCTA5 28433,1617,1625,-8,4449,38.9,1385,0,3003,0.674983142,4376,73
ZCTA5 28434,300,170,130,614,60.1,199,0,150,0.244299674,442,172
ZCTA5 28435,792,8196,-7404,2076,42.6,1276,101,446,0.214836224,20637,-18561
ZCTA5 28436,520,2795,-2275,1731,33.3,1193,0,495,0.285961872,6712,-4981
ZCTA5 28438,518,108,410,1282,57.9,1013,0,210,0.163806552,178,1104
ZCTA5 28439,365,221,144,1003,44.6,673,0,315,0.314057827,540,463
ZCTA5 28441,1102,808,294,3552,27.8,1969,0,1093,0.307713964,1776,1776
ZCTA5 28442,567,5241,-4674,1464,53.4,884,0,326,0.222677596,12857,-11393
ZCTA5 28443,8930,7862,1068,24427,41.9,21584,237,1121,0.045891841,18081,6346
ZCTA5 28444,872,3703,-2831,2233,45.4,1146,0,838,0.375279893,9243,-7010
ZCTA5 28445,3815,6760,-2945,9162,38.9,8188,50,310,0.033835407,16680,-7518
ZCTA5 28447,451,10230,-9779,1673,42.4,972,0,694,0.41482367,24336,-22663
ZCTA5 28448,346,7316,-6970,721,46.4,399,0,133,0.184466019,16872,-16151
ZCTA5 28449,899,839,60,2176,54.5,2106,5,0,0,2044,132
ZCTA5 28450,817,177,640,2056,52.2,1418,9,208,0.101167315,499,1557
ZCTA5 28451,16081,2672,13409,38490,45.1,29242,240,5360,0.13925695,7917,30573
ZCTA5 28452,142,71,71,427,44.2,262,0,131,0.306791569,147,280
ZCTA5 28453,1409,4548,-3139,3811,35.9,2315,1,992,0.260299134,10042,-6231
ZCTA5 28454,1019,2918,-1899,2490,33.7,1485,0,946,0.379919679,6714,-4224
ZCTA5 28455,893,3458,-2565,2384,32,1793,0,207,0.086828859,10809,-8425
ZCTA5 28456,1462,12,1450,3824,44.5,1426,0,2150,0.562238494,17,3807
ZCTA5 28457,3996,1589,2407,10021,37.9,7103,8,1130,0.112763197,3579,6442
ZCTA5 28458,2114,1114,1000,5636,35.9,2226,16,2048,0.363378282,2682,2954
ZCTA5 28460,4755,4036,719,10543,32.1,9316,206,69,0.006544627,9783,760
ZCTA5 28461,9886,3009,6877,22024,61.3,19756,109,932,0.042317472,7498,14526
ZCTA5 28462,5084,6385,-1301,12051,52,10848,78,555,0.046054269,15365,-3314
ZCTA5 28463,2490,29,2461,7443,44.6,4475,22,2387,0.320704017,63,7380
ZCTA5 28464,877,12350,-11473,2490,34.3,1002,0,1053,0.422891566,26707,-24217
ZCTA5 28465,3572,95,3477,7768,59.6,7433,30,36,0.004634398,188,7580
ZCTA5 28466,3588,390,3198,7689,47,6115,0,1128,0.146703082,951,6738
ZCTA5 28467,5913,9334,-3421,12110,64.7,10869,55,571,0.047151115,20912,-8802
ZCTA5 28468,2407,590,1817,4729,62.8,4324,42,157,0.033199408,1747,2982
ZCTA5 28469,3642,1859,1783,7563,62.7,6950,52,246,0.032526775,3637,3926
ZCTA5 28470,4317,1067,3250,10577,45.2,7513,64,1947,0.184078661,2727,7850
ZCTA5 28472,6712,836,5876,18272,39.7,10964,155,5501,0.301061734,1809,16463
ZCTA5 28478,2023,260,1763,5115,44.7,3553,0,1315,0.257086999,478,4637
ZCTA5 28479,2312,1161,1151,6568,39,5169,3,701,0.106729598,2355,4213
ZCTA5 28480,1260,931,329,2655,47.3,2542,6,38,0.014312618,2603,52
ZCTA5 28501,7623,4816,2807,18365,40.7,4561,31,12081,0.657827389,11806,6559
ZCTA5 28504,8625,9,8616,20166,45.7,12996,136,5985,0.296786671,38,20128
ZCTA5 28508,763,1487,-724,2016,34.9,1639,0,145,0.071924603,3029,-1013
ZCTA5 28509,0,12128,-12128,0,-,0,0,0,#DIV/0!,31275,-31275
ZCTA5 28510,682,4583,-3901,1481,55.7,1211,9,192,0.129642134,11516,-10035
ZCTA5 28511,264,2975,-2711,653,49.2,620,0,0,0,7874,-7221
ZCTA5 28512,1666,1673,-7,3320,61.6,3239,0,42,0.012650602,4171,-851
ZCTA5 28513,3952,166,3786,9441,42.9,5504,82,2691,0.285033365,333,9108
ZCTA5 28515,1152,2936,-1784,3097,49.9,1525,21,1417,0.457539554,6865,-3768
ZCTA5 28516,5263,2636,2627,11365,53.6,9099,18,1591,0.139991201,7157,4208
ZCTA5 28518,2884,2623,261,7340,41,5111,0,1603,0.218392371,6780,560
ZCTA5 28519,161,1198,-1037,431,31.3,399,0,32,0.07424594,2641,-2210
ZCTA5 28520,163,709,-546,248,62.3,248,0,0,0,1370,-1122
ZCTA5 28521,648,3120,-2472,1585,47.5,1462,0,85,0.05362776,7349,-5764
ZCTA5 28523,1022,3244,-2222,2568,41.5,1838,0,576,0.224299065,8261,-5693
ZCTA5 28524,92,444,-352,223,40.3,223,0,0,0,1112,-889
ZCTA5 28525,1227,1076,151,2687,46.8,2187,13,374,0.139188686,2452,235
ZCTA5 28526,1194,499,695,2738,44.5,1539,0,1006,0.367421476,1113,1625
ZCTA5 28527,554,178,376,1075,51.9,1023,0,52,0.048372093,355,720
ZCTA5 28528,233,3701,-3468,599,50.2,580,0,0,0,10125,-9526
ZCTA5 28529,760,4139,-3379,1723,50.9,1488,0,124,0.071967499,10987,-9264
ZCTA5 28530,3114,6898,-3784,6454,44.4,3553,231,2516,0.389835761,16472,-10018
ZCTA5 28531,516,409,107,1250,53.8,1205,8,33,0.0264,806,444
ZCTA5 28532,7544,3073,4471,20279,27.8,13168,614,4097,0.202031658,6680,13599
ZCTA5 28533,0,515,-515,3298,21.7,2383,124,374,0.113402062,1048,2250
ZCTA5 28537,20,3413,-3393,39,67.9,39,0,0,0,7928,-7889
ZCTA5 28538,855,9448,-8593,2326,38.4,1159,20,923,0.396818573,20599,-18273
ZCTA5 28539,6910,7624,-714,16872,33.2,14276,195,1261,0.074739213,18381,-1509
ZCTA5 28540,18704,2142,16562,51253,29.3,35303,978,8187,0.159736991,4709,46544
ZCTA5 28542,74,1220,-1146,3056,21.1,2202,148,324,0.106020942,3323,-267
ZCTA5 28543,1891,6340,-4449,6946,22,4667,125,1539,0.221566369,15161,-8215
ZCTA5 28544,2364,13228,-10864,5691,24.9,2972,94,1214,0.213319276,31708,-26017
ZCTA5 28546,18171,6706,11465,49170,27.3,31093,1366,10781,0.219259711,14101,35069
ZCTA5 28547,1810,13452,-11642,19917,21.1,14057,561,2157,0.108299443,29666,-9749
ZCTA5 28551,5259,8525,-3266,14299,38.8,8704,23,3787,0.264843695,20408,-6109
ZCTA5 28552,87,8435,-8348,258,36.4,258,0,0,0,17798,-17540
ZCTA5 28553,180,15694,-15514,381,56.8,381,0,0,0,37736,-37355
ZCTA5 28554,47,2173,-2126,68,61.5,44,0,24,0.352941176,5048,-4980
ZCTA5 28555,2095,491,1604,5105,46.6,3656,4,1180,0.231145935,1386,3719
ZCTA5 28556,388,3542,-3154,761,56.7,728,0,0,0,8504,-7743
ZCTA5 28557,7223,1077,6146,14880,48.6,12766,365,649,0.043615591,2943,11937
ZCTA5 28560,11276,7873,3403,29097,39.5,20378,1536,5301,0.18218373,19057,10040
ZCTA5 28562,16453,405,16048,37447,47.1,27258,436,8360,0.223248858,761,36686
ZCTA5 28570,8481,685,7796,20857,44.4,18568,405,478,0.022917965,1825,19032
ZCTA5 28571,1219,2396,-1177,2527,64.4,2189,12,266,0.105263158,6766,-4239
ZCTA5 28572,2690,3667,-977,6680,36.7,5605,0,421,0.063023952,9897,-3217
ZCTA5 28573,721,943,-222,1630,50,979,0,494,0.303067485,2346,-716
ZCTA5 28574,6765,4122,2643,19231,29.5,15307,167,1767,0.091882897,11877,7354
ZCTA5 28575,75,639,-564,201,45.6,190,11,0,0,1808,-1607
ZCTA5 28577,83,559,-476,287,57,248,0,34,0.118466899,1425,-1138
ZCTA5 28578,1754,5821,-4067,5703,29.3,4418,0,197,0.034543223,15771,-10068
ZCTA5 28579,330,1355,-1025,826,51.5,814,0,12,0.014527845,3663,-2837
ZCTA5 28580,3832,9144,-5312,12228,41.5,6312,9,4342,0.355086686,22542,-10314
ZCTA5 28581,52,946,-894,136,52.3,136,0,0,0,2241,-2105
ZCTA5 28582,697,597,100,1750,48.4,1646,0,90,0.051428571,1449,301
ZCTA5 28584,5864,1653,4211,14231,42.8,13038,197,266,0.018691589,4455,9776
ZCTA5 28585,1470,5306,-3836,3714,52,2139,118,1100,0.296176629,12227,-8513
ZCTA5 28586,2925,7049,-4124,7181,40.5,4605,0,2293,0.319314859,17939,-10758
ZCTA5 28587,107,254,-147,231,57.5,123,0,103,0.445887446,725,-494
ZCTA5 28589,17,903,-886,38,-,0,0,0,0,2736,-2698
ZCTA5 28590,10234,1617,8617,24763,38.9,15486,760,7308,0.295117716,4460,20303
ZCTA5 28594,1764,3305,-1541,3844,57.3,3519,0,14,0.00364204,10149,-6305
ZCTA5 28601,21040,1822,19218,52423,41,40869,2467,4154,0.079240028,5578,46845
ZCTA5 28602,11579,2062,9517,29463,39.2,20697,2159,3835,0.130163256,5393,24070
ZCTA5 28604,3044,7955,-4911,7697,40.7,7037,76,108,0.014031441,20649,-12952
ZCTA5 28605,1840,105,1735,3792,49,3566,0,41,0.010812236,340,3452
ZCTA5 28606,661,1588,-927,1704,49.2,1623,0,58,0.034037559,3902,-2198
ZCTA5 28607,11820,1796,10024,33813,24,31134,583,802,0.023718688,5026,28787
ZCTA5 28609,2425,280,2145,5630,47.3,5168,0,337,0.059857904,1434,4196
ZCTA5 28610,4231,818,3413,11076,41.5,8790,638,1016,0.091729866,2520,8556
ZCTA5 28611,164,6901,-6737,251,68.5,236,0,0,0,18340,-18089
ZCTA5 28612,4759,3466,1293,11954,43.8,10828,671,210,0.017567341,9749,2205
ZCTA5 28613,9098,1739,7359,23355,39.5,17490,1820,576,0.024662813,4419,18936
ZCTA5 28615,832,802,30,1723,53.4,1635,0,0,0,2399,-676
ZCTA5 28616,21,1709,-1688,152,17.4,114,0,38,0.25,4843,-4691
ZCTA5 28617,825,2210,-1385,1821,40.9,1808,10,3,0.001647446,6111,-4290
ZCTA5 28618,965,5100,-4135,2562,39.6,2443,22,4,0.00156128,14471,-11909
ZCTA5 28619,184,38,146,428,53.5,400,0,13,0.030373832,107,321
ZCTA5 28621,4017,11976,-7959,9842,42.5,8586,99,427,0.043385491,33162,-23320
ZCTA5 28622,1179,288,891,2605,49.8,2507,5,13,0.004990403,708,1897
ZCTA5 28623,642,3923,-3281,1703,42.6,1560,0,0,0,10691,-8988
ZCTA5 28624,591,1961,-1370,1412,57.9,1396,0,16,0.011331445,5322,-3910
ZCTA5 28625,14956,5806,9150,37480,41.8,29501,1020,4762,0.127054429,14541,22939
ZCTA5 28626,1279,18423,-17144,2948,48.3,2901,0,0,0,48560,-45612
ZCTA5 28627,616,15114,-14498,1248,45.9,1242,0,0,0,40799,-39551
ZCTA5 28628,18,119,-101,49,50.3,49,0,0,0,246,-197
ZCTA5 28629,0,1202,-1202,0,-,0,0,0,#DIV/0!,3268,-3268
ZCTA5 28630,8033,5645,2388,20808,44.6,18740,180,441,0.021193772,15035,5773
ZCTA5 28631,331,79,252,1044,29.5,1039,0,0,0,116,928
ZCTA5 28634,1764,1126,638,4779,39.5,3831,31,543,0.113622097,3036,1743
ZCTA5 28635,1342,594,748,3240,49.9,2780,0,28,0.008641975,1139,2101
ZCTA5 28636,1655,274,1381,4133,45.7,3863,0,129,0.031212195,620,3513
ZCTA5 28637,675,1065,-390,1572,50.4,1339,73,81,0.051526718,3263,-1691
ZCTA5 28638,4470,6655,-2185,11838,39.8,10980,13,116,0.009798953,18351,-6513
ZCTA5 28640,2075,598,1477,4680,51.7,4429,14,98,0.020940171,1638,3042
ZCTA5 28641,23,459,-436,48,52.3,41,0,7,0.145833333,1075,-1027
ZCTA5 28642,2327,1196,1131,5293,46.3,4533,31,526,0.099376535,2872,2421
ZCTA5 28643,1626,7479,-5853,4231,44.5,4047,67,0,0,20928,-16697
ZCTA5 28644,616,540,76,1185,52.9,1148,0,0,0,1783,-598
ZCTA5 28645,18366,1846,16520,46214,45.6,39414,169,2808,0.060760808,4624,41590
ZCTA5 28646,175,639,-464,414,42.5,414,0,0,0,1757,-1343
ZCTA5 28649,409,804,-395,1183,57.2,1183,0,0,0,2366,-1183
ZCTA5 28650,4499,11203,-6704,11662,45.1,10560,35,254,0.021780141,29029,-17367
ZCTA5 28651,2409,0,2409,5717,47.9,5573,0,24,0.004198006,1209,4508
ZCTA5 28652,61,6385,-6324,154,29.6,154,0,0,0,16223,-16069
ZCTA5 28653,21,28,-7,21,-,21,0,0,0,46,-25
ZCTA5 28654,1344,2632,-1288,2850,62.3,2630,124,67,0.023508772,7181,-4331
ZCTA5 28655,21382,1025,20357,55752,43.2,44420,1389,4847,0.086938585,2311,53441
ZCTA5 28657,3614,862,2752,8226,50.5,7955,6,1,0.000121566,2214,6012
ZCTA5 28658,10524,3171,7353,26578,42,20339,973,2113,0.079501844,7851,18727
ZCTA5 28659,8849,1804,7045,21601,41.7,18720,64,1222,0.056571455,5411,16190
ZCTA5 28660,879,1307,-428,2232,45.4,1998,0,185,0.082885305,3833,-1601
ZCTA5 28662,30,2920,-2890,52,-,52,0,0,0,7067,-7015
ZCTA5 28663,298,419,-121,677,51.6,665,0,2,0.00295421,1240,-563
ZCTA5 28664,74,3352,-3278,167,40.9,167,0,0,0,8505,-8338
ZCTA5 28665,1098,1085,13,2656,44.9,2615,0,12,0.004518072,2760,-104
ZCTA5 28666,55,3567,-3512,90,77.4,90,0,0,0,10714,-10624
ZCTA5 28667,88,1848,-1760,200,42,140,23,0,0,5111,-4911
ZCTA5 28668,97,339,-242,180,60.4,176,0,2,0.011111111,664,-484
ZCTA5 28669,1263,641,622,2723,49.3,2068,0,424,0.155710613,1854,869
ZCTA5 28670,972,0,972,2965,39,2681,52,18,0.006070826,0,2965
ZCTA5 28671,121,2515,-2394,376,63.7,329,0,25,0.066489362,6766,-6390
ZCTA5 28672,64,15574,-15510,152,49.4,152,0,0,0,40679,-40527
ZCTA5 28673,2839,437,2402,6425,52.8,6232,0,159,0.024747082,1716,4709
ZCTA5 28675,2849,5709,-2860,6527,51.2,6003,58,184,0.028190593,16149,-9622
ZCTA5 28676,1295,10881,-9586,3121,51.8,3033,10,70,0.022428709,29769,-26648
ZCTA5 28677,13841,3328,10513,35231,41,22971,242,8502,0.241321563,8701,26530
ZCTA5 28678,2171,4433,-2262,5706,39.8,4700,0,168,0.029442692,11860,-6154
ZCTA5 28679,891,913,-22,2313,42.2,2058,0,0,0,3338,-1025
ZCTA5 28681,9420,895,8525,26297,44.2,22987,201,1702,0.064722212,2195,24102
ZCTA5 28682,540,1694,-1154,1342,48.8,1342,0,0,0,4054,-2712
ZCTA5 28683,570,393,177,1355,48.2,1314,0,0,0,924,431
ZCTA5 28684,859,1059,-200,1703,51.7,1688,1,0,0,2659,-956
ZCTA5 28685,746,10021,-9275,1984,40.8,1819,14,0,0,21985,-20001
ZCTA5 28689,763,8248,-7485,2685,40.5,2087,0,54,0.020111732,20480,-17795
ZCTA5 28690,3928,3494,434,9211,47.7,8304,382,244,0.026490066,8627,584
ZCTA5 28692,2102,208,1894,4456,45.4,4222,67,132,0.02962298,523,3933
ZCTA5 28693,655,1383,-728,1515,47.2,1486,0,0,0,3201,-1686
ZCTA5 28694,3148,5514,-2366,6861,52.2,6416,45,151,0.022008454,14409,-7548
ZCTA5 28697,5771,8011,-2240,13766,42.8,11975,121,586,0.042568647,20116,-6350
ZCTA5 28698,1072,104,968,2594,49.4,2560,0,0,0,179,2415
ZCTA5 28701,1494,15296,-13802,4993,40.8,4767,0,43,0.008612057,40870,-35877
ZCTA5 28702,249,8251,-8002,630,41.9,630,0,0,0,20869,-20239
ZCTA5 28704,7799,11637,-3838,21608,40.5,17469,848,1667,0.077147353,26321,-4713
ZCTA5 28705,2921,7831,-4910,6871,47.6,6548,21,33,0.004802794,19052,-12181
ZCTA5 28707,227,106,121,580,54.8,575,0,5,0.00862069,9875,-9295
ZCTA5 28708,110,0,110,168,35.8,168,0,0,0,860,-692
ZCTA5 28709,1075,12584,-11509,2588,45.4,2515,3,0,0,32098,-29510
ZCTA5 28710,0,16302,-16302,0,-,0,0,0,#DIV/0!,40528,-40528
ZCTA5 28711,5540,11812,-6272,12639,55.7,11650,12,257,0.020333887,30158,-17519
ZCTA5 28712,8588,20271,-11683,19777,54.3,17572,6,1255,0.063457552,51255,-31478
ZCTA5 28713,3390,0,3390,8661,46.4,7526,49,35,0.004041104,1050,7611
ZCTA5 28714,6775,14988,-8213,16441,47.1,15532,62,108,0.006568943,43109,-26668
ZCTA5 28715,10234,11408,-1174,27885,42,25854,200,242,0.008678501,29851,-1966
ZCTA5 28716,7432,6956,476,17701,43.9,16561,105,156,0.008813061,17569,132
ZCTA5 28717,637,8696,-8059,1253,60.1,1174,0,0,0,25602,-24349
ZCTA5 28718,192,6276,-6084,393,48.9,393,0,0,0,15703,-15310
ZCTA5 28719,2796,8412,-5616,6901,37.7,930,138,70,0.010143457,19756,-12855
ZCTA5 28720,72,8090,-8018,149,47.8,147,0,0,0,22144,-21995
ZCTA5 28721,4365,220,4145,9890,46.2,9160,113,56,0.005662285,526,9364
ZCTA5 28722,2759,963,1796,6320,48.4,5912,15,223,0.03528481,2326,3994
ZCTA5 28723,3208,3330,-122,10764,21.9,9418,91,686,0.063730955,9051,1713
ZCTA5 28725,44,4997,-4953,83,43.5,65,0,0,0,13692,-13609
ZCTA5 28726,1311,80,1231,3904,29.2,3200,84,285,0.073002049,188,3716
ZCTA5 28729,1471,5116,-3645,3281,55.9,2893,66,5,0.001523926,14924,-11643
ZCTA5 28730,3140,87,3053,8532,50.3,7947,0,308,0.036099391,215,8317
ZCTA5 28731,3525,3083,442,8779,52.3,8223,13,89,0.010137829,7904,875
ZCTA5 28732,7084,52,7032,18275,42.8,16434,289,731,0.04,152,18123
ZCTA5 28733,45,1041,-996,73,61.1,64,0,0,0,2605,-2532
ZCTA5 28734,13268,238,13030,28676,48.1,26269,196,414,0.01443716,569,28107
ZCTA5 28735,121,4861,-4740,224,49.2,224,0,0,0,12722,-12498
ZCTA5 28736,444,1764,-1320,878,57.5,670,0,0,0,6019,-5141
ZCTA5 28739,9309,11,9298,21454,55.7,19460,172,493,0.022979398,11,21443
ZCTA5 28740,755,7772,-7017,1638,59,1590,1,0,0,20567,-18929
ZCTA5 28741,2163,7411,-5248,3917,61.5,3763,8,56,0.014296656,19285,-15368
ZCTA5 28742,1258,59,1199,3078,48.9,2993,0,12,0.003898635,102,2976
ZCTA5 28743,970,10917,-9947,2424,48.6,2378,0,26,0.010726073,29529,-27105
ZCTA5 28745,147,649,-502,394,57.7,352,0,0,0,1425,-1031
ZCTA5 28746,1195,1629,-434,2652,58.8,2437,8,125,0.047134238,3859,-1207
ZCTA5 28747,863,334,529,2198,40,2077,0,0,0,867,1331
ZCTA5 28748,4242,3166,1076,11885,38.7,10865,13,428,0.03601178,7769,4116
ZCTA5 28749,48,8189,-8141,111,77.4,111,0,0,0,20438,-20327
ZCTA5 28751,1791,286,1505,3964,57.6,3538,19,20,0.005045409,575,3389
ZCTA5 28752,12345,3607,8738,30989,41.5,27215,470,1227,0.039594695,9739,21250
ZCTA5 28753,3904,14,3890,9449,45.6,8954,28,44,0.004656577,14,9435
ZCTA5 28754,3461,4945,-1484,9655,41,8898,33,224,0.023200414,14241,-4586
ZCTA5 28755,0,282,-282,0,-,0,0,0,#DIV/0!,661,-661
ZCTA5 28756,1520,1791,-271,3657,47.7,3011,97,155,0.042384468,4830,-1173
ZCTA5 28757,2,59,-57,343,20.2,240,19,42,0.12244898,158,185
ZCTA5 28758,0,1271,-1271,0,-,0,0,0,#DIV/0!,3239,-3239
ZCTA5 28759,3065,39,3026,7543,46.4,6717,235,265,0.03513191,143,7400
ZCTA5 28761,2938,2338,600,6954,49.3,6620,0,184,0.026459592,6609,345
ZCTA5 28762,2871,152,2719,6523,52.7,6057,0,45,0.006898666,532,5991
ZCTA5 28763,1081,67,1014,2611,43.4,2512,0,49,0.018766756,120,2491
ZCTA5 28766,448,7935,-7487,1101,48.8,897,0,121,0.109900091,19267,-18166
ZCTA5 28768,2950,1680,1270,7302,52.2,6900,8,102,0.013968776,4066,3236
ZCTA5 28770,0,2592,-2592,0,-,0,0,0,#DIV/0!,6664,-6664
ZCTA5 28771,2917,5405,-2488,7476,46.7,6380,0,14,0.001872659,13962,-6486
ZCTA5 28772,538,4628,-4090,1057,46.1,1022,0,0,0,10814,-9757
ZCTA5 28773,1227,8947,-7720,2976,57.6,2883,8,47,0.015793011,22115,-19139
ZCTA5 28774,683,297,386,1225,63.8,1141,17,0,0,1370,-145
ZCTA5 28775,215,9666,-9451,572,54.5,315,25,0,0,27904,-27332
ZCTA5 28777,3588,11067,-7479,10318,44.7,8950,47,600,0.058150804,29487,-19169
ZCTA5 28778,3626,15701,-12075,10771,42.6,9686,24,323,0.029987931,34438,-23667
ZCTA5 28779,7784,26,7758,18377,42.4,16352,241,135,0.007346139,2167,16210
ZCTA5 28781,541,7022,-6481,967,62.8,869,0,0,0,17893,-16926
ZCTA5 28782,3061,15790,-12729,6329,59.3,5894,13,301,0.047558856,35533,-29204
ZCTA5 28783,500,13866,-13366,1535,40.1,1019,0,0,0,32617,-31082
ZCTA5 28785,3219,9196,-5977,8183,46.4,7785,34,0,0,22298,-14115
ZCTA5 28786,9426,7361,2065,21526,50.1,20212,68,202,0.009384001,22614,-1088
ZCTA5 28787,8680,0,8680,23188,45.9,21134,40,249,0.010738313,504,22684
ZCTA5 28788,57,0,57,151,40.2,108,0,0,0,352,-201
ZCTA5 28789,2723,563,2160,6957,42.7,5050,0,65,0.009343108,1492,5465
ZCTA5 28790,1361,1062,299,3313,48.5,3106,79,14,0.004225777,3009,304
ZCTA5 28791,6588,2175,4413,15067,50.6,13760,237,327,0.02170306,6546,8521
ZCTA5 28792,14968,1125,13843,35181,44.1,29336,454,1863,0.05295472,2700,32481
ZCTA5 28801,6544,145,6399,14395,39.9,10298,169,2956,0.20534908,446,13949
ZCTA5 28803,14256,1453,12803,34036,41.9,27228,550,3620,0.106357974,3700,30336
ZCTA5 28804,9496,1514,7982,24854,45.1,22456,419,485,0.019513962,3974,20880
ZCTA5 28805,8885,940,7945,20147,45.9,17202,61,1827,0.090683476,2157,17990
ZCTA5 28806,17058,1169,15889,44733,37.4,37543,810,2824,0.063130128,2430,42303
ZCTA5 28901,2372,1153,1219,5104,49.6,4507,0,231,0.045258621,2215,2889
ZCTA5 28902,395,9605,-9210,1107,46.7,886,90,84,0.075880759,29100,-27993
ZCTA5 28904,4489,18649,-14160,9642,53.9,9109,49,180,0.018668326,55376,-45734
ZCTA5 28905,1220,475,745,3609,34.9,3302,61,0,0,1209,2400
ZCTA5 28906,8701,965,7736,19447,56.1,18382,84,166,0.008536021,2526,16921
ZCTA5 28909,346,3146,-2800,603,56,565,0,0,0,7746,-7143
ZCTA5 29001,633,1027,-394,2032,38.7,941,0,939,0.462106299,2828,-796
ZCTA5 29003,2272,1783,489,5793,52.7,2286,24,3306,0.570688762,4217,1576
ZCTA5 29006,3643,127,3516,9246,42,6311,0,2302,0.248972529,383,8863
ZCTA5 29009,851,508,343,2039,55,1289,0,698,0.342324669,1425,614
ZCTA5 29010,4389,7909,-3520,11877,40.7,4112,22,7401,0.623137156,20114,-8237
ZCTA5 29014,638,9853,-9215,1410,47.7,1194,0,216,0.153191489,28940,-27530
ZCTA5 29015,512,820,-308,1302,45.8,228,0,1073,0.824116743,2286,-984
ZCTA5 29016,10373,10894,-521,27283,39.7,12096,711,11832,0.433676648,30270,-2987
ZCTA5 29018,1221,18218,-16997,3501,38.2,1263,96,2098,0.599257355,44677,-41176
ZCTA5 29020,8956,10374,-1418,21566,44.7,13510,105,6165,0.285866642,28087,-6521
ZCTA5 29030,840,827,13,2096,37.5,1185,0,889,0.424141221,1856,240
ZCTA5 29031,645,233,412,1826,37,327,0,1412,0.773274918,550,1276
ZCTA5 29032,1799,1493,306,5164,39.5,3383,0,1388,0.268783888,4131,1033
ZCTA5 29033,6092,623,5469,12789,38.1,7860,428,3440,0.268981156,1428,11361
ZCTA5 29036,9446,2924,6522,24548,45.1,22321,839,832,0.033892781,9237,15311
ZCTA5 29037,301,866,-565,864,30.7,582,0,217,0.251157407,2327,-1463
ZCTA5 29038,1054,1222,-168,2336,41.2,2004,0,288,0.123287671,2946,-610
ZCTA5 29039,1554,2647,-1093,3284,50.5,1281,0,1902,0.579171742,6581,-3297
ZCTA5 29040,3474,2586,888,9769,30.7,5706,124,3139,0.321322551,7636,2133
ZCTA5 29042,1139,620,519,4633,30.6,613,6,3965,0.855816965,1958,2675
ZCTA5 29044,2128,791,1337,5473,36.8,1667,49,3590,0.655947378,1905,3568
ZCTA5 29045,10440,23433,-12993,28906,37.2,17437,974,8164,0.282432713,66029,-37123
ZCTA5 29046,18,17362,-17344,36,-,0,0,36,1,46879,-46843
ZCTA5 29047,1498,1077,421,3329,54.4,1609,0,1596,0.47942325,2883,446
ZCTA5 29048,1914,8525,-6611,5051,52.2,2022,50,2916,0.577311423,21779,-16728
ZCTA5 29051,153,3923,-3770,358,60.3,64,0,294,0.82122905,10419,-10061
ZCTA5 29052,566,40,526,1722,43.7,253,0,1459,0.847270616,98,1624
ZCTA5 29053,7738,16965,-9227,20458,35.6,12862,39,4637,0.226659498,43004,-22546
ZCTA5 29054,3599,10071,-6472,8852,46.1,7892,22,102,0.01152282,26174,-17322
ZCTA5 29055,1542,7595,-6053,3786,47.2,2238,0,1256,0.331748547,21246,-17460
ZCTA5 29056,925,3715,-2790,2259,46.6,646,0,1530,0.677290837,10970,-8711
ZCTA5 29058,1791,1768,23,5346,38,4016,0,1130,0.211372989,4483,863
ZCTA5 29059,1966,6231,-4265,5312,46.4,1775,6,3293,0.619917169,19051,-13739
ZCTA5 29061,4721,338,4383,12500,43.3,2997,101,8259,0.66072,881,11619
ZCTA5 29062,10,469,-459,10,-,10,0,0,0,1210,-1200
ZCTA5 29063,13848,94,13754,38703,38.5,26814,971,9719,0.251117484,231,38472
ZCTA5 29065,267,5746,-5479,465,40.9,72,0,393,0.84516129,14276,-13811
ZCTA5 29067,3792,680,3112,11158,37.5,8408,96,2137,0.191521778,1638,9520
ZCTA5 29069,1862,14896,-13034,4304,43.9,2553,0,1714,0.398234201,38063,-33759
ZCTA5 29070,5894,8958,-3064,16208,40.2,13025,31,1887,0.116423988,24722,-8514
ZCTA5 29072,24004,964,23040,65308,38.7,55234,2275,4131,0.063254119,2361,62947
ZCTA5 29073,18349,7994,10355,48657,38.1,38053,643,6413,0.131800152,20539,28118
ZCTA5 29074,114,6251,-6137,206,66.3,191,0,15,0.072815534,17204,-16998
ZCTA5 29075,1225,2093,-868,2968,43,2650,0,300,0.101078167,6249,-3281
ZCTA5 29078,5958,3029,2929,15686,40.6,12026,63,2862,0.182455693,8092,7594
ZCTA5 29079,12,197,-185,12,-,0,0,12,1,487,-475
ZCTA5 29080,970,1748,-778,3020,41.2,577,0,2285,0.756622517,5048,-2028
ZCTA5 29081,511,625,-114,1154,58.8,818,0,306,0.265164645,1803,-649
ZCTA5 29082,199,975,-776,466,50,348,31,51,0.10944206,2581,-2115
ZCTA5 29101,1093,751,342,2997,43.8,1846,0,875,0.291958625,1916,1081
ZCTA5 29102,6248,12668,-6420,16351,45.3,7959,204,7319,0.447617883,31525,-15174
ZCTA5 29104,464,3207,-2743,1282,42.8,286,0,996,0.776911076,9122,-7840
ZCTA5 29105,388,2203,-1815,1002,44.4,528,0,352,0.351297405,6398,-5396
ZCTA5 29107,1072,4194,-3122,2870,37.3,1819,0,923,0.321602787,12718,-9848
ZCTA5 29108,7831,4681,3150,20541,38,10062,32,8365,0.407234312,12438,8103
ZCTA5 29111,507,1111,-604,1625,44.7,1000,0,611,0.376,2640,-1015
ZCTA5 29112,1514,323,1191,3466,53,1883,0,1452,0.418926717,931,2535
ZCTA5 29113,610,2896,-2286,2129,36.4,515,0,1582,0.743071865,8001,-5872
ZCTA5 29114,601,7565,-6964,1394,54.8,644,12,698,0.50071736,15869,-14475
ZCTA5 29115,10334,233,10101,26678,38,6737,12,19387,0.726703651,667,26011
ZCTA5 29117,0,5445,-5445,641,20.2,86,4,488,0.761310452,13436,-12795
ZCTA5 29118,5932,6120,-188,16387,36.7,6114,484,9482,0.578629401,16330,57
ZCTA5 29122,36,1485,-1449,84,37.8,51,0,33,0.392857143,4394,-4310
ZCTA5 29123,2741,5853,-3112,7478,38.3,6537,5,467,0.062449853,16099,-8621
ZCTA5 29125,1123,4371,-3248,3050,49,1075,39,1771,0.580655738,8787,-5737
ZCTA5 29126,925,4574,-3649,2406,44.4,1800,0,546,0.226932668,12199,-9793
ZCTA5 29127,3628,7587,-3959,8323,48.5,6506,0,1683,0.202210741,15401,-7078
ZCTA5 29128,1502,11798,-10296,3932,44.4,1161,49,2699,0.686419125,24530,-20598
ZCTA5 29129,1638,11308,-9670,4372,40.2,2259,0,1905,0.435727356,27057,-22685
ZCTA5 29130,2884,12180,-9296,6664,53.9,3551,1,2908,0.43637455,30508,-23844
ZCTA5 29133,294,487,-193,753,39.4,277,0,476,0.632138114,1468,-715
ZCTA5 29135,3347,1643,1704,8766,44.1,3933,13,4374,0.498973306,4376,4390
ZCTA5 29137,893,7507,-6614,2011,52.4,1084,2,825,0.41024366,14541,-12530
ZCTA5 29138,3905,2032,1873,10671,38.8,5735,4,2745,0.257239247,5584,5087
ZCTA5 29142,1927,932,995,5142,40.7,1262,0,3735,0.726371062,2622,2520
ZCTA5 29145,313,5744,-5431,733,35.5,223,0,268,0.365620737,12935,-12202
ZCTA5 29146,456,14281,-13825,1215,37.6,465,0,734,0.604115226,35860,-34645
ZCTA5 29148,2390,878,1512,5808,53.6,2448,5,3235,0.556990358,4095,1713
ZCTA5 29150,15584,2005,13579,38601,39.6,16700,596,18700,0.484443408,5420,33181
ZCTA5 29152,728,323,405,2250,23.1,1661,10,291,0.129333333,1020,1230
ZCTA5 29153,6220,784,5436,15829,38.4,5802,261,9198,0.58108535,2269,13560
ZCTA5 29154,11030,48,10982,28459,34.9,14811,299,10873,0.3820584,122,28337
ZCTA5 29160,2974,1062,1912,6882,43.7,5330,7,1245,0.180906713,2548,4334
ZCTA5 29161,4289,4568,-279,11144,43.2,5853,0,5072,0.455132807,10600,544
ZCTA5 29162,922,13613,-12691,3609,38.5,2243,3,1275,0.353283458,34104,-30495
ZCTA5 29163,445,14292,-13847,1608,32.6,340,0,1227,0.763059701,34752,-33144
ZCTA5 29164,2040,11407,-9367,5305,39.2,3020,76,1586,0.298963242,27952,-22647
ZCTA5 29166,238,10933,-10695,724,46.5,400,0,285,0.393646409,29446,-28722
ZCTA5 29168,1446,0,1446,3837,36.4,1721,24,1916,0.499348449,1551,2286
ZCTA5 29169,10460,71,10389,21690,40.2,15226,501,4308,0.198616874,2895,18795
ZCTA5 29170,8769,15184,-6415,21954,38.2,15784,549,3899,0.177598615,32752,-10798
ZCTA5 29172,3777,10007,-6230,9290,38.6,6336,98,2374,0.255543595,25939,-16649
ZCTA5 29175,167,5238,-5071,419,36.9,375,0,44,0.105011933,13497,-13078
ZCTA5 29177,0,15605,-15605,132,82.4,94,10,28,0.212121212,40388,-40256
ZCTA5 29178,1480,6032,-4552,3495,44.2,2488,0,806,0.230615165,14599,-11104
ZCTA5 29180,5021,11036,-6015,12229,45.2,4490,49,7178,0.58696541,27150,-14921
ZCTA5 29201,8863,5266,3597,21176,22.5,14217,773,5064,0.239138648,13305,7871
ZCTA5 29203,16179,6959,9220,41047,34.5,4942,450,33570,0.817842961,17740,23307
ZCTA5 29204,7144,1149,5995,17871,38.1,7754,220,9289,0.51978065,2593,15278
ZCTA5 29205,10771,5777,4994,23388,29.6,17175,772,4060,0.173593296,13958,9430
ZCTA5 29206,8346,5456,2890,19493,36.9,14654,295,3192,0.16375109,13471,6022
ZCTA5 29207,4,47,-43,11396,20.1,6575,425,2927,0.256844507,6752,4644
ZCTA5 29208,0,653,-653,2261,18.9,1725,100,338,0.149491375,1376,885
ZCTA5 29209,14599,1156,13443,37365,34.1,15526,718,19087,0.510825639,2888,34477
ZCTA5 29210,17139,473,16666,40269,33,14695,732,22093,0.548635427,1752,38517
ZCTA5 29212,12325,11707,618,27724,41.8,18521,983,6662,0.240297215,30838,-3114
ZCTA5 29223,21702,11007,10695,50910,37.4,14166,2183,30383,0.596798271,29506,21404
ZCTA5 29225,0,1142,-1142,476,19,466,0,10,0.021008403,2700,-2224
ZCTA5 29229,18305,7024,11281,49350,35.1,13993,2321,28809,0.583768997,19553,29797
ZCTA5 29301,13581,3571,10010,36124,36.2,19916,1838,11940,0.330528181,10058,26066
ZCTA5 29302,7216,10922,-3706,18050,40.8,13692,582,2973,0.164709141,28763,-10713
ZCTA5 29303,9093,9485,-392,26530,30.2,12629,414,10050,0.378816434,24618,1912
ZCTA5 29306,6882,12998,-6116,17414,31.7,6717,178,9143,0.525037326,33654,-16240
ZCTA5 29307,8010,16523,-8513,19260,40.9,13990,138,4127,0.214278297,43880,-24620
ZCTA5 29316,11094,2044,9050,28930,34.1,21912,1163,4251,0.146940892,5465,23465
ZCTA5 29320,222,3979,-3757,651,41.4,606,0,45,0.069124424,10106,-9455
ZCTA5 29321,1095,2857,-1762,2998,34.9,2547,0,285,0.095063376,7013,-4015
ZCTA5 29322,3703,5510,-1807,9576,47.2,8923,10,195,0.020363409,14068,-4492
ZCTA5 29323,5540,109,5431,14949,38.3,13015,451,764,0.051107097,292,14657
ZCTA5 29324,37,75,-38,91,10.7,10,0,81,0.89010989,201,-110
ZCTA5 29325,5025,2305,2720,14279,39.7,9196,114,3899,0.273058337,5725,8554
ZCTA5 29329,75,5911,-5836,171,38.3,171,0,0,0,14590,-14419
ZCTA5 29330,3380,724,2656,9389,43.6,8125,96,522,0.055596975,1599,7790
ZCTA5 29331,51,55,-4,51,-,51,0,0,0,63,-12
ZCTA5 29332,1112,2311,-1199,3030,38,2104,0,612,0.201980198,6525,-3495
ZCTA5 29333,102,81,21,197,62.4,118,0,56,0.284263959,218,-21
ZCTA5 29334,5710,4671,1039,15892,35.8,11201,605,2904,0.182733451,12056,3836
ZCTA5 29335,1917,3682,-1765,5644,44.4,4325,0,1048,0.185683912,8852,-3208
ZCTA5 29338,25,6763,-6738,49,-,49,0,0,0,17133,-17084
ZCTA5 29340,7748,4660,3088,20549,41,14912,39,4830,0.235047934,11449,9100
ZCTA5 29341,7677,9511,-1834,19436,36.7,11925,22,5470,0.28143651,24737,-5301
ZCTA5 29346,99,2431,-2332,275,38,259,0,0,0,5221,-4946
ZCTA5 29349,12877,8934,3943,34215,42.3,29347,330,3202,0.093584685,21871,12344
ZCTA5 29351,556,9532,-8976,1470,41.8,1347,47,39,0.026530612,28232,-26762
ZCTA5 29353,1488,17329,-15841,3628,46.9,2350,0,1043,0.287486218,48191,-44563
ZCTA5 29355,301,1335,-1034,855,43.6,524,17,210,0.245614035,3678,-2823
ZCTA5 29356,3737,87,3650,8392,52.1,7955,38,298,0.03551001,293,8099
ZCTA5 29360,8139,1877,6262,22143,40.7,14273,162,6397,0.28889491,4869,17274
ZCTA5 29364,299,437,-138,622,42.6,482,0,0,0,1048,-426
ZCTA5 29365,4673,405,4268,13971,32.9,11545,422,1350,0.096628731,1119,12852
ZCTA5 29368,82,16102,-16020,207,23.9,207,0,0,0,41931,-41724
ZCTA5 29369,6151,1613,4538,15223,41.2,10634,227,2978,0.195625041,3913,11310
ZCTA5 29370,289,6863,-6574,658,51.1,589,0,58,0.088145897,19985,-19327
ZCTA5 29372,1698,4444,-2746,4159,42.8,3215,0,799,0.192113489,11446,-7287
ZCTA5 29373,114,1916,-1802,287,56.5,258,0,0,0,5333,-5046
ZCTA5 29374,1352,5840,-4488,3235,49.2,2972,81,25,0.007727975,14442,-11207
ZCTA5 29375,34,1533,-1499,71,36.3,71,0,0,0,3808,-3737
ZCTA5 29376,3031,4454,-1423,8746,38.1,6526,175,1588,0.181568717,12175,-3429
ZCTA5 29377,220,3857,-3637,571,50.3,465,0,81,0.141856392,10240,-9669
ZCTA5 29378,60,1394,-1334,68,56.9,34,0,34,0.5,3429,-3361
ZCTA5 29379,7462,7663,-201,17569,45.5,11020,31,5738,0.326597985,20258,-2689
ZCTA5 29384,1493,7119,-5626,3442,51.9,2778,14,548,0.159209762,16577,-13135
ZCTA5 29385,2759,9427,-6668,7476,34.3,4436,145,1972,0.263777421,25831,-18355
ZCTA5 29388,6070,2472,3598,15369,41.6,12436,82,1942,0.126358254,6432,8937
ZCTA5 29401,3910,10872,-6962,8587,41.2,7614,100,718,0.083614767,28340,-19753
ZCTA5 29403,9451,919,8532,22016,30,13269,192,8025,0.364507631,2345,19671
ZCTA5 29404,571,998,-427,2312,22.2,1551,24,415,0.17949827,2660,-348
ZCTA5 29405,11156,9248,1908,29087,36.6,9933,198,17634,0.606250215,24708,4379
ZCTA5 29406,12490,397,12093,33150,31,13331,899,14099,0.425309201,987,32163
ZCTA5 29407,16630,1410,15220,36294,37.8,23652,454,10970,0.302253816,3694,32600
ZCTA5 29409,35,17412,-17377,2539,20.2,2118,55,201,0.079165026,47480,-44941
ZCTA5 29410,7399,0,7399,20260,35.6,15223,1083,2025,0.099950642,0,20260
ZCTA5 29412,16397,731,15666,41033,39.8,32225,519,6700,0.163283211,1892,39141
ZCTA5 29414,18920,518,18402,42665,37,32897,1004,6367,0.149232392,1374,41291
ZCTA5 29418,10586,3642,6944,22425,39.9,10269,345,9940,0.443255295,10461,11964
ZCTA5 29420,8684,853,7831,21711,38.2,9485,889,9318,0.429183363,2321,19390
ZCTA5 29424,48,20521,-20473,1140,19.3,826,119,105,0.092105263,52071,-50931
ZCTA5 29425,0,21478,-21478,0,-,0,0,0,#DIV/0!,54743,-54743
ZCTA5 29426,683,0,683,1527,50.6,544,0,855,0.559921415,1780,-253
ZCTA5 29429,1590,770,820,4176,50.8,2473,0,1579,0.378113027,1906,2270
ZCTA5 29431,2374,965,1409,6427,44.3,4973,143,913,0.142056947,2425,4002
ZCTA5 29432,1075,390,685,2625,40.8,1607,0,907,0.34552381,995,1630
ZCTA5 29434,316,10392,-10076,671,40.9,345,0,326,0.485842027,29556,-28885
ZCTA5 29435,1680,9960,-8280,4919,34.2,2947,7,1228,0.249644237,26158,-21239
ZCTA5 29436,1830,15596,-13766,4474,43.8,2312,0,2063,0.461108628,37249,-32775
ZCTA5 29437,910,2191,-1281,2214,38.8,943,0,944,0.426377597,5756,-3542
ZCTA5 29438,1167,922,245,2441,62.1,2003,14,387,0.158541581,2211,230
ZCTA5 29439,571,1752,-1181,944,60,944,0,0,0,5116,-4172
ZCTA5 29440,10113,4166,5947,26866,43.3,13407,16,12736,0.474056428,11308,15558
ZCTA5 29445,21360,464,20896,59809,33.6,37542,2126,13059,0.218345065,1331,58478
ZCTA5 29446,423,1966,-1543,1202,48.7,221,0,645,0.536605657,5751,-4549
ZCTA5 29448,1020,445,575,2769,36,2083,21,641,0.231491513,1302,1467
ZCTA5 29449,3002,424,2578,7936,47.9,4147,98,3543,0.446446573,887,7049
ZCTA5 29450,1117,2518,-1401,2569,43.5,900,0,1588,0.618139354,8662,-6093
ZCTA5 29451,1930,58,1872,4383,52.1,4240,85,0,0,82,4301
ZCTA5 29452,99,1341,-1242,204,57.4,103,0,101,0.495098039,4480,-4276
ZCTA5 29453,538,522,16,1200,39.6,523,0,623,0.519166667,1247,-47
ZCTA5 29455,10610,3229,7381,24354,50.2,18464,38,4512,0.185267307,8406,15948
ZCTA5 29456,12282,1503,10779,32237,33.3,17795,1210,8052,0.249775103,3613,28624
ZCTA5 29458,934,2005,-1071,2624,44.7,1152,0,1448,0.551829268,5503,-2879
ZCTA5 29461,15326,704,14622,41317,37.7,26295,91,12567,0.304160515,1615,39702
ZCTA5 29464,23241,3000,20241,51895,41.6,45799,1055,3191,0.061489546,7052,44843
ZCTA5 29466,15098,308,14790,41434,43.5,36436,694,3145,0.075903847,759,40675
ZCTA5 29468,840,319,521,1953,48.2,452,0,1501,0.768561188,564,1389
ZCTA5 29469,353,124,229,695,59.7,622,0,63,0.090647482,170,525
ZCTA5 29470,1718,13124,-11406,4726,42.9,2429,25,2035,0.430596699,32511,-27785
ZCTA5 29471,562,3332,-2770,1357,39.8,634,0,709,0.52247605,8908,-7551
ZCTA5 29472,3235,659,2576,11074,42.8,6357,10,3666,0.331045693,1735,9339
ZCTA5 29474,854,26,828,1720,53.1,1008,0,477,0.277325581,48,1672
ZCTA5 29475,889,445,444,2222,39.8,1282,0,814,0.366336634,1067,1155
ZCTA5 29477,3022,1584,1438,7006,40.8,3756,0,3100,0.442477876,4839,2167
ZCTA5 29479,2659,350,2309,6704,38,2686,0,3794,0.565930788,1000,5704
ZCTA5 29481,601,87,514,1641,42.8,634,0,977,0.595368678,163,1478
ZCTA5 29482,832,54,778,2220,50,2170,30,4,0.001801802,192,2028
ZCTA5 29483,20566,2804,17762,55833,38.3,40971,919,9871,0.176795085,7190,48643
ZCTA5 29485,21364,2329,19035,60321,35.8,39179,1583,14797,0.245304289,6504,53817
ZCTA5 29486,14569,1170,13399,40118,36.3,26803,676,8070,0.201156588,3701,36417
ZCTA5 29487,1080,5318,-4238,2504,51.6,1484,0,993,0.396565495,14476,-11972
ZCTA5 29488,8311,0,8311,21554,40.5,12181,158,8267,0.383548297,1078,20476
ZCTA5 29492,8054,5341,2713,18865,38,16133,363,1304,0.069122714,14187,4678
ZCTA5 29493,66,0,66,195,46.3,127,0,68,0.348717949,349,-154
ZCTA5 29501,18606,25,18581,47145,38.4,27637,1197,16483,0.349623502,4189,42956
ZCTA5 29505,9776,7492,2284,25355,38.6,14598,459,9164,0.361427726,22068,3287
ZCTA5 29506,6826,4636,2190,20733,34.5,5868,60,13932,0.671972218,12124,8609
ZCTA5 29510,3535,8441,-4906,9527,40.1,4957,75,4258,0.446940275,16883,-7356
ZCTA5 29511,1973,12250,-10277,5640,42.3,4971,58,358,0.063475177,33809,-28169
ZCTA5 29512,6005,655,5350,18131,39.6,6726,76,10138,0.559152832,1722,16409
ZCTA5 29516,222,0,222,929,31.9,449,0,337,0.362755651,0,929
ZCTA5 29518,408,203,205,870,35.1,665,0,205,0.235632184,599,271
ZCTA5 29519,111,618,-507,328,16.8,17,0,311,0.948170732,1613,-1285
ZCTA5 29520,5198,1496,3702,12998,45.8,7001,179,5225,0.401984921,5412,7586
ZCTA5 29525,706,3911,-3205,1914,49.7,441,0,1200,0.626959248,9070,-7156
ZCTA5 29526,15983,96,15887,46605,41.1,36303,374,7178,0.154017809,225,46380
ZCTA5 29527,9365,445,8920,26659,42.9,17760,440,6958,0.261000038,1208,25451
ZCTA5 29530,884,177,707,2332,39.4,1896,0,222,0.095197256,576,1756
ZCTA5 29532,7903,1518,6385,19666,43.1,8656,15,10270,0.522221092,4024,15642
ZCTA5 29536,5829,10030,-4201,16005,36.4,6564,0,8356,0.522086848,24293,-8288
ZCTA5 29540,1948,2531,-583,4500,48.4,2380,13,1975,0.438888889,8037,-3537
ZCTA5 29541,3241,7992,-4751,9219,42.1,5452,64,3428,0.371840764,15740,-6521
ZCTA5 29543,117,408,-291,422,62,204,0,137,0.32464455,1044,-622
ZCTA5 29544,2274,68,2206,6309,38,4999,0,1029,0.163100333,116,6193
ZCTA5 29545,648,335,313,1780,35.2,975,0,797,0.447752809,1283,497
ZCTA5 29546,1054,1492,-438,2825,51,1112,0,1501,0.531327434,3180,-355
ZCTA5 29547,903,4476,-3573,2243,40.9,1540,0,487,0.217119929,13684,-11441
ZCTA5 29550,11627,93,11534,29684,40.8,19066,203,9620,0.324080313,235,29449
ZCTA5 29554,3429,1512,1917,8819,43.1,3853,0,4803,0.544619571,3997,4822
ZCTA5 29555,2016,234,1782,5959,36.2,3528,21,2339,0.392515523,500,5459
ZCTA5 29556,4793,184,4609,12048,40.7,2486,76,9087,0.754233068,468,11580
ZCTA5 29560,5065,2030,3035,12420,43.3,4611,180,7113,0.572705314,5435,6985
ZCTA5 29563,738,1633,-895,1839,53.6,1216,0,602,0.327351822,4455,-2616
ZCTA5 29564,458,2622,-2164,1185,54.1,194,0,984,0.830379747,6405,-5220
ZCTA5 29565,2500,19129,-16629,6956,36.2,2917,18,3879,0.557648074,53642,-46686
ZCTA5 29566,8584,12227,-3643,19441,57.4,16110,212,2272,0.116866416,36215,-16774
ZCTA5 29567,150,9896,-9746,445,47.7,115,0,185,0.415730337,30991,-30546
ZCTA5 29568,6104,5416,688,15427,48.6,11561,0,3583,0.232255137,13706,1721
ZCTA5 29569,6257,5073,1184,16741,43.9,10457,197,5730,0.34227346,15099,1642
ZCTA5 29570,1363,8785,-7422,3846,43.6,1745,0,1199,0.31175247,27376,-23530
ZCTA5 29571,4896,8753,-3857,14238,40.8,5230,86,8363,0.587371822,25141,-10903
ZCTA5 29572,4923,12836,-7913,10431,58,9146,19,547,0.052439843,37899,-27468
ZCTA5 29574,3738,16396,-12658,9432,40.7,3942,0,5162,0.547285835,49267,-39835
ZCTA5 29575,8032,6976,1056,18971,54.2,16721,149,636,0.033524854,21135,-2164
ZCTA5 29576,15047,12533,2514,32394,61.4,30527,430,451,0.013922331,40979,-8585
ZCTA5 29577,14413,7773,6640,34068,44.2,23994,604,6447,0.189239169,23212,10856
ZCTA5 29579,17557,22487,-4930,47118,41.5,40481,749,3567,0.075703553,64632,-17514
ZCTA5 29580,554,20491,-19937,1585,38.8,184,0,1401,0.883911672,67734,-66149
ZCTA5 29581,1607,3259,-1652,4573,36.7,3081,0,1284,0.280778482,8889,-4316
ZCTA5 29582,8925,6152,2773,19036,58.9,16735,519,801,0.042078168,19120,-84
ZCTA5 29583,1881,11764,-9883,5044,41,3095,27,1691,0.335249802,26103,-21059
ZCTA5 29584,1069,16364,-15295,2632,43.7,1976,6,614,0.233282675,47003,-44371
ZCTA5 29585,7455,12855,-5400,16131,61,13769,125,1150,0.071291302,29527,-13396
ZCTA5 29588,18199,15882,2317,52184,45.3,42671,913,3287,0.062988656,45723,6461
ZCTA5 29589,44,7302,-7258,44,-,0,0,44,1,20637,-20593
ZCTA5 29590,908,14066,-13158,3560,39.2,829,14,2584,0.725842697,38068,-34508
ZCTA5 29591,1803,13644,-11841,4936,41.7,3214,0,1566,0.31726094,41311,-36375
ZCTA5 29592,274,17964,-17690,718,38.9,224,0,473,0.658774373,56177,-55459
ZCTA5 29593,810,17813,-17003,1969,42.8,1153,0,755,0.383443372,54612,-52643
ZCTA5 29594,105,25191,-25086,164,65,56,0,99,0.603658537,81716,-81552
ZCTA5 29596,931,26320,-25389,1943,49.5,1371,0,494,0.254246011,79381,-77438
ZCTA5 29601,6590,9702,-3112,12745,41.3,8426,153,3347,0.262612789,31777,-19032
ZCTA5 29605,15446,11431,4015,39927,36.7,19419,245,15784,0.395321462,34255,5672
ZCTA5 29607,18947,19467,-520,41624,34.6,26294,1586,11600,0.278685374,60898,-19274
ZCTA5 29609,12920,19298,-6378,29502,40.2,21992,585,3683,0.124838994,58780,-29278
ZCTA5 29611,12487,3931,8556,31784,33.6,16571,249,8182,0.25742512,11829,19955
ZCTA5 29613,0,1074,-1074,2151,19.9,1747,85,202,0.093909809,2743,-592
ZCTA5 29614,4,756,-752,1820,20.3,1434,94,157,0.086263736,2225,-405
ZCTA5 29615,18036,18907,-871,38495,38.9,29570,1915,3547,0.092141837,53773,-15278
ZCTA5 29617,11056,11849,-793,27595,39.9,17488,578,4109,0.148903787,35259,-7664
ZCTA5 29620,4841,22892,-18051,12513,44.4,8448,0,3607,0.288260209,63193,-50680
ZCTA5 29621,16931,17261,-330,44314,40.1,33631,946,8397,0.189488649,46330,-2016
ZCTA5 29624,6003,19888,-13885,14272,40,7293,4,5971,0.418371637,53953,-39681
ZCTA5 29625,12254,18932,-6678,28023,42.3,21689,176,4682,0.167077044,44729,-16706
ZCTA5 29626,5339,12105,-6766,13537,42.6,9294,8,3380,0.249686046,32775,-19238
ZCTA5 29627,6200,135,6065,16236,40.5,13223,23,2253,0.138765706,315,15921
ZCTA5 29628,1086,6232,-5146,2481,47.8,1178,0,1264,0.509471987,19926,-17445
ZCTA5 29630,7073,341,6732,15900,29,12634,671,1101,0.069245283,615,15285
ZCTA5 29631,6127,19682,-13555,16137,24.2,13251,1142,1120,0.069405714,53693,-37556
ZCTA5 29634,27,15772,-15745,5409,19.2,4568,62,576,0.106489185,41630,-36221
ZCTA5 29635,426,11285,-10859,1245,52,1212,0,12,0.009638554,33984,-32739
ZCTA5 29638,1451,1231,220,3861,44.7,3022,0,785,0.203315203,3521,340
ZCTA5 29639,414,23973,-23559,1534,22.6,1207,3,247,0.161016949,51389,-49855
ZCTA5 29640,12248,10255,1993,31993,41.1,28018,98,2191,0.068483731,25005,6988
ZCTA5 29642,13417,18077,-4660,34395,41.7,29859,241,2259,0.065678151,50612,-16217
ZCTA5 29643,1116,13945,-12829,2563,54.3,2456,54,0,0,35867,-33304
ZCTA5 29644,7976,12886,-4910,20731,37.7,14853,197,3428,0.16535623,36016,-15285
ZCTA5 29645,4244,9204,-4960,10563,43.8,7820,2,1966,0.186121367,27215,-16652
ZCTA5 29646,10864,12439,-1575,27562,39.3,13798,31,12042,0.436905885,31081,-3519
ZCTA5 29649,10822,17488,-6666,27004,38.6,17928,464,7496,0.277588505,54540,-27536
ZCTA5 29650,14300,10996,3304,37664,39.6,29252,3137,2643,0.07017311,30975,6689
ZCTA5 29651,19182,24446,-5264,51256,40.6,40532,431,5593,0.109118932,66521,-15265
ZCTA5 29653,1653,13817,-12164,3968,50.3,2937,17,988,0.248991935,40712,-36744
ZCTA5 29654,3613,18549,-14936,9892,44.5,8714,0,685,0.069247877,55262,-45370
ZCTA5 29655,2950,12041,-9091,7727,42.1,6843,0,723,0.093568008,34146,-26419
ZCTA5 29657,6001,5393,608,16243,35.6,15034,3,718,0.044203657,15835,408
ZCTA5 29658,122,1808,-1686,226,53.3,226,0,0,0,4886,-4660
ZCTA5 29659,54,983,-929,116,52.6,27,60,29,0.25,2572,-2456
ZCTA5 29661,2376,7443,-5067,5892,53.8,5580,0,58,0.009843856,18102,-12210
ZCTA5 29662,5988,4877,1111,14677,42.1,8885,212,3684,0.251004974,13145,1532
ZCTA5 29664,813,2819,-2006,1973,48.9,1951,0,4,0.002027369,7476,-5503
ZCTA5 29665,82,4628,-4546,171,49,130,0,0,0,12541,-12370
ZCTA5 29666,2403,2211,192,6127,46,5397,24,626,0.10217072,5951,176
ZCTA5 29667,79,17185,-17106,219,48.6,203,1,15,0.068493151,48930,-48711
ZCTA5 29669,4697,12707,-8010,12637,45.4,10441,0,1054,0.083405872,37630,-24993
ZCTA5 29670,4242,7966,-3724,10163,42.1,8075,211,1437,0.141395257,23524,-13361
ZCTA5 29671,7074,13039,-5965,18534,41.3,16869,87,946,0.051041329,34151,-15617
ZCTA5 29672,5207,0,5207,11988,54.3,10694,388,559,0.046629963,2218,9770
ZCTA5 29673,11179,13063,-1884,30210,40.6,21458,507,5653,0.187123469,37100,-6890
ZCTA5 29676,2521,7898,-5377,5830,61.9,5770,0,2,0.000343053,21895,-16065
ZCTA5 29678,9694,8560,1134,22983,38.3,17406,74,4085,0.177740069,22526,457
ZCTA5 29680,12164,1051,11113,32907,37.4,22019,340,7897,0.239979336,2775,30132
ZCTA5 29681,23157,8468,14689,65829,37.2,51197,2347,7840,0.119096447,25134,40695
ZCTA5 29682,1549,14094,-12545,3785,46.8,3731,7,12,0.00317041,38216,-34431
ZCTA5 29683,151,20849,-20698,482,40.9,478,0,0,0,61312,-60830
ZCTA5 29684,1999,10671,-8672,5501,38.6,4657,0,441,0.080167242,32133,-26632
ZCTA5 29685,910,14677,-13767,2167,52.8,1994,8,90,0.041532072,43585,-41418
ZCTA5 29686,378,20583,-20205,1015,43.9,978,0,16,0.015763547,60809,-59794
ZCTA5 29687,16295,627,15668,41861,39.3,31995,1077,4973,0.118797926,1781,40080
ZCTA5 29689,1686,1649,37,3918,42.5,3746,9,107,0.027309852,4086,-168
ZCTA5 29690,9101,7745,1356,25141,38.6,21071,238,2128,0.084642616,21446,3695
ZCTA5 29691,4697,8300,-3603,12250,42.3,9751,39,281,0.022938776,20955,-8705
ZCTA5 29692,1884,18411,-16527,5034,33.9,4127,9,634,0.125943584,50590,-45556
ZCTA5 29693,5749,2726,3023,13561,46.9,12310,122,569,0.041958558,9165,4396
ZCTA5 29696,1991,1905,86,5416,41.7,5244,10,9,0.001661743,5525,-109
ZCTA5 29697,5624,204,5420,14552,39.7,12142,174,1344,0.092358439,542,14010
ZCTA5 29702,3397,5,3392,9472,41.1,8395,8,662,0.069890203,1372,8100
ZCTA5 29704,1395,14195,-12800,3417,46.5,2761,41,497,0.145449224,41249,-37832
ZCTA5 29706,7671,6696,975,19702,41.4,10821,125,8450,0.428890468,18379,1323
ZCTA5 29707,12818,15186,-2368,31310,44.9,26254,1284,2015,0.064356436,44761,-13451
ZCTA5 29708,15199,13368,1831,40841,39.3,31258,3043,3718,0.091035969,35392,5449
ZCTA5 29709,2402,0,2402,5668,45.3,4158,5,1265,0.223182781,0,5668
ZCTA5 29710,14369,14162,207,37607,40.5,31709,565,3501,0.093094371,38480,-873
ZCTA5 29712,851,9165,-8314,2025,40.3,1759,0,242,0.119506173,26110,-24085
ZCTA5 29714,1181,1259,-78,3270,40.7,2246,21,955,0.29204893,3862,-592
ZCTA5 29715,13913,1255,12658,38942,38.1,29239,1529,4649,0.119382672,3758,35184
ZCTA5 29717,556,1949,-1393,1391,43.9,1047,0,285,0.204888569,5557,-4166
ZCTA5 29718,1292,2272,-980,3730,35.6,2524,0,977,0.261930295,6110,-2380
ZCTA5 29720,19335,2866,16469,49870,41.1,33181,160,13895,0.278624424,7208,42662
ZCTA5 29724,20,512,-492,20,-,20,0,0,0,1548,-1528
ZCTA5 29726,674,1283,-609,1557,45.4,1278,19,233,0.149646757,3663,-2106
ZCTA5 29727,854,5862,-5008,2214,42.3,1316,3,877,0.396115628,16581,-14367
ZCTA5 29728,3679,11895,-8216,9495,38.8,5125,13,3498,0.368404423,32978,-23483
ZCTA5 29729,839,1090,-251,2156,39.5,1317,14,594,0.275510204,3297,-1141
ZCTA5 29730,23440,1843,21597,56424,36.4,30977,643,21340,0.378207855,5407,51017
ZCTA5 29732,22870,2336,20534,57377,39.4,41350,1022,12004,0.209212751,6787,50590
ZCTA5 29733,0,1313,-1313,1648,19.3,1091,0,471,0.285800971,3788,-2140
ZCTA5 29741,784,2916,-2132,1804,52.1,1315,0,458,0.253880266,8619,-6815
ZCTA5 29742,1010,19101,-18091,2449,55,1696,0,627,0.256022866,51768,-49319
ZCTA5 29743,735,12941,-12206,2057,30.5,1793,0,45,0.021876519,37382,-35325
ZCTA5 29745,12609,4740,7869,33329,42.5,25905,260,5134,0.154040025,13272,20057
ZCTA5 29801,11062,1145,9917,28970,39.4,14684,254,12695,0.438211943,2824,26146
ZCTA5 29803,16000,1000,15000,38470,48.6,28631,871,7142,0.185651157,3135,35335
ZCTA5 29805,2163,9873,-7710,5448,48.4,4415,0,811,0.148861968,28374,-22926
ZCTA5 29809,968,10603,-9635,2469,40.1,1283,0,1009,0.408667477,29208,-26739
ZCTA5 29810,1690,11083,-9393,3682,47.2,697,63,2910,0.790331342,31996,-28314
ZCTA5 29812,4178,639,3539,10612,41.1,5821,10,4533,0.427157934,1864,8748
ZCTA5 29816,387,3509,-3122,961,38.4,777,0,85,0.088449532,9459,-8498
ZCTA5 29817,1541,696,845,4310,38.7,1675,8,2496,0.579118329,2230,2080
ZCTA5 29819,626,1775,-1149,1659,43.3,820,0,748,0.45087402,5244,-3585
ZCTA5 29821,429,1614,-1185,1154,49.6,922,0,168,0.145580589,4610,-3456
ZCTA5 29824,2770,12880,-10110,8360,41.5,4047,8,3699,0.442464115,36371,-28011
ZCTA5 29826,113,9370,-9257,233,56.3,33,0,198,0.849785408,24708,-24475
ZCTA5 29827,1167,11825,-10658,4001,41.9,1026,5,2728,0.681829543,35968,-31967
ZCTA5 29828,258,3038,-2780,645,45.7,518,0,127,0.196899225,8561,-7916
ZCTA5 29829,4124,7943,-3819,11243,35,7963,24,2602,0.231432892,23194,-11951
ZCTA5 29831,1926,563,1363,4431,48.7,2845,19,1295,0.292259084,2045,2386
ZCTA5 29832,2031,15660,-13629,5192,42.3,2391,0,2628,0.506163328,46139,-40947
ZCTA5 29834,250,11357,-11107,646,29.6,535,0,29,0.044891641,35499,-34853
ZCTA5 29835,2651,10952,-8301,6018,61.4,3075,12,2748,0.45663011,28441,-22423
ZCTA5 29836,121,8535,-8414,260,63.9,82,0,178,0.684615385,24742,-24482
ZCTA5 29838,189,7425,-7236,571,55.3,483,0,27,0.047285464,23163,-22592
ZCTA5 29840,153,18,135,262,67.7,0,0,262,1,76,186
ZCTA5 29841,13774,858,12916,32700,40.9,24893,173,5661,0.173119266,2552,30148
ZCTA5 29842,2959,13584,-10625,7673,34.8,4009,121,2650,0.345366871,43146,-35473
ZCTA5 29843,454,17455,-17001,1310,48.1,720,4,571,0.435877863,51403,-50093
ZCTA5 29844,64,848,-784,130,59.5,124,0,6,0.046153846,2312,-2182
ZCTA5 29845,549,1465,-916,1175,56.5,498,0,652,0.554893617,4036,-2861
ZCTA5 29847,1688,998,690,5045,35.7,2865,0,1905,0.377601586,2922,2123
ZCTA5 29848,290,1139,-849,772,55,612,0,155,0.200777202,3296,-2524
ZCTA5 29849,114,7941,-7827,390,36.8,213,0,177,0.453846154,25183,-24793
ZCTA5 29851,3084,19505,-16421,8955,34.4,7039,118,1345,0.150195422,52419,-43464
ZCTA5 29853,2676,11440,-8764,6352,41.3,3656,0,2678,0.421599496,31702,-25350
ZCTA5 29856,1024,3266,-2242,3169,37.4,2365,43,209,0.065951404,9085,-5916
ZCTA5 29860,6158,12588,-6430,15788,45.3,12884,70,2336,0.147960476,34804,-19016
ZCTA5 29899,0,4871,-4871,945,43.2,304,0,617,0.652910053,14651,-13706
ZCTA5 29902,5794,11321,-5527,16270,35,11443,393,3067,0.188506454,34151,-17881
ZCTA5 29904,0,0,0,923,21.3,567,25,114,0.123510293,0,923
ZCTA5 29905,0,4993,-4993,1106,20.8,774,22,154,0.139240506,13987,-12881
ZCTA5 29906,8860,7466,1394,25880,28.5,13269,19,9852,0.380680062,20830,5050
ZCTA5 29907,5483,23385,-17902,14673,41.1,11416,278,2092,0.142574797,64962,-50289
ZCTA5 29909,10556,17,10539,21794,70.3,19951,592,585,0.02684225,55,21739
ZCTA5 29910,17184,235,16949,46606,40.8,36881,436,3077,0.066021542,642,45964
ZCTA5 29911,487,8931,-8444,1404,46.1,794,0,570,0.405982906,23938,-22534
ZCTA5 29912,0,3371,-3371,0,-,0,0,0,#DIV/0!,10798,-10798
ZCTA5 29915,329,22,307,533,57.8,345,0,18,0.033771107,47,486
ZCTA5 29916,711,2797,-2086,1989,35.7,1383,0,456,0.229260935,8425,-6436
ZCTA5 29918,1622,8152,-6530,5429,39.4,1644,0,3366,0.620003684,21206,-15777
ZCTA5 29920,4197,1932,2265,11032,53.5,4648,130,5306,0.480964467,6462,4570
ZCTA5 29921,144,1242,-1098,511,30.6,403,0,98,0.191780822,2742,-2231
ZCTA5 29922,297,12586,-12289,1042,38.1,71,0,907,0.870441459,37768,-36726
ZCTA5 29923,79,1644,-1565,176,56.4,0,0,176,1,4300,-4124
ZCTA5 29924,1872,8624,-6752,4725,43.4,2690,78,1859,0.393439153,27238,-22513
ZCTA5 29926,10787,8004,2783,25519,57.1,19653,100,1926,0.075473177,27252,-1733
ZCTA5 29927,3775,1073,2702,9443,40.9,4723,98,2745,0.290691518,4255,5188
ZCTA5 29928,7554,11147,-3593,14857,63.9,13704,219,225,0.015144376,20780,-5923
ZCTA5 29929,412,10603,-10191,1041,42.7,819,0,142,0.136407301,21584,-20543
ZCTA5 29932,60,7963,-7903,184,28.4,26,0,126,0.684782609,17344,-17160
ZCTA5 29934,194,8769,-8575,612,40.9,157,0,343,0.560457516,15106,-14494
ZCTA5 29935,1691,12954,-11263,3825,39.9,2007,12,1541,0.402875817,21069,-17244
ZCTA5 29936,4649,10412,-5763,12708,36.3,4912,36,6662,0.524236701,26062,-13354
ZCTA5 29939,96,13215,-13119,180,53.3,53,0,127,0.705555556,35741,-35561
ZCTA5 29940,1672,9450,-7778,4350,49.1,1496,0,2591,0.595632184,18060,-13710
ZCTA5 29941,68,2178,-2110,143,74.1,133,0,0,0,10085,-9942
ZCTA5 29943,194,6853,-6659,603,45.9,220,0,383,0.635157546,21767,-21164
ZCTA5 29944,1490,11593,-10103,4122,39.1,1764,52,2050,0.497331393,33761,-29639
ZCTA5 29945,2157,12352,-10195,4419,52.9,925,0,3380,0.764878932,31282,-26863
ZCTA5 30002,2810,5061,-2251,6025,41.2,3503,317,1770,0.293775934,11520,-5495
ZCTA5 30004,23933,19511,4422,66315,39.6,41751,12084,6210,0.093643972,54248,12067
ZCTA5 30005,13498,16627,-3129,40309,39.1,23528,9452,4718,0.117045821,36148,4161
ZCTA5 30008,11648,0,11648,35023,34.7,10241,649,15451,0.441167233,2226,32797
ZCTA5 30009,7563,13430,-5867,19922,40.4,13154,3311,1818,0.091255898,25695,-5773
ZCTA5 30011,5836,2460,3376,18377,33.6,12381,435,3080,0.167600805,4777,13600
ZCTA5 30012,11562,9310,2252,33140,35.8,12731,427,17041,0.514212432,22715,10425
ZCTA5 30013,9389,14279,-4890,25205,39.4,6170,760,16306,0.646935132,31326,-6121
ZCTA5 30014,14933,11785,3148,39551,36.8,23647,462,12987,0.328360851,26631,12920
ZCTA5 30016,19625,21744,-2119,57834,35.8,19761,824,33316,0.576062524,58640,-806
ZCTA5 30017,7502,0,7502,24782,39.8,10237,1073,10670,0.430554435,3453,21329
ZCTA5 30018,27,0,27,89,30.4,89,0,0,0,0,89
ZCTA5 30019,14742,202,14540,47152,37.4,28172,2259,12071,0.256001866,542,46610
ZCTA5 30021,6563,4462,2101,25987,25.3,2838,6032,14967,0.575941817,10745,15242
ZCTA5 30022,23465,13476,9989,65433,41.4,39213,13221,7858,0.120092308,33286,32147
ZCTA5 30024,27369,10344,17025,83818,39.4,43862,24811,10092,0.120403732,18531,65287
ZCTA5 30025,3691,10103,-6412,10811,45.4,8288,0,2045,0.18915919,31152,-20341
ZCTA5 30028,10423,11716,-1293,32232,38.3,27672,757,679,0.021066021,28474,3758
ZCTA5 30030,12617,12415,202,31856,39.1,21505,1424,5600,0.17579106,30950,906
ZCTA5 30032,16657,12294,4363,45107,38,7019,432,34457,0.763894739,32425,12682
ZCTA5 30033,13112,9252,3860,31144,38.3,20178,4701,4350,0.139673773,23757,7387
ZCTA5 30034,16929,2763,14166,44450,42.7,1984,132,40387,0.908593926,4750,39700
ZCTA5 30035,7588,24178,-16590,22793,35.6,851,198,20636,0.905365682,67332,-44539
ZCTA5 30038,14393,15258,-865,40902,37.8,1506,141,36322,0.888025035,33625,7277
ZCTA5 30039,15744,5682,10062,48485,39.4,11432,1926,29052,0.599195628,15347,33138
ZCTA5 30040,25461,5346,20115,75151,38,56158,7888,3253,0.043286184,15225,59926
ZCTA5 30041,24705,1354,23351,72535,40,52312,13871,2396,0.033032329,2491,70044
ZCTA5 30043,28151,4828,23323,88458,35.4,41022,12697,21682,0.245110674,13663,74795
ZCTA5 30044,30289,681,29608,99613,32.8,36612,13282,29781,0.298967002,2135,97478
ZCTA5 30045,13514,971,12543,45465,33.8,17292,2365,19766,0.434752007,5397,40068
ZCTA5 30046,13865,27,13838,39763,33.2,14561,3394,14163,0.356185398,73,39690
ZCTA5 30047,21533,528,21005,67842,38.4,26955,11864,12887,0.189956074,1557,66285
ZCTA5 30052,24082,2642,21440,73299,35.6,42843,1713,24245,0.330768496,7441,65858
ZCTA5 30054,4296,4104,192,12294,41.8,8803,197,3015,0.245241581,10977,1317
ZCTA5 30055,1392,503,889,3857,42.9,3384,13,109,0.028260306,1355,2502
ZCTA5 30056,786,1459,-673,2358,39.4,2031,5,303,0.128498728,3348,-990
ZCTA5 30058,21719,31,21688,62716,34.1,1568,183,59030,0.941227119,80,62636
ZCTA5 30060,13536,525,13011,39490,31.5,16017,1373,12007,0.304051659,1299,38191
ZCTA5 30062,23232,315,22917,63418,41.5,44897,6117,6960,0.109748021,919,62499
ZCTA5 30064,18038,4055,13983,49178,41.3,32732,1064,11292,0.229614868,11700,37478
ZCTA5 30066,21998,1003,20995,58846,39.6,39689,3627,8959,0.152244842,2111,56735
ZCTA5 30067,19107,127,18980,45584,33,23344,3375,12526,0.2747894,325,45259
ZCTA5 30068,12667,2159,10508,33554,44.7,26726,3402,1382,0.04118734,6160,27394
ZCTA5 30070,48,4156,-4108,108,36.1,108,0,0,0,11597,-11489
ZCTA5 30071,8438,24,8414,25602,31,7650,3240,6765,0.264237169,65,25537
ZCTA5 30072,325,3753,-3428,655,43.6,514,4,128,0.195419847,10900,-10245
ZCTA5 30075,21172,777,20395,55529,43.8,43550,2445,4723,0.085054656,1904,53625
ZCTA5 30076,17237,2674,14563,47070,38,30948,1812,7342,0.155980455,7012,40058
ZCTA5 30078,12934,1171,11763,41311,37.8,18470,4089,14030,0.339618988,3297,38014
ZCTA5 30079,1357,528,829,4042,31.6,966,476,1806,0.446808511,1872,2170
ZCTA5 30080,24527,32,24495,53270,35.1,23346,4670,17468,0.327914398,109,53161
ZCTA5 30082,10757,25,10732,26161,37.5,13836,2012,7449,0.284736822,72,26089
ZCTA5 30083,20719,908,19811,61522,33.4,6381,4488,48131,0.782338025,2499,59023
ZCTA5 30084,15188,26,15162,38784,42.7,18091,5727,8721,0.224860767,41,38743
ZCTA5 30087,13249,617,12632,37933,44.8,9198,2228,24077,0.634724382,1473,36460
ZCTA5 30088,10683,2455,8228,30762,38.2,1324,261,27400,0.890709317,9969,20793
ZCTA5 30090,0,128,-128,0,-,0,0,0,#DIV/0!,197,-197
ZCTA5 30092,15135,161,14974,36526,35.1,17884,3485,9951,0.272436073,463,36063
ZCTA5 30093,18995,684,18311,52048,30.5,13458,5337,13131,0.252286351,2192,49856
ZCTA5 30094,11759,2211,9548,34248,40.5,11078,597,19758,0.576909601,6506,27742
ZCTA5 30096,27057,14706,12351,68709,37.3,27744,12508,15884,0.231177866,41574,27135
ZCTA5 30097,16839,0,16839,45646,43.1,19808,17792,5395,0.118192175,510,45136
ZCTA5 30101,20710,5100,15610,62337,37.4,44927,949,12246,0.196448337,13617,48720
ZCTA5 30102,15034,25,15009,44289,34.1,33843,1206,5632,0.127164759,86,44203
ZCTA5 30103,4881,4237,644,14387,41.3,11855,68,717,0.049836658,12412,1975
ZCTA5 30104,1609,221,1388,5082,43.5,4533,0,389,0.076544667,547,4535
ZCTA5 30105,839,1527,-688,2158,48.9,2128,6,0,0,4506,-2348
ZCTA5 30106,8796,1086,7710,23401,36.1,7008,528,13904,0.594162643,2893,20508
ZCTA5 30107,5916,6669,-753,16089,39.9,14899,162,145,0.009012369,16694,-605
ZCTA5 30108,2938,0,2938,7611,39.9,6612,71,691,0.090789647,0,7611
ZCTA5 30110,5391,1122,4269,14386,38.5,12933,55,793,0.055123036,3142,11244
ZCTA5 30111,0,8651,-8651,0,-,0,0,0,#DIV/0!,25900,-25900
ZCTA5 30113,1884,7375,-5491,5235,37.5,5022,0,132,0.0252149,22075,-16840
ZCTA5 30114,20205,15311,4894,56623,38.7,43525,1121,5019,0.088638892,42387,14236
ZCTA5 30115,16552,8272,8280,49719,39.8,44808,476,2630,0.052897283,29310,20409
ZCTA5 30116,9181,2422,6759,23951,35.9,18189,37,3023,0.126216024,8228,15723
ZCTA5 30117,13142,1252,11890,36311,32.7,23316,408,9841,0.271019801,3467,32844
ZCTA5 30118,0,8565,-8565,984,19.6,327,27,605,0.614837398,19432,-18448
ZCTA5 30120,14309,4303,10006,41212,36.6,32209,47,5465,0.132607008,10394,30818
ZCTA5 30121,9529,821,8708,25199,37.6,19261,709,3023,0.119965078,1968,23231
ZCTA5 30122,10325,4243,6082,25716,34,8397,448,14112,0.548763416,12582,13134
ZCTA5 30124,1248,14906,-13658,2970,42.7,2530,0,385,0.12962963,46466,-43496
ZCTA5 30125,8527,12498,-3971,23384,36.7,16835,244,3342,0.142918235,40455,-17071
ZCTA5 30126,15905,1561,14344,43134,37,18336,1455,17869,0.414267167,4191,38943
ZCTA5 30127,23774,1877,21897,73312,40.2,31266,911,34070,0.464726102,4600,68712
ZCTA5 30132,15927,441,15486,46387,36.4,34663,761,7230,0.155862634,836,45551
ZCTA5 30134,14666,4980,9686,44552,34.9,19982,183,21331,0.478788831,12466,32086
ZCTA5 30135,22315,3210,19105,66599,38.4,29988,1622,30671,0.46053244,7612,58987
ZCTA5 30137,757,1412,-655,2137,36.8,1982,3,95,0.044454843,3813,-1676
ZCTA5 30139,1704,10181,-8477,4620,42,3939,0,253,0.054761905,22757,-18137
ZCTA5 30141,7960,4102,3858,23573,38.5,15169,451,6563,0.278411742,10737,12836
ZCTA5 30143,9728,2569,7159,24681,48.7,22178,90,162,0.006563753,7446,17235
ZCTA5 30144,21225,4007,17218,58952,31.4,34530,3549,13287,0.225386755,11595,47357
ZCTA5 30145,3136,9225,-6089,8752,43.5,7730,23,763,0.087180073,25314,-16562
ZCTA5 30147,1759,9878,-8119,5000,33.4,4773,0,142,0.0284,27537,-22537
ZCTA5 30148,308,2448,-2140,905,57.9,905,0,0,0,7221,-6316
ZCTA5 30149,32,3335,-3303,2021,20,1499,147,335,0.165759525,7807,-5786
ZCTA5 30152,15772,628,15144,43972,41,29726,3237,6922,0.157418357,1577,42395
ZCTA5 30153,6613,994,5619,17836,39.2,15114,209,1933,0.108376318,2697,15139
ZCTA5 30157,16642,6834,9808,49757,35.5,39053,312,7028,0.141246458,17921,31836
ZCTA5 30161,12946,844,12102,34529,40.8,24797,301,7293,0.211213762,2055,32474
ZCTA5 30165,15168,11242,3926,41330,37.2,31286,724,5257,0.127195742,32810,8520
ZCTA5 30168,8993,1373,7620,24737,31.9,4184,107,16164,0.653434127,3941,20796
ZCTA5 30170,1111,343,768,3016,37.7,2676,0,278,0.092175066,646,2370
ZCTA5 30171,922,3257,-2335,2603,41.6,2427,0,56,0.021513638,7074,-4471
ZCTA5 30173,2584,1198,1386,6825,32.2,5768,0,364,0.053333333,3522,3303
ZCTA5 30175,2200,5199,-2999,5523,44.3,4702,0,18,0.003259098,15578,-10055
ZCTA5 30176,3018,7895,-4877,7686,43.9,7024,41,393,0.051131928,21950,-14264
ZCTA5 30177,530,771,-241,1393,52.3,1094,0,251,0.180186648,1648,-255
ZCTA5 30178,1362,2939,-1577,3654,48.4,3320,73,2,0.000547345,7283,-3629
ZCTA5 30179,6450,2863,3587,18370,38.5,14690,22,2793,0.152041372,7819,10551
ZCTA5 30180,13692,934,12758,39825,35.7,25780,706,10642,0.267219083,2199,37626
ZCTA5 30182,1355,1683,-328,3472,47.9,3215,36,75,0.021601382,4220,-748
ZCTA5 30183,2228,2079,149,6480,45.4,5716,10,230,0.035493827,5896,584
ZCTA5 30184,2408,1842,566,6875,39.2,6427,28,102,0.014836364,3883,2992
ZCTA5 30185,1446,2008,-562,3836,41.5,3110,0,294,0.076642336,4881,-1045
ZCTA5 30187,2828,320,2508,7529,45.1,5458,153,1345,0.178642582,766,6763
ZCTA5 30188,24491,1816,22675,64836,40.1,52929,1967,5013,0.077318157,5188,59648
ZCTA5 30189,15093,1462,13631,40471,40,33142,694,3185,0.078698327,4371,36100
ZCTA5 30204,5235,1470,3765,13931,35.7,8543,108,4602,0.330342402,4002,9929
ZCTA5 30205,1199,3085,-1886,3329,46.8,2964,58,28,0.008410934,8609,-5280
ZCTA5 30206,1162,990,172,3573,42.3,3142,0,357,0.099916037,2830,743
ZCTA5 30213,14918,864,14054,43651,33.4,5532,88,36010,0.824952464,2106,41545
ZCTA5 30214,11609,1685,9924,31396,42.7,12585,733,15429,0.49143203,3838,27558
ZCTA5 30215,12780,545,12235,37826,43.4,22727,1535,10583,0.279781103,1263,36563
ZCTA5 30216,865,35,830,1997,45.3,822,12,901,0.451176765,68,1929
ZCTA5 30217,3450,531,2919,9262,41.5,7753,96,1075,0.116065645,1659,7603
ZCTA5 30218,495,918,-423,1406,46.2,1093,0,278,0.19772404,2395,-989
ZCTA5 30220,1888,8041,-6153,5025,36.2,3170,24,1737,0.345671642,22525,-17500
ZCTA5 30222,1905,0,1905,5214,41.7,2503,0,2601,0.498849252,0,5214
ZCTA5 30223,14408,1524,12884,36119,41.5,19734,278,14379,0.398100723,4176,31943
ZCTA5 30224,10521,7347,3174,28445,37.3,18688,339,8075,0.283881174,20414,8031
ZCTA5 30228,15728,10,15718,48687,35,15114,1814,30265,0.621623842,2670,46017
ZCTA5 30229,20,13665,-13645,39,62,39,0,0,0,39582,-39543
ZCTA5 30230,3492,15692,-12200,9742,39.2,7155,350,1846,0.189488811,40575,-30833
ZCTA5 30233,8417,3675,4742,25676,36.9,19347,72,5280,0.205639508,12094,13582
ZCTA5 30234,778,0,778,1668,54.1,722,0,930,0.557553957,1751,-83
ZCTA5 30236,17234,555,16679,51544,32.1,9500,2698,34100,0.661570697,1576,49968
ZCTA5 30238,13754,3915,9839,41966,32.8,5270,332,30468,0.726016299,11700,30266
ZCTA5 30240,11208,1460,9748,31025,36.3,19754,723,9155,0.295084609,4324,26701
ZCTA5 30241,8680,3764,4916,23909,36.3,11208,533,11337,0.474172906,10016,13893
ZCTA5 30248,9861,31,9830,30756,36.6,19382,422,9705,0.315548186,96,30660
ZCTA5 30250,0,1151,-1151,607,34.9,251,0,218,0.359143328,3031,-2424
ZCTA5 30251,725,833,-108,2046,50.7,1540,0,434,0.212121212,2090,-44
ZCTA5 30252,15580,688,14892,47886,37.8,27713,1458,14227,0.297101449,1944,45942
ZCTA5 30253,19653,2184,17469,59328,33.6,17475,1969,34187,0.57623719,6433,52895
ZCTA5 30256,811,1378,-567,2607,42,2528,0,45,0.01726122,4399,-1792
ZCTA5 30257,1477,806,671,4007,44.1,3298,0,443,0.110556526,2670,1337
ZCTA5 30258,967,663,304,2873,43.7,2500,3,183,0.063696485,1672,1201
ZCTA5 30259,1383,2963,-1580,3731,36.7,3112,1,353,0.094612704,8705,-4974
ZCTA5 30260,8301,815,7486,28395,29.5,3458,6242,15429,0.543370312,2445,25950
ZCTA5 30263,21821,6190,15631,59163,36.8,40100,730,14146,0.239102142,16296,42867
ZCTA5 30265,13612,700,12912,35940,39.9,26313,1582,6284,0.174846967,1965,33975
ZCTA5 30268,4151,4386,-235,10942,38.9,5479,244,4568,0.417473954,10711,231
ZCTA5 30269,14655,6541,8114,38881,42.6,30010,2933,2604,0.066973586,16019,22862
ZCTA5 30272,0,2314,-2314,0,-,0,0,0,#DIV/0!,7079,-7079
ZCTA5 30273,6162,981,5181,17522,35.4,4553,485,10926,0.623558954,2833,14689
ZCTA5 30274,12472,4328,8144,33218,33.7,2950,1595,25643,0.771960985,12238,20980
ZCTA5 30275,77,8531,-8454,247,34.5,247,0,0,0,23156,-22909
ZCTA5 30276,6235,5611,624,17887,39.8,15263,142,1668,0.093252083,15378,2509
ZCTA5 30277,8078,415,7663,22142,43.7,18508,445,1761,0.079532111,1086,21056
ZCTA5 30281,26750,3393,23357,71047,38.1,25905,2819,37913,0.533632666,8849,62198
ZCTA5 30284,2,1143,-1141,6,-,0,0,6,1,3110,-3104
ZCTA5 30285,189,10,179,656,44.6,606,0,50,0.076219512,12,644
ZCTA5 30286,9023,31,8992,23848,41.7,15773,59,7282,0.305350554,65,23783
ZCTA5 30288,3432,2989,443,9588,38,1354,65,6417,0.669274093,8596,992
ZCTA5 30289,0,363,-363,0,-,0,0,0,#DIV/0!,1001,-1001
ZCTA5 30290,3199,858,2341,8876,43.8,5520,303,2470,0.278278504,2096,6780
ZCTA5 30291,10331,1404,8927,23693,34.5,1099,0,21710,0.916304394,3614,20079
ZCTA5 30292,2064,3058,-994,6002,35.9,5201,54,491,0.081806065,7752,-1750
ZCTA5 30293,824,5691,-4867,2032,54.9,1171,0,855,0.420767717,16576,-14544
ZCTA5 30294,14862,590,14272,41037,40,2730,538,35855,0.873723713,1286,39751
ZCTA5 30295,1602,13071,-11469,4886,36.9,3978,21,757,0.15493246,38799,-33913
ZCTA5 30296,9971,2611,7360,27457,36.7,1783,1007,23314,0.849109517,7398,20059
ZCTA5 30297,10349,13486,-3137,28629,30.2,7484,1159,15399,0.537881169,39890,-11261
ZCTA5 30303,1019,12217,-11198,6106,21.7,1874,486,3479,0.569767442,33934,-27828
ZCTA5 30305,14045,6418,7627,26398,36.9,21011,1826,2324,0.088036972,16435,9963
ZCTA5 30306,11766,109,11657,24769,37.4,20569,1586,1060,0.04279543,357,24412
ZCTA5 30307,9329,2204,7125,20712,36.3,15421,993,2707,0.13069718,6543,14169
ZCTA5 30308,14082,1405,12677,22802,30.8,12798,1515,6607,0.289755285,3528,19274
ZCTA5 30309,16758,10372,6386,27469,33.1,19850,2438,3078,0.112053588,28363,-894
ZCTA5 30310,11867,16692,-4825,26979,36.4,3348,747,21558,0.79906594,51841,-24862
ZCTA5 30311,14940,1440,13500,33334,38.9,1097,49,30442,0.913241735,3309,30025
ZCTA5 30312,13207,0,13207,23801,32.8,10508,1116,10863,0.456409395,0,23801
ZCTA5 30313,3293,7284,-3991,11894,21.7,4496,1868,5046,0.42424752,19281,-7387
ZCTA5 30314,7726,579,7147,23987,28.2,2701,860,19172,0.799266269,1627,22360
ZCTA5 30315,13126,958,12168,35324,34.5,5198,156,27868,0.788925377,2142,33182
ZCTA5 30316,14768,643,14125,34810,36.4,13675,1172,17074,0.490491238,1810,33000
ZCTA5 30317,5997,1215,4782,14258,35.9,7041,241,5520,0.387151073,3113,11145
ZCTA5 30318,24206,1956,22250,58839,30.6,20421,3443,31133,0.529121841,5945,52894
ZCTA5 30319,20064,14490,5574,43244,36.8,32126,2755,4584,0.106003145,41739,1505
ZCTA5 30322,0,1401,-1401,2605,19.7,1242,482,779,0.299040307,3426,-821
ZCTA5 30324,16631,1876,14755,30128,34.3,17460,2958,7011,0.232707116,5989,24139
ZCTA5 30326,4929,2878,2051,7207,38.3,4657,960,1429,0.198279451,8514,-1307
ZCTA5 30327,9778,12406,-2628,22932,46.6,19949,905,1515,0.066064887,30631,-7699
ZCTA5 30328,17215,3059,14156,37279,38.8,24287,4002,6959,0.186673462,6978,30301
ZCTA5 30329,11045,504,10541,26891,30.3,14316,1804,5357,0.199211632,1416,25475
ZCTA5 30331,24808,5860,18948,63330,37.4,1314,159,60698,0.958439918,16454,46876
ZCTA5 30332,0,1392,-1392,2708,20.1,1297,481,781,0.288404727,4687,-1979
ZCTA5 30334,0,32,-32,0,-,0,0,0,#DIV/0!,104,-104
ZCTA5 30336,193,3938,-3745,327,47.3,53,25,249,0.76146789,9326,-8999
ZCTA5 30337,5315,2713,2602,12559,33,1501,203,10164,0.809300104,7789,4770
ZCTA5 30338,15672,3277,12395,38553,37.7,24841,7065,4384,0.113713589,9007,29546
ZCTA5 30339,17759,44,17715,33230,33.9,17179,3370,9470,0.284983449,227,33003
ZCTA5 30340,10573,871,9702,30345,31.9,13221,3994,5633,0.1856319,2399,27946
ZCTA5 30341,13852,1932,11920,33131,33.1,17269,2984,5474,0.165222903,5928,27203
ZCTA5 30342,14491,290,14201,32480,32.5,24796,1343,3495,0.10760468,662,31818
ZCTA5 30344,14947,800,14147,35380,34.8,6390,555,26432,0.747088751,2130,33250
ZCTA5 30345,10491,46,10445,24823,37.6,15321,1462,5521,0.222414696,97,24726
ZCTA5 30346,3149,1819,1330,4711,33.7,1951,1431,1168,0.247930376,4710,1
ZCTA5 30349,30974,13479,17495,80047,33.9,3004,597,72486,0.905542993,39972,40075
ZCTA5 30350,18407,850,17557,37635,36,21670,1861,10492,0.278783048,2173,35462
ZCTA5 30354,6273,0,6273,15323,33.8,2482,365,9850,0.642824512,460,14863
ZCTA5 30360,5369,10404,-5035,15866,34.4,8603,1440,1726,0.108786083,31189,-15323
ZCTA5 30363,2042,3033,-991,3783,30.4,1525,984,1139,0.301083796,8236,-4453
ZCTA5 30401,5054,13522,-8468,13693,36.1,7536,0,5174,0.377857299,41247,-27554
ZCTA5 30410,607,757,-150,1537,48.1,1227,0,269,0.175016265,2006,-469
ZCTA5 30411,767,3268,-2501,3816,38.7,2267,0,1527,0.400157233,7679,-3863
ZCTA5 30412,51,186,-135,109,68.2,109,0,0,0,406,-297
ZCTA5 30413,590,511,79,1489,47.5,964,0,523,0.351242445,1227,262
ZCTA5 30414,10,363,-353,41,44.3,41,0,0,0,1061,-1020
ZCTA5 30415,2448,307,2141,5716,45.3,4820,65,613,0.107242827,975,4741
ZCTA5 30417,3973,605,3368,11105,37.1,6297,31,3039,0.273660513,1707,9398
ZCTA5 30420,713,6373,-5660,1921,42.8,1205,49,231,0.12024987,16999,-15078
ZCTA5 30421,1139,1631,-492,2750,42.6,1785,0,707,0.257090909,4058,-1308
ZCTA5 30423,25,4762,-4737,58,50.5,53,0,0,0,14444,-14386
ZCTA5 30425,493,1509,-1016,1324,37.6,993,3,295,0.222809668,3969,-2645
ZCTA5 30426,371,6410,-6039,1094,41,500,0,594,0.542961609,16838,-15744
ZCTA5 30427,3955,124,3831,10332,38,6874,58,2299,0.222512582,357,9975
ZCTA5 30428,729,10887,-10158,3818,22,2758,0,1008,0.264012572,26221,-22403
ZCTA5 30429,53,1062,-1009,204,18.3,8,64,132,0.647058824,6820,-6616
ZCTA5 30434,1880,20339,-18459,5241,38.3,1261,0,3805,0.726006487,61149,-55908
ZCTA5 30436,4276,18719,-14443,11672,38.8,8684,12,2111,0.180860178,49460,-37788
ZCTA5 30439,3845,17343,-13498,10524,41.1,6993,44,2380,0.226149753,37964,-27440
ZCTA5 30441,674,0,674,1843,38.8,1154,2,614,0.333152469,247,1596
ZCTA5 30442,3329,1092,2237,8595,42.6,4994,68,2851,0.331704479,4706,3889
ZCTA5 30445,984,1199,-215,3471,40.4,1719,31,1570,0.452319216,2984,487
ZCTA5 30446,507,80,427,1657,36.6,1145,0,442,0.266747133,172,1485
ZCTA5 30448,5,5227,-5222,27,20.8,7,0,20,0.740740741,14355,-14328
ZCTA5 30449,23,1889,-1866,46,34.6,46,0,0,0,4942,-4896
ZCTA5 30450,800,386,414,2018,43.1,1355,0,600,0.297324083,1141,877
ZCTA5 30451,15,6284,-6269,38,69.2,24,0,0,0,18144,-18106
ZCTA5 30452,532,475,57,1488,42.8,1064,41,255,0.171370968,1338,150
ZCTA5 30453,2231,402,1829,9807,35.6,4209,34,3550,0.361986336,1033,8774
ZCTA5 30454,133,570,-437,437,36.5,244,0,66,0.151029748,3052,-2615
ZCTA5 30455,283,4539,-4256,530,58,441,0,57,0.10754717,14215,-13685
ZCTA5 30456,914,8342,-7428,1936,43.6,1054,0,791,0.40857438,22152,-20216
ZCTA5 30457,1820,403,1417,5007,46.2,3252,26,1665,0.332534452,1101,3906
ZCTA5 30458,16409,575,15834,48031,23.8,26505,923,16901,0.351876913,1707,46324
ZCTA5 30460,0,562,-562,108,-,36,0,72,0.666666667,3102,-2994
ZCTA5 30461,6712,859,5853,16617,38.1,12345,85,3328,0.200276825,2359,14258
ZCTA5 30464,30,869,-839,222,17.6,65,36,92,0.414414414,2367,-2145
ZCTA5 30467,3927,10460,-6533,11780,42.9,6283,143,5177,0.439473684,28702,-16922
ZCTA5 30470,371,466,-95,1012,33.9,964,0,0,0,1251,-239
ZCTA5 30471,1490,5957,-4467,4515,36.6,2733,0,1569,0.347508306,14479,-9964
ZCTA5 30473,1078,8386,-7308,2674,45.3,1972,24,418,0.15632012,20573,-17899
ZCTA5 30474,6022,478,5544,16983,35.5,10471,217,4948,0.291350174,1657,15326
ZCTA5 30477,1048,3791,-2743,2843,41.1,614,0,2091,0.735490679,11039,-8196
ZCTA5 30501,10544,2180,8364,31121,33.1,20342,144,4904,0.157578484,5540,25581
ZCTA5 30504,8643,5562,3081,26638,33.1,19009,1012,1410,0.052931902,15989,10649
ZCTA5 30506,16202,6607,9595,45327,44.3,40703,404,921,0.020319015,19834,25493
ZCTA5 30507,8339,2314,6025,30009,34.4,19222,697,3820,0.127295145,7065,22944
ZCTA5 30510,2484,4703,-2219,9025,34.1,7224,245,643,0.071246537,13179,-4154
ZCTA5 30511,1092,735,357,3316,39.9,2604,44,1,0.000301568,1682,1634
ZCTA5 30512,9519,392,9127,22733,55.5,21456,65,186,0.008181938,1330,21403
ZCTA5 30513,5431,4564,867,12363,50,11903,88,26,0.002103049,12551,-188
ZCTA5 30516,915,1171,-256,2688,38.5,2360,0,139,0.05171131,3654,-966
ZCTA5 30517,5533,316,5217,15825,36.5,13223,333,790,0.049921011,711,15114
ZCTA5 30518,17781,0,17781,55708,36.5,35037,3561,7347,0.13188411,0,55708
ZCTA5 30519,16943,388,16555,55350,37.1,32297,6397,10152,0.183414634,1092,54258
ZCTA5 30520,1595,668,927,5367,30.8,4056,53,725,0.135084777,2101,3266
ZCTA5 30521,1683,924,759,5183,37.9,4847,166,148,0.028554891,2686,2497
ZCTA5 30522,353,49,304,682,65.7,649,0,0,0,83,599
ZCTA5 30523,4800,1341,3459,12562,49.6,11770,119,257,0.020458526,3434,9128
ZCTA5 30525,3092,3929,-837,7556,49.2,6903,0,88,0.011646374,11071,-3515
ZCTA5 30527,1499,693,806,3936,44.6,3785,16,83,0.021087398,1621,2315
ZCTA5 30528,8431,347,8084,24001,43.2,22324,136,279,0.011624516,903,23098
ZCTA5 30529,4135,52,4083,12009,36.2,9349,198,1576,0.131234907,161,11848
ZCTA5 30530,2800,2933,-133,7831,37.3,7136,157,239,0.030519729,8274,-443
ZCTA5 30531,3806,616,3190,10996,37.2,8105,431,418,0.038013823,1698,9298
ZCTA5 30533,9396,3092,6304,26983,37.5,25146,494,311,0.011525775,9379,17604
ZCTA5 30534,10741,754,9987,29695,43.1,27913,206,224,0.007543357,2107,27588
ZCTA5 30535,2937,718,2219,8416,38.2,7528,65,180,0.021387833,1844,6572
ZCTA5 30536,3598,905,2693,9505,45.3,8790,89,99,0.010415571,1932,7573
ZCTA5 30537,608,15944,-15336,1172,62.9,1093,78,0,0,44340,-43168
ZCTA5 30538,1268,0,1268,3434,47.8,3107,0,205,0.059697146,255,3179
ZCTA5 30539,109,1923,-1814,225,29.6,225,0,0,0,5499,-5274
ZCTA5 30540,8127,3390,4737,19621,49.5,18018,6,71,0.003618572,9099,10522
ZCTA5 30541,709,352,357,1383,63.4,1202,0,31,0.02241504,921,462
ZCTA5 30542,12642,470,12172,37193,39.7,30001,929,1871,0.050305165,1091,36102
ZCTA5 30543,1698,57,1641,6107,34.3,4322,0,153,0.025053218,193,5914
ZCTA5 30545,375,1443,-1068,893,57.1,854,17,2,0.002239642,5387,-4494
ZCTA5 30546,3623,7193,-3570,7720,58.9,7335,41,106,0.01373057,20206,-12486
ZCTA5 30547,1012,544,468,2889,35.7,2606,30,114,0.039460021,1512,1377
ZCTA5 30548,7949,529,7420,23006,43.4,19620,1023,1313,0.057072068,1419,21587
ZCTA5 30549,9347,564,8783,29191,38.3,24390,585,2839,0.097256004,1710,27481
ZCTA5 30552,633,737,-104,1600,44.8,1537,13,12,0.0075,1985,-385
ZCTA5 30553,3362,1416,1946,8019,48.4,6366,42,1180,0.147150518,3203,4816
ZCTA5 30554,2960,497,2463,8227,41.7,6920,171,457,0.055548803,1068,7159
ZCTA5 30555,1313,1292,21,2676,47.2,2300,2,0,0,3308,-632
ZCTA5 30557,1867,788,1079,4652,44.5,4138,13,363,0.078030954,2036,2616
ZCTA5 30558,1759,47,1712,4951,48.3,4679,20,56,0.011310846,47,4904
ZCTA5 30559,1871,3872,-2001,4507,52.5,4345,8,0,0,10065,-5558
ZCTA5 30560,1901,118,1783,4230,55.5,3984,17,8,0.001891253,279,3951
ZCTA5 30562,244,35,209,778,27.3,516,0,0,0,96,682
ZCTA5 30563,1955,405,1550,6438,36.1,5290,38,4,0.000621311,1313,5125
ZCTA5 30564,1706,2849,-1143,4447,45.5,4221,9,0,0,9463,-5016
ZCTA5 30565,1485,19103,-17618,3959,43.4,3395,126,159,0.040161657,50323,-46364
ZCTA5 30566,2968,1672,1296,8590,32.5,6011,291,604,0.070314319,5107,3483
ZCTA5 30567,1224,275,949,3691,36,2985,168,235,0.063668383,643,3048
ZCTA5 30568,748,1327,-579,1948,49.9,1825,0,85,0.043634497,5119,-3171
ZCTA5 30571,1512,2655,-1143,3227,58.6,2733,14,207,0.064146266,6464,-3237
ZCTA5 30572,467,10799,-10332,1010,61.1,956,0,29,0.028712871,28575,-27565
ZCTA5 30573,83,346,-263,88,88.2,88,0,0,0,719,-631
ZCTA5 30575,581,2271,-1690,2039,35.5,1379,0,0,0,7389,-5350
ZCTA5 30576,1052,478,574,3189,47.1,2845,5,42,0.013170273,1036,2153
ZCTA5 30577,8211,881,7330,22052,40.8,17797,281,2615,0.118583348,3150,18902
ZCTA5 30581,31,3314,-3283,232,75.1,230,0,2,0.00862069,9176,-8944
ZCTA5 30582,1869,12433,-10564,5001,46.3,4687,4,173,0.034593081,30395,-25394
ZCTA5 30597,0,9924,-9924,1192,19.6,934,8,187,0.156879195,30332,-29140
ZCTA5 30598,7,15,-8,7,-,7,0,0,0,1323,-1316
ZCTA5 30601,10110,12161,-2051,23186,27.8,13090,382,7762,0.334770982,31568,-8382
ZCTA5 30602,0,6571,-6571,1613,19.2,943,328,249,0.154370738,16174,-14561
ZCTA5 30605,17251,0,17251,42473,26.4,27441,2143,10275,0.241918395,0,42473
ZCTA5 30606,20625,5707,14918,47448,32.7,30150,1803,11776,0.248187489,16127,31321
ZCTA5 30607,4379,6714,-2335,10769,38.6,6318,38,3271,0.303742223,19512,-8743
ZCTA5 30609,0,5065,-5065,3933,19,2662,421,552,0.140350877,13963,-10030
ZCTA5 30619,645,1877,-1232,1392,53.4,1292,0,35,0.025143678,5264,-3872
ZCTA5 30620,4359,2928,1431,13262,35,10266,286,1646,0.12411401,8689,4573
ZCTA5 30621,2014,862,1152,5571,43.8,4973,62,200,0.035900197,2253,3318
ZCTA5 30622,4202,0,4202,11684,37.9,9609,526,778,0.066586785,0,11684
ZCTA5 30623,29,2457,-2428,107,43.8,104,0,3,0.028037383,7297,-7190
ZCTA5 30624,1234,202,1032,3878,39.2,3241,82,545,0.140536359,392,3486
ZCTA5 30625,951,2389,-1438,2209,54.1,1820,0,379,0.171570847,6452,-4243
ZCTA5 30627,871,420,451,2577,41.4,1976,120,326,0.126503686,1078,1499
ZCTA5 30628,2105,5471,-3366,6707,38.8,5546,1,828,0.123453109,15190,-8483
ZCTA5 30629,1806,15222,-13416,5228,43.4,4092,278,437,0.08358837,40706,-35478
ZCTA5 30630,932,0,932,2613,39.5,1561,13,1000,0.382701875,1600,1013
ZCTA5 30631,614,2247,-1633,1645,46.8,627,0,869,0.528267477,8531,-6886
ZCTA5 30633,2709,3233,-524,8213,36,6961,46,265,0.03226592,9479,-1266
ZCTA5 30634,726,139,587,1713,47.5,1697,0,10,0.005837712,360,1353
ZCTA5 30635,6321,3669,2652,15223,42.6,9074,115,5011,0.329172962,9280,5943
ZCTA5 30639,0,2351,-2351,0,-,0,0,0,#DIV/0!,6406,-6406
ZCTA5 30641,712,7542,-6830,1602,49,1402,0,134,0.083645443,21012,-19410
ZCTA5 30642,5660,721,4939,13601,52.9,8764,110,3723,0.273729873,1627,11974
ZCTA5 30643,6325,7322,-997,15634,48.1,11168,230,3775,0.241460919,20717,-5083
ZCTA5 30646,2891,6636,-3745,7092,44.1,5706,0,1135,0.160039481,20062,-12970
ZCTA5 30648,1005,66,939,2939,44.4,2366,0,532,0.18101395,111,2828
ZCTA5 30650,5042,1396,3646,13484,41.1,9417,0,3597,0.266760605,3224,10260
ZCTA5 30655,9205,3067,6138,26925,35.6,18964,205,6949,0.258087279,9057,17868
ZCTA5 30656,5983,2415,3568,17510,42.2,12816,96,3462,0.197715591,6509,11001
ZCTA5 30660,308,8137,-7829,1117,27.6,916,0,201,0.179946285,20254,-19137
ZCTA5 30662,3083,11326,-8243,8371,37.1,7298,138,755,0.090192331,31355,-22984
ZCTA5 30663,1006,13390,-12384,3066,40.1,2188,20,564,0.183953033,36453,-33387
ZCTA5 30664,13,13436,-13423,13,42.3,5,0,8,0.615384615,34865,-34852
ZCTA5 30665,94,2712,-2618,218,37.6,5,0,213,0.97706422,7118,-6900
ZCTA5 30666,3314,3343,-29,9748,38.2,7898,150,1181,0.121153057,10315,-567
ZCTA5 30667,382,0,382,806,56.7,726,2,72,0.089330025,290,516
ZCTA5 30668,854,9928,-9074,2255,42.3,1269,0,960,0.425720621,24102,-21847
ZCTA5 30669,1065,3771,-2706,3149,39.4,1408,89,1390,0.441409971,8082,-4933
ZCTA5 30673,2955,4290,-1335,6661,48.9,3271,0,2817,0.422909473,11366,-4705
ZCTA5 30677,6944,21026,-14082,20229,42.4,16853,791,1170,0.057837758,53818,-33589
ZCTA5 30678,454,5826,-5372,1311,45.3,621,1,675,0.514874142,15346,-14035
ZCTA5 30680,16081,7631,8450,46657,36.6,33498,2122,6179,0.132434576,21432,25225
ZCTA5 30683,2809,3565,-756,7702,40.2,5228,65,1776,0.230589457,9875,-2173
ZCTA5 30701,14424,807,13617,41355,36.8,33318,580,1498,0.036222948,2284,39071
ZCTA5 30705,11792,6335,5457,33347,38.1,31415,177,272,0.008156656,16686,16661
ZCTA5 30707,6389,5522,867,16986,40.6,15909,36,609,0.035853055,14293,2693
ZCTA5 30708,135,271,-136,289,53,289,0,0,0,766,-477
ZCTA5 30710,2447,1389,1058,7106,40.5,6380,48,182,0.025612159,3259,3847
ZCTA5 30711,1421,8110,-6689,3547,40,3470,13,0,0,21585,-18038
ZCTA5 30720,8962,6935,2027,26725,36.4,20898,808,887,0.033189897,14570,12155
ZCTA5 30721,18395,4892,13503,53180,35.4,44723,514,1929,0.036273035,13932,39248
ZCTA5 30724,13,0,13,38,30.7,24,14,0,0,0,38
ZCTA5 30725,1422,10588,-9166,4588,43.1,4300,0,227,0.049476896,28217,-23629
ZCTA5 30726,0,466,-466,0,-,0,0,0,#DIV/0!,844,-844
ZCTA5 30728,7515,357,7158,19283,39.5,17129,307,716,0.037131152,1071,18212
ZCTA5 30730,667,6258,-5591,1822,47.3,1706,1,31,0.01701427,16625,-14803
ZCTA5 30731,963,4291,-3328,2323,35.3,2239,0,3,0.001291433,12506,-10183
ZCTA5 30733,888,3105,-2217,2451,45.9,2234,72,5,0.002039984,10753,-8302
ZCTA5 30734,1207,5369,-4162,3042,50.3,2757,0,8,0.002629849,13980,-10938
ZCTA5 30735,2227,957,1270,7220,40.2,6390,254,262,0.036288089,2289,4931
ZCTA5 30736,15792,1482,14310,43284,41,39957,701,969,0.022387025,4374,38910
ZCTA5 30738,1452,291,1161,3712,44.2,3639,0,34,0.009159483,608,3104
ZCTA5 30739,2253,5643,-3390,7031,40.6,6523,0,156,0.022187456,16115,-9084
ZCTA5 30740,3057,2181,876,8238,41,7659,1,120,0.014566642,7990,248
ZCTA5 30741,11613,94,11519,28639,43.5,25995,273,1024,0.035755438,927,27712
ZCTA5 30742,3324,7396,-4072,7539,40.5,6287,246,409,0.054251227,20608,-13069
ZCTA5 30746,390,878,-488,1228,38.9,1228,0,0,0,1883,-655
ZCTA5 30747,5898,306,5592,14496,44.5,12806,12,1121,0.077331678,885,13611
ZCTA5 30750,1165,371,794,4173,27,3780,70,89,0.021327582,1138,3035
ZCTA5 30751,42,362,-320,148,29.5,148,0,0,0,1039,-891
ZCTA5 30752,3522,1732,1790,8885,43.5,8347,89,61,0.006865504,4477,4408
ZCTA5 30753,2365,1858,507,8560,35.4,6353,0,1278,0.149299065,7265,1295
ZCTA5 30755,3662,1037,2625,10775,32.4,9717,6,241,0.022366589,2847,7928
ZCTA5 30756,16,45,-29,24,49.5,24,0,0,0,155,-131
ZCTA5 30757,938,1154,-216,1964,59.6,1845,15,76,0.038696538,2999,-1035
ZCTA5 30802,2010,7187,-5177,6568,48,5314,47,1011,0.153928136,20171,-13603
ZCTA5 30803,321,1152,-831,1136,35.5,997,0,88,0.077464789,2856,-1720
ZCTA5 30805,772,86,686,2204,42,1820,0,263,0.119328494,306,1898
ZCTA5 30807,82,673,-591,250,36.7,36,0,214,0.856,2244,-1994
ZCTA5 30808,1512,496,1016,4427,37.1,3104,0,1064,0.240343348,1138,3289
ZCTA5 30809,15401,831,14570,51985,39.5,39714,2297,5781,0.111205155,1929,50056
ZCTA5 30810,691,1481,-790,2096,43,1815,0,263,0.125477099,4527,-2431
ZCTA5 30812,0,384,-384,330,73.5,211,0,119,0.360606061,1086,-756
ZCTA5 30813,13260,410,12850,45178,33.8,27722,898,10955,0.24248528,988,44190
ZCTA5 30814,3439,2188,1251,11201,35.2,7323,0,3256,0.290688331,5706,5495
ZCTA5 30815,13900,11961,1939,42342,35.6,12499,529,25927,0.612323461,33958,8384
ZCTA5 30816,813,13181,-12368,1783,55.2,1184,31,502,0.281547953,33643,-31860
ZCTA5 30817,2860,7683,-4823,7389,47.3,5019,6,2114,0.286100961,20985,-13596
ZCTA5 30818,207,1309,-1102,538,40.9,306,0,232,0.431226766,3775,-3237
ZCTA5 30820,439,3943,-3504,921,52,769,0,148,0.160694897,10629,-9708
ZCTA5 30821,375,767,-392,1017,50.9,485,0,532,0.523107178,2004,-987
ZCTA5 30822,0,15,-15,0,-,0,0,0,#DIV/0!,74,-74
ZCTA5 30823,495,331,164,1262,42.2,915,5,232,0.183835182,1001,261
ZCTA5 30824,6620,559,6061,17006,39,8311,111,7828,0.460308127,1331,15675
ZCTA5 30828,1331,1539,-208,3739,42.7,1332,8,2320,0.620486761,3732,7
ZCTA5 30830,5021,102,4919,14934,35.1,6273,94,8087,0.541516004,208,14726
ZCTA5 30833,1345,374,971,3942,39.6,1980,43,1737,0.440639269,931,3011
ZCTA5 30901,7004,133,6871,17143,38.1,2824,46,13705,0.799451671,478,16665
ZCTA5 30904,10403,297,10106,27125,33.5,12395,472,12708,0.468497696,698,26427
ZCTA5 30905,820,3648,-2828,7933,22,4671,364,1804,0.227404513,10277,-2344
ZCTA5 30906,20718,2223,18495,61719,34.7,16912,294,40918,0.662972504,5835,55884
ZCTA5 30907,17312,2209,15103,47655,39.3,34907,3489,6922,0.145252334,5825,41830
ZCTA5 30909,17467,3476,13991,42498,36.4,18873,1439,18323,0.431149701,9771,32727
ZCTA5 30912,0,1063,-1063,0,-,0,0,0,#DIV/0!,2783,-2783
ZCTA5 31001,825,348,477,4501,39.7,2472,0,1890,0.419906687,827,3674
ZCTA5 31002,1081,3911,-2830,3332,36.1,3059,6,214,0.06422569,10141,-6809
ZCTA5 31003,48,606,-558,87,64.8,87,0,0,0,2001,-1914
ZCTA5 31004,0,1630,-1630,0,-,0,0,0,#DIV/0!,4861,-4861
ZCTA5 31005,6972,3461,3511,20791,34.8,13522,489,4588,0.220672406,9107,11684
ZCTA5 31006,1779,2046,-267,4527,40.8,1888,0,2506,0.553567484,5559,-1032
ZCTA5 31007,291,1257,-966,774,56.1,359,0,304,0.392764858,3411,-2637
ZCTA5 31008,7897,379,7518,20955,42,14383,140,5572,0.265903126,1096,19859
ZCTA5 31009,487,508,-21,1582,28.8,1393,2,81,0.051201011,1496,86
ZCTA5 31011,239,1004,-765,664,39.8,477,0,187,0.281626506,3275,-2611
ZCTA5 31012,365,0,365,2590,40.8,1247,0,1247,0.481467181,1667,923
ZCTA5 31014,4303,0,4303,12784,36.6,8370,45,4142,0.323998748,296,12488
ZCTA5 31015,7238,8354,-1116,19401,39.4,9728,26,9228,0.475645585,21677,-2276
ZCTA5 31016,698,11666,-10968,1998,50.3,829,0,1165,0.583083083,34725,-32727
ZCTA5 31017,598,10752,-10154,1576,55.7,1302,5,240,0.152284264,25700,-24124
ZCTA5 31018,525,5802,-5277,2785,38.7,1076,0,1495,0.536804309,15395,-12610
ZCTA5 31019,956,386,570,2899,37.7,2153,0,471,0.162469817,1027,1872
ZCTA5 31020,629,395,234,1362,52.9,673,0,653,0.479441997,983,379
ZCTA5 31021,9944,2320,7624,27821,41.6,13477,145,13797,0.495920348,6606,21215
ZCTA5 31022,661,1048,-387,1808,38.6,1406,0,385,0.212942478,2761,-953
ZCTA5 31023,4980,3504,1476,14153,41.3,10456,68,3232,0.228361478,10738,3415
ZCTA5 31024,8850,170,8680,20644,47.4,14211,45,5481,0.265500872,447,20197
ZCTA5 31025,376,7477,-7101,999,45.8,765,0,167,0.167167167,19728,-18729
ZCTA5 31027,3715,176,3539,10202,35.5,6457,0,3202,0.313860027,529,9673
ZCTA5 31028,2065,3376,-1311,6170,33.8,3138,406,2354,0.381523501,9105,-2935
ZCTA5 31029,5978,680,5298,16524,41,11723,82,4170,0.252360203,1842,14682
ZCTA5 31030,5955,322,5633,17461,34.2,7028,54,9193,0.526487601,828,16633
ZCTA5 31031,2232,761,1471,6488,33.5,4384,0,1914,0.295006165,1996,4492
ZCTA5 31032,5353,153,5200,15141,38.9,11576,68,3034,0.200383066,447,14694
ZCTA5 31033,826,1148,-322,2531,40.4,1873,13,568,0.224417226,3122,-591
ZCTA5 31034,33,81,-48,166,18.5,0,0,166,1,158,8
ZCTA5 31035,382,1027,-645,1003,45.5,617,5,336,0.334995015,3319,-2316
ZCTA5 31036,3245,6853,-3608,10348,43.6,5814,37,4092,0.395438732,19222,-8874
ZCTA5 31037,657,328,329,3008,38.3,1679,6,1208,0.401595745,1249,1759
ZCTA5 31038,398,3802,-3404,945,57.8,753,0,144,0.152380952,10248,-9303
ZCTA5 31039,0,7987,-7987,0,-,0,0,0,#DIV/0!,23293,-23293
ZCTA5 31041,285,578,-293,885,32.3,338,8,539,0.609039548,1447,-562
ZCTA5 31042,521,1096,-575,1437,49.8,335,0,1071,0.745302714,2862,-1425
ZCTA5 31044,966,8496,-7530,2878,47.1,840,41,1952,0.678248784,23338,-20460
ZCTA5 31045,27,2163,-2136,27,-,11,0,16,0.592592593,6293,-6266
ZCTA5 31046,1323,173,1150,3365,48.2,2630,0,678,0.201485884,568,2797
ZCTA5 31047,5722,1306,4416,16375,38.5,11114,820,3000,0.183206107,3328,13047
ZCTA5 31049,604,2115,-1511,1731,33.2,1557,0,85,0.049104564,6150,-4419
ZCTA5 31050,446,937,-491,831,60.6,736,0,81,0.097472924,2827,-1996
ZCTA5 31051,33,875,-842,82,34,20,0,31,0.37804878,2267,-2185
ZCTA5 31052,3033,3412,-379,9462,42.8,6521,186,2191,0.23155781,10328,-866
ZCTA5 31054,461,849,-388,1384,33.4,777,0,490,0.354046243,2298,-914
ZCTA5 31055,1256,684,572,6118,39.8,2996,9,1734,0.283425956,1829,4289
ZCTA5 31057,728,380,348,1495,55.6,728,0,702,0.469565217,1073,422
ZCTA5 31058,630,308,322,1633,33.6,1506,0,57,0.034905083,847,786
ZCTA5 31060,680,533,147,1777,45.7,1194,6,545,0.30669668,1673,104
ZCTA5 31061,15344,3256,12088,41678,36.6,22177,660,17259,0.414103364,10575,31103
ZCTA5 31062,0,603,-603,59,20.4,0,0,23,0.389830508,1703,-1644
ZCTA5 31063,1618,601,1017,4707,41.2,1629,94,2842,0.603781602,1800,2907
ZCTA5 31064,3489,4447,-958,9550,39.6,7128,15,1990,0.208376963,12008,-2458
ZCTA5 31065,526,9481,-8955,1573,48.7,1137,0,365,0.232040687,23646,-22073
ZCTA5 31066,445,2641,-2196,1299,50.1,595,0,704,0.54195535,8558,-7259
ZCTA5 31067,80,9608,-9528,227,55.3,151,0,53,0.233480176,26905,-26678
ZCTA5 31068,1163,741,422,4990,36.2,1372,0,3313,0.663927856,2317,2673
ZCTA5 31069,9096,568,8528,22927,39.1,14966,572,6548,0.285602128,1377,21550
ZCTA5 31070,368,238,130,1017,50.8,608,0,402,0.395280236,789,228
ZCTA5 31071,424,843,-419,1294,40.2,633,0,653,0.504636785,2208,-914
ZCTA5 31072,396,2145,-1749,1083,45.1,939,0,104,0.096029548,6306,-5223
ZCTA5 31075,926,1840,-914,2702,43.6,2078,0,484,0.179126573,5351,-2649
ZCTA5 31076,1040,1060,-20,2736,45.1,2056,20,643,0.23501462,3111,-375
ZCTA5 31077,376,1725,-1349,1166,40.5,620,0,530,0.454545455,4818,-3652
ZCTA5 31078,1208,702,506,3034,47,1533,0,1468,0.483849703,2116,918
ZCTA5 31079,1039,2264,-1225,2627,45.5,1961,0,657,0.250095166,6455,-3828
ZCTA5 31081,22,66,-44,22,-,22,0,0,0,189,-167
ZCTA5 31082,3950,1865,2085,10255,40.8,4714,120,5106,0.497903462,5549,4706
ZCTA5 31083,96,212,-116,427,36.8,384,0,43,0.100702576,448,-21
ZCTA5 31084,0,70,-70,0,-,0,0,0,#DIV/0!,230,-230
ZCTA5 31085,414,802,-388,1150,51.8,619,0,388,0.337391304,2746,-1596
ZCTA5 31087,3030,2062,968,8922,47.7,2185,3,6594,0.739071957,5376,3546
ZCTA5 31088,20733,3114,17619,56997,33.7,32392,2862,18383,0.322525747,8916,48081
ZCTA5 31089,1606,197,1409,4238,37.7,1592,6,2533,0.597687588,447,3791
ZCTA5 31090,410,2112,-1702,1188,56.5,798,0,379,0.319023569,5680,-4492
ZCTA5 31091,1207,324,883,4185,44,2138,0,1922,0.459259259,913,3272
ZCTA5 31092,2001,793,1208,5430,37.9,2221,0,2959,0.544935543,1878,3552
ZCTA5 31093,11100,1074,10026,26498,37.5,12439,275,11829,0.44641105,2846,23652
ZCTA5 31094,321,895,-574,710,54.2,330,0,348,0.490140845,2476,-1766
ZCTA5 31096,2429,1053,1376,7353,40.8,3890,14,3116,0.42377261,2828,4525
ZCTA5 31097,478,475,3,1437,49.5,1286,0,116,0.08072373,1406,31
ZCTA5 31098,1077,852,225,3721,26,1768,98,1630,0.438054286,2110,1611
ZCTA5 31201,3500,1225,2275,7240,33.6,2717,60,4221,0.58301105,3163,4077
ZCTA5 31204,11866,82,11784,30715,35.2,9399,525,19285,0.627869119,181,30534
ZCTA5 31206,9020,2635,6385,27238,30.8,3604,87,21963,0.806336735,6980,20258
ZCTA5 31207,0,389,-389,1728,19.9,974,193,514,0.297453704,906,822
ZCTA5 31210,13962,3337,10625,34106,37.5,18863,1902,11306,0.331495924,7650,26456
ZCTA5 31211,6132,8063,-1931,15008,40.1,4779,1,9763,0.650519723,21748,-6740
ZCTA5 31213,0,12937,-12937,0,-,0,0,0,#DIV/0!,31007,-31007
ZCTA5 31216,6202,2709,3493,17533,42.3,11246,284,4768,0.271944334,19459,-1926
ZCTA5 31217,6168,8880,-2712,16950,39.8,7504,105,8657,0.510737463,20729,-3779
ZCTA5 31220,5907,21072,-15165,15393,42,8016,319,6729,0.437146755,57265,-41872
ZCTA5 31301,1610,13894,-12284,3915,35.3,1431,48,1856,0.474074074,33801,-29886
ZCTA5 31302,3027,9923,-6896,8084,46.2,7333,81,431,0.05331519,28493,-20409
ZCTA5 31303,1088,2050,-962,2501,49.3,1942,0,492,0.196721311,5159,-2658
ZCTA5 31305,2235,943,1292,5183,49.6,3163,0,1802,0.347675092,2937,2246
ZCTA5 31307,448,4973,-4525,1432,32.7,1416,0,16,0.011173184,14034,-12602
ZCTA5 31308,3007,7084,-4077,8394,37.7,6481,94,1317,0.156897784,20287,-11893
ZCTA5 31309,261,7379,-7118,615,56.1,484,0,131,0.21300813,22463,-21848
ZCTA5 31312,7262,0,7262,23175,35.1,18521,169,1952,0.084228695,1016,22159
ZCTA5 31313,15166,1805,13361,41967,29.7,14996,1006,19538,0.46555627,4618,37349
ZCTA5 31314,0,12627,-12627,1740,21.3,1035,9,449,0.258045977,30605,-28865
ZCTA5 31315,2277,2976,-699,7952,20.7,4396,152,1538,0.193410463,8274,-322
ZCTA5 31316,4043,2533,1510,12363,34.4,8080,111,2609,0.211032921,7497,4866
ZCTA5 31318,132,8647,-8515,400,29.4,332,0,68,0.17,24462,-24062
ZCTA5 31320,3281,705,2576,8710,39.3,5302,75,2795,0.320895522,2071,6639
ZCTA5 31321,2747,3244,-497,7859,35.9,6210,36,1154,0.14683802,9580,-1721
ZCTA5 31322,10718,2379,8339,26399,37.6,14342,591,9509,0.360203038,9217,17182
ZCTA5 31323,691,1387,-696,1562,48.9,337,0,1151,0.7368758,3673,-2111
ZCTA5 31324,10847,3369,7478,31978,34.9,23545,645,3936,0.123084621,11850,20128
ZCTA5 31326,8731,6424,2307,22290,36.1,16955,280,3597,0.161372813,17163,5127
ZCTA5 31327,18,1468,-1450,18,-,0,0,18,1,5197,-5179
ZCTA5 31328,1615,829,786,3483,61.6,3346,0,90,0.025839793,2208,1275
ZCTA5 31329,3162,8384,-5222,9313,32.7,6591,16,2471,0.265328036,22524,-13211
ZCTA5 31331,2409,39,2370,5963,51.7,3854,161,1821,0.305383196,189,5774
ZCTA5 31333,136,813,-677,174,53.5,81,0,76,0.436781609,2140,-1966
ZCTA5 31401,8275,4354,3921,19833,28.6,10698,703,7346,0.37039278,13794,6039
ZCTA5 31404,12832,2535,10297,33495,34.6,9631,391,22265,0.664726079,6848,26647
ZCTA5 31405,14304,11246,3058,38145,35.2,16636,1061,17949,0.470546599,33901,4244
ZCTA5 31406,13920,2125,11795,34676,37,18243,1342,12871,0.371178913,7082,27594
ZCTA5 31407,8149,16911,-8762,20750,33.2,10397,227,8840,0.426024096,48758,-28008
ZCTA5 31408,3608,1179,2429,11336,33.5,4066,309,5964,0.526111503,2731,8605
ZCTA5 31409,0,17,-17,726,23,413,4,271,0.373278237,62,664
ZCTA5 31410,9709,14974,-5265,24151,40.7,21687,604,535,0.022152292,40087,-15936
ZCTA5 31411,4392,155,4237,9085,65.2,8176,160,179,0.019702807,299,8786
ZCTA5 31415,4153,9836,-5683,11935,34.7,608,0,10970,0.919145371,20841,-8906
ZCTA5 31419,22141,1358,20783,56947,35.5,27487,2766,21777,0.382408204,3880,53067
ZCTA5 31421,0,12300,-12300,0,-,0,0,0,#DIV/0!,29094,-29094
ZCTA5 31501,5803,559,5244,14258,39.1,6976,28,6749,0.473348296,4808,9450
ZCTA5 31503,7368,12091,-4723,22421,39,16444,396,4267,0.190312653,30710,-8289
ZCTA5 31510,3192,10449,-7257,9344,37.7,6943,58,1699,0.181827911,25031,-15687
ZCTA5 31512,842,1471,-629,1931,43.1,1627,0,116,0.060072501,5553,-3622
ZCTA5 31513,5722,5248,474,15723,40.3,11500,0,3154,0.20059785,14438,1285
ZCTA5 31516,5776,9671,-3895,15477,41,13416,0,1345,0.086903147,28308,-12831
ZCTA5 31518,238,860,-622,756,38.5,677,0,20,0.026455026,1968,-1212
ZCTA5 31519,1476,2628,-1152,3640,41.2,2780,21,774,0.212637363,7055,-3415
ZCTA5 31520,8493,1058,7435,21864,36.3,8258,677,11020,0.504024881,2585,19279
ZCTA5 31522,7763,5628,2135,17250,57,16288,102,326,0.018898551,16018,1232
ZCTA5 31523,5326,945,4381,14182,41.3,11436,142,1980,0.139613595,2030,12152
ZCTA5 31524,0,2496,-2496,0,-,0,0,0,#DIV/0!,7407,-7407
ZCTA5 31525,11091,2734,8357,29792,37.1,19208,346,8143,0.27332841,8058,21734
ZCTA5 31527,668,2043,-1375,1182,51.9,1156,0,0,0,5170,-3988
ZCTA5 31532,257,12654,-12397,594,56.5,467,0,39,0.065656566,33221,-32627
ZCTA5 31533,6217,9600,-3383,16810,33.4,8854,289,5925,0.352468769,24564,-7754
ZCTA5 31535,4254,8313,-4059,12185,36.4,8647,65,2911,0.238900287,16392,-4207
ZCTA5 31537,3270,9003,-5733,9996,40.9,5890,91,3308,0.330932373,20063,-10067
ZCTA5 31539,5072,1173,3899,14543,37,10637,72,1952,0.13422265,5066,9477
ZCTA5 31542,892,12201,-11309,2592,33.3,2567,0,25,0.009645062,29075,-26483
ZCTA5 31543,1651,6708,-5057,4326,38.3,4126,0,101,0.023347203,16744,-12418
ZCTA5 31544,217,8581,-8364,659,42.3,469,0,182,0.276176024,20354,-19695
ZCTA5 31545,5928,1807,4121,15445,39.2,11009,729,3078,0.199287795,6528,8917
ZCTA5 31546,2746,1642,1104,8870,39.8,6299,16,1975,0.222660654,4597,4273
ZCTA5 31547,0,2828,-2828,1534,21.4,1337,0,177,0.115384615,6421,-4887
ZCTA5 31548,8390,40,8350,22717,32.9,14598,622,5204,0.229079544,80,22637
ZCTA5 31549,665,3330,-2665,2287,53.3,857,0,1366,0.597289025,8397,-6110
ZCTA5 31550,251,3425,-3174,597,50.6,597,0,0,0,7540,-6943
ZCTA5 31551,354,14788,-14434,879,44.8,853,0,0,0,36548,-35669
ZCTA5 31552,283,510,-227,943,43.1,892,0,7,0.007423118,1077,-134
ZCTA5 31553,1781,563,1218,4777,40.1,4393,91,139,0.02909776,1034,3743
ZCTA5 31554,1801,7476,-5675,7641,35.6,4917,0,2513,0.328883654,18492,-10851
ZCTA5 31555,1037,1782,-745,2786,45.6,2364,1,298,0.106963388,4762,-1976
ZCTA5 31556,29,87,-58,63,39.3,63,0,0,0,247,-184
ZCTA5 31557,1246,4392,-3146,3637,35.7,2885,0,600,0.16497113,10713,-7076
ZCTA5 31558,8364,129,8235,21725,33.6,16553,456,2844,0.130909091,488,21237
ZCTA5 31560,1082,15140,-14058,2733,34.9,2487,4,190,0.069520673,29698,-26965
ZCTA5 31561,60,23862,-23802,103,69.2,103,0,0,0,43460,-43357
ZCTA5 31562,706,14482,-13776,2463,36.9,2106,14,122,0.04953309,43200,-40737
ZCTA5 31563,526,11021,-10495,1508,38.6,1016,0,410,0.271883289,25333,-23825
ZCTA5 31564,0,4698,-4698,0,-,0,0,0,#DIV/0!,9983,-9983
ZCTA5 31565,1023,19074,-18051,2301,46.1,1605,21,452,0.196436332,45625,-43324
ZCTA5 31566,1376,7089,-5713,4184,35.5,3520,27,184,0.043977055,14508,-10324
ZCTA5 31567,500,10035,-9535,1252,53,1252,0,0,0,27408,-26156
ZCTA5 31568,241,3180,-2939,459,57.7,329,19,111,0.241830065,6924,-6465
ZCTA5 31569,1996,1318,678,5469,39.4,4151,34,1184,0.21649296,4313,1156
ZCTA5 31599,0,973,-973,0,-,0,0,0,#DIV/0!,2434,-2434
ZCTA5 31601,12023,896,11127,31972,32.2,10914,141,19095,0.597241336,1891,30081
ZCTA5 31602,13046,2744,10302,35837,28.5,17819,621,15019,0.419092,6052,29785
ZCTA5 31605,8677,224,8453,23839,30.3,14532,702,6406,0.268719325,448,23391
ZCTA5 31606,1266,441,825,3575,37,2992,0,275,0.076923077,1051,2524
ZCTA5 31620,4016,1175,2841,11236,36.4,7704,119,2825,0.251423994,2904,8332
ZCTA5 31622,678,1803,-1125,1667,41.2,1340,0,309,0.185362927,6127,-4460
ZCTA5 31623,43,3197,-3154,367,33.2,170,0,57,0.155313351,6384,-6017
ZCTA5 31624,475,12144,-11669,1342,42.6,1172,0,31,0.023099851,28612,-27270
ZCTA5 31625,475,6789,-6314,1283,38.3,1071,105,58,0.045206547,17140,-15857
ZCTA5 31626,1313,14275,-12962,3266,51.2,2027,0,1167,0.35731782,31990,-28724
ZCTA5 31627,81,11392,-11311,224,54.3,107,0,117,0.522321429,30229,-30005
ZCTA5 31629,305,13145,-12840,1232,43.7,676,0,355,0.288149351,34511,-33279
ZCTA5 31630,225,22202,-21977,569,41.1,463,0,101,0.177504394,57704,-57135
ZCTA5 31631,241,11740,-11499,470,47.3,404,0,43,0.091489362,30265,-29795
ZCTA5 31632,4904,176,4728,13896,35.9,12113,138,962,0.069228555,1370,12526
ZCTA5 31634,1826,13842,-12016,5277,38.8,3400,12,1520,0.288042448,34458,-29181
ZCTA5 31635,2493,8161,-5668,7133,35.1,5035,0,1788,0.250665919,20200,-13067
ZCTA5 31636,3833,19188,-15355,10121,36.9,7093,121,1282,0.126667325,55200,-45079
ZCTA5 31637,1154,4292,-3138,2916,39.8,2522,0,341,0.116941015,11929,-9013
ZCTA5 31638,415,4731,-4316,1165,44.3,593,5,565,0.484978541,14163,-12998
ZCTA5 31639,3845,9602,-5757,10523,41.7,8447,204,1042,0.099021192,27760,-17237
ZCTA5 31641,592,3098,-2506,1731,48.6,1193,0,414,0.239168111,10171,-8440
ZCTA5 31642,1578,9405,-7827,4721,30.9,2758,0,1026,0.217326838,24543,-19822
ZCTA5 31643,3485,14202,-10717,9433,41.4,4859,5,4274,0.453090215,37153,-27720
ZCTA5 31645,1636,19396,-17760,4534,31.4,3483,0,804,0.177326864,53143,-48609
ZCTA5 31647,1010,5621,-4611,3405,35,1804,0,1255,0.368575624,15372,-11967
ZCTA5 31648,341,451,-110,815,42.7,573,56,114,0.139877301,3006,-2191
ZCTA5 31649,370,0,370,910,45,710,105,78,0.085714286,178,732
ZCTA5 31650,1283,8996,-7713,3473,41.1,2621,0,446,0.128419234,23134,-19661
ZCTA5 31698,0,2009,-2009,796,18.9,440,6,290,0.364321608,5439,-4643
ZCTA5 31699,0,21631,-21631,728,21.5,544,24,68,0.093406593,60796,-60068
ZCTA5 31701,7439,17280,-9841,18105,38.3,3600,127,13968,0.771499586,48285,-30180
ZCTA5 31704,0,11325,-11325,146,21.7,102,2,29,0.198630137,25903,-25757
ZCTA5 31705,10421,4805,5616,31241,32.3,7215,100,21901,0.701033898,13807,17434
ZCTA5 31707,10995,17947,-6952,23900,35.3,8134,479,14209,0.594518828,39862,-15962
ZCTA5 31709,6222,14245,-8023,16631,31.2,7726,388,7877,0.473633576,35542,-18911
ZCTA5 31711,247,9667,-9420,712,32.8,484,1,189,0.265449438,26253,-25541
ZCTA5 31712,484,12083,-11599,1515,49.7,1377,0,135,0.089108911,37163,-35648
ZCTA5 31714,2385,3375,-990,6021,41.3,2741,0,3170,0.526490616,6886,-865
ZCTA5 31716,1131,10815,-9684,2757,49.1,1380,10,1247,0.452303228,30361,-27604
ZCTA5 31719,2737,12502,-9765,8060,40.4,2493,18,5292,0.656575682,28199,-20139
ZCTA5 31720,138,19811,-19673,286,53.8,106,0,180,0.629370629,47953,-47667
ZCTA5 31721,7979,16276,-8297,20094,42.7,8669,321,10841,0.539514283,46695,-26601
ZCTA5 31722,253,7872,-7619,771,39.3,530,2,139,0.180285344,19938,-19167
ZCTA5 31727,0,9754,-9754,0,-,0,0,0,#DIV/0!,21363,-21363
ZCTA5 31730,3261,11858,-8597,8103,40.5,2636,7,4865,0.600394915,31077,-22974
ZCTA5 31733,458,7016,-6558,1218,38.8,886,0,180,0.147783251,17602,-16384
ZCTA5 31735,254,7605,-7351,517,56.2,470,0,15,0.02901354,18437,-17920
ZCTA5 31738,936,11732,-10796,2031,46.9,1469,9,413,0.203348104,31586,-29555
ZCTA5 31743,53,5134,-5081,112,38.6,27,0,63,0.5625,13656,-13544
ZCTA5 31744,1235,1501,-266,3078,39,2220,71,735,0.238791423,3465,-387
ZCTA5 31747,57,1694,-1637,171,33.8,106,31,34,0.198830409,6660,-6489
ZCTA5 31749,929,1381,-452,2446,39,2162,0,64,0.026165168,4264,-1818
ZCTA5 31750,7308,101,7207,18415,40.7,11137,41,6417,0.348465925,135,18280
ZCTA5 31753,23,1465,-1442,101,36.1,14,0,87,0.861386139,4870,-4769
ZCTA5 31756,627,9195,-8568,1317,60,1127,0,0,0,27113,-25796
ZCTA5 31757,4061,1229,2832,11498,39.9,8373,0,2505,0.217863976,3192,8306
ZCTA5 31763,9724,319,9405,27998,35.5,19267,686,6891,0.246124723,946,27052
ZCTA5 31764,677,1830,-1153,1743,53.8,685,1,1036,0.59437751,5133,-3390
ZCTA5 31765,936,515,421,2516,40.4,1782,0,628,0.249602544,1691,825
ZCTA5 31768,8136,4251,3885,22024,36.6,12432,247,6508,0.295495823,10215,11809
ZCTA5 31771,2253,660,1593,7744,34,5218,21,1631,0.210614669,1639,6105
ZCTA5 31772,213,537,-324,543,59,351,9,183,0.337016575,1357,-814
ZCTA5 31773,1895,4001,-2106,4583,47.6,3512,57,655,0.142919485,11326,-6743
ZCTA5 31774,2393,1134,1259,6309,39.9,3662,56,2452,0.388651133,2996,3313
ZCTA5 31775,1007,4792,-3785,3046,37.8,2018,2,207,0.067957978,12762,-9716
ZCTA5 31778,1066,700,366,2612,44.1,1942,0,436,0.166921899,1653,959
ZCTA5 31779,2979,2968,11,9575,37.9,4996,18,4082,0.426318538,8471,1104
ZCTA5 31780,676,3626,-2950,2092,33.2,1123,0,819,0.391491396,11719,-9627
ZCTA5 31781,677,643,34,2094,30.3,1800,4,268,0.127984718,1814,280
ZCTA5 31783,541,6672,-6131,1512,37.5,1386,32,3,0.001984127,19663,-18151
ZCTA5 31784,370,2252,-1882,1030,26.9,982,0,40,0.038834951,6442,-5412
ZCTA5 31787,638,122,516,1255,49.4,896,0,359,0.286055777,253,1002
ZCTA5 31788,3396,32,3364,9940,38.8,6209,59,1781,0.17917505,56,9884
ZCTA5 31789,608,819,-211,1337,39.3,1161,0,168,0.12565445,1906,-569
ZCTA5 31790,692,872,-180,2318,36.9,1832,0,175,0.075496117,1806,512
ZCTA5 31791,4352,88,4264,11434,43.1,6683,58,4403,0.385079587,157,11277
ZCTA5 31792,9318,0,9318,22915,37.7,11115,248,11115,0.485053458,0,22915
ZCTA5 31793,3240,9763,-6523,9267,36.9,7441,30,994,0.107262329,23395,-14128
ZCTA5 31794,10638,747,9891,28009,35.6,15006,438,10295,0.367560427,3885,24124
ZCTA5 31795,594,13679,-13085,1610,43.7,1140,0,406,0.252173913,36090,-34480
ZCTA5 31796,495,12645,-12150,1231,44.6,811,0,396,0.321689683,30653,-29422
ZCTA5 31798,390,4017,-3627,1209,34,978,0,225,0.186104218,8882,-7673
ZCTA5 31801,1138,7740,-6602,2829,52.7,2214,133,283,0.100035348,16418,-13589
ZCTA5 31803,1877,3127,-1250,4681,43.6,2098,0,2236,0.47767571,8056,-3375
ZCTA5 31804,2066,402,1664,6266,45.2,5067,0,659,0.105170763,823,5443
ZCTA5 31805,1009,5667,-4658,2223,44.2,1286,0,707,0.318038686,12328,-10105
ZCTA5 31806,1538,776,762,4462,37.8,3062,0,1141,0.255714926,2057,2405
ZCTA5 31807,738,1524,-786,2000,49.8,1389,21,551,0.2755,4414,-2414
ZCTA5 31808,2803,463,2340,8406,39.2,6022,729,1178,0.140137997,1343,7063
ZCTA5 31810,99,2434,-2335,220,59.2,73,0,147,0.668181818,7946,-7726
ZCTA5 31811,2004,4695,-2691,6028,40,4988,33,776,0.128732581,14164,-8136
ZCTA5 31812,239,398,-159,663,54.4,233,0,397,0.598793363,822,-159
ZCTA5 31814,0,466,-466,0,-,0,0,0,#DIV/0!,1445,-1445
ZCTA5 31815,834,5831,-4997,3515,34.4,719,121,1941,0.552204836,17015,-13500
ZCTA5 31816,2066,457,1609,4956,35.6,2316,98,2379,0.480024213,1020,3936
ZCTA5 31820,4453,1756,2697,12477,42.6,8394,628,2778,0.222649675,4414,8063
ZCTA5 31821,29,0,29,40,79.5,40,0,0,0,0,40
ZCTA5 31822,2316,5454,-3138,5899,46.7,3556,0,2207,0.374131209,15484,-9585
ZCTA5 31823,321,2843,-2522,602,58.1,537,0,37,0.061461794,7162,-6560
ZCTA5 31824,468,249,219,1131,35.9,401,0,516,0.456233422,754,377
ZCTA5 31825,1073,1438,-365,2512,40,870,49,1431,0.569665605,4046,-1534
ZCTA5 31826,803,3176,-2373,1962,39,1299,16,556,0.283384302,8238,-6276
ZCTA5 31827,926,2147,-1221,2114,47.4,441,12,1634,0.772942289,7455,-5341
ZCTA5 31829,521,1336,-815,1467,40.5,930,37,493,0.336059986,3582,-2115
ZCTA5 31830,961,1038,-77,2523,44.6,1683,0,769,0.304795878,2849,-326
ZCTA5 31831,1358,7570,-6212,3751,40.1,3069,2,513,0.13676353,19254,-15503
ZCTA5 31832,73,519,-446,175,54.8,139,0,18,0.102857143,3121,-2946
ZCTA5 31833,2525,3638,-1113,6872,36.9,3671,0,3120,0.454016298,11582,-4710
ZCTA5 31836,408,0,408,809,58.4,491,0,291,0.359703337,339,470
ZCTA5 31901,3107,3497,-390,5728,38.8,3027,145,2206,0.385125698,8325,-2597
ZCTA5 31903,7543,238,7305,19587,31,2317,209,15166,0.774289069,659,18928
ZCTA5 31904,14016,1674,12342,34865,36.7,21306,740,9305,0.266886562,4431,30434
ZCTA5 31905,3641,3289,352,16973,22.6,11357,546,1959,0.115418606,7554,9419
ZCTA5 31906,8768,5094,3674,20722,37.4,6142,176,13865,0.669095647,11977,8745
ZCTA5 31907,22637,1635,21002,61085,35.8,14092,958,40765,0.667348776,5858,55227
ZCTA5 31909,15723,13,15710,40062,33.7,24041,1633,9310,0.232389796,28,40034
ZCTA5 32003,11090,1328,9762,29505,46.1,24623,705,1557,0.052770717,3938,25567
ZCTA5 32008,2354,40,2314,5920,41.3,5061,26,182,0.030743243,97,5823
ZCTA5 32009,1383,1458,-75,3372,43.6,3184,0,43,0.012752076,3716,-344
ZCTA5 32011,5480,2281,3199,14791,39.4,13790,84,678,0.045838686,8655,6136
ZCTA5 32013,5,2474,-2469,66,-,66,0,0,0,6239,-6173
ZCTA5 32024,7220,4374,2846,18712,45.4,15337,287,1377,0.073589141,12277,6435
ZCTA5 32025,8127,1363,6764,23649,38,16489,201,4988,0.210918009,2895,20754
ZCTA5 32026,0,12301,-12301,3368,42.6,1565,11,1501,0.445665083,34416,-31048
ZCTA5 32033,1915,9652,-7737,4666,53.7,4392,61,138,0.029575654,22055,-17389
ZCTA5 32034,16526,9853,6673,38747,53.8,34669,548,1812,0.046764911,25619,13128
ZCTA5 32038,3824,13423,-9599,9905,49.2,8284,105,771,0.077839475,35414,-25509
ZCTA5 32040,2663,11270,-8607,8006,35.6,7171,6,148,0.018486135,27496,-19490
ZCTA5 32043,11018,278,10740,30249,40.2,24498,517,2430,0.080333234,6524,23725
ZCTA5 32044,813,0,813,2268,35.4,2165,0,63,0.027777778,668,1600
ZCTA5 32046,3602,0,3602,10745,40.3,9841,0,397,0.036947417,977,9768
ZCTA5 32052,2245,15564,-13319,8712,39.4,5019,38,3251,0.373163453,38406,-29694
ZCTA5 32053,1289,13076,-11787,3729,44.9,2360,40,1006,0.26977742,35105,-31376
ZCTA5 32054,3567,95,3472,12757,38.4,9497,7,2033,0.159363487,95,12662
ZCTA5 32055,6190,1835,4355,16184,36.4,10365,111,4914,0.303633218,5079,11105
ZCTA5 32058,1494,9717,-8223,5411,37.5,4096,76,1024,0.189244132,26962,-21551
ZCTA5 32059,1109,5307,-4198,2670,45.2,2166,0,151,0.056554307,13264,-10594
ZCTA5 32060,7754,1800,5954,23078,43.8,20041,110,1998,0.08657596,6334,16744
ZCTA5 32061,85,7471,-7386,344,24.6,344,0,0,0,19921,-19577
ZCTA5 32062,668,8739,-8071,1862,48.1,1662,0,0,0,25090,-23228
ZCTA5 32063,4523,6677,-2154,14024,38.6,11023,78,1844,0.131488876,15558,-1534
ZCTA5 32064,2865,918,1947,7433,42.4,3500,0,2859,0.384636082,3542,3891
ZCTA5 32065,13336,399,12937,39146,37.3,22710,2884,7653,0.195498902,1862,37284
ZCTA5 32066,1978,14056,-12078,6973,40.9,5162,0,1378,0.197619389,34201,-27228
ZCTA5 32068,19950,8448,11502,57231,38.3,47920,372,3230,0.056437944,19808,37423
ZCTA5 32071,1173,3149,-1976,2987,44.7,2269,24,64,0.02142618,5957,-2970
ZCTA5 32072,43,3369,-3326,80,66.5,80,0,0,0,8714,-8634
ZCTA5 32073,15600,9098,6502,42278,39.5,27410,1641,8274,0.195704622,23863,18415
ZCTA5 32079,172,1179,-1007,384,80.8,350,0,34,0.088541667,2792,-2408
ZCTA5 32080,9618,2257,7361,21001,56.8,19882,435,49,0.002333222,6100,14901
ZCTA5 32081,7113,12484,-5371,20867,40.3,17458,1330,567,0.02717209,34005,-13138
ZCTA5 32082,11696,1407,10289,28721,50.3,26591,393,719,0.025033947,3420,25301
ZCTA5 32083,616,994,-378,2159,38.6,1514,10,529,0.245020843,2836,-677
ZCTA5 32084,13125,4628,8497,35618,43.2,27997,184,4857,0.136363636,10638,24980
ZCTA5 32086,12531,11025,1506,32753,50.1,29209,640,960,0.029310292,28004,4749
ZCTA5 32087,1209,10814,-9605,5605,34.8,3588,8,1535,0.273862623,30282,-24677
ZCTA5 32091,5457,1764,3693,15618,38,11646,82,3183,0.203803304,4744,10874
ZCTA5 32092,14569,11821,2748,42245,41.8,34384,1490,2385,0.056456385,30374,11871
ZCTA5 32094,925,4485,-3560,3358,36.2,2979,0,0,0,9944,-6586
ZCTA5 32095,5218,1532,3686,15021,41.8,12822,815,329,0.02190267,4197,10824
ZCTA5 32096,1142,8441,-7299,2793,41.2,2125,0,635,0.2273541,24415,-21622
ZCTA5 32097,7650,7733,-83,20752,37.3,16708,220,1948,0.09387047,18997,1755
ZCTA5 32102,1120,2109,-989,2319,55.5,2079,0,56,0.02414834,8396,-6077
ZCTA5 32110,3272,9746,-6474,8909,46.6,7524,7,850,0.095409137,23302,-14393
ZCTA5 32112,2767,9553,-6786,7501,43.1,5151,165,554,0.073856819,22510,-15009
ZCTA5 32113,1927,11982,-10055,4966,44.8,3747,12,824,0.165928313,30023,-25057
ZCTA5 32114,14270,18936,-4666,34560,34.6,13872,451,17169,0.496788194,43101,-8541
ZCTA5 32117,12399,6430,5969,29100,40.9,17527,1044,8322,0.285979381,18778,10322
ZCTA5 32118,9639,5,9634,18123,56.8,15709,441,644,0.035534956,6707,11416
ZCTA5 32119,10403,6339,4064,22677,46.3,19013,433,2079,0.091678793,15365,7312
ZCTA5 32124,2312,268,2044,7449,41.6,5555,229,1297,0.174117331,614,6835
ZCTA5 32127,12799,1672,11127,28136,53.4,25507,491,726,0.025803241,4045,24091
ZCTA5 32128,8901,2864,6037,21811,48.7,19720,277,1066,0.048874421,7008,14803
ZCTA5 32129,10166,1885,8281,22670,45.5,19303,940,1228,0.054168505,5170,17500
ZCTA5 32130,1661,1908,-247,4756,45.3,3572,15,42,0.00883095,5495,-739
ZCTA5 32131,1665,445,1220,4273,46.9,3370,17,645,0.150947812,1245,3028
ZCTA5 32132,3741,640,3101,7667,58.6,7148,38,177,0.023085953,1570,6097
ZCTA5 32133,294,3536,-3242,711,51,711,0,0,0,8702,-7991
ZCTA5 32134,3198,1442,1756,7147,55.3,6711,58,69,0.0096544,5220,1927
ZCTA5 32136,3905,111,3794,8209,60.5,7747,25,145,0.01766354,303,7906
ZCTA5 32137,18346,67,18279,44687,54.2,36855,1442,3006,0.067267886,189,44498
ZCTA5 32139,338,4154,-3816,853,60.5,814,8,0,0,10547,-9694
ZCTA5 32140,570,4434,-3864,1802,43.6,1569,0,178,0.098779134,13054,-11252
ZCTA5 32141,8592,3668,4924,18859,53.5,17488,300,325,0.017233151,9903,8956
ZCTA5 32145,1989,178,1811,5539,37.5,4198,0,490,0.088463622,429,5110
ZCTA5 32147,796,5506,-4710,1961,40.3,1746,0,37,0.018867925,13580,-11619
ZCTA5 32148,4359,5237,-878,10552,44.3,9587,27,270,0.025587566,14100,-3548
ZCTA5 32157,163,44,119,376,38.7,346,0,0,0,109,267
ZCTA5 32159,15676,174,15502,29613,68.6,27214,491,923,0.031168743,356,29257
ZCTA5 32162,29994,2609,27385,51373,73.3,50208,632,99,0.001927082,6478,44895
ZCTA5 32163,13131,1677,11454,24467,69.1,23612,156,76,0.003106225,3641,20826
ZCTA5 32164,18982,1886,17096,50008,47.7,35955,1232,7082,0.141617341,4696,45312
ZCTA5 32168,13517,4675,8842,30060,55.5,27248,180,1336,0.044444444,11478,18582
ZCTA5 32169,5889,4050,1839,10400,63.2,9740,119,9,0.000865385,9810,590
ZCTA5 32174,22934,49,22885,51319,54.4,45559,1302,2248,0.043804439,150,51169
ZCTA5 32176,6885,98,6787,13741,58.9,12533,106,467,0.033985882,321,13420
ZCTA5 32177,10055,1953,8102,26087,41.5,17373,179,7244,0.277686204,5823,20264
ZCTA5 32179,3665,164,3501,8043,50.7,6848,91,102,0.012681835,285,7758
ZCTA5 32180,1409,4444,-3035,5144,38.5,2996,0,215,0.041796267,13203,-8059
ZCTA5 32181,1159,810,349,3119,38.4,2484,3,228,0.073100353,2416,703
ZCTA5 32182,21,4197,-4176,55,43.4,55,0,0,0,10616,-10561
ZCTA5 32187,615,57,558,1337,53.2,1175,0,155,0.115931189,228,1109
ZCTA5 32189,2449,8780,-6331,5287,51,4869,0,304,0.057499527,21844,-16557
ZCTA5 32190,513,1094,-581,1524,41.3,734,2,141,0.092519685,2662,-1138
ZCTA5 32192,0,15987,-15987,0,-,0,0,0,#DIV/0!,46987,-46987
ZCTA5 32193,560,13201,-12641,1057,61.3,469,0,437,0.413434248,34690,-33633
ZCTA5 32195,1114,14815,-13701,2984,52.2,2919,0,0,0,42716,-39732
ZCTA5 32202,2149,840,1309,6717,39.2,2856,178,3319,0.494119399,2796,3921
ZCTA5 32203,0,14752,-14752,0,-,0,0,0,#DIV/0!,41354,-41354
ZCTA5 32204,4314,7862,-3548,7750,38.9,4878,178,2092,0.269935484,19424,-11674
ZCTA5 32205,14447,12890,1557,31398,37.3,20940,810,7529,0.239792343,34763,-3365
ZCTA5 32206,6840,11439,-4599,16406,36.9,4145,242,11116,0.677556991,31760,-15354
ZCTA5 32207,15890,11628,4262,36711,38.3,23707,3224,6957,0.189507232,31551,5160
ZCTA5 32208,13365,15971,-2606,32244,39.3,5771,49,24956,0.773973452,45165,-12921
ZCTA5 32209,14517,7831,6686,35915,37.9,1980,164,32748,0.911819574,19680,16235
ZCTA5 32210,26474,2266,24208,66824,35.7,32009,2418,26723,0.399901233,5543,61281
ZCTA5 32211,13301,1523,11778,35668,34.7,18726,1013,12264,0.343837614,4043,31625
ZCTA5 32212,237,1500,-1263,2275,21.9,1582,28,435,0.191208791,3317,-1042
ZCTA5 32214,0,3118,-3118,0,-,0,0,0,#DIV/0!,8478,-8478
ZCTA5 32216,17224,13699,3525,39762,37.5,23794,2473,9083,0.228434183,43369,-3607
ZCTA5 32217,8807,1283,7524,20303,37.2,15071,476,1876,0.092400138,3294,17009
ZCTA5 32218,23743,14079,9664,68534,34.7,27796,1572,33857,0.494017568,40677,27857
ZCTA5 32219,5019,7909,-2890,14169,42.3,4972,349,8227,0.580633778,22761,-8592
ZCTA5 32220,4604,7866,-3262,12020,44.3,7700,347,2750,0.228785358,20264,-8244
ZCTA5 32221,10397,4076,6321,29346,40.1,15878,1237,9475,0.322871942,10158,19188
ZCTA5 32222,5450,9494,-4044,14879,36.9,6647,365,5108,0.343302641,22867,-7988
ZCTA5 32223,10311,1173,9138,25824,47.6,21421,750,1320,0.051115242,2969,22855
ZCTA5 32224,15366,8761,6605,41366,34,32463,2497,3335,0.080621767,21006,20360
ZCTA5 32225,21065,1343,19722,55401,37.6,37255,3496,7977,0.143986571,3603,51798
ZCTA5 32226,6389,18678,-12289,18097,42,12710,674,3275,0.180969221,57953,-39856
ZCTA5 32227,544,4633,-4089,3510,21.5,2212,224,474,0.135042735,15387,-11877
ZCTA5 32228,0,903,-903,412,22.3,285,20,71,0.172330097,3400,-2988
ZCTA5 32233,9901,16355,-6454,24489,41.9,19529,835,1914,0.07815754,47212,-22723
ZCTA5 32234,2750,9587,-6837,7780,39.3,6497,33,830,0.106683805,28361,-20581
ZCTA5 32244,23759,3548,20211,63709,34.2,29190,4245,22338,0.3506255,9358,54351
ZCTA5 32246,22370,8322,14048,56222,35.3,34373,5944,7899,0.140496603,19289,36933
ZCTA5 32250,12403,10057,2346,28859,40.4,25636,502,885,0.030666343,28563,296
ZCTA5 32254,5100,14525,-9425,13798,37.6,4404,34,8225,0.596100884,34722,-20924
ZCTA5 32256,22519,4185,18334,48988,32.6,27922,6303,8838,0.180411529,11389,37599
ZCTA5 32257,16968,10233,6735,41487,41.2,28394,1893,4543,0.109504182,24808,16679
ZCTA5 32258,14831,19415,-4584,41004,34,28223,3184,4564,0.111306214,47716,-6712
ZCTA5 32259,19000,8033,10967,62354,38,49894,2777,4426,0.070981814,20854,41500
ZCTA5 32266,2957,1303,1654,6880,42.7,6604,13,0,0,2450,4430
ZCTA5 32277,12859,6063,6796,33948,33,17124,719,13719,0.404118063,10112,23836
ZCTA5 32301,14163,9430,4733,32425,29.3,13700,1095,15597,0.481017733,18245,14180
ZCTA5 32303,21986,8199,13787,50598,30.4,28068,1176,18057,0.356871813,16581,34017
ZCTA5 32304,18175,7918,10257,45853,22.5,22636,1686,18306,0.399232329,22369,23484
ZCTA5 32305,7603,10606,-3003,20815,37,7771,17,11751,0.564544799,24748,-3933
ZCTA5 32306,0,11540,-11540,1827,19,1446,43,202,0.110563766,32265,-30438
ZCTA5 32307,0,16515,-16515,1758,19.5,905,42,664,0.377701934,51794,-50036
ZCTA5 32308,10827,8535,2292,22415,42.8,15637,554,4836,0.215748383,24741,-2326
ZCTA5 32309,13011,12373,638,33505,40.7,27108,1307,3111,0.092851813,32269,1236
ZCTA5 32310,5775,13955,-8180,14090,33.6,6201,0,6754,0.479347055,37385,-23295
ZCTA5 32311,8555,14319,-5764,21231,35.7,11266,1656,5930,0.279308558,37164,-15933
ZCTA5 32312,12229,2251,9978,31956,42.9,26342,1933,2713,0.084897985,5181,26775
ZCTA5 32313,0,11654,-11654,0,-,0,0,0,#DIV/0!,32798,-32798
ZCTA5 32317,5353,15107,-9754,14492,45.1,10852,862,2168,0.149599779,45955,-31463
ZCTA5 32320,1801,8825,-7024,4010,52.3,3209,27,623,0.155361596,24925,-20915
ZCTA5 32321,1662,2557,-895,6443,38.7,4802,9,1187,0.184230948,8652,-2209
ZCTA5 32322,951,6872,-5921,3824,41.1,2450,0,888,0.232217573,15685,-11861
ZCTA5 32323,53,20659,-20606,104,61.5,104,0,0,0,54772,-54668
ZCTA5 32324,1843,10666,-8823,5039,49.2,2069,41,2766,0.548918436,36212,-31173
ZCTA5 32327,9942,19036,-9094,29946,42,23610,201,4318,0.144192881,58250,-28304
ZCTA5 32328,1508,7383,-5875,3889,44.4,3540,12,46,0.011828233,27126,-23237
ZCTA5 32330,212,2166,-1954,779,27,371,0,184,0.236200257,6261,-5482
ZCTA5 32331,1725,19405,-17680,4775,46.2,3101,112,1358,0.284397906,58633,-53858
ZCTA5 32332,520,6244,-5724,1178,51.5,7,0,1131,0.960101868,20142,-18964
ZCTA5 32333,4494,2,4492,11695,50.8,6638,15,3978,0.340145361,6,11689
ZCTA5 32334,581,75,506,1494,40.8,1388,1,0,0,2518,-1024
ZCTA5 32336,531,4757,-4226,1553,49.2,944,0,601,0.386992917,15043,-13490
ZCTA5 32337,27,3165,-3138,48,-,0,0,48,1,9621,-9573
ZCTA5 32340,3526,16259,-12733,10456,43.3,5383,9,4593,0.439269319,44329,-33873
ZCTA5 32343,1098,5902,-4804,3416,33.3,226,31,2947,0.862704918,17717,-14301
ZCTA5 32344,4577,16884,-12307,12151,47.6,7223,63,4397,0.361863221,51812,-39661
ZCTA5 32346,873,15742,-14869,2049,52.1,2012,0,8,0.003904344,44036,-41987
ZCTA5 32347,2455,10842,-8387,7072,40.8,5999,41,467,0.066035068,24533,-17461
ZCTA5 32348,3920,5776,-1856,13032,41.6,8208,0,4420,0.339165132,13363,-331
ZCTA5 32350,681,10548,-9867,1421,48.8,1160,0,245,0.172413793,26395,-24974
ZCTA5 32351,5792,9384,-3592,17508,38.1,6548,16,9468,0.540781357,21424,-3916
ZCTA5 32352,1810,14828,-13018,4618,39.5,587,0,3977,0.861195323,41425,-36807
ZCTA5 32355,152,3310,-3158,298,63.4,286,0,0,0,10828,-10530
ZCTA5 32356,0,10302,-10302,0,-,0,0,0,#DIV/0!,30944,-30944
ZCTA5 32358,545,5632,-5087,1256,55.2,1068,1,160,0.127388535,9884,-8628
ZCTA5 32359,497,6230,-5733,958,67.1,958,0,0,0,15207,-14249
ZCTA5 32360,36,325,-289,50,63.6,50,0,0,0,1320,-1270
ZCTA5 32361,207,8425,-8218,430,44.2,394,0,0,0,22820,-22390
ZCTA5 32399,0,9637,-9637,0,-,0,0,0,#DIV/0!,26517,-26517
ZCTA5 32401,8804,6953,1851,19208,44.1,12271,328,4720,0.245730945,13793,5415
ZCTA5 32403,266,7047,-6781,1416,21.7,1052,75,225,0.158898305,18248,-16832
ZCTA5 32404,14273,17151,-2878,39832,38.9,30819,1052,4615,0.115861619,39151,681
ZCTA5 32405,12216,10517,1699,29999,38.5,20969,457,5368,0.178939298,25124,4875
ZCTA5 32407,6153,13032,-6879,14355,38.8,11201,468,1613,0.11236503,32363,-18008
ZCTA5 32408,8706,1900,6806,19821,43.6,17436,570,566,0.028555572,7484,12337
ZCTA5 32409,3729,1041,2688,10004,44.8,9239,198,0,0,2412,7592
ZCTA5 32410,279,1487,-1208,517,58.3,494,13,10,0.01934236,3939,-3422
ZCTA5 32413,6835,5138,1697,14472,53.3,12898,202,167,0.011539525,11542,2930
ZCTA5 32420,1178,8128,-6950,2275,56.4,2134,0,7,0.003076923,20300,-18025
ZCTA5 32421,1445,9326,-7881,4197,44.8,4020,45,24,0.00571837,22112,-17915
ZCTA5 32423,487,14054,-13567,974,64.1,910,0,60,0.061601643,35983,-35009
ZCTA5 32424,2179,10879,-8700,7208,40.8,4746,29,1503,0.208518313,25247,-18039
ZCTA5 32425,4766,8786,-4020,14135,40.5,12094,183,1268,0.089706403,20123,-5988
ZCTA5 32426,294,9251,-8957,802,54.8,170,0,632,0.788029925,21730,-20928
ZCTA5 32427,469,7412,-6943,1088,43.2,974,2,92,0.084558824,15395,-14307
ZCTA5 32428,5936,7731,-1795,17578,40.4,14103,87,2446,0.139151212,15180,2398
ZCTA5 32430,326,7388,-7062,837,48.3,822,0,0,0,19439,-18602
ZCTA5 32431,1780,4838,-3058,4412,46.8,3765,0,548,0.124206709,13224,-8812
ZCTA5 32432,0,183,-183,0,-,0,0,0,#DIV/0!,535,-535
ZCTA5 32433,6971,4753,2218,19500,38.7,15882,115,1644,0.084307692,8852,10648
ZCTA5 32435,2694,121,2573,6638,41.2,5772,0,518,0.078035553,243,6395
ZCTA5 32437,282,6833,-6551,601,48.8,481,0,73,0.121464226,14818,-14217
ZCTA5 32438,1756,19292,-17536,4920,39,4373,0,84,0.017073171,39499,-34579
ZCTA5 32439,5303,15348,-10045,13306,39.9,11241,149,333,0.025026304,45600,-32294
ZCTA5 32440,1999,23032,-21033,7731,38.2,5585,25,1801,0.23295822,74418,-66687
ZCTA5 32442,1396,9799,-8403,3568,40.1,2911,30,347,0.097253363,32220,-28652
ZCTA5 32443,1109,14173,-13064,3082,44.4,1769,0,1185,0.384490591,40816,-37734
ZCTA5 32444,7600,19915,-12315,21148,35.1,17418,545,1483,0.070124834,63733,-42585
ZCTA5 32445,474,14287,-13813,2483,38.1,1380,8,820,0.330245671,46394,-43911
ZCTA5 32446,3916,12616,-8700,11161,41,7728,43,2651,0.237523519,46409,-35248
ZCTA5 32448,3349,7252,-3903,7524,43.3,3918,0,3260,0.43328017,14685,-7161
ZCTA5 32449,340,17795,-17455,998,30.8,806,0,0,0,41257,-40259
ZCTA5 32455,1694,19157,-17463,3953,50.9,3621,36,55,0.013913483,48005,-44052
ZCTA5 32456,3655,18901,-15246,8088,54,7099,48,663,0.081973294,63587,-55499
ZCTA5 32459,7880,21914,-14034,18544,47,16590,204,35,0.001887403,67043,-48499
ZCTA5 32460,1690,20740,-19050,5891,40.4,3848,34,1707,0.289764047,56388,-50497
ZCTA5 32461,953,11228,-10275,2158,55.4,1951,21,0,0,29525,-27367
ZCTA5 32462,1376,21124,-19748,3691,44.3,2358,60,961,0.260363045,57114,-53423
ZCTA5 32463,81,8174,-8093,191,40.9,183,0,3,0.015706806,26566,-26375
ZCTA5 32464,1565,13023,-11458,3729,46.8,3264,0,92,0.024671494,45984,-42255
ZCTA5 32465,2273,9468,-7195,7873,41.9,5812,36,1576,0.200177823,32808,-24935
ZCTA5 32466,2019,1971,48,5718,38.5,5009,59,178,0.031129766,6552,-834
ZCTA5 32501,4474,9826,-5352,10985,38,4659,78,5478,0.498680018,35227,-24242
ZCTA5 32502,1725,14241,-12516,3799,39,2380,10,881,0.231903132,50018,-46219
ZCTA5 32503,12984,4468,8516,32950,34.8,21196,918,8466,0.25693475,27587,5363
ZCTA5 32504,9608,4280,5328,21687,38.6,15351,641,3279,0.151196569,12762,8925
ZCTA5 32505,10852,1633,9219,27661,36.7,12215,531,11827,0.427569502,3671,23990
ZCTA5 32506,14482,5006,9476,37202,37.3,22660,2728,6735,0.181038654,12510,24692
ZCTA5 32507,13618,41,13577,33615,39.1,24874,890,5423,0.161326789,205,33410
ZCTA5 32508,555,11882,-11327,5423,20.4,3656,199,565,0.104185875,32543,-27120
ZCTA5 32509,0,2494,-2494,566,44.8,321,0,232,0.409893993,6039,-5473
ZCTA5 32511,0,1645,-1645,1292,20.1,932,39,128,0.099071207,3821,-2529
ZCTA5 32512,0,3653,-3653,0,-,0,0,0,#DIV/0!,8923,-8923
ZCTA5 32514,17435,294,17141,42059,33.7,28102,1409,9317,0.221522147,565,41494
ZCTA5 32526,15004,8823,6181,39318,43.1,29017,1169,5852,0.148837682,29426,9892
ZCTA5 32530,20,11912,-11892,92,36.4,48,0,0,0,43781,-43689
ZCTA5 32531,2748,9542,-6794,6452,48.6,5821,52,377,0.058431494,35217,-28765
ZCTA5 32533,10783,12176,-1393,29568,42.1,22810,783,3981,0.134638799,32853,-3285
ZCTA5 32534,6778,13109,-6331,15931,39.4,9741,593,4700,0.295022284,23033,-7102
ZCTA5 32535,1669,21649,-19980,5689,42.2,2912,7,2370,0.416593426,52264,-46575
ZCTA5 32536,8780,19289,-10509,24643,34,17915,649,3366,0.136590513,54866,-30223
ZCTA5 32539,10637,17441,-6804,30924,34,23765,483,4195,0.135655155,51600,-20676
ZCTA5 32541,9104,8521,583,20559,43.1,17659,343,461,0.02242327,15859,4700
ZCTA5 32542,881,8280,-7399,4244,21.9,2825,233,470,0.110744581,24952,-20708
ZCTA5 32544,416,14596,-14180,2169,21.6,1651,91,110,0.050714615,49007,-46838
ZCTA5 32547,14313,10585,3728,32556,36.6,21335,945,4080,0.125322521,24914,7642
ZCTA5 32548,9937,1994,7943,22938,40.1,15599,1180,2708,0.118057372,5053,17885
ZCTA5 32550,4251,12876,-8625,8648,56.9,7647,43,502,0.058048104,38877,-30229
ZCTA5 32561,4123,10273,-6150,9610,50.4,8350,26,141,0.014672216,29344,-19734
ZCTA5 32563,10811,9509,1302,28186,43.5,25390,457,840,0.029802029,30840,-2654
ZCTA5 32564,992,0,992,2577,46,2270,27,35,0.013581684,0,2577
ZCTA5 32565,2039,179,1860,5192,42.9,4980,22,25,0.0048151,482,4710
ZCTA5 32566,15286,0,15286,42753,37.5,35398,1008,2702,0.063200243,0,42753
ZCTA5 32567,1574,18631,-17057,4554,31.3,3829,6,436,0.095740009,52821,-48267
ZCTA5 32568,1214,16702,-15488,3269,48,2942,0,202,0.061792597,46880,-43611
ZCTA5 32569,4828,9163,-4335,12184,38.5,8440,1235,1271,0.104317137,29801,-17617
ZCTA5 32570,13445,2840,10605,33099,42,27296,597,1838,0.055530379,7652,25447
ZCTA5 32571,13461,6702,6759,37727,36,31160,931,1886,0.049990723,13086,24641
ZCTA5 32577,1855,10282,-8427,4453,42.7,3733,31,59,0.013249495,23717,-19264
ZCTA5 32578,12862,6861,6001,34015,39.6,28794,1295,1536,0.045156549,13082,20933
ZCTA5 32579,4452,4102,350,10452,44.7,8145,461,663,0.063432836,8424,2028
ZCTA5 32580,1535,13793,-12258,3860,31.9,2886,126,447,0.115803109,33553,-29693
ZCTA5 32583,9570,15403,-5833,30379,40.4,24239,323,3374,0.111063564,37554,-7175
ZCTA5 32601,8603,13490,-4887,21460,23.6,14391,1491,3657,0.170410065,35709,-14249
ZCTA5 32603,1740,4940,-3200,5625,21.1,4462,472,302,0.053688889,13162,-7537
ZCTA5 32605,11298,8092,3206,28058,38.5,21646,860,2659,0.094767981,19737,8321
ZCTA5 32606,10323,10909,-586,23682,40.6,17200,2098,2456,0.103707457,28101,-4419
ZCTA5 32607,12175,21375,-9200,30445,26.6,18438,1407,6730,0.22105436,38665,-8220
ZCTA5 32608,20707,9522,11185,51317,29.3,33279,6920,6510,0.126858546,21424,29893
ZCTA5 32609,7463,15518,-8055,19542,34.8,10653,291,7314,0.374270801,36319,-16777
ZCTA5 32610,0,16902,-16902,42,40.5,36,0,6,0.142857143,55089,-55047
ZCTA5 32612,4,12322,-12318,7152,19.1,5117,716,673,0.094099553,31110,-23958
ZCTA5 32615,5984,8362,-2378,14933,40.8,10908,224,2826,0.189245296,25976,-11043
ZCTA5 32616,79,11281,-11202,149,45.3,5,0,144,0.966442953,31124,-30975
ZCTA5 32617,1432,3588,-2156,4090,50.8,3291,0,354,0.086552567,15510,-11420
ZCTA5 32618,3229,13309,-10080,8640,39,6047,20,1749,0.202430556,44278,-35638
ZCTA5 32619,2013,4347,-2334,5139,43.9,4851,5,10,0.001945904,12385,-7246
ZCTA5 32621,2016,8548,-6532,4703,46.1,3833,68,507,0.10780353,27929,-23226
ZCTA5 32622,575,6077,-5502,1510,42.5,1222,7,189,0.125165563,14078,-12568
ZCTA5 32625,682,14668,-13986,1527,53,1408,0,91,0.059593975,46603,-45076
ZCTA5 32626,3781,10989,-7208,8950,49.2,7273,138,1083,0.121005587,31537,-22587
ZCTA5 32628,1581,20123,-18542,5262,40.9,3754,42,959,0.182250095,66756,-61494
ZCTA5 32631,183,2082,-1899,366,60,366,0,0,0,6719,-6353
ZCTA5 32634,7,18754,-18747,18,-,18,0,0,0,36968,-36950
ZCTA5 32639,127,15494,-15367,248,65.3,248,0,0,0,52622,-52374
ZCTA5 32640,4028,12941,-8913,10543,50.4,7356,90,2681,0.254291947,45754,-35211
ZCTA5 32641,5142,16793,-11651,17035,34.3,4903,13,11364,0.667097153,55492,-38457
ZCTA5 32643,4171,7213,-3042,12260,38.3,10178,63,1428,0.116476346,21993,-9733
ZCTA5 32648,103,5090,-4987,369,31.7,369,0,0,0,18835,-18466
ZCTA5 32653,6383,6603,-220,15799,43.1,10561,1100,2943,0.186277613,27739,-11940
ZCTA5 32656,5103,11863,-6760,13900,41.4,12071,135,287,0.020647482,38309,-24409
ZCTA5 32658,73,3068,-2995,446,37.3,188,0,224,0.502242152,12096,-11650
ZCTA5 32664,139,12562,-12423,290,56.1,290,0,0,0,36940,-36650
ZCTA5 32666,2746,11815,-9069,6804,57.2,5886,59,684,0.100529101,35455,-28651
ZCTA5 32667,1865,8962,-7097,4399,50.3,3135,25,1013,0.230279609,29094,-24695
ZCTA5 32668,2279,15657,-13378,5694,55.6,5313,0,199,0.034949069,53933,-48239
ZCTA5 32669,5282,17338,-12056,15125,39.1,10961,685,1922,0.12707438,50661,-35536
ZCTA5 32680,4197,13959,-9762,10682,50.9,9784,0,310,0.029020783,54808,-44126
ZCTA5 32681,63,11905,-11842,255,62.4,211,0,0,0,41780,-41525
ZCTA5 32683,99,15070,-14971,281,25.1,221,0,41,0.145907473,40591,-40310
ZCTA5 32686,2344,14037,-11693,5232,46.3,3337,30,1495,0.28574159,32159,-26927
ZCTA5 32692,40,7154,-7114,40,-,40,0,0,0,17509,-17469
ZCTA5 32693,3978,3811,167,10872,40.9,9121,85,857,0.078826343,15317,-4445
ZCTA5 32694,975,11734,-10759,1753,57.8,1422,23,216,0.123217342,35708,-33955
ZCTA5 32696,5302,6062,-760,13955,44.4,11215,114,1593,0.114152633,20877,-6922
ZCTA5 32697,68,7657,-7589,147,28.9,104,0,22,0.149659864,28271,-28124
ZCTA5 32701,11274,22808,-11534,24931,39.5,14646,496,4909,0.196903454,70969,-46038
ZCTA5 32702,1228,4400,-3172,2576,58.1,2448,6,68,0.026397516,15995,-13419
ZCTA5 32703,19247,7267,11980,54551,38.1,29272,1620,15637,0.286649191,21812,32739
ZCTA5 32707,15695,3827,11868,37495,39.8,26508,1467,2917,0.07779704,11647,25848
ZCTA5 32708,19422,13079,6343,48218,42.7,37547,2279,2892,0.059977602,44175,4043
ZCTA5 32709,546,1430,-884,1310,46.6,1160,0,81,0.061832061,7581,-6271
ZCTA5 32712,15902,12986,2916,49441,41.6,33198,1425,5972,0.120790437,44702,4739
ZCTA5 32713,9149,6694,2455,22154,48.6,18110,1066,1026,0.046312178,13459,8695
ZCTA5 32714,15818,9158,6660,37957,36.7,24815,908,6464,0.170297969,18120,19837
ZCTA5 32720,12271,6159,6112,33239,41.8,25003,244,4218,0.126899125,11292,21947
ZCTA5 32723,0,1752,-1752,0,-,0,0,0,#DIV/0!,3243,-3243
ZCTA5 32724,16055,15856,199,40157,43,29993,628,2692,0.06703688,27548,12609
ZCTA5 32725,18035,13011,5024,50336,39.7,31785,964,5362,0.106524158,35254,15082
ZCTA5 32726,9424,20644,-11220,23236,38.1,15906,111,5071,0.21823894,63598,-40362
ZCTA5 32730,2865,18513,-15648,6536,41.1,4529,394,586,0.089657283,53571,-47035
ZCTA5 32732,1817,20071,-18254,5394,43,4931,16,39,0.007230256,57469,-52075
ZCTA5 32735,2169,7864,-5695,5050,48.6,4337,296,144,0.028514851,21445,-16395
ZCTA5 32736,4120,5250,-1130,11748,43,10822,43,494,0.042049711,11494,254
ZCTA5 32738,15798,5545,10253,47559,36.5,31747,443,6548,0.137681617,11098,36461
ZCTA5 32744,1197,12227,-11030,3487,41,3289,4,101,0.028964726,35691,-32204
ZCTA5 32746,18501,18901,-400,45145,43.5,32285,3990,4110,0.091039982,45335,-190
ZCTA5 32750,9522,19858,-10336,25189,42.4,19395,614,1771,0.070308468,44235,-19046
ZCTA5 32751,9243,16287,-7044,22671,40.6,16211,799,3476,0.153323629,35852,-13181
ZCTA5 32754,4664,6358,-1694,12159,51.8,11019,30,711,0.058475204,19212,-7053
ZCTA5 32757,12268,18589,-6321,29950,48.1,23022,401,3822,0.127612688,44706,-14756
ZCTA5 32759,1014,9460,-8446,2544,56.2,2246,11,234,0.091981132,28417,-25873
ZCTA5 32763,9817,10761,-944,23839,44.2,18678,261,2075,0.087042242,31655,-7816
ZCTA5 32764,1032,6122,-5090,2687,54.2,2526,0,59,0.021957574,21296,-18609
ZCTA5 32765,21830,9656,12174,62675,35.1,46500,3940,4538,0.072405265,28101,34574
ZCTA5 32766,5087,4173,914,16523,41.2,13116,1014,672,0.04067058,13150,3373
ZCTA5 32767,1110,6918,-5808,3156,49.4,3062,10,2,0.000633714,23127,-19971
ZCTA5 32768,0,3283,-3283,0,-,0,0,0,#DIV/0!,12328,-12328
ZCTA5 32771,20680,11979,8701,57074,37.7,30864,2999,15511,0.271769983,28296,28778
ZCTA5 32773,11807,11622,185,31903,34.9,15983,1927,7426,0.232768078,34708,-2805
ZCTA5 32775,0,10944,-10944,0,-,0,0,0,#DIV/0!,23587,-23587
ZCTA5 32776,4493,4440,53,12620,42.5,11473,309,295,0.023375594,11841,779
ZCTA5 32778,10458,10447,11,23210,53.6,18181,359,2830,0.121930202,26755,-3545
ZCTA5 32779,11083,7429,3654,28948,47.1,24295,1089,834,0.028810281,21256,7692
ZCTA5 32780,16126,8444,7682,37301,46.3,28662,897,4466,0.119728694,25896,11405
ZCTA5 32784,4258,10772,-6514,10929,44.8,10334,12,411,0.037606368,29351,-18422
ZCTA5 32789,11035,9393,1642,25801,45.4,21314,1186,1461,0.056625712,17689,8112
ZCTA5 32792,20913,11066,9847,51929,34.7,34714,2298,6400,0.1232452,29651,22278
ZCTA5 32796,8419,13999,-5580,20953,50.3,17642,134,1998,0.095356274,32979,-12026
ZCTA5 32798,1117,22316,-21199,2235,66.7,1790,111,132,0.059060403,63313,-61078
ZCTA5 32801,8621,5040,3581,13589,35.3,9454,1076,908,0.06681875,14600,-1011
ZCTA5 32803,10420,4942,5478,22136,37.8,17795,897,1107,0.050009035,14293,7843
ZCTA5 32804,8676,17579,-8903,20073,38.9,16524,568,1015,0.050565436,53682,-33609
ZCTA5 32805,6944,15703,-8759,18547,41.7,3191,9,13747,0.741198037,43742,-25195
ZCTA5 32806,11120,13707,-2587,27050,38.2,22269,428,1383,0.051127542,30644,-3594
ZCTA5 32807,12429,15636,-3207,35638,36.7,20329,1467,3376,0.094730344,35775,-137
ZCTA5 32808,19218,9156,10062,64001,31.8,11499,1318,43811,0.684536179,20081,43920
ZCTA5 32809,9259,13766,-4507,30744,35.4,16478,729,4224,0.137392662,38504,-7760
ZCTA5 32810,13830,6301,7529,39602,33.1,14732,1397,15441,0.38990455,21316,18286
ZCTA5 32811,14154,6757,7397,40402,32.2,12098,700,20711,0.512623137,17651,22751
ZCTA5 32812,14091,9186,4905,37241,36.4,23890,1720,4010,0.107677023,18958,18283
ZCTA5 32814,3941,19182,-15241,9293,35.1,7159,378,232,0.024965027,42538,-33245
ZCTA5 32816,0,9557,-9557,11667,19.2,10121,313,449,0.038484615,19322,-7655
ZCTA5 32817,11123,12800,-1677,35491,30.7,23426,2548,3226,0.090896284,32668,2823
ZCTA5 32818,17486,18296,-810,62693,33.3,10368,2022,43096,0.687413268,41700,20993
ZCTA5 32819,10034,17820,-7786,28765,37.2,17317,2102,4846,0.168468625,36181,-7416
ZCTA5 32820,3123,158,2965,11162,36.8,7343,500,1656,0.148360509,494,10668
ZCTA5 32821,8437,5390,3047,20618,31.9,13562,892,906,0.043942186,18690,1928
ZCTA5 32822,23119,11195,11924,67238,37.3,38205,1246,6899,0.102605669,26714,40524
ZCTA5 32824,14440,14270,170,53049,37.1,26469,2367,7911,0.149126279,28699,24350
ZCTA5 32825,19278,7910,11368,60846,35.5,36528,4717,6121,0.100598232,20165,40681
ZCTA5 32826,8632,13569,-4937,25763,28.3,17548,1148,2052,0.079649109,30655,-4892
ZCTA5 32827,5401,11875,-6474,16007,37.9,11088,1112,745,0.046542138,22086,-6079
ZCTA5 32828,23591,3233,20358,70039,35.6,48173,4775,6373,0.090992162,9449,60590
ZCTA5 32829,6142,8821,-2679,19331,35.7,12429,1316,1395,0.072163882,20002,-671
ZCTA5 32830,22,19045,-19023,44,40.2,42,0,0,0,49514,-49470
ZCTA5 32831,35,10123,-10088,2679,37.6,1565,0,915,0.341545353,30497,-27818
ZCTA5 32832,9545,13562,-4017,27072,35.4,16257,2133,1711,0.063201832,40826,-13754
ZCTA5 32833,3271,11740,-8469,10299,43.4,7583,542,1108,0.107583261,31473,-21174
ZCTA5 32835,17730,16897,833,50115,33.6,24294,5393,11599,0.23144767,55310,-5195
ZCTA5 32836,7751,19898,-12147,21868,37.2,13250,3172,1284,0.058715932,51134,-29266
ZCTA5 32837,15618,6003,9615,49669,40.6,26168,5327,3746,0.075419276,13555,36114
ZCTA5 32839,16899,7871,9028,52756,31.9,18991,2124,22107,0.419042384,26204,26552
ZCTA5 32899,0,1921,-1921,0,-,0,0,0,#DIV/0!,7049,-7049
ZCTA5 32901,10648,7886,2762,25176,44.5,18014,812,4530,0.17993327,19115,6061
ZCTA5 32903,6233,1623,4610,14347,51.4,13414,261,118,0.008224716,5628,8719
ZCTA5 32904,13444,2353,11091,35079,42.4,28410,1389,1951,0.055617321,7767,27312
ZCTA5 32905,10685,6664,4021,26073,41.6,18067,596,4272,0.163847658,11947,14126
ZCTA5 32907,16193,3882,12311,47209,44.5,32465,602,7730,0.163739965,11797,35412
ZCTA5 32908,4270,5552,-1282,13351,36.7,7994,88,3220,0.241180436,9605,3746
ZCTA5 32909,11530,6263,5267,34156,39.6,20350,1231,7098,0.207811219,12692,21464
ZCTA5 32920,5906,13726,-7820,9979,58.6,9364,103,82,0.008217256,23595,-13616
ZCTA5 32922,6505,8706,-2201,15108,37.3,7921,91,5000,0.33095049,21899,-6791
ZCTA5 32925,484,7554,-7070,1609,25.3,1023,82,192,0.119328776,17113,-15504
ZCTA5 32926,9333,664,8669,23193,50.1,17650,745,3558,0.153408356,4954,18239
ZCTA5 32927,10224,9542,682,28618,40.9,24338,255,1442,0.050387868,22675,5943
ZCTA5 32931,7179,5337,1842,13469,58.2,12493,132,126,0.009354815,15417,-1948
ZCTA5 32934,7309,4,7305,18901,52.9,15930,313,507,0.026823978,17,18884
ZCTA5 32935,17254,10097,7157,41744,40.1,32936,1831,2752,0.065925642,26792,14952
ZCTA5 32937,11227,20003,-8776,27557,47.5,23751,407,829,0.0300831,51784,-24227
ZCTA5 32940,18599,3784,14815,45050,48.1,37538,2250,1993,0.044239734,11946,33104
ZCTA5 32948,1735,767,968,6079,35.6,4185,0,773,0.127159072,2227,3852
ZCTA5 32949,962,251,711,2616,56.3,2392,30,56,0.021406728,634,1982
ZCTA5 32950,1821,6632,-4811,4565,53.5,3961,0,143,0.031325301,19710,-15145
ZCTA5 32951,5826,6867,-1041,11814,61.6,11161,191,8,0.000677163,18494,-6680
ZCTA5 32952,8228,4418,3810,20515,51.3,18251,384,346,0.016865708,14986,5529
ZCTA5 32953,9322,4403,4919,23853,48.5,19870,864,1077,0.045151553,14344,9509
ZCTA5 32955,15437,2540,12897,38892,46.9,31354,674,4319,0.111051116,5244,33648
ZCTA5 32958,12440,3858,8582,28339,58.2,25843,122,440,0.015526307,9498,18841
ZCTA5 32959,0,9114,-9114,0,-,0,0,0,#DIV/0!,20983,-20983
ZCTA5 32960,9367,9671,-304,23085,44,17760,712,1579,0.068399394,20957,2128
ZCTA5 32962,9314,8079,1235,25958,47.7,21222,182,3347,0.128939055,22220,3738
ZCTA5 32963,7594,7938,-344,15182,69.2,14505,211,110,0.007245422,23806,-8624
ZCTA5 32966,8651,4011,4640,18916,60.6,17153,220,453,0.023947981,12365,6551
ZCTA5 32967,8791,6320,2471,24405,53.3,15756,301,5259,0.215488629,20024,4381
ZCTA5 32968,5440,2123,3317,15825,47.4,12761,541,856,0.054091627,5989,9836
ZCTA5 32970,45,6180,-6135,213,56.4,0,0,213,1,16024,-15811
ZCTA5 32976,5048,7388,-2340,8759,68.2,8565,79,0,0,21212,-12453
ZCTA5 33001,179,7641,-7462,341,65.6,305,0,0,0,19754,-19413
ZCTA5 33004,7003,6310,693,15876,41.9,8731,172,4901,0.308704963,16176,-300
ZCTA5 33009,20180,8713,11467,43547,45.4,27016,744,8177,0.187774129,25178,18369
ZCTA5 33010,15483,6352,9131,42246,47.5,25215,143,1138,0.026937462,18416,23830
ZCTA5 33012,24959,6614,18345,70485,48.2,45184,83,761,0.010796623,20593,49892
ZCTA5 33013,9481,3131,6350,30706,46.7,19697,149,234,0.00762066,10118,20588
ZCTA5 33014,14311,7982,6329,41021,41.7,25900,487,939,0.022890715,23528,17493
ZCTA5 33015,23078,7188,15890,69023,40.4,39694,437,5167,0.074859105,19713,49310
ZCTA5 33016,15606,5724,9882,46498,43.1,29920,413,976,0.02099015,14594,31904
ZCTA5 33018,16681,11373,5308,55079,41.5,34603,538,406,0.00737123,20258,34821
ZCTA5 33019,6371,1713,4658,13613,52.5,11619,57,333,0.024461911,3931,9682
ZCTA5 33020,19434,14334,5100,45416,39.1,22187,1057,12107,0.26658006,36632,8784
ZCTA5 33021,18969,7599,11370,49788,40,34052,1067,8014,0.160962481,23680,26108
ZCTA5 33022,0,8869,-8869,0,-,0,0,0,#DIV/0!,25706,-25706
ZCTA5 33023,20812,464,20348,71463,36.3,21294,1175,37839,0.529490785,1375,70088
ZCTA5 33024,24329,3867,20462,74017,36.7,39244,3185,13349,0.18035046,10498,63519
ZCTA5 33025,26946,11420,15526,71690,36.6,24738,2633,35512,0.495355001,32759,38931
ZCTA5 33026,12071,9835,2236,31671,45,20664,998,4383,0.138391589,29207,2464
ZCTA5 33027,24219,3104,21115,63068,46.8,31801,4994,16564,0.262637154,8117,54951
ZCTA5 33028,8730,3665,5065,27530,40.5,15365,2788,4469,0.162332001,12662,14868
ZCTA5 33029,13150,6042,7108,45177,39.8,25805,3157,8163,0.180689289,11484,33693
ZCTA5 33030,10199,7921,2278,37225,29.9,19489,488,5021,0.134882471,18805,18420
ZCTA5 33031,2690,14330,-11640,9190,42.6,6597,16,524,0.057018498,37801,-28611
ZCTA5 33032,16043,6192,9851,54545,33.7,27190,969,12710,0.233018608,16381,38164
ZCTA5 33033,19036,7392,11644,67265,32.4,37912,529,12430,0.184791496,17173,50092
ZCTA5 33034,5448,9575,-4127,23044,29.9,9533,8,8454,0.366863392,24140,-1096
ZCTA5 33035,5287,7985,-2698,16127,34.2,9435,0,3971,0.246233025,17197,-1070
ZCTA5 33036,1792,14878,-13086,3810,56.1,3439,79,7,0.00183727,41120,-37310
ZCTA5 33037,5159,14416,-9257,12090,52.8,10691,98,32,0.002646816,30147,-18057
ZCTA5 33039,0,17230,-17230,0,-,0,0,0,#DIV/0!,44965,-44965
ZCTA5 33040,14608,13148,1460,37404,41.6,26659,667,5197,0.138942359,31389,6015
ZCTA5 33042,2908,17865,-14957,7054,50.4,6262,24,103,0.014601644,47421,-40367
ZCTA5 33043,1896,17224,-15328,4801,51.6,4605,36,26,0.005415538,45916,-41115
ZCTA5 33050,4299,5541,-1242,10423,49.8,8329,101,498,0.04777895,13478,-3055
ZCTA5 33051,410,17007,-16597,744,66.9,698,0,0,0,42831,-42087
ZCTA5 33054,10164,10430,-266,32390,34.7,7314,346,19709,0.608490275,24522,7868
ZCTA5 33055,11464,10835,629,38817,44.3,18435,605,9539,0.245742845,34483,4334
ZCTA5 33056,10925,0,10925,37579,38.2,5154,27,27881,0.741930333,3765,33814
ZCTA5 33060,13959,440,13519,37826,40.2,18179,204,15875,0.419684873,1862,35964
ZCTA5 33062,13274,15410,-2136,23763,60.8,21190,107,505,0.021251525,39780,-16017
ZCTA5 33063,24961,8829,16132,54907,47.2,29266,2081,15715,0.28621123,24563,30344
ZCTA5 33064,22668,9547,13121,60586,40.3,32158,1059,16872,0.278480177,26533,34053
ZCTA5 33065,19546,10187,9359,60590,35.3,30817,2139,16524,0.27271827,24430,36160
ZCTA5 33066,8453,7163,1290,16163,58.8,11149,493,2370,0.146631195,19186,-3023
ZCTA5 33067,8380,6318,2062,25649,39.4,16873,1494,4028,0.15704316,15322,10327
ZCTA5 33068,18539,6119,12420,52541,36.6,14295,1633,29847,0.56807065,15326,37215
ZCTA5 33069,11115,20848,-9733,29089,36.7,13018,1058,10136,0.348447867,59098,-30009
ZCTA5 33070,2378,7764,-5386,5559,53.1,4753,39,12,0.002158662,13727,-8168
ZCTA5 33071,13401,13116,285,39182,37.6,23094,1483,7163,0.182813537,30125,9057
ZCTA5 33073,11655,10302,1353,34243,36.1,23585,933,5192,0.151622229,24271,9972
ZCTA5 33076,12833,7440,5393,42044,39,28300,3966,5113,0.121610694,16925,25119
ZCTA5 33101,0,10261,-10261,0,-,0,0,0,#DIV/0!,25829,-25829
ZCTA5 33109,258,8597,-8339,568,67.7,568,0,0,0,16051,-15483
ZCTA5 33122,724,11870,-11146,1771,31.7,1233,96,138,0.077922078,24752,-22981
ZCTA5 33125,20956,7892,13064,55161,42.9,33304,259,3647,0.066115553,14757,40404
ZCTA5 33126,18017,11251,6766,48130,44.8,33732,310,622,0.012923333,24607,23523
ZCTA5 33127,9891,13661,-3770,29097,37.3,7450,325,12782,0.439289274,32565,-3468
ZCTA5 33128,3577,6920,-3343,8665,41.3,5490,0,599,0.069128679,19303,-10638
ZCTA5 33129,6906,9522,-2616,14390,42.5,9870,273,455,0.03161918,25261,-10871
ZCTA5 33130,16124,12392,3732,31835,38.7,21282,712,1524,0.047871839,30045,1790
ZCTA5 33131,12296,8041,4255,22529,34.6,15315,822,473,0.020995162,18930,3599
ZCTA5 33132,8126,3637,4489,15834,34.8,8508,984,1646,0.103953518,6510,9324
ZCTA5 33133,14203,7735,6468,34434,41.7,20490,939,3924,0.113957135,14840,19594
ZCTA5 33134,16171,0,16171,39082,43.9,27975,595,328,0.00839261,129,38953
ZCTA5 33135,14245,8999,5246,35115,43.9,21141,65,694,0.019763634,24550,10565
ZCTA5 33136,6634,12694,-6060,16190,36.7,6547,236,6799,0.419950587,29839,-13649
ZCTA5 33137,10405,7484,2921,22768,35.2,13311,458,4641,0.203838721,16742,6026
ZCTA5 33138,12766,5988,6778,30029,40.5,15740,418,9107,0.303273502,15092,14937
ZCTA5 33139,19898,8982,10916,35393,40.4,24169,763,1693,0.047834318,18986,16407
ZCTA5 33140,8709,2780,5929,20672,40.2,15197,351,840,0.040634675,7370,13302
ZCTA5 33141,16538,9246,7292,35855,43.6,20210,668,1755,0.048947148,18702,17153
ZCTA5 33142,20091,11498,8593,57733,38.2,22576,45,18429,0.31921085,25394,32339
ZCTA5 33143,12669,5871,6798,31012,40.8,20921,754,2278,0.073455437,13888,17124
ZCTA5 33144,9535,4464,5071,28606,46.1,18904,141,566,0.019786059,7873,20733
ZCTA5 33145,11459,11915,-456,28944,45,18811,513,530,0.018311222,25200,3744
ZCTA5 33146,5160,13750,-8590,16507,24.5,11291,914,943,0.057127279,28431,-11924
ZCTA5 33147,14747,10128,4619,46363,38,11079,64,25785,0.556154692,22093,24270
ZCTA5 33149,4601,7212,-2611,14611,41.9,9623,34,48,0.003285196,17302,-2691
ZCTA5 33150,11030,8025,3005,33116,34.9,3244,583,23600,0.712646455,18772,14344
ZCTA5 33154,5687,5053,634,14636,41.4,10817,113,524,0.035802132,13460,1176
ZCTA5 33155,14866,6765,8101,44440,44,30495,777,471,0.01059856,17171,27269
ZCTA5 33156,11749,6298,5451,33111,42,23485,1599,930,0.028087343,14740,18371
ZCTA5 33157,20554,10534,10020,69212,39.1,37966,1410,12888,0.186210484,26007,43205
ZCTA5 33158,2017,9046,-7029,6351,44.8,4759,533,115,0.018107385,21153,-14802
ZCTA5 33160,20050,3061,16989,42053,50.3,32089,662,1863,0.044301239,5656,36397
ZCTA5 33161,17264,732,16532,54241,37.2,13333,840,32473,0.598679965,1609,52632
ZCTA5 33162,14605,11920,2685,47698,36.4,15439,1408,24455,0.512704935,32288,15410
ZCTA5 33165,17042,12077,4965,53198,46,35693,445,1100,0.020677469,27818,25380
ZCTA5 33166,9418,8498,920,25177,40.5,17497,229,884,0.035111411,23131,2046
ZCTA5 33167,6537,11691,-5154,22081,38.5,5279,0,14504,0.656854309,29874,-7793
ZCTA5 33168,6687,16963,-10276,23938,40.1,4660,172,16767,0.700434456,48057,-24119
ZCTA5 33169,12858,7391,5467,41417,33.4,5215,416,33274,0.803389912,20050,21367
ZCTA5 33170,4201,4361,-160,13788,38.8,7179,0,4241,0.307586307,13661,127
ZCTA5 33172,14604,11444,3160,40897,42.3,30388,1035,725,0.017727462,31590,9307
ZCTA5 33173,11644,5135,6509,33089,44.1,22323,1241,583,0.017619148,13662,19427
ZCTA5 33174,11170,10299,871,34114,41.1,19999,1055,1307,0.038312716,29046,5068
ZCTA5 33175,17019,9082,7937,51693,47.4,36737,707,257,0.00497166,25888,25805
ZCTA5 33176,18635,927,17708,52932,40.9,31718,813,6758,0.127673241,2612,50320
ZCTA5 33177,16052,8942,7110,57167,41.2,32613,854,6832,0.119509507,26274,30893
ZCTA5 33178,19069,1886,17183,64366,36.7,48248,1685,1580,0.024547121,7554,56812
ZCTA5 33179,17863,7084,10779,46858,39.5,19395,533,19534,0.416876521,19794,27064
ZCTA5 33180,14528,1574,12954,32925,48.2,25488,615,741,0.022505695,3618,29307
ZCTA5 33181,8164,1123,7041,20180,38.8,10711,191,5714,0.283151635,2944,17236
ZCTA5 33182,4106,2896,1210,13060,45.1,8915,22,219,0.01676876,9140,3920
ZCTA5 33183,12472,3781,8691,34662,45.1,23606,772,741,0.021377878,12137,22525
ZCTA5 33184,6455,12101,-5646,21528,45.8,14445,120,300,0.01393534,32669,-11141
ZCTA5 33185,8799,51,8748,29599,42.1,20288,574,354,0.011959864,199,29400
ZCTA5 33186,22617,480,22137,67686,40.5,45629,2364,3448,0.05094111,1210,66476
ZCTA5 33187,5523,268,5255,18781,41.1,12168,369,1171,0.062350248,1049,17732
ZCTA5 33189,8156,2735,5421,24120,40.8,13668,732,3157,0.130887231,7036,17084
ZCTA5 33190,5118,289,4829,17230,33.7,10627,94,2304,0.133720255,745,16485
ZCTA5 33193,15548,8197,7351,47571,41.9,31208,1044,671,0.014105232,20669,26902
ZCTA5 33194,2093,4142,-2049,9388,41.7,6388,47,932,0.099275671,10781,-1393
ZCTA5 33196,16601,104,16497,55287,38.4,32281,1597,2507,0.045345199,155,55132
ZCTA5 33301,9170,8,9162,16261,42.6,12861,384,1318,0.081052826,16,16245
ZCTA5 33304,9530,240,9290,18085,45.3,12108,210,2957,0.163505668,351,17734
ZCTA5 33305,6640,739,5901,12634,50.2,10930,163,584,0.046224474,1937,10697
ZCTA5 33306,1843,4072,-2229,3111,54.5,2611,32,91,0.029251045,9975,-6864
ZCTA5 33308,15638,7576,8062,28428,56.5,24249,698,764,0.026874912,22793,5635
ZCTA5 33309,14066,218,13848,40100,37,15312,780,18333,0.457182045,806,39294
ZCTA5 33311,24737,161,24576,73388,34.6,8750,360,60033,0.81802202,350,73038
ZCTA5 33312,18490,3723,14767,53855,38,30281,913,15456,0.286992851,12876,40979
ZCTA5 33313,21780,8923,12857,63715,34.6,8906,1136,49856,0.782484501,21952,41763
ZCTA5 33314,10435,6602,3833,28730,32.5,15682,1625,3834,0.133449356,14306,14424
ZCTA5 33315,5895,3869,2026,13178,40.6,11189,103,636,0.048262255,13229,-51
ZCTA5 33316,5552,4095,1457,11194,50.8,8787,524,835,0.074593532,10197,997
ZCTA5 33317,12762,1940,10822,37161,42.3,19520,1363,8597,0.231344689,4713,32448
ZCTA5 33319,20733,134,20599,50703,43.4,12849,1992,30635,0.604204879,221,50482
ZCTA5 33321,21625,12809,8816,50513,48.2,28525,1382,12086,0.23926514,36329,14184
ZCTA5 33322,18399,12130,6269,40244,53.3,21795,1777,9298,0.231040652,30428,9816
ZCTA5 33323,8319,11528,-3209,23099,40.4,14450,1265,3902,0.168925062,28925,-5826
ZCTA5 33324,19516,1608,17908,49343,38.4,30487,2586,7969,0.161502138,5825,43518
ZCTA5 33325,10364,3045,7319,31410,38.1,20434,1413,2175,0.069245463,7591,23819
ZCTA5 33326,10655,5461,5194,31687,41.3,21901,1353,1148,0.036229369,14599,17088
ZCTA5 33327,6557,6450,107,23593,39.9,14531,1749,1325,0.056160726,15488,8105
ZCTA5 33328,9940,7237,2703,28373,39.4,20685,1443,1366,0.048144363,18529,9844
ZCTA5 33330,4614,9647,-5033,14450,41.9,9644,1474,1423,0.098477509,18987,-4537
ZCTA5 33331,7454,12932,-5478,25150,42.2,15328,2048,975,0.038767396,29933,-4783
ZCTA5 33332,3393,10412,-7019,11484,45.2,7509,615,1011,0.088035528,30511,-19027
ZCTA5 33334,12730,8867,3863,29497,42.5,19117,657,4822,0.163474252,19895,9602
ZCTA5 33351,12589,16153,-3564,34699,36.5,13086,2077,14857,0.428167959,34013,686
ZCTA5 33388,0,7392,-7392,0,-,0,0,0,#DIV/0!,22633,-22633
ZCTA5 33401,13578,7002,6576,31144,36,16043,455,11497,0.369156178,16041,15103
ZCTA5 33403,4922,6164,-1242,14139,36.6,5820,279,6035,0.426833581,17868,-3729
ZCTA5 33404,11356,13502,-2146,30431,40,7992,77,20257,0.665669876,37842,-7411
ZCTA5 33405,8368,7426,942,21138,42.3,15867,127,767,0.036285363,22819,-1681
ZCTA5 33406,8451,13291,-4840,26006,38.3,17492,603,2470,0.094978082,29759,-3753
ZCTA5 33407,12174,13436,-1262,32422,39.1,8845,691,20323,0.626827463,28509,3913
ZCTA5 33408,9535,1828,7707,18522,58.9,17101,208,168,0.009070295,5439,13083
ZCTA5 33409,11569,561,11008,33146,32.6,15074,1128,10608,0.320038617,1186,31960
ZCTA5 33410,15085,1691,13394,35711,44.6,28125,1255,2220,0.062165719,4133,31578
ZCTA5 33411,27024,71,26953,74923,42.5,45513,3589,17563,0.234413998,225,74698
ZCTA5 33412,5551,9120,-3569,15234,50.3,11501,602,2209,0.145004595,20235,-5001
ZCTA5 33413,5421,320,5101,16910,35.9,8172,697,4856,0.287167357,884,16026
ZCTA5 33414,19306,5640,13666,58505,39.8,39135,2424,7767,0.132757884,10509,47996
ZCTA5 33415,18184,5773,12411,51913,39.4,27246,1060,9557,0.184096469,19356,32557
ZCTA5 33417,16050,8511,7539,35443,45.7,17400,491,11704,0.330220354,22197,13246
ZCTA5 33418,18010,132,17878,42372,52.6,35957,1591,2668,0.06296611,590,41782
ZCTA5 33426,9992,10,9982,23591,43.9,14543,996,4915,0.208342164,33,23558
ZCTA5 33428,15775,779,14996,44551,40.7,31905,2012,3030,0.068011941,1801,42750
ZCTA5 33430,6524,3920,2604,20628,32.9,5926,343,12113,0.587211557,8466,12162
ZCTA5 33431,7546,6992,554,21554,39.5,14977,982,2840,0.131762086,16168,5386
ZCTA5 33432,10287,9589,698,20263,54.2,17351,332,938,0.04629127,19618,645
ZCTA5 33433,19372,13083,6289,42684,50.4,34137,1991,858,0.020101209,29968,12716
ZCTA5 33434,10331,2331,8000,21017,63.7,17705,504,602,0.028643479,5031,15986
ZCTA5 33435,14236,3806,10430,36644,41,17352,418,15528,0.423752865,9806,26838
ZCTA5 33436,19144,3811,15333,47089,43.4,29982,1123,10955,0.232644567,9329,37760
ZCTA5 33437,18053,1935,16118,37997,65.6,28083,769,4888,0.128641735,3435,34562
ZCTA5 33438,153,3390,-3237,431,56.6,342,0,89,0.20649652,6604,-6173
ZCTA5 33440,6985,327,6658,20438,38.6,12127,343,3621,0.177169977,1043,19395
ZCTA5 33441,12682,0,12682,29347,44.6,15591,823,9516,0.324258016,983,28364
ZCTA5 33442,15358,3512,11846,31680,51.1,23947,371,3234,0.102083333,8786,22894
ZCTA5 33444,8984,7720,1264,23842,41.1,10528,414,10897,0.457050583,24228,-386
ZCTA5 33445,13796,6255,7541,30309,53.5,19882,970,6401,0.211191395,22705,7604
ZCTA5 33446,13680,3437,10243,26791,68.2,23541,578,930,0.03471315,10967,15824
ZCTA5 33449,3265,3028,237,9799,45.3,7650,416,1174,0.119808144,11406,-1607
ZCTA5 33455,9399,3496,5903,21068,57.7,19179,182,968,0.045946459,11703,9365
ZCTA5 33458,20913,3769,17144,56174,40.9,44932,1138,1680,0.029907074,14014,42160
ZCTA5 33460,12328,4780,7548,36346,35.7,19512,359,5838,0.160622902,9787,26559
ZCTA5 33461,15771,4051,11720,47633,36.1,23794,1211,9830,0.206369534,9306,38327
ZCTA5 33462,12727,3908,8819,32371,43.3,20547,431,7388,0.22822897,9837,22534
ZCTA5 33463,20371,5981,14390,65754,35.5,32005,3014,19718,0.299875293,14229,51525
ZCTA5 33467,21173,10553,10620,54790,48.8,41662,1970,4203,0.076711079,29797,24993
ZCTA5 33469,6711,5830,881,14754,57,13872,122,56,0.003795581,15885,-1131
ZCTA5 33470,8961,6542,2419,28800,43,20928,528,3507,0.121770833,21285,7515
ZCTA5 33471,2380,0,2380,6571,47.2,4352,0,1616,0.245929082,0,6571
ZCTA5 33472,8020,5154,2866,19422,58.1,14792,987,1858,0.09566471,10754,8668
ZCTA5 33473,4116,5618,-1502,11454,47,9948,378,418,0.036493801,12352,-898
ZCTA5 33476,2083,9670,-7587,7001,35.8,1451,0,4415,0.630624197,23901,-16900
ZCTA5 33477,6532,6353,179,11712,67.7,11219,105,17,0.001451503,14450,-2738
ZCTA5 33478,5132,7976,-2844,15064,44.5,13332,298,146,0.009691981,17185,-2121
ZCTA5 33480,6436,10083,-3647,11050,69.6,10227,155,37,0.003348416,24459,-13409
ZCTA5 33483,6584,9126,-2542,12795,56.9,11387,246,749,0.058538492,20822,-8027
ZCTA5 33484,14639,11317,3322,26457,67.2,21488,612,1514,0.057224931,26422,35
ZCTA5 33486,8816,6489,2327,22515,43.5,18782,706,1084,0.048145681,18078,4437
ZCTA5 33487,9859,5689,4170,21691,52.4,17875,530,1323,0.060993039,14120,7571
ZCTA5 33493,860,8420,-7560,6298,42,1850,64,3662,0.58145443,31798,-25500
ZCTA5 33496,10121,4095,6026,23144,55.7,19743,757,998,0.043121327,15229,7915
ZCTA5 33498,5742,9565,-3823,16769,47.1,13680,809,540,0.032202278,23713,-6944
ZCTA5 33503,77,7786,-7709,269,43,103,12,0,0,27325,-27056
ZCTA5 33510,11312,6938,4374,29629,38.8,17677,1528,5122,0.172871174,14188,15441
ZCTA5 33511,22233,14944,7289,59118,37.9,37331,2644,9413,0.159223925,37330,21788
ZCTA5 33513,4138,115,4023,12781,45.1,10550,49,1434,0.112197794,129,12652
ZCTA5 33514,761,187,574,2391,42.4,1920,0,106,0.044332915,523,1868
ZCTA5 33521,206,170,36,596,34.6,362,0,211,0.354026846,373,223
ZCTA5 33523,6552,112,6440,18684,40.4,14265,322,1551,0.083012203,261,18423
ZCTA5 33525,6860,45,6815,17940,46.3,15449,194,1160,0.064659978,129,17811
ZCTA5 33527,5359,4467,892,16814,39.6,12294,188,1329,0.079041275,25075,-8261
ZCTA5 33530,0,7751,-7751,0,-,0,0,0,#DIV/0!,16570,-16570
ZCTA5 33534,5520,1758,3762,17859,31.4,10000,414,3693,0.206786494,3832,14027
ZCTA5 33538,2305,7774,-5469,4983,50.4,4690,36,42,0.008428657,20802,-15819
ZCTA5 33540,4539,13597,-9058,10223,57.1,9218,45,339,0.03316052,35824,-25601
ZCTA5 33541,9991,12530,-2539,22459,58.6,18945,864,1216,0.054143105,29971,-7512
ZCTA5 33542,10393,12896,-2503,23134,52.6,20061,139,838,0.03622374,29230,-6096
ZCTA5 33543,11371,11537,-166,32610,38.1,22649,2218,3275,0.100429316,34069,-1459
ZCTA5 33544,9437,14063,-4626,28270,36.8,19517,1441,2518,0.089069685,32610,-4340
ZCTA5 33545,7199,7035,164,23118,35.7,14627,826,3628,0.156933991,15323,7795
ZCTA5 33547,9100,1048,8052,29236,35.7,23359,1254,2162,0.073949925,2494,26742
ZCTA5 33548,2688,5496,-2808,7385,42.4,6012,438,342,0.046310088,15443,-8058
ZCTA5 33549,7376,430,6946,18677,45.5,13583,952,1609,0.086148739,873,17804
ZCTA5 33550,0,729,-729,0,-,0,0,0,#DIV/0!,1389,-1389
ZCTA5 33556,9714,2782,6932,27729,44,22141,1646,1396,0.050344405,5142,22587
ZCTA5 33558,9958,5914,4044,27309,41.1,19755,2503,1308,0.047896298,16642,10667
ZCTA5 33559,6335,15143,-8808,17355,35.2,12695,1073,1541,0.088792855,39306,-21951
ZCTA5 33563,9940,5255,4685,27097,36.4,18043,85,3948,0.145698786,11470,15627
ZCTA5 33565,6086,8736,-2650,17394,42.9,14436,157,251,0.014430263,17322,72
ZCTA5 33566,7752,7370,382,22415,37.9,16572,623,1216,0.054249387,15443,6972
ZCTA5 33567,3769,3590,179,11821,41.1,8441,187,1790,0.151425429,6612,5209
ZCTA5 33569,9421,3268,6153,25960,39.3,17771,947,3572,0.137596302,6997,18963
ZCTA5 33570,10296,14235,-3939,30088,37,18102,605,5573,0.185223345,29592,496
ZCTA5 33572,8767,13088,-4321,22771,44,16924,685,2647,0.116244346,31574,-8803
ZCTA5 33573,13640,7539,6101,26042,70.1,20607,344,2692,0.103371477,17363,8679
ZCTA5 33574,0,8292,-8292,1187,19.3,664,20,353,0.297388374,20509,-19322
ZCTA5 33576,2317,6193,-3876,4698,66.8,4356,17,196,0.041719881,13922,-9224
ZCTA5 33578,22071,5831,16240,54136,34.4,31989,1399,11762,0.217267622,10337,43799
ZCTA5 33579,12506,6724,5782,39551,36.7,23872,1302,8830,0.223256049,17033,22518
ZCTA5 33584,9582,8897,685,26711,41,17602,1210,3825,0.143199431,17153,9558
ZCTA5 33585,484,7133,-6649,1350,46.9,1141,0,54,0.04,16809,-15459
ZCTA5 33592,4055,4348,-293,11771,42.6,9202,313,1340,0.113839096,11715,56
ZCTA5 33594,13077,5240,7837,36154,42.4,23443,1630,5366,0.148420645,13930,22224
ZCTA5 33596,10198,4375,5823,30103,42.9,23887,614,2734,0.090821513,8673,21430
ZCTA5 33597,3187,11836,-8649,8414,42.6,7294,0,318,0.037794153,26315,-17901
ZCTA5 33598,7705,1875,5830,26115,35.2,13860,268,3396,0.130040207,6031,20084
ZCTA5 33602,8892,8809,83,16044,36.8,10812,664,2583,0.160994764,30640,-14596
ZCTA5 33603,8560,48,8512,20245,36,13097,99,4148,0.204890096,214,20031
ZCTA5 33604,15302,1651,13651,38743,37.9,20887,482,10355,0.267274088,3774,34969
ZCTA5 33605,7140,7490,-350,16139,37.1,5237,186,7992,0.495197968,16020,119
ZCTA5 33606,8693,9524,-831,21281,29.3,18110,616,1108,0.052065222,17910,3371
ZCTA5 33607,10694,6694,4000,24171,39.3,13532,870,4298,0.177816392,20157,4014
ZCTA5 33609,8330,10776,-2446,18117,38.9,14873,992,620,0.034222001,24037,-5920
ZCTA5 33610,16775,3866,12909,47068,32.5,13796,1209,27169,0.57722869,11001,36067
ZCTA5 33611,16136,658,15478,34295,39.8,26845,1501,1911,0.055722409,1405,32890
ZCTA5 33612,18746,1650,17096,49352,33.9,23639,1106,15156,0.307100016,4487,44865
ZCTA5 33613,15808,7055,8753,36941,28.4,21463,1812,7411,0.2006172,13645,23296
ZCTA5 33614,18410,15228,3182,47591,38.8,27736,1507,4819,0.101258641,32840,14751
ZCTA5 33615,18494,6403,12091,47969,38.7,29488,1649,4095,0.085367633,16994,30975
ZCTA5 33616,6086,4150,1936,14531,37.5,10092,577,1804,0.124148372,9630,4901
ZCTA5 33617,19168,3673,15495,47472,32.4,21252,2965,16608,0.349848332,7919,39553
ZCTA5 33618,11957,3309,8648,27396,45.6,21968,897,1431,0.052233903,7616,19780
ZCTA5 33619,14074,5145,8929,41225,33.1,18336,937,14786,0.358665858,12845,28380
ZCTA5 33620,10,2258,-2248,4743,19.3,3388,186,683,0.144001687,6013,-1270
ZCTA5 33621,536,2939,-2403,2599,21.6,1557,119,603,0.232012312,8071,-5472
ZCTA5 33624,15533,3007,12526,40904,40.1,29232,1274,3070,0.075053784,7252,33652
ZCTA5 33625,11133,6037,5096,28577,40.9,19245,1540,2240,0.078384715,14066,14511
ZCTA5 33626,11518,0,11518,29944,40.5,21625,3187,942,0.031458723,0,29944
ZCTA5 33629,10163,7655,2508,26175,40.2,22512,663,632,0.024145177,17492,8683
ZCTA5 33634,7839,4674,3165,23662,37.6,14498,637,2993,0.12648973,11158,12504
ZCTA5 33635,7624,1426,6198,20075,37.3,15482,1869,838,0.041743462,3051,17024
ZCTA5 33637,7236,5092,2144,18522,31.9,10141,1791,4527,0.244412051,10867,7655
ZCTA5 33647,25206,4658,20548,71767,36.6,40250,10733,10933,0.152340212,11548,60219
ZCTA5 33701,9405,4060,5345,16802,46.5,13387,174,2040,0.121414117,10579,6223
ZCTA5 33702,14241,3926,10315,32150,43.3,24821,1509,2766,0.086034215,10021,22129
ZCTA5 33703,11132,7231,3901,26709,43.6,22681,622,1569,0.058744244,15822,10887
ZCTA5 33704,7689,8101,-412,16059,48.4,14350,242,661,0.04116072,18196,-2137
ZCTA5 33705,11145,9894,1251,26749,45,11443,492,12831,0.479681483,24454,2295
ZCTA5 33706,8273,10173,-1900,15478,61.1,14430,176,258,0.01666882,25929,-10451
ZCTA5 33707,12659,6035,6624,25260,57.9,21428,306,1773,0.070190024,17280,7980
ZCTA5 33708,7747,6692,1055,14826,60.5,13618,295,229,0.015445838,15691,-865
ZCTA5 33709,10493,4167,6326,23264,52.8,18949,814,1171,0.050335282,13275,9989
ZCTA5 33710,14176,9824,4352,34462,45.6,29288,1205,1550,0.044977076,22764,11698
ZCTA5 33711,6180,5063,1117,18409,39.5,7748,116,9707,0.527296431,14013,4396
ZCTA5 33712,9340,6736,2604,24495,38.1,5940,147,17032,0.695325577,18388,6107
ZCTA5 33713,14053,8489,5564,32572,42.1,24025,2550,2526,0.077551271,16529,16043
ZCTA5 33714,8172,7543,629,20163,40.3,13434,1952,2742,0.135991668,22964,-2801
ZCTA5 33715,3672,1146,2526,7653,62.4,7137,149,7,0.000914674,2976,4677
ZCTA5 33716,9557,4717,4840,18396,32.7,12480,892,2396,0.130245706,10723,7673
ZCTA5 33744,0,12474,-12474,73,67.4,54,0,19,0.260273973,27256,-27183
ZCTA5 33755,10529,290,10239,27437,39.9,17496,537,6903,0.251594562,565,26872
ZCTA5 33756,13378,8902,4476,32899,44.2,24033,548,5200,0.158059515,21691,11208
ZCTA5 33759,7746,2997,4749,17370,45.6,13369,497,1126,0.06482441,7457,9913
ZCTA5 33760,7524,3640,3884,21304,37.2,13933,1203,4286,0.201182876,10327,10977
ZCTA5 33761,8881,11470,-2589,19308,55.4,16539,805,607,0.031437746,25331,-6023
ZCTA5 33762,2655,3804,-1149,5402,49.8,4639,199,119,0.022028878,7815,-2413
ZCTA5 33763,9755,12811,-3056,20657,54.8,16991,434,988,0.047828823,32131,-11474
ZCTA5 33764,12091,14403,-2312,27600,49.3,23772,942,803,0.029094203,37921,-10321
ZCTA5 33765,6526,4156,2370,15257,47.5,11706,924,1107,0.072556859,11553,3704
ZCTA5 33767,4120,8246,-4126,7615,63.7,7192,140,170,0.02232436,17970,-10355
ZCTA5 33770,11275,2093,9182,25880,48.1,21425,544,1719,0.066421947,6085,19795
ZCTA5 33771,12788,2183,10605,28174,51.3,23207,716,2181,0.077411798,6167,22007
ZCTA5 33772,9904,6587,3317,23559,49.1,21286,561,397,0.016851309,20556,3003
ZCTA5 33773,7043,8306,-1263,17135,47.9,13994,1654,361,0.021067989,24146,-7011
ZCTA5 33774,8330,10364,-2034,19691,50.8,16416,142,1837,0.093291351,23506,-3815
ZCTA5 33776,5004,12712,-7708,13181,50.5,11773,308,226,0.017145892,30684,-17503
ZCTA5 33777,7057,8115,-1058,17214,49.2,14656,738,369,0.02143604,21619,-4405
ZCTA5 33778,6219,15286,-9067,15912,47.8,12117,464,1534,0.096405229,37625,-21713
ZCTA5 33781,10384,124,10260,26887,41.9,19625,2751,1919,0.071372782,249,26638
ZCTA5 33782,9249,14589,-5340,22457,48.4,17160,2628,669,0.029790266,32000,-9543
ZCTA5 33785,2477,17962,-15485,4873,58.3,4464,110,25,0.00513031,42317,-37444
ZCTA5 33786,718,4760,-4042,1607,57.3,1536,34,34,0.021157436,12533,-10926
ZCTA5 33801,11630,7846,3784,32411,35.4,22993,370,5838,0.180124032,20712,11699
ZCTA5 33803,11878,5,11873,29942,41.2,23741,424,2671,0.089205798,11,29931
ZCTA5 33805,9473,648,8825,25229,38.8,11347,539,10411,0.412660034,1808,23421
ZCTA5 33809,11272,12982,-1710,30368,42.2,22238,985,3822,0.125856164,32110,-1742
ZCTA5 33810,18926,13061,5865,51505,43.6,38904,724,6530,0.126783807,27372,24133
ZCTA5 33811,8554,7177,1377,24186,38.1,19233,257,1668,0.068965517,17624,6562
ZCTA5 33812,4556,3323,1233,14241,40.1,10784,375,1603,0.11256232,7936,6305
ZCTA5 33813,13391,10960,2431,38103,40.5,30160,1233,2084,0.054693856,25933,12170
ZCTA5 33815,6004,5494,510,14965,41.1,7985,295,4256,0.284396926,12696,2269
ZCTA5 33823,12068,8268,3800,36098,40.4,28970,591,3305,0.091556319,20685,15413
ZCTA5 33825,9905,7505,2400,25264,44.8,16072,376,4462,0.176614946,17572,7692
ZCTA5 33827,879,17013,-16134,2770,42.1,2585,10,100,0.036101083,37665,-34895
ZCTA5 33830,9917,937,8980,29151,38,19362,677,5504,0.188809989,2673,26478
ZCTA5 33834,1652,18698,-17046,6799,36.4,4951,96,662,0.09736726,53748,-46949
ZCTA5 33835,29,5083,-5054,64,65.2,0,0,64,1,14577,-14513
ZCTA5 33837,11775,4770,7005,34428,40.2,21393,499,4564,0.132566516,15359,19069
ZCTA5 33838,1492,4287,-2795,5070,32.6,2163,114,1038,0.204733728,10533,-5463
ZCTA5 33839,1260,1236,24,4221,35.2,3546,61,355,0.084103293,3996,225
ZCTA5 33840,23,4669,-4646,67,15.5,67,0,0,0,14191,-14124
ZCTA5 33841,2841,993,1848,8149,39.2,5821,3,1011,0.124064302,2379,5770
ZCTA5 33843,3942,384,3558,11034,50,8861,50,864,0.078303426,944,10090
ZCTA5 33844,14563,15377,-814,43911,39.9,24932,280,8836,0.201225206,41694,2217
ZCTA5 33847,102,11150,-11048,288,31.5,257,0,7,0.024305556,36340,-36052
ZCTA5 33848,209,15081,-14872,1062,40.9,856,0,136,0.128060264,44902,-43840
ZCTA5 33849,168,11247,-11079,534,46,534,0,0,0,33630,-33096
ZCTA5 33850,3175,5277,-2102,8535,41.3,5339,682,1409,0.165084944,13690,-5155
ZCTA5 33851,255,18864,-18609,805,50.1,586,158,0,0,40141,-39336
ZCTA5 33852,8995,1511,7484,20813,53.3,18588,226,514,0.024696103,5435,15378
ZCTA5 33853,4452,1117,3335,11530,39.8,6214,14,2422,0.210060711,3115,8415
ZCTA5 33854,273,9036,-8763,530,69.3,315,0,42,0.079245283,30408,-29878
ZCTA5 33855,37,10594,-10557,112,50.9,112,0,0,0,31411,-31299
ZCTA5 33856,235,297,-62,297,72,250,0,20,0.067340067,736,-439
ZCTA5 33857,619,12238,-11619,1200,57.8,1167,0,0,0,37882,-36682
ZCTA5 33858,188,259,-71,793,8.7,150,0,205,0.25851198,642,151
ZCTA5 33859,4263,8121,-3858,10573,51,8119,71,1095,0.103565686,20909,-10336
ZCTA5 33860,8556,4997,3559,26338,33,17245,369,2942,0.111701724,14212,12126
ZCTA5 33865,291,7595,-7304,1006,60.5,811,0,165,0.164015905,22734,-21728
ZCTA5 33867,90,1063,-973,139,74.9,139,0,0,0,3432,-3293
ZCTA5 33868,4146,4636,-490,13718,40.8,10696,95,882,0.064295087,17480,-3762
ZCTA5 33870,10974,9213,1761,25301,49.9,18611,292,3486,0.137781115,27543,-2242
ZCTA5 33872,5834,15432,-9598,12916,61.2,9929,537,751,0.058144937,46101,-33185
ZCTA5 33873,4741,7449,-2708,13273,35.1,10107,139,508,0.038273186,16827,-3554
ZCTA5 33875,4734,605,4129,10616,54.2,9120,150,347,0.032686511,1184,9432
ZCTA5 33876,2501,1501,1000,6098,57.6,5552,0,266,0.043620859,5048,1050
ZCTA5 33877,125,2368,-2243,158,57.9,67,0,91,0.575949367,6418,-6260
ZCTA5 33880,14590,3833,10757,43354,36,27470,678,8664,0.199843152,12291,31063
ZCTA5 33881,13437,3332,10105,35142,43.9,19883,324,9180,0.261225884,6077,29065
ZCTA5 33884,13607,5418,8189,36300,46.2,27761,831,4535,0.124931129,15770,20530
ZCTA5 33890,1400,6546,-5146,4750,31.1,3186,63,147,0.030947368,14880,-10130
ZCTA5 33896,6471,16724,-10253,17830,31.5,11965,494,1499,0.084071789,37535,-19705
ZCTA5 33897,8803,19375,-10572,25842,37.3,17544,421,2306,0.089234579,60648,-34806
ZCTA5 33898,6670,2096,4574,16194,52.2,13562,72,1053,0.065024083,10865,5329
ZCTA5 33901,9246,10782,-1536,23531,40.7,14292,243,5927,0.251880498,22304,1227
ZCTA5 33903,10902,5777,5125,21509,62.1,18855,170,743,0.034543679,20050,1459
ZCTA5 33904,14605,8986,5619,31594,58.3,27907,507,1163,0.036810787,23917,7677
ZCTA5 33905,13046,1402,11644,37700,41.8,28486,506,3517,0.093289125,3802,33898
ZCTA5 33907,10805,9868,937,25268,40.9,17583,509,2349,0.092963432,25470,-202
ZCTA5 33908,18899,13223,5676,36555,64.5,33873,477,567,0.015510874,38875,-2320
ZCTA5 33909,11751,4838,6913,33658,39.6,25615,449,1742,0.051755898,14160,19498
ZCTA5 33912,8609,9959,-1350,19521,58.9,17944,376,230,0.011782183,23887,-4366
ZCTA5 33913,10000,1951,8049,26117,49.9,21440,706,1053,0.040318566,5940,20177
ZCTA5 33914,17216,10823,6393,42036,54.6,35628,323,1203,0.028618327,27331,14705
ZCTA5 33916,9339,7328,2011,25429,35.2,10033,240,9293,0.365448897,16548,8881
ZCTA5 33917,13709,4971,8738,30120,60.4,27377,325,810,0.02689243,10328,19792
ZCTA5 33919,14015,16351,-2336,28787,58.8,25828,647,796,0.02765137,40650,-11863
ZCTA5 33920,2401,3939,-1538,6488,49.9,5717,174,210,0.032367448,10080,-3592
ZCTA5 33921,435,3065,-2630,925,68.7,831,2,92,0.099459459,8353,-7428
ZCTA5 33922,1779,1181,598,4236,59.3,3644,10,0,0,3403,833
ZCTA5 33924,35,9383,-9348,173,38.3,107,0,43,0.248554913,26757,-26584
ZCTA5 33928,13072,8205,4867,28600,62.6,25782,798,654,0.022867133,21055,7545
ZCTA5 33930,292,18,274,577,29.9,577,0,0,0,41,536
ZCTA5 33931,4695,1592,3103,9186,67.9,8824,75,30,0.003265839,5140,4046
ZCTA5 33935,6924,6516,408,22083,34.3,16933,38,673,0.030475932,16507,5576
ZCTA5 33936,9360,707,8653,27178,40.1,19635,293,2551,0.093862683,1763,25415
ZCTA5 33944,106,10307,-10201,182,75,182,0,0,0,25924,-25742
ZCTA5 33946,1374,7627,-6253,2830,62.2,2708,54,9,0.003180212,19053,-16223
ZCTA5 33947,4885,9229,-4344,9486,65.6,9189,127,72,0.007590133,25278,-15792
ZCTA5 33948,7666,2945,4721,17523,60,14395,313,1644,0.093819551,7681,9842
ZCTA5 33950,11693,29,11664,24039,62.8,21855,360,877,0.036482383,89,23950
ZCTA5 33952,14601,1219,13382,34214,53.9,28728,466,2077,0.060706144,3276,30938
ZCTA5 33953,3037,1289,1748,7084,65.1,6436,35,165,0.023291925,4936,2148
ZCTA5 33954,4108,519,3589,10355,52.3,8117,94,950,0.091743119,1465,8890
ZCTA5 33955,4684,93,4591,10429,61.5,8917,68,203,0.019464953,233,10196
ZCTA5 33956,1719,5586,-3867,3551,63.7,3414,13,24,0.00675866,14828,-11277
ZCTA5 33957,3471,2164,1307,6437,68.2,6271,49,18,0.002796334,6172,265
ZCTA5 33960,304,3045,-2741,603,53.5,497,0,0,0,8674,-8071
ZCTA5 33965,0,3232,-3232,2530,19.9,1950,26,370,0.146245059,7850,-5320
ZCTA5 33966,4491,5436,-945,9738,45.2,7355,568,735,0.075477511,13993,-4255
ZCTA5 33967,9185,2100,7085,26690,36.2,20860,717,727,0.027238666,5203,21487
ZCTA5 33971,7847,1628,6219,28061,33.8,16983,374,6087,0.216920281,4306,23755
ZCTA5 33972,4405,3303,1102,14883,39.5,10373,61,2329,0.156487267,9179,5704
ZCTA5 33973,4037,37,4000,15048,28.2,5675,215,5792,0.384901648,115,14933
ZCTA5 33974,5180,1146,4034,19187,32.4,11609,98,3384,0.176369417,2836,16351
ZCTA5 33976,4708,1705,3003,17137,32.2,9220,200,3440,0.200735251,3979,13158
ZCTA5 33980,6038,8067,-2029,13173,64.5,10867,197,1060,0.080467623,20543,-7370
ZCTA5 33981,5448,4669,779,12683,61.3,11864,146,281,0.022155641,11904,779
ZCTA5 33982,4157,3539,618,11016,53.2,9384,101,892,0.08097313,9020,1996
ZCTA5 33983,6812,136,6676,15487,56,13110,201,1723,0.111254601,289,15198
ZCTA5 33990,12993,452,12541,35283,47.3,26513,1668,1381,0.039140663,1272,34011
ZCTA5 33991,9004,2656,6348,23899,44.9,20920,86,763,0.031926022,7076,16823
ZCTA5 33993,9987,1438,8549,29502,41.9,22332,751,1986,0.06731747,3701,25801
ZCTA5 34101,0,4388,-4388,0,-,0,0,0,#DIV/0!,11605,-11605
ZCTA5 34102,5334,3280,2054,10723,62.9,8997,65,971,0.090553017,7141,3582
ZCTA5 34103,5535,181,5354,11310,62.5,10041,187,98,0.008664898,292,11018
ZCTA5 34104,10888,6430,4458,23813,52.7,18847,694,1185,0.049762735,16256,7557
ZCTA5 34105,7766,2096,5670,16530,56.5,15138,528,151,0.009134906,4991,11539
ZCTA5 34108,8389,951,7438,16631,66.5,15183,338,42,0.002525404,2618,14013
ZCTA5 34109,11908,40,11868,26000,54.5,22539,1180,789,0.030346154,111,25889
ZCTA5 34110,12584,5122,7462,24773,62.2,22097,480,405,0.016348444,13478,11295
ZCTA5 34112,12938,840,12098,26789,62,22347,196,1884,0.070327373,2422,24367
ZCTA5 34113,10341,3283,7058,24383,52.9,18996,487,2593,0.106344584,9170,15213
ZCTA5 34114,8634,5604,3030,18599,63.9,15370,40,1278,0.068713372,16333,2266
ZCTA5 34116,10541,0,10541,35705,36.2,22114,325,3651,0.102254586,0,35705
ZCTA5 34117,5331,1214,4117,18927,38.1,13364,140,669,0.035346331,3411,15516
ZCTA5 34119,13477,3114,10363,31714,51.3,28489,396,352,0.011099199,8588,23126
ZCTA5 34120,12228,625,11603,35117,44.1,27498,228,4263,0.121394197,1379,33738
ZCTA5 34134,7754,988,6766,14859,68.5,14054,235,95,0.006393432,2621,12238
ZCTA5 34135,19189,920,18269,45996,56.2,38782,658,1036,0.022523698,2760,43236
ZCTA5 34137,139,5694,-5555,492,14.8,492,0,0,0,14465,-13973
ZCTA5 34138,326,3225,-2899,958,45.6,958,0,0,0,8332,-7374
ZCTA5 34139,61,614,-553,110,61.4,110,0,0,0,1733,-1623
ZCTA5 34140,60,612,-552,168,26.3,168,0,0,0,1624,-1456
ZCTA5 34141,16,5579,-5563,110,19.4,59,0,51,0.463636364,15915,-15805
ZCTA5 34142,8598,131,8467,33241,30,17961,125,6236,0.187599651,352,32889
ZCTA5 34145,8131,2409,5722,15929,66.9,15064,129,59,0.003703936,6666,9263
ZCTA5 34201,1706,5228,-3522,3695,69.4,3482,0,71,0.019215156,13928,-10233
ZCTA5 34202,9519,1567,7952,24920,52.1,21711,736,393,0.015770465,3995,20925
ZCTA5 34203,16032,1993,14039,38698,49.9,29911,907,4149,0.107214843,5574,33124
ZCTA5 34205,12856,1222,11634,31061,45.6,24594,855,2965,0.095457326,3103,27958
ZCTA5 34207,14881,30,14851,35394,47.1,28065,370,2738,0.077357744,72,35322
ZCTA5 34208,13860,5260,8600,41102,37.7,27163,503,7855,0.191109922,14663,26439
ZCTA5 34209,15080,5430,9650,34848,56.5,31337,440,892,0.025596878,15059,19789
ZCTA5 34210,7618,8883,-1265,16579,55.9,13737,418,1190,0.07177755,22839,-6260
ZCTA5 34211,5004,3746,1258,13251,51.2,11446,89,221,0.016677987,10477,2774
ZCTA5 34212,8462,7717,745,22962,50,19936,1605,493,0.021470255,20971,1991
ZCTA5 34215,357,3771,-3414,778,58,748,1,7,0.008997429,10277,-9499
ZCTA5 34216,610,3671,-3061,1021,67.2,1007,0,1,0.000979432,9154,-8133
ZCTA5 34217,2042,1328,714,3927,64.3,3769,28,4,0.001018589,3141,786
ZCTA5 34219,9253,1720,7533,25658,46.6,22108,560,1403,0.054680801,4575,21083
ZCTA5 34221,18247,1432,16815,51531,45.2,36981,811,8763,0.170052978,3959,47572
ZCTA5 34222,5552,702,4850,13076,56,10999,181,381,0.029137351,1662,11414
ZCTA5 34223,9827,784,9043,18760,67.5,17864,455,0,0,1996,16764
ZCTA5 34224,7624,75,7549,15387,63.5,14200,276,76,0.004939234,198,15189
ZCTA5 34228,4106,1280,2826,7446,71.1,7145,66,31,0.004163309,3010,4436
ZCTA5 34229,3534,3583,-49,7820,59.7,7628,44,78,0.009974425,11897,-4077
ZCTA5 34231,15069,2133,12936,32460,51.4,29011,359,838,0.025816389,6049,26411
ZCTA5 34232,14658,1216,13442,34108,47.9,29908,559,1243,0.036443063,3293,30815
ZCTA5 34233,8415,124,8291,19195,51.9,16892,586,241,0.012555353,452,18743
ZCTA5 34234,8696,7826,870,21692,42.7,12391,119,6960,0.320855615,18936,2756
ZCTA5 34235,6935,2969,3966,14349,58.5,12542,37,375,0.026134225,7481,6868
ZCTA5 34236,7186,9654,-2468,12523,66.1,10870,290,413,0.032979318,25342,-12819
ZCTA5 34237,6940,1372,5568,17742,39.5,13036,386,2193,0.123605005,3776,13966
ZCTA5 34238,10711,1255,9456,21148,64.4,19468,500,467,0.022082466,3463,17685
ZCTA5 34239,6708,8911,-2203,14203,53.5,12661,247,270,0.019010068,24991,-10788
ZCTA5 34240,4975,1920,3055,12713,53,11697,222,130,0.010225753,4999,7714
ZCTA5 34241,5865,384,5481,15737,48.1,14536,324,59,0.003749126,859,14878
ZCTA5 34242,3962,1362,2600,7387,66.8,6960,123,20,0.002707459,3452,3935
ZCTA5 34243,13301,3504,9797,31400,52.6,26960,1109,1465,0.046656051,9171,22229
ZCTA5 34250,145,5027,-4882,276,64.1,276,0,0,0,13511,-13235
ZCTA5 34251,2322,188,2134,7659,43.1,7094,65,81,0.010575793,536,7123
ZCTA5 34266,9826,2214,7612,28317,38.9,21989,28,3636,0.128403433,6628,21689
ZCTA5 34267,39,1791,-1752,119,31.4,119,0,0,0,4690,-4571
ZCTA5 34268,86,6,80,392,32.4,0,0,392,1,16,376
ZCTA5 34269,2256,791,1465,5199,58.8,4598,13,216,0.041546451,2500,2699
ZCTA5 34275,9789,1356,8433,19555,63,17576,645,428,0.021886985,3382,16173
ZCTA5 34285,10348,4613,5735,18746,68.9,17384,254,47,0.002507202,10881,7865
ZCTA5 34286,7418,9494,-2076,20264,45.1,17805,157,690,0.034050533,18840,1424
ZCTA5 34287,11635,6809,4826,28218,57.3,24984,665,1446,0.051243887,17797,10421
ZCTA5 34288,5010,3626,1384,13476,42.8,11697,428,868,0.064410804,9584,3892
ZCTA5 34289,1434,5795,-4361,4511,42.3,3737,0,529,0.117268898,15294,-10783
ZCTA5 34291,2460,12009,-9549,6786,51.1,5621,82,605,0.089154141,28437,-21651
ZCTA5 34292,7919,5769,2150,15676,68.8,14617,350,154,0.009823935,13974,1702
ZCTA5 34293,21260,11421,9839,44643,61.5,41992,705,247,0.005532782,26505,18138
ZCTA5 34420,7081,5147,1934,18060,43.4,16125,0,1042,0.057696567,12875,5185
ZCTA5 34428,4028,5625,-1597,9164,53.8,8183,188,115,0.012549105,13599,-4435
ZCTA5 34429,4057,7203,-3146,8903,63.2,8226,129,414,0.046501179,18735,-9832
ZCTA5 34431,3701,17789,-14088,7933,59.7,7192,153,293,0.036934325,46884,-38951
ZCTA5 34432,5699,14585,-8886,12657,58.5,11005,106,866,0.068420637,35954,-23297
ZCTA5 34433,2973,5589,-2616,7604,45,6393,19,0,0,13854,-6250
ZCTA5 34434,3421,3165,256,9424,45.9,7972,0,821,0.087117997,7952,1472
ZCTA5 34436,3645,2176,1469,7694,59.5,7315,54,100,0.012997141,5342,2352
ZCTA5 34442,7673,3897,3776,16532,62.7,14710,868,468,0.028308735,8492,8040
ZCTA5 34445,0,4051,-4051,0,-,0,0,0,#DIV/0!,10668,-10668
ZCTA5 34446,8033,2496,5537,18033,59.9,16790,206,101,0.005600843,6560,11473
ZCTA5 34448,4699,11872,-7173,10180,59.7,9879,5,158,0.015520629,31427,-21247
ZCTA5 34449,1394,3906,-2512,3273,52.1,3099,0,41,0.012526734,9810,-6537
ZCTA5 34450,4984,9,4975,10066,62,9306,106,138,0.013709517,1309,8757
ZCTA5 34452,5378,343,5035,13206,52.7,12166,304,138,0.010449796,626,12580
ZCTA5 34453,4194,2103,2091,9835,53.8,8969,241,429,0.043619725,6109,3726
ZCTA5 34461,4557,7857,-3300,12397,54.9,11355,0,494,0.03984835,20363,-7966
ZCTA5 34465,8026,19564,-11538,18483,55.8,16485,491,448,0.024238489,49551,-31068
ZCTA5 34470,8723,7718,1005,20707,38.9,15777,208,3165,0.152846863,17207,3500
ZCTA5 34471,10885,12340,-1455,26420,41.4,21177,871,2321,0.087850114,32218,-5798
ZCTA5 34472,11911,82,11829,32035,39.7,19459,491,7603,0.237334166,820,31215
ZCTA5 34473,7397,11375,-3978,22441,38.4,12760,450,5350,0.238402923,37089,-14648
ZCTA5 34474,7418,7328,90,17686,42.8,12217,1113,2360,0.133438878,22048,-4362
ZCTA5 34475,4788,15493,-10705,14387,35.4,6681,85,6295,0.437547786,42068,-27681
ZCTA5 34476,10931,5491,5440,23924,57.7,19253,574,1697,0.070932954,14132,9792
ZCTA5 34479,5542,420,5122,14205,41.3,11893,246,1305,0.09186906,933,13272
ZCTA5 34480,8398,2008,6390,22352,40,17519,388,2297,0.102764853,5242,17110
ZCTA5 34481,11958,611,11347,22890,68.9,20151,212,1429,0.062429008,1680,21210
ZCTA5 34482,7422,1244,6178,23415,47.4,17825,83,3927,0.167713004,3935,19480
ZCTA5 34484,2769,675,2094,5399,54.2,4306,455,222,0.041118726,1842,3557
ZCTA5 34487,0,1325,-1325,0,-,0,0,0,#DIV/0!,3467,-3467
ZCTA5 34488,4886,1319,3567,11878,42.8,10177,26,901,0.075854521,3380,8498
ZCTA5 34491,13125,3892,9233,31192,55.8,27258,322,2179,0.069857656,10728,20464
ZCTA5 34498,292,1168,-876,614,56,612,0,1,0.001628664,3132,-2518
ZCTA5 34601,10336,56,10280,22995,52,19521,89,1773,0.077103718,106,22889
ZCTA5 34602,2980,158,2822,8590,49.3,7204,43,987,0.114901048,307,8283
ZCTA5 34604,4425,294,4131,13398,42.9,11278,143,579,0.043215405,915,12483
ZCTA5 34606,12399,173,12226,28162,50.6,24180,183,1092,0.038775655,386,27776
ZCTA5 34607,3701,805,2896,8300,55.8,6959,56,422,0.050843373,1772,6528
ZCTA5 34608,14207,1810,12397,35708,44.7,28418,749,1540,0.04312759,5198,30510
ZCTA5 34609,16397,590,15807,43429,44.6,33898,936,2838,0.065348039,1801,41628
ZCTA5 34610,5531,221,5310,16566,39.2,14017,316,611,0.036882772,848,15718
ZCTA5 34613,8360,2251,6109,17388,61.9,16176,103,459,0.026397516,5540,11848
ZCTA5 34614,2719,47,2672,8072,41.8,6923,0,168,0.020812686,81,7991
ZCTA5 34637,3075,1851,1224,10548,37.2,8890,254,510,0.048350398,5227,5321
ZCTA5 34638,10292,5632,4660,32345,36.9,22902,1273,2548,0.078775699,15245,17100
ZCTA5 34639,10454,2067,8387,29652,41.1,23673,830,1411,0.047585323,5783,23869
ZCTA5 34652,11249,4910,6339,25101,51.1,21945,229,831,0.033106251,14070,11031
ZCTA5 34653,15021,2789,12232,33790,49.1,28795,433,2176,0.064397751,7170,26620
ZCTA5 34654,8938,87,8851,24321,46.7,21730,482,965,0.039677645,192,24129
ZCTA5 34655,18283,412,17871,44069,46.8,38872,1372,1280,0.029045361,1082,42987
ZCTA5 34661,166,1706,-1540,289,49.9,256,0,0,0,3934,-3645
ZCTA5 34667,15467,1335,14132,31137,59.6,28826,277,514,0.016507692,4329,26808
ZCTA5 34668,21043,4211,16832,49271,42.9,40123,723,1896,0.038481054,10931,38340
ZCTA5 34669,5467,3142,2325,13915,46.4,12640,214,476,0.03420769,7831,6084
ZCTA5 34677,8788,5322,3466,22528,46.1,18569,890,995,0.044167259,13405,9123
ZCTA5 34679,33,795,-762,77,63.2,77,0,0,0,2043,-1966
ZCTA5 34681,422,1336,-914,923,44.2,870,53,0,0,3538,-2615
ZCTA5 34683,13571,483,13088,33490,47.9,30418,658,382,0.01140639,1349,32141
ZCTA5 34684,13090,618,12472,27304,52.4,24044,1121,887,0.032486083,1786,25518
ZCTA5 34685,7345,401,6944,17555,50.1,14639,658,601,0.034235261,1021,16534
ZCTA5 34688,3399,38,3361,8689,50.8,7610,401,172,0.019795143,50,8639
ZCTA5 34689,11529,1513,10016,26393,53.2,22414,170,1699,0.064373129,3831,22562
ZCTA5 34690,5163,809,4354,11285,45.8,9827,106,520,0.046078866,1736,9549
ZCTA5 34691,9391,1858,7533,20625,43.9,16621,218,1653,0.080145455,4601,16024
ZCTA5 34695,7116,2253,4863,17778,48,15409,335,937,0.052705591,5638,12140
ZCTA5 34698,18883,512,18371,38390,57.9,35104,671,917,0.023886429,1130,37260
ZCTA5 34705,1122,1813,-691,3141,38.3,2711,10,77,0.024514486,4639,-1498
ZCTA5 34711,24097,418,23679,66167,43.2,45781,2630,7800,0.117883537,997,65170
ZCTA5 34714,8159,4128,4031,24200,34.5,17053,292,2261,0.093429752,9738,14462
ZCTA5 34715,7537,12,7525,23642,40.1,16531,1053,2539,0.107393622,25,23617
ZCTA5 34729,16,1843,-1827,32,-,32,0,0,0,4312,-4280
ZCTA5 34731,4754,987,3767,11546,47.4,9724,7,1130,0.097869392,2266,9280
ZCTA5 34734,1300,5134,-3834,4581,34.2,2674,249,537,0.117223314,12437,-7856
ZCTA5 34736,9232,4504,4728,23734,43.8,15581,1032,3110,0.131035645,11484,12250
ZCTA5 34737,1654,449,1205,3715,52.4,3211,0,74,0.019919246,969,2746
ZCTA5 34739,247,434,-187,581,52.4,328,0,0,0,1187,-606
ZCTA5 34741,16380,529,15851,52998,33.3,26247,1766,4686,0.088418431,1225,51773
ZCTA5 34743,11739,366,11373,46292,35.3,23282,1163,5287,0.114209799,923,45369
ZCTA5 34744,17589,1254,16335,60324,37.5,32486,2996,5102,0.08457662,2860,57464
ZCTA5 34746,14803,17,14786,50514,39.1,31578,1845,5683,0.112503464,38,50476
ZCTA5 34747,8069,2229,5840,22109,36.9,15800,749,1485,0.067167217,5610,16499
ZCTA5 34748,19237,1125,18112,42457,58.8,31588,643,7255,0.170878771,3197,39260
ZCTA5 34753,1885,1519,366,6563,30.6,4654,0,1112,0.16943471,4504,2059
ZCTA5 34756,1298,2075,-777,3879,41.3,3512,2,98,0.025264243,5351,-1472
ZCTA5 34758,10796,1791,9005,42974,34.1,21722,224,9925,0.2309536,4060,38914
ZCTA5 34759,12708,246,12462,39453,41,20019,626,8117,0.205738474,655,38798
ZCTA5 34760,304,629,-325,989,51.8,508,9,424,0.428715875,1258,-269
ZCTA5 34761,14022,1985,12037,46585,35.8,24424,2638,9828,0.210969196,4456,42129
ZCTA5 34762,143,478,-335,315,68.6,288,0,27,0.085714286,1227,-912
ZCTA5 34769,8879,1738,7141,29985,37.1,19084,422,2270,0.075704519,4375,25610
ZCTA5 34771,7042,812,6230,23948,39.7,17867,402,1535,0.064097211,2106,21842
ZCTA5 34772,8931,3235,5696,31178,37.3,19894,674,2634,0.084482648,7790,23388
ZCTA5 34773,1220,13173,-11953,4074,38.1,3420,84,0,0,33794,-29720
ZCTA5 34785,6249,12344,-6095,19972,43.5,12252,100,6571,0.329010615,30687,-10715
ZCTA5 34786,14869,838,14031,46817,36.3,32574,5046,2678,0.057201444,2042,44775
ZCTA5 34787,26245,10474,15771,81398,37.2,53256,4956,9461,0.116231357,25171,56227
ZCTA5 34788,8832,6487,2345,20689,57.1,17819,120,1154,0.055778433,20926,-237
ZCTA5 34797,641,2916,-2275,1473,63.5,1317,15,141,0.095723014,7779,-6306
ZCTA5 34945,1461,0,1461,5314,43.7,3856,36,906,0.170493037,0,5314
ZCTA5 34946,2523,1648,875,5916,40.6,2123,67,2726,0.460784314,4141,1775
ZCTA5 34947,4076,842,3234,13216,31.5,3784,286,7882,0.596398305,1878,11338
ZCTA5 34949,4435,1992,2443,7960,65.3,7373,36,116,0.014572864,5340,2620
ZCTA5 34950,6250,3278,2972,16675,40.6,5334,2,10183,0.610674663,8451,8224
ZCTA5 34951,6997,1042,5955,16275,58.1,13388,734,1497,0.091981567,2812,13463
ZCTA5 34952,17478,2742,14736,42196,48.6,31292,996,4781,0.113304579,7207,34989
ZCTA5 34953,24483,14815,9668,74414,39.2,45641,1209,15077,0.202609724,33283,41131
ZCTA5 34956,2484,8263,-5779,9751,34.8,4747,115,2075,0.212798687,20329,-10578
ZCTA5 34957,10730,3706,7024,22583,57.8,20825,542,404,0.017889563,9108,13475
ZCTA5 34972,6085,9242,-3157,19728,37.5,14709,53,2908,0.147404704,25080,-5352
ZCTA5 34974,10109,1214,8895,23055,49.1,19064,414,547,0.023725873,2964,20091
ZCTA5 34981,1662,5725,-4063,6167,34.4,4663,24,1162,0.188422247,15774,-9607
ZCTA5 34982,10768,1598,9170,25825,47.2,19691,454,3293,0.127512101,4061,21764
ZCTA5 34983,15387,435,14952,44999,41.6,30833,1132,7623,0.169403765,1158,43841
ZCTA5 34984,6161,1409,4752,18333,42.3,12289,172,4364,0.238040692,3379,14954
ZCTA5 34986,11487,35,11452,28438,56.5,19901,1155,4752,0.167100359,93,28345
ZCTA5 34987,5464,5767,-303,12818,58.6,9684,200,1931,0.150647527,14130,-1312
ZCTA5 34990,12039,456,11583,30156,51.5,26904,805,242,0.008024937,1279,28877
ZCTA5 34994,7841,3114,4727,18187,49.5,14211,56,2457,0.135096497,7507,10680
ZCTA5 34996,5825,4332,1493,11062,65,10219,38,362,0.032724643,12097,-1035
ZCTA5 34997,18365,3251,15114,44630,51.9,37747,762,2384,0.053416984,8292,36338
ZCTA5 35004,4616,3859,757,11917,39.9,10151,16,1048,0.087941596,9060,2857
ZCTA5 35005,2869,7104,-4235,8180,47.7,3623,30,4328,0.529095355,17601,-9421
ZCTA5 35006,1190,3052,-1862,3386,42.8,3286,0,93,0.027466037,7578,-4192
ZCTA5 35007,9896,1015,8881,27323,38,19748,439,4026,0.147348388,2175,25148
ZCTA5 35010,8082,2516,5566,20899,43.5,13419,25,6530,0.312455141,6293,14606
ZCTA5 35013,27,2766,-2739,99,30.4,99,0,0,0,7715,-7616
ZCTA5 35014,1683,7531,-5848,4212,51.2,2221,0,1975,0.468898386,17889,-13677
ZCTA5 35016,6446,636,5810,16906,40.2,15955,239,85,0.005027801,1589,15317
ZCTA5 35019,867,2077,-1210,2289,38.3,2147,0,0,0,5471,-3182
ZCTA5 35020,10145,1375,8770,25763,38.8,3490,12,19471,0.755773784,3272,22491
ZCTA5 35022,9062,1217,7845,22211,43.2,9867,205,11831,0.532663995,3211,19000
ZCTA5 35023,8632,1000,7632,24780,39.1,15390,88,8074,0.32582728,2626,22154
ZCTA5 35031,2601,125,2476,7379,38.9,6361,18,92,0.012467814,205,7174
ZCTA5 35032,22,370,-348,50,34.5,33,0,4,0.08,803,-753
ZCTA5 35033,1250,2135,-885,3235,40.9,3120,0,21,0.006491499,5801,-2566
ZCTA5 35034,1276,2433,-1157,5451,35.4,2266,0,3119,0.572188589,6584,-1133
ZCTA5 35035,364,7100,-6736,991,45.9,738,0,244,0.246215943,19910,-18919
ZCTA5 35036,75,4443,-4368,153,26.9,25,0,128,0.836601307,12165,-12012
ZCTA5 35040,6688,131,6557,18433,32.8,11849,81,4845,0.262843813,440,17993
ZCTA5 35042,2248,769,1479,6221,44.6,5266,46,873,0.140331136,1727,4494
ZCTA5 35043,4325,1788,2537,14054,39,12887,9,729,0.051871353,5284,8770
ZCTA5 35044,3310,215,3095,7960,43.5,4624,122,2977,0.373994975,527,7433
ZCTA5 35045,5676,3333,2343,14576,41.3,11450,210,1819,0.124794182,9044,5532
ZCTA5 35046,1895,4759,-2864,5106,40.6,4879,0,37,0.007246377,13080,-7974
ZCTA5 35049,1373,16024,-14651,3643,37,3310,0,31,0.00850947,41817,-38174
ZCTA5 35051,2897,2386,511,8627,40.5,6313,0,1536,0.178045671,6750,1877
ZCTA5 35052,19,2048,-2029,224,73.8,176,0,48,0.214285714,5277,-5053
ZCTA5 35053,1039,4062,-3023,2833,51.2,2644,0,28,0.009883516,10718,-7885
ZCTA5 35054,1538,5078,-3540,4233,48.3,4164,0,58,0.013701866,14958,-10725
ZCTA5 35055,9088,241,8847,22597,40.9,20748,133,219,0.009691552,559,22038
ZCTA5 35057,5022,1496,3526,14165,40.3,13618,33,0,0,3467,10698
ZCTA5 35058,3862,98,3764,10112,40.3,9059,136,59,0.005834652,185,9927
ZCTA5 35060,99,4849,-4750,184,50.4,40,0,100,0.543478261,11982,-11798
ZCTA5 35061,427,3988,-3561,1517,40.7,37,0,1473,0.970995386,9518,-8001
ZCTA5 35062,3152,1508,1644,8698,43.2,7655,16,780,0.089675788,4084,4614
ZCTA5 35063,1178,1928,-750,3085,44.1,2960,0,0,0,5076,-1991
ZCTA5 35064,3917,4712,-795,10083,31.7,499,0,9306,0.922939601,13727,-3644
ZCTA5 35068,3461,36,3425,8205,38.6,4572,306,2632,0.320780012,156,8049
ZCTA5 35070,42,280,-238,112,59.6,111,0,0,0,666,-554
ZCTA5 35071,6837,1418,5419,17487,41,14146,334,1812,0.103619832,3776,13711
ZCTA5 35072,1745,9700,-7955,4791,43.5,2837,14,1712,0.357336673,21915,-17124
ZCTA5 35073,1260,9861,-8601,3082,45.1,2080,0,924,0.299805321,20839,-17757
ZCTA5 35074,50,10509,-10459,114,-,114,0,0,0,25394,-25280
ZCTA5 35077,5578,9322,-3744,14184,45.3,13011,9,567,0.039974619,22550,-8366
ZCTA5 35078,781,7953,-7172,1951,44.3,1556,0,344,0.176319836,18779,-16828
ZCTA5 35079,3250,304,2946,9469,43.3,9103,48,77,0.008131799,1580,7889
ZCTA5 35080,6466,11482,-5016,19266,36.2,15124,125,2450,0.12716703,31415,-12149
ZCTA5 35082,0,9819,-9819,0,-,0,0,0,#DIV/0!,25977,-25977
ZCTA5 35083,1381,6273,-4892,4024,37.5,3951,0,1,0.000248509,14605,-10581
ZCTA5 35085,2894,2742,152,8140,39.3,7008,0,444,0.054545455,5467,2673
ZCTA5 35087,987,0,987,2702,40.8,2686,0,0,0,612,2090
ZCTA5 35089,559,7894,-7335,1546,48,728,0,783,0.506468305,20196,-18650
ZCTA5 35091,1071,7409,-6338,3193,41.3,2903,15,134,0.041966802,18023,-14830
ZCTA5 35094,5690,5675,15,15206,41.7,12845,35,1864,0.122583191,13598,1608
ZCTA5 35096,2975,2556,419,8644,36,6115,20,1832,0.211938917,6594,2050
ZCTA5 35097,709,3807,-3098,1940,49.4,1918,0,0,0,9874,-7934
ZCTA5 35098,533,2881,-2348,1337,34.8,1298,0,0,0,8209,-6872
ZCTA5 35111,6445,7274,-829,17103,39,11772,219,4668,0.272934573,21137,-4034
ZCTA5 35112,0,5009,-5009,0,-,0,0,0,#DIV/0!,14177,-14177
ZCTA5 35114,2869,2972,-103,8156,37.4,6027,39,1674,0.20524767,7863,293
ZCTA5 35115,6046,2487,3559,17448,32.7,12216,141,2317,0.13279459,6736,10712
ZCTA5 35116,1865,4830,-2965,4885,37.7,4596,38,63,0.012896622,13089,-8204
ZCTA5 35117,2275,3173,-898,5866,42.6,5334,5,457,0.07790658,8437,-2571
ZCTA5 35118,1069,5573,-4504,3477,37,2558,0,669,0.192407248,15770,-12293
ZCTA5 35119,28,1156,-1128,136,48.8,0,0,136,1,3031,-2895
ZCTA5 35120,6239,2158,4081,17106,36,14548,85,1994,0.116567286,4336,12770
ZCTA5 35121,6224,4715,1509,16441,43.7,15104,85,353,0.021470713,10080,6361
ZCTA5 35124,9752,2359,7393,24594,41.8,18870,710,2965,0.12055786,6733,17861
ZCTA5 35125,3961,2610,1351,10752,37.3,9681,72,674,0.062686012,7767,2985
ZCTA5 35126,7508,579,6929,21997,36.7,14231,15,6822,0.3101332,1497,20500
ZCTA5 35127,3398,1658,1740,9638,43.6,3450,6,5915,0.613716539,4698,4940
ZCTA5 35128,4177,6320,-2143,10831,40.4,8979,242,1178,0.108761887,16396,-5565
ZCTA5 35130,1411,1527,-116,3509,47.1,2843,0,373,0.106298091,3718,-209
ZCTA5 35131,1252,2058,-806,3347,40.1,3027,0,160,0.047804004,6075,-2728
ZCTA5 35133,1272,466,806,3406,46.4,3304,31,61,0.017909571,1079,2327
ZCTA5 35135,842,1549,-707,2075,41.7,1588,25,388,0.186987952,3924,-1849
ZCTA5 35136,764,559,205,2153,47.3,1726,0,366,0.169995355,1515,638
ZCTA5 35143,1244,520,724,3238,47.4,3046,22,20,0.006176652,1209,2029
ZCTA5 35146,3915,6327,-2412,12049,42.4,10103,0,1533,0.127230476,16388,-4339
ZCTA5 35147,2004,2083,-79,5752,34.8,4907,14,361,0.062760779,5002,750
ZCTA5 35148,956,462,494,2419,41.7,2266,0,87,0.035965275,1518,901
ZCTA5 35149,80,1791,-1711,127,27.8,73,0,54,0.42519685,5394,-5267
ZCTA5 35150,7029,878,6151,17421,39,10889,0,5648,0.324206418,3098,14323
ZCTA5 35151,2979,1553,1426,7893,45.8,6948,0,709,0.089826428,3430,4463
ZCTA5 35160,10192,890,9302,26369,43.3,14152,53,10968,0.415942963,1931,24438
ZCTA5 35171,1215,2688,-1473,3556,40.6,3239,0,126,0.035433071,7584,-4028
ZCTA5 35172,1024,1150,-126,2761,38.3,2397,0,116,0.042013763,2773,-12
ZCTA5 35173,10343,639,9704,30218,40.3,26411,201,2131,0.070520882,1895,28323
ZCTA5 35175,2040,1134,906,5054,47.8,4901,0,4,0.000791452,3074,1980
ZCTA5 35176,355,4,351,766,44.3,725,0,30,0.039164491,14,752
ZCTA5 35178,1190,737,453,2894,51.2,2446,0,422,0.145818936,1764,1130
ZCTA5 35179,3033,664,2369,8602,43.6,7526,0,78,0.009067659,1508,7094
ZCTA5 35180,4968,518,4450,14615,38,13176,55,756,0.051727677,1330,13285
ZCTA5 35181,13,1240,-1227,26,-,26,0,0,0,2777,-2751
ZCTA5 35183,312,2014,-1702,949,58,845,0,0,0,4752,-3803
ZCTA5 35184,1891,188,1703,5788,36.6,5048,0,606,0.104699378,445,5343
ZCTA5 35185,0,1420,-1420,0,-,0,0,0,#DIV/0!,5054,-5054
ZCTA5 35186,1924,651,1273,5151,46.3,4543,50,335,0.065035915,3072,2079
ZCTA5 35188,829,412,417,2745,39.8,2632,0,56,0.020400729,1088,1657
ZCTA5 35203,1563,3888,-2325,3160,41.5,1249,0,1858,0.587974684,11163,-8003
ZCTA5 35204,4167,2073,2094,9287,46,626,25,8564,0.922149241,5178,4109
ZCTA5 35205,9251,1217,8034,18709,29.7,11843,967,4994,0.266930354,7109,11600
ZCTA5 35206,6388,431,5957,16447,41.1,4283,76,11364,0.690946677,848,15599
ZCTA5 35207,3131,6226,-3095,7153,40.6,654,0,6416,0.896966308,16224,-9071
ZCTA5 35208,5663,828,4835,14112,40.7,491,36,13343,0.94550737,1841,12271
ZCTA5 35209,12457,311,12146,29287,31.3,20570,753,6413,0.218970874,847,28440
ZCTA5 35210,6074,145,5929,13457,44.1,8252,63,4469,0.332094821,360,13097
ZCTA5 35211,11273,19,11254,24762,38.8,2681,131,20031,0.808941119,57,24705
ZCTA5 35212,4245,835,3410,10626,32.5,2594,128,7471,0.703086768,2213,8413
ZCTA5 35213,6153,1641,4512,14807,36.7,14487,65,132,0.008914703,3900,10907
ZCTA5 35214,7171,343,6828,18106,43.3,3208,222,13546,0.748149785,795,17311
ZCTA5 35215,17142,785,16357,46817,33.6,9983,43,35694,0.762415362,1856,44961
ZCTA5 35216,15492,768,14724,38829,36,25784,1404,9247,0.238146746,1966,36863
ZCTA5 35217,4759,5509,-750,12906,38.8,3664,32,8058,0.624360762,14131,-1225
ZCTA5 35218,2755,41,2714,7622,39.3,449,0,6270,0.822618735,90,7532
ZCTA5 35221,1517,83,1434,3787,48.9,107,0,3584,0.946395564,338,3449
ZCTA5 35222,3768,1444,2324,8739,33.8,5847,59,2436,0.278750429,3730,5009
ZCTA5 35223,4514,446,4068,11432,47.3,10979,215,84,0.007347796,944,10488
ZCTA5 35224,1971,463,1508,5535,39.3,1577,0,3665,0.662149955,1143,4392
ZCTA5 35226,14283,1373,12910,38064,36.9,29851,2256,4487,0.117880412,3380,34684
ZCTA5 35228,3820,578,3242,10152,40.2,781,0,8821,0.868892829,1587,8565
ZCTA5 35229,0,487,-487,1985,20,1396,20,437,0.220151134,1299,686
ZCTA5 35233,1596,607,989,2469,27.8,1184,569,474,0.191980559,1534,935
ZCTA5 35234,1941,2240,-299,4887,44.9,628,3,4173,0.853898097,5874,-987
ZCTA5 35235,8290,851,7439,21357,36.6,6795,390,13150,0.615723182,2199,19158
ZCTA5 35242,23129,433,22696,57077,42.3,47036,2088,5367,0.094030871,1077,56000
ZCTA5 35243,8474,790,7684,17532,39.7,15479,535,832,0.04745608,2151,15381
ZCTA5 35244,13462,5742,7720,36121,38.8,25227,2430,6797,0.188173085,14872,21249
ZCTA5 35249,0,2508,-2508,40,43.9,16,0,24,0.6,6614,-6574
ZCTA5 35254,0,6775,-6775,1395,19.8,933,17,372,0.266666667,17823,-16428
ZCTA5 35401,12352,9931,2421,36403,23.7,16014,693,18309,0.502953053,28222,8181
ZCTA5 35404,8051,763,7288,23644,29.2,11237,417,10976,0.464219252,1697,21947
ZCTA5 35405,18842,345,18497,47828,34.4,18972,1336,25827,0.539997491,839,46989
ZCTA5 35406,7178,876,6302,18228,40.4,15781,988,806,0.044217687,2457,15771
ZCTA5 35441,353,5025,-4672,1170,38.2,569,0,601,0.513675214,13750,-12580
ZCTA5 35442,1713,3763,-2050,5798,39.8,2006,8,3618,0.624008279,9124,-3326
ZCTA5 35443,471,851,-380,1170,48.9,53,0,951,0.812820513,2469,-1299
ZCTA5 35444,1570,6447,-4877,4216,37,3827,0,223,0.052893738,16223,-12007
ZCTA5 35446,724,0,724,2168,37.4,1898,0,142,0.065498155,1190,978
ZCTA5 35447,1220,3798,-2578,3173,42.8,1658,0,1391,0.438386385,8606,-5433
ZCTA5 35452,1494,1404,90,3886,43.7,3413,7,184,0.04734946,4927,-1041
ZCTA5 35453,4294,2834,1460,12163,39.5,8862,48,2608,0.214420784,8413,3750
ZCTA5 35456,1712,1379,333,4855,33.7,3926,6,754,0.155303811,3720,1135
ZCTA5 35457,57,7536,-7479,57,-,57,0,0,0,20851,-20794
ZCTA5 35458,210,3662,-3452,742,20.9,742,0,0,0,9629,-8887
ZCTA5 35459,432,2960,-2528,976,51.1,469,0,507,0.519467213,9359,-8383
ZCTA5 35460,322,4478,-4156,782,30.7,162,0,620,0.792838875,11570,-10788
ZCTA5 35461,836,6193,-5357,1949,47.2,1437,0,509,0.261159569,14406,-12457
ZCTA5 35462,1813,3474,-1661,4408,47.4,1060,0,3261,0.739791289,8801,-4393
ZCTA5 35463,725,8175,-7450,2143,34.3,1090,0,1053,0.491367242,21196,-19053
ZCTA5 35464,158,10423,-10265,642,19,198,0,444,0.691588785,25061,-24419
ZCTA5 35466,2015,4631,-2616,5310,43.7,4418,0,783,0.147457627,13126,-7816
ZCTA5 35469,217,5153,-4936,432,53.8,71,0,350,0.810185185,13061,-12629
ZCTA5 35470,1632,16,1616,5067,24.7,1398,159,3423,0.675547661,352,4715
ZCTA5 35473,7590,211,7379,19138,35.4,13967,146,4112,0.214860487,1575,17563
ZCTA5 35474,2244,216,2028,7335,37.9,4046,26,2949,0.40204499,792,6543
ZCTA5 35475,6762,16532,-9770,19533,37.4,18781,10,580,0.029693339,44877,-25344
ZCTA5 35476,3071,20686,-17615,7755,37.2,4059,1,3495,0.450676983,50979,-43224
ZCTA5 35477,33,7729,-7696,137,26.9,10,0,127,0.927007299,20425,-20288
ZCTA5 35480,505,6615,-6110,1926,28.9,990,0,918,0.476635514,18743,-16817
ZCTA5 35481,1300,356,944,3308,45.8,1666,0,1531,0.462817412,605,2703
ZCTA5 35487,0,4390,-4390,1130,19.2,811,28,197,0.174336283,11588,-10458
ZCTA5 35490,1833,8500,-6667,5445,33.2,4984,0,406,0.07456382,19808,-14363
ZCTA5 35491,0,1811,-1811,0,-,0,0,0,#DIV/0!,4709,-4709
ZCTA5 35501,3548,2097,1451,10045,34.4,8187,7,964,0.095968143,5013,5032
ZCTA5 35503,3674,351,3323,9450,41,8892,0,97,0.01026455,1060,8390
ZCTA5 35504,5207,717,4490,13582,41,11968,97,468,0.03445737,1722,11860
ZCTA5 35540,969,559,410,2410,41.2,2367,0,0,0,1400,1010
ZCTA5 35541,1480,1655,-175,3707,49.5,3572,22,1,0.00026976,4173,-466
ZCTA5 35542,372,437,-65,888,45.5,845,0,2,0.002252252,1353,-465
ZCTA5 35543,472,319,153,1266,39.9,1195,0,0,0,888,378
ZCTA5 35544,330,3413,-3083,794,49.9,786,3,0,0,9229,-8435
ZCTA5 35545,59,7606,-7547,165,49.2,165,0,0,0,20596,-20431
ZCTA5 35546,1380,2349,-969,3784,41.2,3666,0,39,0.010306554,5575,-1791
ZCTA5 35548,849,51,798,2066,47.1,2034,0,17,0.008228461,83,1983
ZCTA5 35549,1446,2010,-564,3152,47.9,2778,0,244,0.077411168,5474,-2322
ZCTA5 35550,1956,411,1545,5184,47.5,4849,0,140,0.027006173,1312,3872
ZCTA5 35552,464,2132,-1668,1331,33.4,1182,0,137,0.102930128,5656,-4325
ZCTA5 35553,1772,5230,-3458,4882,41.5,4661,18,20,0.004096682,12793,-7911
ZCTA5 35554,408,1215,-807,1074,40.9,1037,0,12,0.011173184,2988,-1914
ZCTA5 35555,3693,4231,-538,9688,46.1,7430,53,1934,0.199628406,10873,-1185
ZCTA5 35559,12,908,-896,64,42.2,28,0,36,0.5625,2320,-2256
ZCTA5 35563,1386,1936,-550,3816,43.8,3265,13,242,0.063417191,4761,-945
ZCTA5 35564,851,1606,-755,2114,39,2024,3,11,0.005203406,3764,-1650
ZCTA5 35565,4448,1004,3444,11431,46.3,10490,11,192,0.016796431,2697,8734
ZCTA5 35570,4281,1629,2652,11097,45.6,9989,5,709,0.063891142,4551,6546
ZCTA5 35571,248,13925,-13677,754,36.9,730,14,0,0,36416,-35662
ZCTA5 35572,677,11416,-10739,1426,54.9,1368,0,0,0,29938,-28512
ZCTA5 35573,4,5567,-5563,9,-,9,0,0,0,14385,-14376
ZCTA5 35574,520,2825,-2305,1411,47.6,1287,0,113,0.080085046,6694,-5283
ZCTA5 35575,434,1071,-637,1020,47.2,988,0,0,0,2955,-1935
ZCTA5 35576,1233,2347,-1114,3356,45.9,2991,15,305,0.090882002,6282,-2926
ZCTA5 35577,2,101,-99,3,-,0,0,0,0,287,-284
ZCTA5 35578,2014,193,1821,5331,43.9,5239,0,18,0.003376477,445,4886
ZCTA5 35579,1267,484,783,3597,45.4,3474,0,79,0.021962747,1013,2584
ZCTA5 35580,1426,174,1252,3817,43.2,3251,0,466,0.122085407,343,3474
ZCTA5 35581,1858,564,1294,5925,40.3,5723,0,0,0,1369,4556
ZCTA5 35582,1880,938,942,4590,45.2,4280,9,0,0,2209,2381
ZCTA5 35584,91,1498,-1407,262,42.4,137,0,125,0.477099237,3727,-3465
ZCTA5 35585,502,599,-97,1728,35.9,1694,0,24,0.013888889,1506,222
ZCTA5 35586,1468,3627,-2159,3851,42.4,3546,0,272,0.070631005,8764,-4913
ZCTA5 35587,258,3304,-3046,616,48.9,609,0,0,0,8569,-7953
ZCTA5 35592,1698,13097,-11399,4127,45.6,3225,0,738,0.178822389,35051,-30924
ZCTA5 35593,614,2439,-1825,1713,44.9,1647,40,4,0.002335085,6254,-4541
ZCTA5 35594,2565,583,1982,7198,43.9,6630,76,257,0.035704362,1368,5830
ZCTA5 35601,13231,2194,11037,34682,37.4,20778,41,8921,0.257222767,4896,29786
ZCTA5 35603,13724,2943,10781,32186,44.5,24181,174,5105,0.158609333,7783,24403
ZCTA5 35610,687,483,204,1799,45.2,1690,23,0,0,1214,585
ZCTA5 35611,11416,2659,8757,26761,41.8,19331,294,4620,0.172639289,7344,19417
ZCTA5 35613,7803,1448,6355,20475,44.4,17703,241,1059,0.051721612,3865,16610
ZCTA5 35614,2592,1868,724,6950,38,6017,43,99,0.014244604,4754,2196
ZCTA5 35615,0,800,-800,0,-,0,0,0,#DIV/0!,1905,-1905
ZCTA5 35616,1438,8278,-6840,3519,46.5,2883,0,538,0.152884342,19413,-15894
ZCTA5 35618,834,1228,-394,2148,44.9,937,0,1013,0.47160149,5254,-3106
ZCTA5 35619,1723,377,1346,4703,39.5,4130,2,262,0.055709122,1016,3687
ZCTA5 35620,4248,238,4010,11572,40.2,10666,139,202,0.017455928,643,10929
ZCTA5 35621,1032,301,731,2932,39.2,2814,113,0,0,700,2232
ZCTA5 35622,2461,376,2085,7331,32.8,6755,44,35,0.004774246,1051,6280
ZCTA5 35630,14573,3045,11528,32632,35.1,23524,207,6832,0.20936504,8202,24430
ZCTA5 35632,0,879,-879,618,19.8,439,96,69,0.111650485,2334,-1716
ZCTA5 35633,8210,2904,5306,20454,45,18421,97,1182,0.057788208,7349,13105
ZCTA5 35634,4084,4022,62,10375,48.1,9586,15,576,0.055518072,10291,84
ZCTA5 35640,9942,3454,6488,26780,41.1,23816,181,1250,0.046676624,8793,17987
ZCTA5 35643,1542,359,1183,4061,47.2,2741,0,949,0.233686284,1104,2957
ZCTA5 35645,4929,6045,-1116,13206,45.5,12090,24,267,0.020218083,15036,-1830
ZCTA5 35646,1814,951,863,4327,53.9,2772,0,1388,0.32077652,2785,1542
ZCTA5 35647,379,166,213,1191,32,1090,1,94,0.078925273,474,717
ZCTA5 35648,1223,100,1123,3325,41.8,3274,0,0,0,294,3031
ZCTA5 35649,32,174,-142,83,56.7,80,1,0,0,475,-392
ZCTA5 35650,4980,1539,3441,12996,43.6,10767,36,820,0.063096337,4221,8775
ZCTA5 35651,474,1574,-1100,1441,46.2,1259,0,47,0.032616239,4157,-2716
ZCTA5 35652,3664,313,3351,9350,44.1,8758,9,394,0.042139037,741,8609
ZCTA5 35653,3536,1772,1764,10904,35.5,5919,0,918,0.084189288,4485,6419
ZCTA5 35654,2903,192,2711,7939,37.7,6397,24,466,0.058697569,391,7548
ZCTA5 35660,4282,1925,2357,9438,44,6445,8,2583,0.273680865,4340,5098
ZCTA5 35661,7466,929,6537,18799,41.5,15150,135,2384,0.126815256,2319,16480
ZCTA5 35670,2383,10,2373,6667,38.9,6283,0,225,0.033748313,16,6651
ZCTA5 35671,654,177,477,1874,53.7,628,0,866,0.462113127,511,1363
ZCTA5 35672,2009,757,1252,5391,39.8,3749,0,512,0.094973103,2195,3196
ZCTA5 35673,2685,4205,-1520,7350,39.2,6341,12,249,0.033877551,11407,-4057
ZCTA5 35674,7321,4091,3230,19841,38,16320,111,2403,0.121112847,10319,9522
ZCTA5 35677,771,23,748,2120,43.3,2115,0,0,0,23,2097
ZCTA5 35739,2129,510,1619,4887,48.2,4239,57,254,0.051974627,1238,3649
ZCTA5 35740,1493,36,1457,3371,45.4,3063,0,73,0.021655295,186,3185
ZCTA5 35741,1703,1205,498,3415,52.7,3181,0,103,0.030161054,3044,371
ZCTA5 35744,705,842,-137,1995,47.7,1768,15,28,0.014035088,2436,-441
ZCTA5 35745,56,15,41,100,61.1,100,0,0,0,33,67
ZCTA5 35746,272,1975,-1703,570,55.9,432,15,0,0,4522,-3952
ZCTA5 35747,2287,763,1524,5930,44.7,5672,8,23,0.003878583,1816,4114
ZCTA5 35748,2834,147,2687,7338,46.5,6611,37,354,0.048242028,354,6984
ZCTA5 35749,8869,369,8500,27196,39.4,17359,819,7605,0.279636711,846,26350
ZCTA5 35750,5003,158,4845,13349,40.7,11051,608,1312,0.098284516,390,12959
ZCTA5 35751,94,6337,-6243,264,39.5,233,0,0,0,19093,-18829
ZCTA5 35752,936,443,493,2091,43.5,1845,7,123,0.058823529,1337,754
ZCTA5 35754,2260,6382,-4122,5699,46,4848,0,89,0.015616775,17501,-11802
ZCTA5 35755,205,669,-464,455,49.2,446,0,5,0.010989011,2222,-1767
ZCTA5 35756,7855,255,7600,22410,33.9,14309,1186,5599,0.24984382,774,21636
ZCTA5 35757,6344,26,6318,17829,37.9,11789,193,4564,0.255987436,26,17803
ZCTA5 35758,19142,217,18925,47184,39.4,34730,2956,6683,0.141636996,619,46565
ZCTA5 35759,3967,1062,2905,10557,40.9,6515,305,2796,0.264847968,2612,7945
ZCTA5 35760,1731,1959,-228,5077,34.8,4895,3,34,0.006696868,5944,-867
ZCTA5 35761,4780,2293,2487,13187,36.8,10254,17,1780,0.134981421,6486,6701
ZCTA5 35763,7010,755,6255,19328,39.6,17244,319,822,0.042528974,1892,17436
ZCTA5 35764,259,461,-202,557,65,543,4,0,0,1211,-654
ZCTA5 35765,1681,712,969,4768,45.5,4357,48,11,0.002307047,1842,2926
ZCTA5 35766,79,11586,-11507,231,49,217,0,0,0,30015,-29784
ZCTA5 35768,4743,5021,-278,12851,39.3,11823,92,378,0.029414053,12518,333
ZCTA5 35769,4123,536,3587,9810,44,8859,0,372,0.037920489,1366,8444
ZCTA5 35771,1102,135,967,3071,38.7,2760,0,0,0,451,2620
ZCTA5 35772,1856,2888,-1032,4895,41.4,3698,0,911,0.186108274,6837,-1942
ZCTA5 35773,5475,11675,-6200,14089,45.3,10935,96,2510,0.178153169,28676,-14587
ZCTA5 35774,58,10360,-10302,199,43.3,199,0,0,0,25729,-25530
ZCTA5 35775,207,210,-3,554,49.7,531,0,1,0.001805054,409,145
ZCTA5 35776,1322,330,992,3447,44.7,3331,0,0,0,1050,2397
ZCTA5 35801,10555,298,10257,25145,39.6,20380,345,2825,0.112348379,678,24467
ZCTA5 35802,11209,5431,5778,23629,42.6,17703,598,3988,0.168775657,14797,8832
ZCTA5 35803,11846,5320,6526,27990,45.5,23934,1022,1072,0.038299393,12488,15502
ZCTA5 35805,9252,34,9218,20033,33.4,8884,159,7265,0.362651625,110,19923
ZCTA5 35806,12886,4174,8712,26199,32.6,15987,851,7989,0.304935303,11861,14338
ZCTA5 35808,379,3557,-3178,1218,30.5,861,67,97,0.079638752,10814,-9596
ZCTA5 35810,12067,434,11633,31735,37.2,7334,322,22426,0.706664566,1076,30659
ZCTA5 35811,11011,2487,8524,28129,39.2,19617,316,6998,0.248782395,4734,23395
ZCTA5 35816,6758,42,6716,14440,29.1,3865,364,9218,0.638365651,72,14368
ZCTA5 35824,4218,2794,1424,9129,41.3,5560,339,2362,0.258735897,7942,1187
ZCTA5 35896,0,1274,-1274,619,19.7,115,0,455,0.735056543,3669,-3050
ZCTA5 35901,7123,335,6788,18827,41.4,11049,57,5707,0.303128486,778,18049
ZCTA5 35903,7051,58,6993,18240,41.7,11460,164,5989,0.328344298,113,18127
ZCTA5 35904,5056,1599,3457,13571,42.5,10729,149,2044,0.150615283,3608,9963
ZCTA5 35905,2196,91,2105,5934,42.4,5601,23,66,0.011122346,174,5760
ZCTA5 35906,3882,1044,2838,10309,38.2,8341,241,1144,0.110970996,3276,7033
ZCTA5 35907,2971,2618,353,9138,41.1,8732,0,77,0.008426351,6151,2987
ZCTA5 35950,7185,495,6690,20816,33.6,17724,55,750,0.036029977,1218,19598
ZCTA5 35951,4526,9,4517,13348,37.4,11584,223,155,0.011612227,19,13329
ZCTA5 35952,3221,4705,-1484,8682,41,8107,56,23,0.002649159,12845,-4163
ZCTA5 35953,2770,16,2754,6967,49.3,6197,32,597,0.08568968,68,6899
ZCTA5 35954,4642,365,4277,12551,43.8,10777,2,1086,0.08652697,890,11661
ZCTA5 35956,2983,5525,-2542,8562,40.1,8318,9,5,0.000583976,14632,-6070
ZCTA5 35957,5961,2360,3601,16240,37.2,13812,16,626,0.038546798,6419,9821
ZCTA5 35958,1186,536,650,3403,40.6,3379,0,0,0,1601,1802
ZCTA5 35959,1774,6957,-5183,4212,52.1,3932,0,228,0.054131054,19063,-14851
ZCTA5 35960,3452,1547,1905,8459,53.1,7409,0,781,0.092327698,4128,4331
ZCTA5 35961,2049,609,1440,6144,37.2,4308,0,161,0.026204427,1384,4760
ZCTA5 35962,2846,634,2212,8139,37,6327,14,6,0.000737191,1397,6742
ZCTA5 35963,495,2238,-1743,1137,50.2,1083,0,26,0.022867194,5876,-4739
ZCTA5 35966,1259,142,1117,3336,49.1,3143,0,0,0,404,2932
ZCTA5 35967,6287,9700,-3413,16649,39.1,14320,9,223,0.013394198,25805,-9156
ZCTA5 35968,1766,221,1545,5237,42,3882,3,428,0.081726179,647,4590
ZCTA5 35971,1928,308,1620,5661,40.8,5255,1,114,0.020137785,809,4852
ZCTA5 35972,463,336,127,1036,44.8,1026,0,0,0,1050,-14
ZCTA5 35973,1120,3928,-2808,3577,37.4,3403,0,73,0.020408163,11475,-7898
ZCTA5 35974,644,0,644,1749,34.8,1624,0,3,0.001715266,0,1749
ZCTA5 35975,449,453,-4,1306,40.9,1306,0,0,0,631,675
ZCTA5 35976,6683,2888,3795,17292,45.3,15175,104,1136,0.065695119,10017,7275
ZCTA5 35978,1804,4069,-2265,5538,38.4,5122,17,0,0,9743,-4205
ZCTA5 35979,382,10993,-10611,1005,40,946,0,0,0,29886,-28881
ZCTA5 35980,1915,8031,-6116,6208,35,5455,18,12,0.00193299,20106,-13898
ZCTA5 35981,649,3190,-2541,2015,47.4,1902,16,0,0,7787,-5772
ZCTA5 35983,1488,15037,-13549,3966,40.2,3729,10,0,0,37111,-33145
ZCTA5 35984,747,10381,-9634,1401,60.4,1369,27,0,0,23661,-22260
ZCTA5 35986,3075,4918,-1843,7844,43.9,6419,0,151,0.019250382,12365,-4521
ZCTA5 35987,932,2451,-1519,2483,37,1858,8,56,0.022553363,6085,-3602
ZCTA5 35988,802,1948,-1146,2423,36.4,2092,0,0,0,5154,-2731
ZCTA5 35989,1288,4679,-3391,3750,37.9,2960,0,2,0.000533333,13238,-9488
ZCTA5 35990,0,86,-86,0,-,0,0,0,#DIV/0!,248,-248
ZCTA5 36003,1056,0,1056,2397,47.7,843,20,1458,0.608260325,0,2397
ZCTA5 36005,563,5123,-4560,1486,42.5,987,65,315,0.211978466,13641,-12155
ZCTA5 36006,699,6076,-5377,1685,51.4,1556,0,129,0.076557864,16908,-15223
ZCTA5 36008,0,5379,-5379,0,-,0,0,0,#DIV/0!,13831,-13831
ZCTA5 36009,866,0,866,2233,46.3,1625,30,526,0.235557546,723,1510
ZCTA5 36010,1852,7354,-5502,5316,44.4,2834,10,2099,0.394845749,17919,-12603
ZCTA5 36013,148,17265,-17117,395,47.8,324,5,65,0.164556962,44880,-44485
ZCTA5 36016,1484,8695,-7211,4990,38.7,2099,23,2738,0.548697395,22591,-17601
ZCTA5 36017,791,5213,-4422,3257,40.5,1221,14,1520,0.466687135,14678,-11421
ZCTA5 36020,414,258,156,1119,46.2,563,18,478,0.427167113,883,236
ZCTA5 36022,5373,169,5204,15336,35.5,12951,83,1967,0.128260303,598,14738
ZCTA5 36024,2208,38,2170,5152,51.1,4575,0,409,0.079386646,131,5021
ZCTA5 36025,1581,1694,-113,7267,40.7,3831,17,2937,0.404155773,5205,2062
ZCTA5 36026,541,86,455,1239,58.7,1209,0,10,0.008071025,213,1026
ZCTA5 36027,5768,175,5593,14825,39.5,7053,63,6697,0.451736931,437,14388
ZCTA5 36028,588,3418,-2830,1501,51.9,1059,0,425,0.28314457,8149,-6648
ZCTA5 36029,334,493,-159,1188,49.3,494,0,634,0.533670034,1429,-241
ZCTA5 36030,126,301,-175,425,57.8,259,0,166,0.390588235,724,-299
ZCTA5 36031,26,669,-643,107,32.3,0,0,107,1,1597,-1490
ZCTA5 36032,862,873,-11,2355,34.5,462,0,1853,0.786836518,2126,229
ZCTA5 36033,1306,2856,-1550,3544,48.1,2283,30,1133,0.31969526,7456,-3912
ZCTA5 36034,309,1381,-1072,975,38.5,782,0,164,0.168205128,3070,-2095
ZCTA5 36035,733,415,318,1972,39.4,1634,0,241,0.122210953,959,1013
ZCTA5 36036,743,1173,-430,1933,45.7,1083,0,744,0.384893947,3065,-1132
ZCTA5 36037,4345,309,4036,13194,39.6,5941,255,6704,0.508109747,1025,12169
ZCTA5 36038,25,720,-695,80,50.5,47,0,33,0.4125,1836,-1756
ZCTA5 36039,92,28,64,279,34.6,20,0,259,0.928315412,28,251
ZCTA5 36040,1345,232,1113,3762,41.7,453,0,3288,0.87400319,475,3287
ZCTA5 36041,530,1854,-1324,1423,40.6,1166,0,252,0.177090654,5844,-4421
ZCTA5 36042,404,717,-313,1188,38.2,1115,0,0,0,1783,-595
ZCTA5 36043,1307,533,774,3805,42.9,2227,0,1511,0.397109067,1640,2165
ZCTA5 36046,491,438,53,1556,30.9,855,0,564,0.362467866,953,603
ZCTA5 36047,385,69,316,940,55.2,412,0,528,0.561702128,209,731
ZCTA5 36048,581,639,-58,1243,48.8,579,0,608,0.489139179,1505,-262
ZCTA5 36049,1941,1,1940,5984,40.9,4481,144,1194,0.199532086,9,5975
ZCTA5 36051,1004,808,196,3080,35.2,2033,0,731,0.237337662,2213,867
ZCTA5 36052,357,261,96,668,61,546,0,113,0.169161677,1003,-335
ZCTA5 36053,910,845,65,2419,38,247,6,2146,0.887143448,2633,-214
ZCTA5 36054,5706,263,5443,15362,32.7,9818,358,4143,0.269691446,918,14444
ZCTA5 36057,0,257,-257,128,16.4,28,0,100,0.78125,628,-500
ZCTA5 36064,4305,490,3815,12737,34.6,8094,772,3364,0.264112428,1604,11133
ZCTA5 36066,8677,1142,7535,21383,36.9,16643,579,3519,0.164569986,2953,18430
ZCTA5 36067,9971,324,9647,27717,38.4,20358,135,5974,0.215535592,891,26826
ZCTA5 36069,919,2717,-1798,1950,52.4,1142,0,801,0.410769231,8076,-6126
ZCTA5 36071,163,519,-356,356,45.3,233,0,114,0.320224719,1510,-1154
ZCTA5 36075,731,1142,-411,1770,55.5,362,11,1395,0.788135593,3646,-1876
ZCTA5 36078,5207,27,5180,13346,40.7,10226,10,2759,0.206728608,80,13266
ZCTA5 36079,3340,480,2860,9397,38.1,6509,24,2470,0.262849846,1429,7968
ZCTA5 36080,843,282,561,2413,46.5,2272,0,72,0.029838375,648,1765
ZCTA5 36081,5606,8842,-3236,15653,25,8091,452,6497,0.415064205,22043,-6390
ZCTA5 36082,0,7008,-7008,979,19.5,519,101,344,0.351378958,17096,-16117
ZCTA5 36083,3399,13818,-10419,9145,38.7,1176,2,7745,0.84691088,33079,-23934
ZCTA5 36088,1105,10091,-8986,3561,23,133,19,3335,0.936534681,23207,-19646
ZCTA5 36089,2547,0,2547,7743,38.5,1734,46,5444,0.703086659,3071,4672
ZCTA5 36091,1532,979,553,3670,45.5,3367,0,240,0.065395095,2700,970
ZCTA5 36092,7752,923,6829,20457,41,14941,245,4524,0.221146796,2279,18178
ZCTA5 36093,4235,3297,938,12291,38.8,10617,39,1519,0.123586364,7885,4406
ZCTA5 36101,0,6154,-6154,50,33.6,11,0,39,0.78,15899,-15849
ZCTA5 36104,3825,683,3142,9291,34.1,1980,8,6731,0.724464536,1612,7679
ZCTA5 36105,4383,1271,3112,10559,46.5,1222,0,9296,0.8803864,4047,6512
ZCTA5 36106,6220,187,6033,15276,34.2,6868,326,7613,0.498363446,538,14738
ZCTA5 36107,3095,0,3095,7965,35.1,3242,62,3314,0.416070308,8,7957
ZCTA5 36108,6363,621,5742,15588,43.2,1662,0,13352,0.856556325,1479,14109
ZCTA5 36109,10058,1174,8884,24344,39.6,14771,311,8229,0.338029905,2722,21622
ZCTA5 36110,3952,2410,1542,11932,34.7,1635,164,9549,0.800284948,6206,5726
ZCTA5 36111,4790,4745,45,13058,38.7,4762,285,7613,0.583014244,12047,1011
ZCTA5 36112,17,12,5,217,24.5,122,56,9,0.041474654,12,205
ZCTA5 36113,270,1618,-1348,1807,38.6,1163,49,442,0.244604317,3802,-1995
ZCTA5 36114,0,8833,-8833,0,-,0,0,0,#DIV/0!,21607,-21607
ZCTA5 36115,242,7104,-6862,1278,19.5,700,47,192,0.150234742,17884,-16606
ZCTA5 36116,17215,6206,11009,44722,34.7,6258,1405,35258,0.788381557,18451,26271
ZCTA5 36117,21303,666,20637,52622,35.7,20182,3918,26642,0.506290145,1373,51249
ZCTA5 36130,0,3323,-3323,0,-,0,0,0,#DIV/0!,9064,-9064
ZCTA5 36201,7388,1712,5676,17748,45.2,9006,10,7916,0.446022087,4699,13049
ZCTA5 36203,7026,4241,2785,18895,37.9,13532,422,3372,0.17845991,11018,7877
ZCTA5 36205,423,920,-497,1030,39.8,455,24,528,0.512621359,2381,-1351
ZCTA5 36206,4172,170,4002,11019,38.6,6453,205,3553,0.322443053,485,10534
ZCTA5 36207,7663,1552,6111,18940,40.2,13984,100,4371,0.230781415,4089,14851
ZCTA5 36250,1534,785,749,4650,39.4,3748,1,629,0.135268817,1966,2684
ZCTA5 36251,2035,931,1104,5413,41.4,4499,21,532,0.098281914,2383,3030
ZCTA5 36255,402,26,376,1016,41.6,859,0,139,0.136811024,26,990
ZCTA5 36256,625,655,-30,1478,42.3,1347,0,127,0.085926928,1723,-245
ZCTA5 36258,550,48,502,1303,48.3,1260,12,0,0,128,1175
ZCTA5 36260,1398,234,1164,4386,42.1,3320,8,831,0.189466484,679,3707
ZCTA5 36262,567,220,347,1647,47.5,1625,0,2,0.001214329,647,1000
ZCTA5 36263,156,842,-686,482,37.5,467,0,15,0.031120332,2148,-1666
ZCTA5 36264,3142,534,2608,8731,41.2,7933,1,342,0.039170771,1337,7394
ZCTA5 36265,8338,217,8121,21422,37.4,17282,71,3118,0.145551302,601,20821
ZCTA5 36266,2377,1319,1058,6159,45.1,5020,0,1056,0.171456405,3698,2461
ZCTA5 36267,13,1939,-1926,228,9.6,228,0,0,0,5751,-5523
ZCTA5 36268,2135,922,1213,5944,35.5,4637,40,1156,0.19448183,2436,3508
ZCTA5 36269,544,31083,-30539,1492,31.7,1340,0,20,0.013404826,79903,-78411
ZCTA5 36271,2300,669,1631,6056,43.6,5751,0,105,0.017338177,1746,4310
ZCTA5 36272,5134,6578,-1444,13091,45.7,11894,0,681,0.052020472,16985,-3894
ZCTA5 36273,1150,375,775,2851,40.5,2756,0,27,0.009470361,935,1916
ZCTA5 36274,4123,765,3358,10187,44.4,6933,0,2950,0.289584765,1821,8366
ZCTA5 36276,997,365,632,2817,40.1,2082,0,489,0.173588924,959,1858
ZCTA5 36277,1924,1806,118,5912,35.9,4455,73,993,0.167963464,5158,754
ZCTA5 36278,1740,2067,-327,3985,52,3015,0,795,0.199498118,5439,-1454
ZCTA5 36279,914,629,285,2921,38.8,2844,13,29,0.009928107,1558,1363
ZCTA5 36280,1585,2258,-673,4237,43.8,3982,0,138,0.032570215,6348,-2111
ZCTA5 36301,15084,843,14241,37699,39.8,23933,311,11846,0.314225842,2226,35473
ZCTA5 36303,11898,17788,-5890,31269,38.4,17138,277,12358,0.395215709,49832,-18563
ZCTA5 36305,6350,343,6007,16878,40.3,13926,358,1833,0.108602915,1054,15824
ZCTA5 36310,2408,2112,296,5929,51.9,3801,0,1788,0.301568561,5357,572
ZCTA5 36311,912,2730,-1818,2280,44.3,2063,0,151,0.06622807,7259,-4979
ZCTA5 36312,2339,1405,934,6095,41.8,4980,11,830,0.136177194,3948,2147
ZCTA5 36313,140,1632,-1492,166,68.6,122,0,44,0.265060241,4470,-4304
ZCTA5 36314,207,3121,-2914,531,36.4,468,0,0,0,7950,-7419
ZCTA5 36316,790,2485,-1695,2138,44.5,1908,24,170,0.079513564,7210,-5072
ZCTA5 36317,266,1102,-836,651,56.3,267,0,376,0.577572965,3257,-2606
ZCTA5 36318,554,2275,-1721,1505,39.7,1497,0,1,0.000664452,6008,-4503
ZCTA5 36319,878,2001,-1123,2385,39.3,2133,0,221,0.092662474,6293,-3908
ZCTA5 36320,1304,16102,-14798,3250,46.7,2462,4,739,0.227384615,42918,-39668
ZCTA5 36321,761,24067,-23306,2133,36.2,1785,0,170,0.079699953,67119,-64986
ZCTA5 36322,3922,15842,-11920,8437,42.9,5336,155,2139,0.253526135,41236,-32799
ZCTA5 36323,2970,1409,1561,7865,46.8,5623,8,1718,0.218436109,3973,3892
ZCTA5 36330,14726,963,13763,37874,37.5,26623,726,7257,0.191609019,2474,35400
ZCTA5 36340,2327,2246,81,5533,46.1,4758,139,543,0.098138442,6211,-678
ZCTA5 36343,535,1114,-579,1300,50.3,829,0,412,0.316923077,2941,-1641
ZCTA5 36344,2100,720,1380,6176,37.7,4431,0,923,0.149449482,1747,4429
ZCTA5 36345,3146,1381,1765,8630,41.6,6877,69,1546,0.179142526,3991,4639
ZCTA5 36346,474,789,-315,1150,46,1090,0,7,0.006086957,2183,-1033
ZCTA5 36350,2940,10372,-7432,7634,39,5420,12,1728,0.226355777,27476,-19842
ZCTA5 36351,1509,384,1125,3678,43.3,3010,28,230,0.062533986,1070,2608
ZCTA5 36352,1882,2856,-974,5442,43.4,5012,4,287,0.052737964,7081,-1639
ZCTA5 36353,581,508,73,1614,47.7,1231,0,317,0.196406444,1379,235
ZCTA5 36360,7823,872,6951,19022,42.4,12726,266,4910,0.258122174,2361,16661
ZCTA5 36362,1461,2130,-669,5912,24.1,4403,233,654,0.110622463,5366,546
ZCTA5 36370,398,3855,-3457,990,50.9,865,0,87,0.087878788,10214,-9224
ZCTA5 36371,195,18336,-18141,434,45.3,372,0,48,0.110599078,50207,-49773
ZCTA5 36373,217,16645,-16428,665,42.9,178,0,487,0.732330827,42873,-42208
ZCTA5 36374,222,9287,-9065,534,48.6,448,0,51,0.095505618,22980,-22446
ZCTA5 36375,2611,6532,-3921,6882,42.9,6059,5,597,0.086748038,19475,-12593
ZCTA5 36376,915,11807,-10892,2276,45.3,1672,7,542,0.238137083,29598,-27322
ZCTA5 36401,2577,4982,-2405,7398,42.4,2880,8,4429,0.598675318,13150,-5752
ZCTA5 36420,4076,2450,1626,10367,44.4,8803,25,1230,0.118645703,6922,3445
ZCTA5 36421,3581,22237,-18656,9720,37.7,8116,113,1112,0.114403292,59694,-49974
ZCTA5 36425,293,15276,-14983,843,44.9,185,0,658,0.78054567,37784,-36941
ZCTA5 36426,5328,377,4951,15351,39.5,10652,70,3796,0.247280307,943,14408
ZCTA5 36432,665,894,-229,2073,51.6,1431,0,600,0.289435601,2386,-313
ZCTA5 36435,167,3045,-2878,493,52.3,80,0,413,0.837728195,8189,-7696
ZCTA5 36436,202,2447,-2245,619,41.5,462,0,157,0.253634895,6539,-5920
ZCTA5 36439,34,5136,-5102,82,36.7,74,0,8,0.097560976,13528,-13446
ZCTA5 36441,1461,1496,-35,3824,39.7,3026,0,633,0.165533473,4240,-416
ZCTA5 36442,1231,10500,-9269,3631,44,3022,92,421,0.11594602,31672,-28041
ZCTA5 36444,252,15816,-15564,653,50.3,471,0,164,0.251148545,42364,-41711
ZCTA5 36445,1901,4819,-2918,5339,40.6,3917,28,1181,0.221202472,12155,-6816
ZCTA5 36446,136,7941,-7805,451,29.2,294,0,157,0.348115299,20095,-19644
ZCTA5 36451,1800,650,1150,4706,43.8,2727,1,1972,0.419039524,1706,3000
ZCTA5 36453,940,2262,-1322,2472,50.8,2362,17,3,0.001213592,5350,-2878
ZCTA5 36454,22,961,-939,23,43.6,23,0,0,0,2466,-2443
ZCTA5 36455,116,1795,-1679,261,52.8,236,0,25,0.095785441,4638,-4377
ZCTA5 36456,648,2443,-1795,1725,41.1,1101,11,600,0.347826087,6465,-4740
ZCTA5 36460,3735,12795,-9060,9960,44.3,4185,44,5550,0.557228916,32982,-23022
ZCTA5 36467,3958,15762,-11804,9829,47.3,8083,6,1470,0.149557432,36171,-26342
ZCTA5 36470,0,605,-605,0,-,0,0,0,#DIV/0!,1757,-1757
ZCTA5 36471,310,16532,-16222,716,54.2,167,11,504,0.703910615,46075,-45359
ZCTA5 36473,74,5563,-5489,323,32.5,314,0,9,0.027863777,15609,-15286
ZCTA5 36474,1051,14760,-13709,2682,43,2290,0,318,0.118568233,39889,-37207
ZCTA5 36475,623,18395,-17772,1662,40.9,1097,20,483,0.290613718,49884,-48222
ZCTA5 36476,11,19914,-19903,26,38.1,26,0,0,0,50013,-49987
ZCTA5 36477,1511,39,1472,3647,51.3,3154,4,254,0.069646285,2649,998
ZCTA5 36480,575,1113,-538,1669,49.2,1228,0,223,0.133612942,2878,-1209
ZCTA5 36481,69,3148,-3079,258,50.3,143,0,115,0.445736434,9377,-9119
ZCTA5 36482,363,1064,-701,995,57,419,0,576,0.578894472,2692,-1697
ZCTA5 36483,211,8861,-8650,545,50.6,533,0,12,0.022018349,21408,-20863
ZCTA5 36502,6053,58,5995,16285,40,8420,14,6295,0.386552042,1348,14937
ZCTA5 36503,0,442,-442,1371,39.3,584,8,779,0.568198395,1190,181
ZCTA5 36505,366,780,-414,920,39.7,829,0,43,0.04673913,2194,-1274
ZCTA5 36507,7121,1354,5767,20910,38.5,15230,35,4732,0.226303204,3925,16985
ZCTA5 36509,593,1331,-738,1596,49,856,497,170,0.106516291,3427,-1831
ZCTA5 36511,271,833,-562,355,63.6,355,0,0,0,2009,-1654
ZCTA5 36512,7,2375,-2368,13,-,0,0,13,1,7074,-7061
ZCTA5 36513,104,8101,-7997,298,57.2,70,0,228,0.765100671,22092,-21794
ZCTA5 36518,785,718,67,2497,44.8,2198,0,228,0.091309571,2039,458
ZCTA5 36521,1949,2052,-103,5165,39.7,4584,90,232,0.044917715,5089,76
ZCTA5 36522,2454,165,2289,7063,35.4,5078,46,1219,0.172589551,563,6500
ZCTA5 36523,932,1950,-1018,2913,42,2687,0,199,0.068314452,6206,-3293
ZCTA5 36524,428,11466,-11038,1165,44.7,784,7,365,0.313304721,32139,-30974
ZCTA5 36525,744,22,722,2335,36,1625,0,544,0.232976445,74,2261
ZCTA5 36526,12682,5010,7672,34627,36.9,27283,824,5035,0.145406764,13215,21412
ZCTA5 36527,5926,18312,-12386,17146,36.2,14072,271,1155,0.06736265,50453,-33307
ZCTA5 36528,773,318,455,1771,61,1678,0,30,0.016939582,684,1087
ZCTA5 36529,86,10566,-10480,256,35.8,183,0,38,0.1484375,29571,-29315
ZCTA5 36530,2870,9270,-6400,6411,49.3,6021,19,14,0.002183747,27238,-20827
ZCTA5 36532,13481,463,13018,35688,44.9,31476,422,2646,0.074142569,1183,34505
ZCTA5 36535,15286,867,14419,36605,48.5,31204,306,2338,0.063871056,2007,34598
ZCTA5 36538,146,3470,-3324,363,47.6,74,0,282,0.776859504,10148,-9785
ZCTA5 36539,203,1140,-937,542,27.7,512,0,10,0.018450185,2887,-2345
ZCTA5 36540,257,588,-331,863,32.1,208,0,509,0.589803013,1525,-662
ZCTA5 36541,5214,1225,3989,15048,38.1,11980,17,2358,0.156698565,3520,11528
ZCTA5 36542,7926,2475,5451,16699,49.7,15970,190,67,0.004012216,6672,10027
ZCTA5 36543,5,3652,-3647,8,-,8,0,0,0,8271,-8263
ZCTA5 36544,4263,3291,972,12049,41.5,8964,1310,1231,0.102166155,9223,2826
ZCTA5 36545,3151,2457,694,9006,44.5,4245,80,4427,0.491561181,6328,2678
ZCTA5 36547,0,5091,-5091,0,-,0,0,0,#DIV/0!,13731,-13731
ZCTA5 36548,319,1205,-886,1018,31.6,573,0,414,0.406679764,3299,-2281
ZCTA5 36549,2314,3489,-1175,5759,54.2,5643,0,0,0,8910,-3151
ZCTA5 36550,143,1606,-1463,349,54.7,258,0,9,0.025787966,4458,-4109
ZCTA5 36551,3873,557,3316,12635,36.6,9471,0,2113,0.167233874,1784,10851
ZCTA5 36553,1007,5369,-4362,3361,43.1,1169,2,1082,0.321927998,11171,-7810
ZCTA5 36555,446,5313,-4867,1351,48.6,1225,1,11,0.008142117,12826,-11475
ZCTA5 36556,54,10424,-10370,133,66.6,83,0,50,0.37593985,23605,-23472
ZCTA5 36558,1421,10534,-9113,3969,43.3,2930,0,751,0.189216427,25264,-21295
ZCTA5 36559,69,12878,-12809,150,79.2,150,0,0,0,32896,-32746
ZCTA5 36560,1075,6102,-5027,2936,44.3,656,56,1594,0.542915531,15593,-12657
ZCTA5 36561,4029,14230,-10201,8801,56.3,8535,91,0,0,36480,-27679
ZCTA5 36562,532,5902,-5370,1404,46.7,1238,0,103,0.073361823,15337,-13933
ZCTA5 36564,0,28844,-28844,0,-,0,0,0,#DIV/0!,75621,-75621
ZCTA5 36567,5051,6533,-1482,14005,41.8,12327,0,833,0.059478758,18961,-4956
ZCTA5 36568,55,39,16,99,52.1,99,0,0,0,185,-86
ZCTA5 36569,231,13200,-12969,710,50.7,397,0,313,0.44084507,29668,-28958
ZCTA5 36571,6421,9840,-3419,16543,43.4,13250,203,2187,0.132200931,22224,-5681
ZCTA5 36572,2395,7730,-5335,6725,43.2,6005,67,433,0.064386617,18078,-11353
ZCTA5 36574,485,11876,-11391,1559,46.9,1505,0,24,0.015394484,28758,-27199
ZCTA5 36575,7610,5130,2480,22027,39.2,16584,70,4042,0.183502066,14464,7563
ZCTA5 36576,1701,828,873,4285,38,3621,0,151,0.035239207,1078,3207
ZCTA5 36578,448,2300,-1852,1215,49.6,1149,11,0,0,5876,-4661
ZCTA5 36579,430,16243,-15813,1252,47.8,718,0,514,0.410543131,37582,-36330
ZCTA5 36580,2072,780,1292,5919,37.5,4596,5,150,0.025342119,1570,4349
ZCTA5 36581,132,36,96,303,66.8,193,0,110,0.363036304,684,-381
ZCTA5 36582,9216,0,9216,24274,39.4,18001,609,4603,0.189626761,0,24274
ZCTA5 36583,304,0,304,834,47,773,0,25,0.029976019,0,834
ZCTA5 36584,272,502,-230,449,58.8,292,16,141,0.31403118,1539,-1090
ZCTA5 36585,297,1204,-907,996,31.5,725,0,243,0.243975904,3139,-2143
ZCTA5 36587,3942,10278,-6336,12279,37.2,11364,109,326,0.026549393,25504,-13225
ZCTA5 36602,588,345,243,861,57.4,489,8,314,0.364692218,956,-95
ZCTA5 36603,2971,1053,1918,8438,38.2,1105,18,7149,0.847238682,3042,5396
ZCTA5 36604,3825,2032,1793,9158,37.9,4813,29,3953,0.431644464,5394,3764
ZCTA5 36605,9965,790,9175,26830,38.1,6634,272,19181,0.714908684,2159,24671
ZCTA5 36606,7943,814,7129,18697,34.9,7372,110,10195,0.545274643,2130,16567
ZCTA5 36607,2545,1658,887,6004,45,2005,6,3751,0.624750167,4057,1947
ZCTA5 36608,15134,10193,4941,35268,35,21191,841,11454,0.32477033,27131,8137
ZCTA5 36609,11099,11948,-849,23413,35.8,11277,743,9399,0.401443642,31626,-8213
ZCTA5 36610,3671,609,3062,9948,39.4,94,0,9820,0.987133092,1786,8162
ZCTA5 36611,2316,86,2230,6421,30,3034,71,3033,0.472356331,1242,5179
ZCTA5 36612,1414,1196,218,4208,39.9,210,0,3998,0.950095057,3064,1144
ZCTA5 36613,4140,804,3336,12659,38.2,5323,0,7070,0.558495932,1625,11034
ZCTA5 36615,0,7089,-7089,0,-,0,0,0,#DIV/0!,19711,-19711
ZCTA5 36617,5012,3034,1978,12409,45.6,469,28,11817,0.952292691,7902,4507
ZCTA5 36618,6801,11278,-4477,18204,38.2,5763,208,11365,0.624313338,30207,-12003
ZCTA5 36619,5606,2115,3491,15334,38.1,11840,1007,1582,0.103169427,5190,10144
ZCTA5 36652,0,603,-603,0,-,0,0,0,#DIV/0!,1389,-1389
ZCTA5 36663,4,144,-140,59,40.5,32,0,14,0.237288136,456,-397
ZCTA5 36688,96,4432,-4336,1275,20.5,739,11,500,0.392156863,11384,-10109
ZCTA5 36693,7609,564,7045,19528,41.9,13249,674,4683,0.239809504,1398,18130
ZCTA5 36695,19367,2412,16955,52433,35.9,38451,1268,11028,0.210325558,6290,46143
ZCTA5 36701,7746,2870,4876,21247,37.8,6313,109,14701,0.691909446,7166,14081
ZCTA5 36703,4756,3259,1497,12471,42.1,2892,146,9273,0.743565071,7548,4923
ZCTA5 36720,237,940,-703,668,40,9,0,659,0.986526946,2516,-1848
ZCTA5 36722,66,227,-161,118,42.7,57,0,45,0.381355932,634,-516
ZCTA5 36723,123,8833,-8710,444,19.2,2,0,442,0.995495495,21458,-21014
ZCTA5 36726,1734,1003,731,4986,41.5,1516,0,3307,0.66325712,2647,2339
ZCTA5 36727,76,1654,-1578,108,38.7,106,0,0,0,4275,-4167
ZCTA5 36728,137,547,-410,539,24.5,151,0,388,0.719851577,1145,-606
ZCTA5 36732,3178,1041,2137,7425,42.4,3721,104,3467,0.466936027,2937,4488
ZCTA5 36736,424,754,-330,1725,31.5,285,0,1440,0.834782609,1798,-73
ZCTA5 36738,284,212,72,1021,53.6,188,0,833,0.815866797,464,557
ZCTA5 36740,361,5019,-4658,1083,44.8,202,0,881,0.813481071,13542,-12459
ZCTA5 36741,0,1287,-1287,0,-,0,0,0,#DIV/0!,3285,-3285
ZCTA5 36742,1029,15887,-14858,2917,31.4,1229,0,1308,0.448405896,41213,-38296
ZCTA5 36744,2194,870,1324,5681,39.8,1923,20,3634,0.639676113,2059,3622
ZCTA5 36748,893,3030,-2137,2520,48.6,1589,0,896,0.355555556,7161,-4641
ZCTA5 36749,297,511,-214,734,48.6,419,0,315,0.429155313,1350,-616
ZCTA5 36750,844,711,133,2320,39.6,1550,0,632,0.272413793,1864,456
ZCTA5 36751,136,325,-189,538,33.6,45,0,493,0.916356877,687,-149
ZCTA5 36752,498,1208,-710,1014,51.2,681,0,333,0.328402367,3182,-2168
ZCTA5 36753,27,1580,-1553,27,-,27,0,0,0,4258,-4231
ZCTA5 36754,136,6532,-6396,594,58.4,6,0,588,0.98989899,16353,-15759
ZCTA5 36756,1490,10070,-8580,5180,37.1,2140,7,3018,0.582625483,25889,-20709
ZCTA5 36758,453,1055,-602,1367,41.4,852,0,515,0.376737381,2540,-1173
ZCTA5 36759,716,1975,-1259,2106,42.4,506,0,1600,0.759734093,5210,-3104
ZCTA5 36761,303,326,-23,667,54.3,115,0,550,0.824587706,886,-219
ZCTA5 36763,38,580,-542,126,55.6,118,0,3,0.023809524,1493,-1367
ZCTA5 36764,0,626,-626,0,-,0,0,0,#DIV/0!,1569,-1569
ZCTA5 36765,513,1204,-691,1554,49.6,339,0,1215,0.781853282,3135,-1581
ZCTA5 36766,16,11694,-11678,24,61.5,13,0,11,0.458333333,31668,-31644
ZCTA5 36767,371,495,-124,1383,22.8,115,0,1268,0.916847433,1366,17
ZCTA5 36768,325,390,-65,990,49.4,229,0,761,0.768686869,889,101
ZCTA5 36769,829,3426,-2597,2037,46.1,761,2,1245,0.611192931,9934,-7897
ZCTA5 36773,99,313,-214,290,35.8,54,0,236,0.813793103,741,-451
ZCTA5 36775,584,1688,-1104,1319,49.8,225,0,1093,0.828658074,5058,-3739
ZCTA5 36776,569,1139,-570,1986,31.1,516,0,1451,0.7306143,2746,-760
ZCTA5 36782,776,751,25,2140,38.8,1123,0,1017,0.475233645,2192,-52
ZCTA5 36783,324,1130,-806,708,49.3,339,0,369,0.521186441,4232,-3524
ZCTA5 36784,2040,188,1852,6019,36.5,3284,17,2618,0.434955973,504,5515
ZCTA5 36785,426,5722,-5296,916,55.1,190,0,710,0.77510917,15310,-14394
ZCTA5 36786,981,10380,-9399,2396,41.5,161,0,2233,0.93196995,26579,-24183
ZCTA5 36790,238,2294,-2056,579,49.2,543,0,36,0.062176166,5737,-5158
ZCTA5 36792,469,3628,-3159,1246,36,1113,0,92,0.073836276,8920,-7674
ZCTA5 36793,191,3170,-2979,680,36.9,628,0,52,0.076470588,8343,-7663
ZCTA5 36801,9454,1387,8067,23566,40.3,13510,417,9239,0.392047866,3377,20189
ZCTA5 36804,6961,10043,-3082,19307,39.8,12939,442,5061,0.262132905,24718,-5411
ZCTA5 36830,19492,460,19032,48282,32.5,35268,4163,7531,0.155979454,1043,47239
ZCTA5 36832,10248,54,10194,27384,25,16517,2100,7354,0.268550979,143,27241
ZCTA5 36849,0,87,-87,4339,19.4,2672,56,1430,0.329569025,258,4081
ZCTA5 36850,1117,3994,-2877,2799,48.4,616,0,2138,0.76384423,10540,-7741
ZCTA5 36851,0,5855,-5855,0,-,0,0,0,#DIV/0!,14159,-14159
ZCTA5 36852,761,2161,-1400,2862,28.8,2015,1,604,0.21104123,3816,-954
ZCTA5 36853,3238,1368,1870,8163,50.8,6243,0,1763,0.215974519,5563,2600
ZCTA5 36854,6201,4853,1348,16226,36,11143,135,4718,0.290767903,12358,3868
ZCTA5 36855,561,6729,-6168,1305,50.2,900,0,403,0.308812261,14686,-13381
ZCTA5 36856,2737,5656,-2919,8606,34.1,3187,26,4484,0.521031838,14450,-5844
ZCTA5 36858,224,3114,-2890,473,56.5,317,8,148,0.312896406,9059,-8586
ZCTA5 36860,775,650,125,1854,53.3,373,7,1459,0.786947141,1280,574
ZCTA5 36861,1218,1137,81,2816,55.7,2512,24,216,0.076704545,2928,-112
ZCTA5 36862,2115,1667,448,5380,50.4,2552,26,2676,0.49739777,4628,752
ZCTA5 36863,4549,7570,-3021,12408,47.8,6532,196,5440,0.438426821,18232,-5824
ZCTA5 36865,13,9255,-9242,42,26.8,16,0,26,0.619047619,21029,-20987
ZCTA5 36866,1670,10771,-9101,4145,43.3,2307,36,1711,0.41278649,23464,-19319
ZCTA5 36867,8852,5982,2870,21298,36.8,11406,582,8200,0.385012677,14694,6604
ZCTA5 36869,8732,2615,6117,22109,35.8,9425,124,10766,0.486951015,6164,15945
ZCTA5 36870,7254,19231,-11977,19581,36.6,15252,177,2619,0.133752107,46835,-27254
ZCTA5 36871,435,16170,-15735,1085,50.8,660,0,425,0.391705069,36864,-35779
ZCTA5 36874,3487,15248,-11761,9488,43.4,7605,20,1759,0.185392074,34683,-25195
ZCTA5 36875,1445,0,1445,3732,46.7,2555,0,1034,0.277063237,1783,1949
ZCTA5 36877,4020,7935,-3915,12904,34.8,9158,12,2831,0.219389337,19024,-6120
ZCTA5 36879,826,2172,-1346,2583,41.3,1767,69,684,0.264808362,4982,-2399
ZCTA5 36901,34,5588,-5554,74,61.9,47,0,27,0.364864865,14239,-14165
ZCTA5 36904,1582,5514,-3932,3842,43.1,2179,15,1552,0.403956273,13376,-9534
ZCTA5 36907,794,16796,-16002,1800,47.3,486,4,1283,0.712777778,38660,-36860
ZCTA5 36908,682,1535,-853,1824,42.4,1752,0,68,0.037280702,3594,-1770
ZCTA5 36910,6,3427,-3421,14,-,14,0,0,0,7903,-7889
ZCTA5 36912,640,6102,-5462,1814,54.6,240,0,1479,0.815325248,14272,-12458
ZCTA5 36913,23,14301,-14278,50,62.3,50,0,0,0,34225,-34175
ZCTA5 36915,290,2113,-1823,741,44.5,633,0,107,0.14439946,5156,-4415
ZCTA5 36916,307,5219,-4912,770,42.4,371,0,399,0.518181818,12470,-11700
ZCTA5 36919,700,1684,-984,1730,52,888,0,832,0.480924855,3965,-2235
ZCTA5 36921,641,498,143,969,58.3,821,0,147,0.151702786,981,-12
ZCTA5 36922,205,1839,-1634,724,33.2,215,0,509,0.703038674,4058,-3334
ZCTA5 36925,1337,10907,-9570,2863,47.2,325,0,2435,0.850506462,27319,-24456
ZCTA5 37010,1821,17564,-15743,5425,40.8,4519,46,453,0.083502304,39880,-34455
ZCTA5 37012,872,6090,-5218,2082,41.5,1954,10,68,0.032660903,15156,-13074
ZCTA5 37013,35483,11068,24415,102184,31.5,47688,5076,36750,0.359645346,26194,75990
ZCTA5 37014,1220,2355,-1135,2954,50.2,2873,0,11,0.003723764,5401,-2447
ZCTA5 37015,7047,239,6808,18979,40.7,17469,112,364,0.019179093,468,18511
ZCTA5 37016,409,2500,-2091,927,53.9,913,0,0,0,6220,-5293
ZCTA5 37018,750,18,732,2487,41.3,2242,73,7,0.002814636,631,1856
ZCTA5 37019,266,5187,-4921,788,32.9,757,0,31,0.039340102,13627,-12839
ZCTA5 37020,1974,3039,-1065,5228,37.6,4528,124,187,0.035768936,7229,-2001
ZCTA5 37022,2281,1957,324,6499,40.6,5953,0,242,0.037236498,5058,1441
ZCTA5 37023,529,401,128,1384,44.4,1339,0,3,0.00216763,889,495
ZCTA5 37025,1902,1652,250,5089,42.3,5034,0,19,0.003733543,3887,1202
ZCTA5 37026,965,310,655,2424,40.8,2382,0,0,0,667,1757
ZCTA5 37027,21914,1845,20069,60610,42.5,51751,4244,2392,0.039465435,4842,55768
ZCTA5 37028,194,812,-618,347,59.2,343,0,2,0.005763689,2037,-1690
ZCTA5 37029,2451,2952,-501,7018,41.4,6573,14,69,0.009831861,6778,240
ZCTA5 37030,3099,1783,1316,7821,40.8,7068,56,297,0.037974684,4683,3138
ZCTA5 37031,1645,2710,-1065,4137,44.9,3934,0,71,0.017162195,6616,-2479
ZCTA5 37032,1732,1434,298,5236,36.4,5109,12,86,0.016424752,3939,1297
ZCTA5 37033,3046,415,2631,8090,47,7721,0,110,0.013597033,1175,6915
ZCTA5 37034,2915,2089,826,7549,39.3,7096,22,43,0.005696119,5028,2521
ZCTA5 37035,1433,551,882,3551,37.1,3323,32,31,0.008729935,1381,2170
ZCTA5 37036,2055,1773,282,6338,41.8,6027,0,134,0.021142316,4287,2051
ZCTA5 37037,2672,280,2392,8798,36.7,7951,0,492,0.0559218,667,8131
ZCTA5 37040,21037,10118,10919,58490,31,36211,1595,15065,0.257565396,25544,32946
ZCTA5 37042,30082,48,30034,82706,29.4,46451,1777,21936,0.265228641,107,82599
ZCTA5 37043,18988,4991,13997,51607,36.4,42783,1273,4405,0.085356638,12795,38812
ZCTA5 37046,2180,2489,-309,5935,44.2,5472,92,0,0,6622,-687
ZCTA5 37047,836,414,422,2275,46.1,1873,0,81,0.035604396,944,1331
ZCTA5 37048,2374,1065,1309,6727,42.4,6298,36,68,0.010108518,2556,4171
ZCTA5 37049,1383,6203,-4820,3895,36.3,3592,8,51,0.01309371,15716,-11821
ZCTA5 37050,623,731,-108,1812,35.2,1502,0,118,0.065121413,1462,350
ZCTA5 37051,1431,969,462,3879,44,3670,0,0,0,2272,1607
ZCTA5 37052,844,558,286,1688,52.7,1686,0,0,0,1802,-114
ZCTA5 37055,10449,29,10420,28369,37.1,25078,259,1677,0.059113821,34,28335
ZCTA5 37057,320,217,103,718,59.4,621,0,65,0.090529248,559,159
ZCTA5 37058,2825,61,2764,7620,45.8,6915,56,27,0.003543307,102,7518
ZCTA5 37059,588,11,577,1487,39.3,1410,0,25,0.016812374,21,1466
ZCTA5 37060,963,2252,-1289,2683,41.1,2554,4,103,0.038389862,5677,-2994
ZCTA5 37061,1625,2559,-934,5340,42,4890,27,304,0.056928839,5210,130
ZCTA5 37062,4778,2273,2505,12848,40.3,11490,117,422,0.032845579,5968,6880
ZCTA5 37064,22401,10758,11643,60932,41.1,51821,2195,4074,0.066861419,25819,35113
ZCTA5 37066,22478,7696,14782,57618,40.4,44371,1426,7234,0.125551043,18250,39368
ZCTA5 37067,12896,7189,5707,32417,36.9,24722,4683,1257,0.038775951,17774,14643
ZCTA5 37069,7019,2433,4586,20396,44.2,18240,369,610,0.029907825,6470,13926
ZCTA5 37072,13324,370,12954,32097,42.1,22693,895,4792,0.149297442,790,31307
ZCTA5 37073,4974,1724,3250,14253,40.6,13274,183,147,0.010313618,4434,9819
ZCTA5 37074,2936,1081,1855,10568,32.4,8766,63,1158,0.109576079,3115,7453
ZCTA5 37075,26699,1221,25478,70819,39.8,60244,1086,6016,0.084948954,3349,67470
ZCTA5 37076,16614,3593,13021,38557,36.3,25454,544,9597,0.24890422,9385,29172
ZCTA5 37078,171,5104,-4933,461,48.8,461,0,0,0,13795,-13334
ZCTA5 37079,1018,1196,-178,2901,32.4,2859,0,0,0,2867,34
ZCTA5 37080,3001,6641,-3640,7101,48.9,6096,23,449,0.063230531,16030,-8929
ZCTA5 37082,2222,3701,-1479,5705,42.2,5381,0,75,0.013146363,9328,-3623
ZCTA5 37083,5851,214,5637,15289,38.4,14646,26,42,0.002747073,445,14844
ZCTA5 37085,1909,7493,-5584,5165,39.8,4763,11,104,0.020135528,18887,-13722
ZCTA5 37086,12593,2414,10179,36668,33,20953,1097,8847,0.241273045,6123,30545
ZCTA5 37087,18754,1215,17539,50976,37.5,42260,681,4588,0.090003139,3068,47908
ZCTA5 37090,5959,6132,-173,15857,40.4,14385,193,457,0.028820079,15526,331
ZCTA5 37091,8597,4448,4149,23107,39,20367,134,1624,0.070281733,10559,12548
ZCTA5 37095,953,7832,-6879,2535,42.4,2441,20,29,0.011439842,19084,-16549
ZCTA5 37096,2126,4944,-2818,5963,43.2,5299,188,61,0.01022975,12050,-6087
ZCTA5 37097,757,1710,-953,1870,48.1,1823,0,0,0,4493,-2623
ZCTA5 37098,2170,9833,-7663,6404,33.5,5921,0,63,0.009837601,24703,-18299
ZCTA5 37101,2171,12065,-9894,6714,40.7,6521,0,3,0.000446828,30917,-24203
ZCTA5 37110,12962,9518,3444,32956,40.9,29315,219,942,0.028583566,24483,8473
ZCTA5 37115,17142,1068,16074,41274,36.7,19412,396,14158,0.343024664,2916,38358
ZCTA5 37118,449,3667,-3218,1078,57.4,1057,21,0,0,9594,-8516
ZCTA5 37122,22563,1110,21453,62696,40.8,53055,1561,4222,0.067340819,2719,59977
ZCTA5 37127,6901,763,6138,20242,35,15234,495,2858,0.141191582,1862,18380
ZCTA5 37128,24552,1372,23180,69285,32.1,51125,3614,9260,0.133650862,3409,65876
ZCTA5 37129,20894,7075,13819,59266,36.6,46847,2293,7186,0.121249958,18581,40685
ZCTA5 37130,22855,12746,10109,59046,31.5,41544,973,12071,0.204433831,32674,26372
ZCTA5 37132,0,2031,-2031,2662,19.4,1706,70,785,0.294891059,4942,-2280
ZCTA5 37134,1004,269,735,3151,37.8,2799,3,12,0.003808315,602,2549
ZCTA5 37135,6566,2811,3755,21171,36.9,17652,900,1518,0.071701856,7599,13572
ZCTA5 37137,1136,9404,-8268,2449,54.4,2155,106,98,0.040016333,22196,-19747
ZCTA5 37138,9527,3535,5992,24267,42.7,20334,243,2541,0.1047101,8473,15794
ZCTA5 37140,83,1654,-1571,1713,36.8,942,0,712,0.415645067,4299,-2586
ZCTA5 37141,494,737,-243,1256,47.5,1181,0,60,0.047770701,1622,-366
ZCTA5 37142,711,777,-66,2030,45.7,1966,2,11,0.005418719,1983,47
ZCTA5 37143,1443,12830,-11387,3864,40.7,3767,0,25,0.006469979,29698,-25834
ZCTA5 37144,1296,4074,-2778,3403,43.7,3242,6,59,0.017337643,9518,-6115
ZCTA5 37145,1013,3826,-2813,2672,46.6,2387,0,0,0,10006,-7334
ZCTA5 37146,2866,1449,1417,7554,40.3,6704,101,437,0.057850146,3676,3878
ZCTA5 37148,8820,255,8565,24880,36.1,23015,65,569,0.022869775,558,24322
ZCTA5 37149,920,2067,-1147,2103,50.4,2026,0,74,0.035187827,6181,-4078
ZCTA5 37150,1693,971,722,4572,38.8,3945,0,98,0.021434821,2412,2160
ZCTA5 37151,238,107,131,434,58.1,346,0,37,0.085253456,245,189
ZCTA5 37153,1845,9122,-7277,5349,41.8,5226,26,26,0.004860722,25989,-20640
ZCTA5 37160,12616,9,12607,35264,37.7,28321,0,2910,0.082520417,37,35227
ZCTA5 37165,26,1080,-1054,60,28.8,59,0,0,0,2601,-2541
ZCTA5 37166,5676,1414,4262,14108,43.2,12591,69,235,0.016657216,3807,10301
ZCTA5 37167,21585,5252,16333,60408,35.3,42812,3121,9255,0.153208184,12582,47826
ZCTA5 37171,358,8803,-8445,1353,42.7,1353,0,0,0,21523,-20170
ZCTA5 37172,11514,1510,10004,31161,39.4,23021,179,4023,0.129103687,4175,26986
ZCTA5 37174,16722,3286,13436,46204,36,40307,642,2353,0.050926327,8056,38148
ZCTA5 37175,341,9440,-9099,694,54.8,663,0,0,0,21797,-21103
ZCTA5 37178,835,2720,-1885,1986,47.8,1913,0,6,0.003021148,6538,-4552
ZCTA5 37179,5088,8161,-3073,16192,37.1,14760,78,139,0.008584486,20373,-4181
ZCTA5 37180,1454,677,777,4295,40.8,4194,0,61,0.014202561,1577,2718
ZCTA5 37181,678,2220,-1542,1679,53.1,1578,0,1,0.000595593,5031,-3352
ZCTA5 37183,1311,1830,-519,3146,51.3,2903,62,105,0.033375715,4973,-1827
ZCTA5 37184,2638,3442,-804,6943,42.7,6243,118,301,0.043353017,8742,-1799
ZCTA5 37185,3392,683,2709,8846,46.2,7972,141,196,0.022156907,1661,7185
ZCTA5 37186,3651,1749,1902,10718,37.4,10174,11,51,0.00475835,4508,6210
ZCTA5 37187,2962,5338,-2376,7746,38.6,7208,0,60,0.007745933,13650,-5904
ZCTA5 37188,6288,11470,-5182,16351,36.9,14611,174,411,0.025136077,29337,-12986
ZCTA5 37189,1655,3010,-1355,4412,42,2141,6,2193,0.49705349,8022,-3610
ZCTA5 37190,3416,206,3210,8702,38.3,8342,0,163,0.018731326,587,8115
ZCTA5 37191,1525,4267,-2742,4255,43.3,3765,32,134,0.031492362,10654,-6399
ZCTA5 37201,857,1772,-915,1477,36.8,1103,106,155,0.104942451,4053,-2576
ZCTA5 37203,10819,910,9909,18100,31.5,11059,1429,4581,0.253093923,2316,15784
ZCTA5 37204,6632,1337,5295,17047,29.2,13786,514,2038,0.119551827,3043,14004
ZCTA5 37205,11588,2062,9526,25437,48.1,22763,391,1419,0.05578488,4819,20618
ZCTA5 37206,12176,1707,10469,28694,33.2,17999,328,8624,0.300550638,4558,24136
ZCTA5 37207,15745,1850,13895,40697,35.2,11533,401,24760,0.608398653,7517,33180
ZCTA5 37208,8114,1054,7060,19546,30.4,6504,200,12050,0.616494423,2657,16889
ZCTA5 37209,17410,2640,14770,37363,31.9,25406,1904,7460,0.199662768,6825,30538
ZCTA5 37210,7154,1301,5853,16593,30.6,8753,906,5535,0.333574399,3051,13542
ZCTA5 37211,29394,818,28576,75073,33,47639,4477,12853,0.171206692,1987,73086
ZCTA5 37212,6896,1132,5764,20917,25.4,15682,1815,2518,0.120380552,1752,19165
ZCTA5 37213,24,6741,-6717,45,39.1,13,11,12,0.266666667,15924,-15879
ZCTA5 37214,14203,10496,3707,31341,37.8,21609,980,6603,0.210682493,19178,12163
ZCTA5 37215,10345,8584,1761,22829,44.5,19800,1355,367,0.016076044,20307,2522
ZCTA5 37216,8572,3198,5374,19227,34.7,13434,764,4072,0.21178551,5982,13245
ZCTA5 37217,12416,3118,9298,31096,34.1,17185,319,10821,0.347986879,12647,18449
ZCTA5 37218,5877,12747,-6870,15056,41.3,3243,126,10615,0.705034538,24466,-9410
ZCTA5 37219,991,17802,-16811,1411,31.1,1342,35,0,0,43240,-41829
ZCTA5 37220,2456,12948,-10492,6481,41.6,6147,26,183,0.028236383,28927,-22446
ZCTA5 37221,18388,17070,1318,42232,40.3,35124,1440,3314,0.078471301,37359,4873
ZCTA5 37228,1249,12484,-11235,1650,29.6,691,26,714,0.432727273,27838,-26188
ZCTA5 37232,0,11912,-11912,0,-,0,0,0,#DIV/0!,33871,-33871
ZCTA5 37238,0,12228,-12228,0,-,0,0,0,#DIV/0!,27731,-27731
ZCTA5 37301,376,4922,-4546,976,40.6,870,3,11,0.011270492,10597,-9621
ZCTA5 37302,1885,10147,-8262,5070,44.9,4363,225,175,0.034516765,25646,-20576
ZCTA5 37303,9900,5207,4693,24621,41.2,21969,176,1281,0.052028756,14272,10349
ZCTA5 37305,385,8780,-8395,1037,45.7,677,0,0,0,24597,-23560
ZCTA5 37306,892,6610,-5718,2227,49.9,1919,15,172,0.077233947,18005,-15778
ZCTA5 37307,1882,1701,181,5065,44.6,4554,2,60,0.011846002,4214,851
ZCTA5 37308,1010,12548,-11538,2431,46.2,2338,0,28,0.011517894,37458,-35027
ZCTA5 37309,853,3502,-2649,2201,46.6,2164,4,2,0.000908678,10125,-7924
ZCTA5 37310,1430,1970,-540,3338,46.5,3141,0,131,0.039245057,5786,-2448
ZCTA5 37311,11117,26,11091,30148,33.5,24577,190,2886,0.095727743,94,30054
ZCTA5 37312,13706,3254,10452,36102,40.6,31066,1031,1728,0.047864384,9121,26981
ZCTA5 37313,522,3244,-2722,1222,53.8,1189,0,0,0,9239,-8017
ZCTA5 37315,0,5642,-5642,1761,19.9,1092,235,161,0.091425327,14308,-12547
ZCTA5 37316,0,1034,-1034,0,-,0,0,0,#DIV/0!,2963,-2963
ZCTA5 37317,1217,17040,-15823,2729,47.9,2539,2,9,0.003297911,43137,-40408
ZCTA5 37318,714,15612,-14898,1836,36.8,1593,1,144,0.078431373,47262,-45426
ZCTA5 37321,7634,13346,-5712,20498,37.1,18232,187,434,0.021172797,34728,-14230
ZCTA5 37322,3304,5984,-2680,8359,45.6,7764,0,200,0.023926307,16078,-7719
ZCTA5 37323,12005,84,11921,31127,42.9,28798,33,517,0.016609374,191,30936
ZCTA5 37324,2255,2118,137,5153,42.2,4490,46,476,0.092373375,6135,-982
ZCTA5 37325,730,11042,-10312,1693,45.6,1676,5,0,0,27729,-26036
ZCTA5 37326,245,2448,-2203,496,57.8,479,0,9,0.018145161,6899,-6403
ZCTA5 37327,4441,0,4441,11834,44.1,11278,0,67,0.005661653,0,11834
ZCTA5 37328,567,315,252,1285,44.7,1226,0,0,0,799,486
ZCTA5 37329,2561,1205,1356,6207,42.7,5937,19,2,0.000322217,3229,2978
ZCTA5 37330,2813,189,2624,6729,45.7,6234,20,152,0.022588795,502,6227
ZCTA5 37331,2807,729,2078,6901,46.3,6027,0,469,0.067961165,2101,4800
ZCTA5 37332,952,551,401,2241,41.6,2094,0,31,0.01383311,1719,522
ZCTA5 37333,231,2139,-1908,513,50.1,513,0,0,0,5496,-4983
ZCTA5 37334,9380,1132,8248,24144,40.8,20446,163,2150,0.089049039,4979,19165
ZCTA5 37335,1071,306,765,2617,48.3,2590,15,0,0,762,1855
ZCTA5 37336,1883,286,1597,5220,44.5,4806,9,214,0.040996169,719,4501
ZCTA5 37337,402,26,376,742,58.1,737,0,0,0,47,695
ZCTA5 37338,1077,73,1004,2941,45.7,2664,0,71,0.024141448,313,2628
ZCTA5 37339,540,1696,-1156,1682,34.8,1570,0,6,0.003567182,4758,-3076
ZCTA5 37340,207,198,9,514,54.8,496,18,0,0,512,2
ZCTA5 37341,5216,1548,3668,13116,44.4,10729,62,1343,0.102394023,4366,8750
ZCTA5 37342,1460,10320,-8860,3955,40,3770,12,5,0.001264223,28871,-24916
ZCTA5 37343,16815,20,16795,41540,43.8,35381,1507,2268,0.054597978,238,41302
ZCTA5 37345,969,1273,-304,2583,41.5,2332,7,97,0.037553233,3545,-962
ZCTA5 37347,3464,3222,242,8235,38,7179,12,420,0.051001821,8904,-669
ZCTA5 37348,312,2661,-2349,692,46.8,692,0,0,0,7247,-6555
ZCTA5 37350,770,3698,-2928,2070,49.2,1994,13,24,0.011594203,9459,-7389
ZCTA5 37351,150,387,-237,290,37.8,206,0,35,0.120689655,687,-397
ZCTA5 37352,1211,6470,-5259,3155,44,2884,147,94,0.029793978,16683,-13528
ZCTA5 37353,2033,984,1049,5034,48.8,4748,0,69,0.013706794,2532,2502
ZCTA5 37354,6959,554,6405,17363,42.4,16233,0,297,0.017105339,1499,15864
ZCTA5 37355,10981,4119,6862,28492,37.2,25757,288,1056,0.037063035,10951,17541
ZCTA5 37356,1040,848,192,2814,51.7,2659,71,22,0.007818053,2393,421
ZCTA5 37357,2011,32,1979,5619,34.5,4708,5,408,0.072610785,46,5573
ZCTA5 37359,436,1388,-952,1090,50.9,918,0,66,0.060550459,7060,-5970
ZCTA5 37360,714,370,344,1923,49.1,1673,2,7,0.003640146,1241,682
ZCTA5 37361,760,16,744,1708,56.8,1579,10,0,0,16,1692
ZCTA5 37362,1351,1423,-72,3447,43.1,3325,0,0,0,5473,-2026
ZCTA5 37363,14878,1038,13840,39400,42.5,33560,401,3313,0.084086294,2558,36842
ZCTA5 37365,536,6163,-5627,1835,38.2,1685,0,0,0,12168,-10333
ZCTA5 37366,425,12090,-11665,974,43.9,917,0,3,0.003080082,23031,-22057
ZCTA5 37367,3907,2807,1100,11868,42,10250,29,1115,0.093950118,6445,5423
ZCTA5 37369,178,9463,-9285,486,52.4,336,0,74,0.152263374,25065,-24579
ZCTA5 37370,2124,6589,-4465,5551,41.3,5259,147,47,0.008466943,16739,-11188
ZCTA5 37373,1119,6544,-5425,3168,48,3001,0,16,0.005050505,19630,-16462
ZCTA5 37374,666,16407,-15741,1781,39.9,1735,0,0,0,48322,-46541
ZCTA5 37375,1053,16713,-15660,3853,28.7,3451,69,102,0.026472878,43199,-39346
ZCTA5 37376,216,6572,-6356,361,48.3,347,0,0,0,17531,-17170
ZCTA5 37377,6159,10311,-4152,16300,44.1,15504,99,104,0.006380368,28363,-12063
ZCTA5 37379,10781,15749,-4968,27698,45.3,26967,12,255,0.009206441,39084,-11386
ZCTA5 37380,2444,13991,-11547,6266,40.5,5587,92,400,0.063836578,40468,-34202
ZCTA5 37381,3959,11443,-7484,9856,47.5,9611,0,65,0.006594968,26622,-16766
ZCTA5 37383,0,13867,-13867,315,21,276,4,11,0.034920635,43021,-42706
ZCTA5 37385,3070,9476,-6406,8599,43.3,7950,48,0,0,23361,-14762
ZCTA5 37387,1453,6068,-4615,3914,42.6,3537,0,0,0,14003,-10089
ZCTA5 37388,10692,9172,1520,26426,42,23651,334,1203,0.045523348,23838,2588
ZCTA5 37391,636,13446,-12810,1756,39.8,1645,0,0,0,37414,-35658
ZCTA5 37394,51,2316,-2265,99,70.4,81,0,14,0.141414141,6881,-6782
ZCTA5 37396,110,15013,-14903,252,68.3,252,0,0,0,46994,-46742
ZCTA5 37397,4004,15188,-11184,9895,45.2,9625,4,106,0.010712481,43348,-33453
ZCTA5 37398,6150,0,6150,15530,40.7,13657,61,870,0.056020605,0,15530
ZCTA5 37402,2421,0,2421,4293,36.5,1619,52,2408,0.560913114,0,4293
ZCTA5 37403,1801,7546,-5745,7452,20.7,5810,149,1172,0.157273215,21646,-14194
ZCTA5 37404,5123,14744,-9621,13152,35.2,6130,70,5589,0.42495438,43406,-30254
ZCTA5 37405,8857,10281,-1424,18788,35.1,15747,694,854,0.045454545,29058,-10270
ZCTA5 37406,5480,9423,-3943,13243,36.1,2592,57,9989,0.754285283,23329,-10086
ZCTA5 37407,3168,5411,-2243,10169,29.8,4735,0,3290,0.323532304,16752,-6583
ZCTA5 37408,1054,7886,-6832,2121,33.9,1393,26,597,0.281471004,22750,-20629
ZCTA5 37409,1535,0,1535,3399,36.9,2514,168,322,0.094733745,619,2780
ZCTA5 37410,1494,3892,-2398,3346,35.1,314,0,2723,0.813807531,10015,-6669
ZCTA5 37411,7682,780,6902,18379,39.3,7674,120,9292,0.505577017,1736,16643
ZCTA5 37412,9774,1462,8312,21937,41.1,17359,195,2653,0.120937229,3311,18626
ZCTA5 37415,10712,1086,9626,22706,38.1,19614,283,1726,0.07601515,2520,20186
ZCTA5 37416,6142,326,5816,14742,38.1,7221,299,6911,0.468796635,953,13789
ZCTA5 37419,2600,2348,252,6152,43.9,5301,255,351,0.057054616,6248,-96
ZCTA5 37421,21863,88,21775,53653,40.3,35461,2385,11794,0.219819954,211,53442
ZCTA5 37450,0,1206,-1206,0,-,0,0,0,#DIV/0!,2942,-2942
ZCTA5 37601,16115,1545,14570,36707,37.8,31776,705,2130,0.058027079,3623,33084
ZCTA5 37604,16739,739,16000,37150,37.7,31483,705,2742,0.073808883,2253,34897
ZCTA5 37614,0,850,-850,2666,19.8,2067,120,419,0.157164291,2062,604
ZCTA5 37615,9211,1083,8128,21992,43.8,20668,230,202,0.009185158,2878,19114
ZCTA5 37616,1982,87,1895,4860,46.1,4621,154,4,0.000823045,195,4665
ZCTA5 37617,5549,237,5312,14615,46.4,14199,27,108,0.007389668,548,14067
ZCTA5 37618,5231,6525,-1294,13073,44.1,12472,9,93,0.007113899,16345,-3272
ZCTA5 37620,16327,898,15429,38335,43.5,35308,121,912,0.02379027,2220,36115
ZCTA5 37640,1518,444,1074,3281,53.2,3217,11,0,0,963,2318
ZCTA5 37641,4014,8268,-4254,9710,45.3,9385,0,38,0.003913491,19952,-10242
ZCTA5 37642,6194,1145,5049,14873,44.8,14225,119,119,0.008001076,2941,11932
ZCTA5 37643,13970,535,13435,33713,45.6,32134,152,546,0.016195533,1442,32271
ZCTA5 37645,2251,13,2238,5460,44.2,5318,0,37,0.006776557,36,5424
ZCTA5 37650,5393,934,4459,12937,44.6,12310,0,28,0.002164335,2452,10485
ZCTA5 37656,1484,1375,109,3420,53.4,3351,0,0,0,2728,692
ZCTA5 37657,349,1795,-1446,887,42.7,827,0,0,0,4354,-3467
ZCTA5 37658,1550,637,913,3894,48.2,3832,3,3,0.000770416,1580,2314
ZCTA5 37659,11463,388,11075,28109,45.4,26553,429,295,0.010494859,945,27164
ZCTA5 37660,17343,1431,15912,38778,44.9,35073,282,1565,0.040357935,3824,34954
ZCTA5 37663,6070,6552,-482,13958,48.3,13668,76,32,0.002292592,16661,-2703
ZCTA5 37664,12553,13361,-808,28543,45.9,26933,301,447,0.015660582,36045,-7502
ZCTA5 37665,2180,18212,-16032,4990,43.3,4866,6,67,0.013426854,49537,-44547
ZCTA5 37680,197,2482,-2285,378,48.6,378,0,0,0,6477,-6099
ZCTA5 37681,2495,436,2059,6071,49.3,5867,9,49,0.008071158,1048,5023
ZCTA5 37682,31,1144,-1113,579,20.3,454,11,6,0.010362694,3082,-2503
ZCTA5 37683,4969,1353,3616,13943,45.2,12658,31,703,0.050419565,3688,10255
ZCTA5 37686,3148,1223,1925,8667,44.8,8119,336,25,0.002884504,3152,5515
ZCTA5 37687,1777,927,850,4528,47.2,4455,0,47,0.010379859,2635,1893
ZCTA5 37688,485,152,333,932,60.3,897,0,0,0,267,665
ZCTA5 37690,1966,4505,-2539,5173,44.1,4934,0,44,0.008505703,10617,-5444
ZCTA5 37691,221,969,-748,554,40.5,515,0,0,0,2271,-1717
ZCTA5 37692,2124,1015,1109,5077,50.1,4851,17,39,0.007681702,2230,2847
ZCTA5 37694,888,183,705,2075,46.8,1961,0,29,0.013975904,451,1624
ZCTA5 37701,3398,264,3134,8393,37.3,6952,145,873,0.104015251,721,7672
ZCTA5 37705,1733,1448,285,5099,35.9,4651,0,0,0,3441,1658
ZCTA5 37708,2633,1716,917,6497,47.1,6285,0,63,0.009696783,4577,1920
ZCTA5 37709,1479,524,955,3943,40.7,3828,0,0,0,1586,2357
ZCTA5 37710,421,229,192,1128,48.3,1128,0,0,0,402,726
ZCTA5 37711,2053,647,1406,5300,47.3,5226,0,0,0,1734,3566
ZCTA5 37713,533,529,4,1410,46.4,1397,0,0,0,1327,83
ZCTA5 37714,1648,224,1424,4326,47.7,4225,0,0,0,570,3756
ZCTA5 37715,331,4707,-4376,830,55.4,827,0,0,0,13926,-13096
ZCTA5 37716,10468,1028,9440,26441,46,24850,112,387,0.01463636,2416,24025
ZCTA5 37719,23,498,-475,62,28.9,62,0,0,0,1379,-1317
ZCTA5 37721,5595,6607,-1012,14163,41.4,13807,0,107,0.007554897,15732,-1569
ZCTA5 37722,2645,3176,-531,6864,46.8,6732,0,0,0,8879,-2015
ZCTA5 37723,563,786,-223,1154,46.5,1117,0,0,0,1880,-726
ZCTA5 37724,1189,89,1100,2465,39.6,2328,95,15,0.006085193,146,2319
ZCTA5 37725,6442,415,6027,18055,47.3,17015,170,280,0.015508169,1081,16974
ZCTA5 37726,654,7306,-6652,1901,38.4,1866,0,6,0.003156234,18569,-16668
ZCTA5 37727,859,125,734,2234,44.3,2206,0,0,0,322,1912
ZCTA5 37729,553,1943,-1390,1675,44.6,1670,0,0,0,5544,-3869
ZCTA5 37730,20,955,-935,45,49.2,45,0,0,0,2619,-2574
ZCTA5 37731,226,1247,-1021,619,42.7,619,0,0,0,2964,-2345
ZCTA5 37732,17,4492,-4475,38,-,38,0,0,0,11676,-11638
ZCTA5 37733,0,155,-155,0,-,0,0,0,#DIV/0!,355,-355
ZCTA5 37737,2547,297,2250,6240,48,5713,12,35,0.005608974,835,5405
ZCTA5 37738,1910,380,1530,5002,44.1,4141,182,265,0.052978808,1021,3981
ZCTA5 37742,2391,2468,-77,6289,38.4,6122,23,31,0.004929242,5752,537
ZCTA5 37743,9727,0,9727,24890,46.1,23347,78,528,0.021213339,0,24890
ZCTA5 37745,7390,738,6652,19305,42.7,17450,162,659,0.034136234,2367,16938
ZCTA5 37748,7014,1073,5941,16300,47.1,14976,29,817,0.050122699,2857,13443
ZCTA5 37752,2384,613,1771,6049,40.8,5758,75,65,0.010745578,1414,4635
ZCTA5 37753,372,653,-281,1047,49.5,1042,0,2,0.00191022,1885,-838
ZCTA5 37754,1432,326,1106,3546,49.7,3392,0,36,0.010152284,637,2909
ZCTA5 37755,1144,478,666,2913,38.7,2771,96,41,0.014074837,1252,1661
ZCTA5 37756,1286,6846,-5560,3102,42.3,3026,8,22,0.007092199,17754,-14652
ZCTA5 37757,4033,782,3251,9880,40.4,9619,142,20,0.002024291,1640,8240
ZCTA5 37760,4823,3523,1300,13839,38.7,12818,88,393,0.028398006,9191,4648
ZCTA5 37762,1098,71,1027,2581,49.1,2399,0,52,0.02014723,161,2420
ZCTA5 37763,6645,436,6209,16165,49.3,15040,106,503,0.03111661,1039,15126
ZCTA5 37764,3763,295,3468,10051,45.2,9775,0,0,0,647,9404
ZCTA5 37765,253,575,-322,703,47.5,703,0,0,0,1397,-694
ZCTA5 37766,7144,3698,3446,17534,44.4,16747,26,39,0.00222425,9410,8124
ZCTA5 37769,2254,212,2042,5561,44.2,5414,0,35,0.006293832,523,5038
ZCTA5 37770,1263,785,478,2801,40,2756,0,0,0,1941,860
ZCTA5 37771,6818,318,6500,17837,40,15888,15,266,0.014912822,905,16932
ZCTA5 37772,5308,514,4794,13287,47.8,12227,235,133,0.010009784,1300,11987
ZCTA5 37774,8300,264,8036,18914,57.6,17719,221,210,0.011102887,634,18280
ZCTA5 37777,5227,21335,-16108,13113,41.3,11446,58,614,0.046823763,54028,-40915
ZCTA5 37779,1331,596,735,3505,43.6,3375,5,0,0,3483,22
ZCTA5 37801,11147,1177,9970,27724,44.1,25922,252,547,0.019730198,3159,24565
ZCTA5 37803,13025,1077,11948,32701,47,30989,54,286,0.00874591,2828,29873
ZCTA5 37804,9669,1999,7670,26934,39.8,24498,382,684,0.025395411,5148,21786
ZCTA5 37806,1279,513,766,3156,46.1,2910,0,100,0.031685678,1320,1836
ZCTA5 37807,4090,149,3941,11338,41.1,10975,3,115,0.010142882,430,10908
ZCTA5 37809,831,486,345,2179,48,2153,0,26,0.011932079,1489,690
ZCTA5 37810,614,53,561,1906,36.4,1809,0,0,0,124,1782
ZCTA5 37811,1723,1286,437,4203,48.9,4136,13,31,0.007375684,3905,298
ZCTA5 37813,6614,224,6390,17458,40.3,14290,266,844,0.048344598,667,16791
ZCTA5 37814,13298,250,13048,34138,39.8,29636,289,1491,0.043675669,720,33418
ZCTA5 37818,2156,590,1566,5378,50.7,5254,0,27,0.005020454,1478,3900
ZCTA5 37819,241,549,-308,648,35.2,620,0,0,0,1543,-895
ZCTA5 37820,2804,4068,-1264,7213,45.1,6860,25,97,0.013447941,10435,-3222
ZCTA5 37821,8641,1077,7564,21710,44.1,20133,186,514,0.023675725,2520,19190
ZCTA5 37825,3831,9161,-5330,8850,40.4,8289,11,162,0.018305085,23046,-14196
ZCTA5 37826,1851,2051,-200,4394,50.8,3979,103,138,0.031406463,5068,-674
ZCTA5 37828,778,1559,-781,1489,60.1,1439,6,6,0.00402955,3887,-2398
ZCTA5 37829,630,224,406,1899,43.1,1775,0,0,0,595,1304
ZCTA5 37830,13056,1028,12028,31633,39.7,25659,897,1985,0.062750925,2672,28961
ZCTA5 37840,3943,350,3593,10457,42.7,10202,22,0,0,950,9507
ZCTA5 37841,3707,3171,536,9601,38.8,9321,0,16,0.001666493,8047,1554
ZCTA5 37843,1813,241,1572,4265,45.5,3963,0,195,0.045720985,681,3584
ZCTA5 37845,112,532,-420,374,50.5,374,0,0,0,1254,-880
ZCTA5 37846,1489,1087,402,4154,44.1,3677,0,209,0.050312951,2718,1436
ZCTA5 37847,1030,7261,-6231,2893,40.1,2880,10,0,0,17996,-15103
ZCTA5 37848,47,400,-353,79,51.4,74,0,0,0,960,-881
ZCTA5 37849,10828,621,10207,28971,38.3,27189,61,549,0.018949984,1355,27616
ZCTA5 37851,0,1869,-1869,0,-,0,0,0,#DIV/0!,5344,-5344
ZCTA5 37852,1171,2696,-1525,3084,39.2,3055,0,0,0,6576,-3492
ZCTA5 37853,1386,306,1080,3347,45.6,3054,12,113,0.033761578,892,2455
ZCTA5 37854,4741,230,4511,12290,48.4,11559,263,88,0.007160293,521,11769
ZCTA5 37857,7685,904,6781,20383,45.3,19275,63,394,0.019329834,2317,18066
ZCTA5 37860,1556,15380,-13824,3964,43.3,3748,0,0,0,37080,-33116
ZCTA5 37861,3431,394,3037,8196,45.4,8020,7,7,0.000854075,1194,7002
ZCTA5 37862,8787,0,8787,23016,42.9,20542,487,202,0.008776503,1648,21368
ZCTA5 37863,2379,10089,-7710,6516,45.3,5816,116,9,0.001381215,25920,-19404
ZCTA5 37865,8987,709,8278,24701,39.7,23617,103,222,0.00898749,1715,22986
ZCTA5 37866,661,10,651,1632,47,1597,0,0,0,28,1604
ZCTA5 37869,1929,235,1694,4557,40.1,4469,31,24,0.005266623,544,4013
ZCTA5 37870,1857,2703,-846,4175,49.8,4055,0,0,0,7306,-3131
ZCTA5 37871,3506,476,3030,9101,42.9,8638,13,133,0.014613779,1334,7767
ZCTA5 37872,648,615,33,1978,43.3,1949,0,0,0,1619,359
ZCTA5 37873,1738,226,1512,4285,46.1,4161,13,22,0.005134189,686,3599
ZCTA5 37874,6338,1811,4527,15490,39.5,13580,82,565,0.036475145,3813,11677
ZCTA5 37876,12376,1688,10688,32305,45.9,30021,212,416,0.012877264,3923,28382
ZCTA5 37877,3403,167,3236,8922,45.8,8670,43,171,0.019166106,599,8323
ZCTA5 37878,173,992,-819,404,54.2,383,0,0,0,2507,-2103
ZCTA5 37879,4784,412,4372,11509,41.5,11131,102,22,0.001911547,902,10607
ZCTA5 37880,1546,7879,-6333,3927,50.1,3475,18,90,0.022918258,19436,-15509
ZCTA5 37881,779,5039,-4260,1871,47,1824,0,0,0,12049,-10178
ZCTA5 37882,1306,3710,-2404,2848,61,2808,14,23,0.008075843,7249,-4401
ZCTA5 37885,2591,438,2153,5958,53.8,5705,35,143,0.024001343,1430,4528
ZCTA5 37886,1529,534,995,4678,35.5,4542,27,0,0,1371,3307
ZCTA5 37887,1900,2619,-719,7224,39.3,5829,37,1159,0.160437431,6570,654
ZCTA5 37888,1297,970,327,3428,52,3364,15,0,0,2337,1091
ZCTA5 37890,3058,160,2898,7708,45,7043,5,12,0.001556824,334,7374
ZCTA5 37891,1402,462,940,3597,42.9,3571,0,0,0,1052,2545
ZCTA5 37892,834,340,494,2067,41.5,2011,0,11,0.005321722,887,1180
ZCTA5 37902,1534,853,681,2371,35.4,2058,65,163,0.068747364,2107,264
ZCTA5 37909,7560,155,7405,16192,34.5,13923,443,857,0.052927372,476,15716
ZCTA5 37912,9766,4009,5757,21729,35.4,15890,163,3638,0.167426021,10086,11643
ZCTA5 37914,8737,5297,3440,20482,41.9,11361,121,7891,0.385265111,13496,6986
ZCTA5 37915,2739,4039,-1300,5200,32.6,2172,0,2916,0.560769231,10121,-4921
ZCTA5 37916,2992,990,2002,13967,20.7,11749,523,872,0.062432877,2295,11672
ZCTA5 37917,12255,3214,9041,25671,40,19664,336,3396,0.132289354,8166,17505
ZCTA5 37918,18524,501,18023,46160,38.9,40234,547,3022,0.065467938,1324,44836
ZCTA5 37919,13356,439,12917,29796,39.2,26173,1032,1453,0.048764935,905,28891
ZCTA5 37920,17461,52,17409,41826,36.7,36413,461,2680,0.064074977,114,41712
ZCTA5 37921,10972,392,10580,28397,34.2,20132,218,5598,0.1971335,1011,27386
ZCTA5 37922,14245,744,13501,39158,40.2,34023,2083,1422,0.036314419,1744,37414
ZCTA5 37923,13054,1604,11450,31893,34.7,26502,933,2436,0.076380397,4243,27650
ZCTA5 37924,5234,602,4632,13354,37.9,11424,722,1020,0.076381609,1403,11951
ZCTA5 37929,0,9148,-9148,0,-,0,0,0,#DIV/0!,24010,-24010
ZCTA5 37931,11904,1461,10443,29749,38.4,26209,616,1296,0.04356449,4113,25636
ZCTA5 37932,7405,492,6913,19661,38,17131,900,357,0.018157774,1156,18505
ZCTA5 37934,10570,319,10251,27423,46.2,24742,1429,242,0.008824709,700,26723
ZCTA5 37938,6660,90,6570,17021,45.7,16104,216,235,0.013806474,238,16783
ZCTA5 38001,1696,850,846,4384,35.8,3293,20,439,0.100136861,2808,1576
ZCTA5 38002,14555,1165,13390,43098,39.4,31900,998,8531,0.19794422,2934,40164
ZCTA5 38004,4047,5332,-1285,11282,36.7,9709,64,1132,0.10033682,15562,-4280
ZCTA5 38006,1893,1196,697,5259,38.2,4051,5,749,0.142422514,3326,1933
ZCTA5 38007,6,6092,-6086,13,-,13,0,0,0,16299,-16286
ZCTA5 38008,3652,7086,-3434,8427,44,3210,16,4789,0.568292393,19997,-11570
ZCTA5 38011,3338,283,3055,9666,36.9,8134,66,1075,0.111214567,892,8774
ZCTA5 38012,5234,4102,1132,13185,42.6,5139,29,7356,0.557906712,11309,1876
ZCTA5 38015,892,1594,-702,2248,48.3,1953,3,201,0.089412811,5223,-2975
ZCTA5 38016,18536,1441,17095,45170,38.4,15471,2377,24393,0.540026566,4012,41158
ZCTA5 38017,19699,597,19102,55161,41.6,41318,5692,5602,0.10155726,1847,53314
ZCTA5 38018,14134,257,13877,38789,35.9,16615,2175,18232,0.470030163,527,38262
ZCTA5 38019,5881,114,5767,15408,37.7,9365,6,5429,0.352349429,267,15141
ZCTA5 38021,5,426,-421,12,-,12,0,0,0,1223,-1211
ZCTA5 38023,1918,495,1423,5618,38.8,4731,106,483,0.085973656,1251,4367
ZCTA5 38024,10532,414,10118,26306,41.1,20299,150,4275,0.162510454,1129,25177
ZCTA5 38028,2876,940,1936,7782,41.9,5656,53,1676,0.2153688,2610,5172
ZCTA5 38029,15,112,-97,29,-,29,0,0,0,229,-200
ZCTA5 38030,139,395,-256,394,30.9,394,0,0,0,958,-564
ZCTA5 38034,1328,8646,-7318,3297,43.6,2687,14,301,0.091295117,24714,-21417
ZCTA5 38036,70,888,-818,246,70.4,140,0,101,0.410569106,2612,-2366
ZCTA5 38037,521,5644,-5123,1203,43,804,0,370,0.307564422,17194,-15991
ZCTA5 38039,605,8834,-8229,1658,41.9,312,0,1322,0.7973462,26120,-24462
ZCTA5 38040,2095,357,1738,4762,40.5,4026,0,546,0.114657707,1255,3507
ZCTA5 38041,1038,843,195,4718,37.2,2700,48,1796,0.380669775,2460,2258
ZCTA5 38042,303,704,-401,581,53.6,452,5,117,0.201376936,1890,-1309
ZCTA5 38044,231,1010,-779,532,42.3,515,0,15,0.028195489,2565,-2033
ZCTA5 38046,5,73,-68,8,58,8,0,0,0,286,-278
ZCTA5 38047,60,670,-610,252,38.8,252,0,0,0,1931,-1679
ZCTA5 38049,1458,1222,236,4091,42.7,1792,37,2042,0.499144463,3180,911
ZCTA5 38050,255,482,-227,508,50.3,222,0,251,0.494094488,1355,-847
ZCTA5 38052,1633,1582,51,3855,41.2,3419,164,249,0.06459144,4375,-520
ZCTA5 38053,9687,2563,7124,26135,39.6,17596,360,6109,0.233747848,7081,19054
ZCTA5 38054,0,5887,-5887,200,23.8,96,26,22,0.11,15407,-15207
ZCTA5 38057,1383,16759,-15376,3392,52.2,2160,0,1189,0.35053066,46582,-43190
ZCTA5 38058,3778,13127,-9349,10537,40.3,8875,162,1017,0.096517035,36109,-25572
ZCTA5 38059,3016,801,2215,7910,36.5,6621,38,458,0.057901391,1581,6329
ZCTA5 38060,4183,989,3194,10752,42.5,8294,55,2259,0.210100446,2751,8001
ZCTA5 38061,432,573,-141,1240,43,1054,0,186,0.15,1556,-316
ZCTA5 38063,6036,4520,1516,16096,38.2,9247,44,6080,0.377733598,11438,4658
ZCTA5 38066,1219,1384,-165,2925,54.2,1836,40,962,0.328888889,3583,-658
ZCTA5 38067,711,861,-150,1508,59.2,1263,0,175,0.116047745,2515,-1007
ZCTA5 38068,4043,2709,1334,11407,38.7,6779,13,4045,0.35460682,7690,3717
ZCTA5 38069,1147,5074,-3927,2841,53.4,1170,0,1538,0.541358677,15053,-12212
ZCTA5 38070,70,413,-343,79,64.4,15,0,64,0.810126582,1272,-1193
ZCTA5 38075,1551,13733,-12182,7376,37.5,3800,17,3270,0.443329718,36312,-28936
ZCTA5 38076,355,3582,-3227,938,39.9,571,0,306,0.326226013,10700,-9762
ZCTA5 38077,21,195,-174,37,-,37,0,0,0,678,-641
ZCTA5 38079,1242,422,820,4859,41.8,3083,17,1464,0.301296563,1087,3772
ZCTA5 38080,964,2332,-1368,2600,38.4,2013,0,399,0.153461538,6022,-3422
ZCTA5 38103,7594,8,7586,14243,33.9,8819,650,4068,0.285613986,4680,9563
ZCTA5 38104,12667,1903,10764,22900,36.9,14746,718,6058,0.264541485,5580,17320
ZCTA5 38105,3157,1998,1159,5437,42.3,845,124,4273,0.785911348,5344,93
ZCTA5 38106,9414,438,8976,23745,41.8,753,9,22794,0.959949463,1316,22429
ZCTA5 38107,6481,8784,-2303,15071,36.6,2923,118,11340,0.752438458,23728,-8657
ZCTA5 38108,6634,0,6634,17300,37.1,4218,24,10898,0.629942197,0,17300
ZCTA5 38109,16268,4854,11414,44899,38.7,1127,0,43011,0.957950066,14058,30841
ZCTA5 38111,17364,14,17350,40947,33.6,16951,676,19762,0.48262388,25,40922
ZCTA5 38112,6639,202,6437,16437,34.5,5955,282,8604,0.523453185,668,15769
ZCTA5 38113,0,405,-405,0,-,0,0,0,#DIV/0!,1198,-1198
ZCTA5 38114,9791,226,9565,22580,39.7,981,25,21058,0.932595217,551,22029
ZCTA5 38115,16352,6,16346,37626,28.8,2650,180,31567,0.838967735,6,37620
ZCTA5 38116,15105,307,14798,40854,33.8,1977,10,38348,0.938659617,820,40034
ZCTA5 38117,11425,150,11275,26584,39.8,21699,588,3173,0.119357508,402,26182
ZCTA5 38118,12665,583,12082,38931,28.3,3422,544,30036,0.771518841,1682,37249
ZCTA5 38119,9996,102,9894,24027,40.1,11698,699,10081,0.419569651,230,23797
ZCTA5 38120,6237,6562,-325,14724,43.8,12367,1043,809,0.054944309,17896,-3172
ZCTA5 38122,8511,220,8291,22961,32.7,12485,652,3746,0.163146204,618,22343
ZCTA5 38125,14997,1015,13982,42717,33.9,5304,2357,32992,0.772338881,4096,38621
ZCTA5 38126,2421,77,2344,5660,28.3,350,21,5230,0.924028269,2881,2779
ZCTA5 38127,13935,140,13795,40820,31.3,4303,215,34497,0.845100441,347,40473
ZCTA5 38128,15599,269,15330,45087,29.8,5171,108,36965,0.819859383,837,44250
ZCTA5 38131,0,56,-56,0,-,0,0,0,#DIV/0!,172,-172
ZCTA5 38132,0,224,-224,81,31.4,72,0,9,0.111111111,742,-661
ZCTA5 38133,7764,1485,6279,21702,35.3,13122,1094,5946,0.273983965,4231,17471
ZCTA5 38134,14616,8,14608,43991,33.8,19832,847,19698,0.447773408,20,43971
ZCTA5 38135,10695,3714,6981,30438,40.7,17995,803,10723,0.352289901,11611,18827
ZCTA5 38138,10049,516,9533,25459,42.8,22355,1360,1130,0.04438509,1473,23986
ZCTA5 38139,5742,589,5153,16265,45.2,14608,1115,281,0.01727636,1751,14514
ZCTA5 38141,7861,2475,5386,23299,32.1,1974,0,19678,0.844585605,6854,16445
ZCTA5 38152,0,472,-472,880,19.6,493,0,377,0.428409091,1074,-194
ZCTA5 38201,3654,302,3352,10306,40.2,8923,129,911,0.08839511,872,9434
ZCTA5 38220,687,781,-94,1703,33,1304,0,134,0.078684674,2674,-971
ZCTA5 38221,1241,866,375,2982,54.3,2942,13,3,0.001006036,2561,421
ZCTA5 38222,772,164,608,2213,39.3,2009,0,22,0.009941256,370,1843
ZCTA5 38224,296,14,282,828,51.8,781,0,39,0.047101449,89,739
ZCTA5 38225,2236,29,2207,5428,42.7,5056,0,223,0.041083272,83,5345
ZCTA5 38226,154,58,96,279,61.8,278,0,0,0,171,108
ZCTA5 38229,1127,836,291,2766,41.3,2607,10,42,0.015184382,2439,327
ZCTA5 38230,1684,1027,657,3885,41.9,3541,71,170,0.043758044,3042,843
ZCTA5 38231,696,47,649,1715,46.4,1570,2,43,0.025072886,145,1570
ZCTA5 38232,828,1299,-471,2090,47.9,2022,9,5,0.002392344,3590,-1500
ZCTA5 38233,1066,919,147,2642,42.1,2224,1,193,0.073050719,2388,254
ZCTA5 38235,82,549,-467,182,52.2,124,0,43,0.236263736,1670,-1488
ZCTA5 38236,407,95,312,736,57,721,0,15,0.020380435,163,573
ZCTA5 38237,5773,11276,-5503,15091,32.7,12518,233,1818,0.120469154,29129,-14038
ZCTA5 38240,893,6836,-5943,2104,43.5,1871,5,69,0.032794677,17595,-15491
ZCTA5 38241,393,5049,-4656,1022,43.9,997,0,0,0,12418,-11396
ZCTA5 38242,7936,3497,4439,20177,43.7,17061,79,2139,0.106011796,8821,11356
ZCTA5 38251,1143,1687,-544,3149,42.4,2857,24,109,0.034614163,4745,-1596
ZCTA5 38253,361,972,-611,1027,38.7,867,0,29,0.028237585,2762,-1735
ZCTA5 38254,0,1860,-1860,0,-,0,0,0,#DIV/0!,4718,-4718
ZCTA5 38255,1100,6800,-5700,2550,47.7,2319,30,120,0.047058824,17890,-15340
ZCTA5 38256,1579,1167,412,3101,59.3,3017,21,24,0.007739439,3165,-64
ZCTA5 38257,1839,11333,-9494,4273,47.6,3744,49,279,0.065293705,29772,-25499
ZCTA5 38258,575,510,65,1485,37.7,1114,0,248,0.167003367,1363,122
ZCTA5 38259,282,759,-477,765,39.8,750,4,8,0.010457516,2000,-1235
ZCTA5 38260,1600,4353,-2753,3838,40.1,3730,0,41,0.010682647,11518,-7680
ZCTA5 38261,6554,73,6481,16190,41.3,12069,70,2872,0.177393453,173,16017
ZCTA5 38301,13533,952,12581,34420,36,14598,71,18053,0.524491575,2363,32057
ZCTA5 38305,20328,1304,19024,51864,37.1,31088,826,16410,0.316404442,3382,48482
ZCTA5 38310,2385,274,2111,6359,38.1,6089,0,191,0.030036169,894,5465
ZCTA5 38311,387,2117,-1730,740,57.5,703,0,37,0.05,5685,-4945
ZCTA5 38313,1344,1183,161,3714,41.7,3539,0,133,0.035810447,3067,647
ZCTA5 38315,1500,3235,-1735,4036,46,3555,0,251,0.062190287,8522,-4486
ZCTA5 38316,1071,3576,-2505,2874,46.4,2656,0,86,0.029923452,8802,-5928
ZCTA5 38317,1145,1767,-622,2560,48.3,2240,72,157,0.061328125,5062,-2502
ZCTA5 38318,168,690,-522,547,38.6,396,0,135,0.246800731,1846,-1299
ZCTA5 38320,4223,1146,3077,10661,43.5,9840,125,234,0.02194916,3220,7441
ZCTA5 38321,1090,2718,-1628,2611,44.7,2419,16,176,0.067407124,6986,-4375
ZCTA5 38326,1362,234,1128,2744,57.1,2715,0,0,0,618,2126
ZCTA5 38327,237,2160,-1923,515,54.4,509,0,6,0.011650485,5647,-5132
ZCTA5 38328,321,1103,-782,906,46.7,803,0,0,0,2871,-1965
ZCTA5 38329,1158,6813,-5655,3229,45,2929,0,116,0.035924435,20871,-17642
ZCTA5 38330,1452,511,941,4064,36.3,3113,7,612,0.150590551,1559,2505
ZCTA5 38332,517,1687,-1170,1201,55,1195,0,0,0,4223,-3022
ZCTA5 38333,97,4256,-4159,163,69.4,163,0,0,0,11878,-11715
ZCTA5 38334,671,1941,-1270,1774,44,1621,0,57,0.032130778,4937,-3163
ZCTA5 38337,482,129,353,1179,44.9,1001,4,127,0.107718405,276,903
ZCTA5 38338,25,1209,-1184,77,29.2,74,2,0,0,2941,-2864
ZCTA5 38339,247,672,-425,622,43.7,457,0,135,0.217041801,2080,-1458
ZCTA5 38340,4009,1028,2981,11756,35.4,9454,73,1763,0.149965975,2609,9147
ZCTA5 38341,1021,597,424,2234,50.5,2118,8,94,0.042076992,1476,758
ZCTA5 38342,577,1150,-573,1325,38.3,1197,0,67,0.050566038,3033,-1708
ZCTA5 38343,6550,299,6251,15739,44.2,11476,52,3690,0.234449457,671,15068
ZCTA5 38344,3399,7164,-3765,8738,41.1,7537,0,761,0.087090867,18627,-9889
ZCTA5 38345,628,176,452,1768,40,1724,0,0,0,422,1346
ZCTA5 38347,117,202,-85,448,40.8,448,0,0,0,505,-57
ZCTA5 38348,393,1634,-1241,876,47.7,760,0,99,0.113013699,3876,-3000
ZCTA5 38351,6929,1995,4934,17959,40.4,15291,22,1908,0.106241996,4787,13172
ZCTA5 38352,309,1111,-802,695,36,695,0,0,0,2851,-2156
ZCTA5 38355,2986,271,2715,7954,40.6,7133,85,433,0.054438019,598,7356
ZCTA5 38356,1200,1708,-508,3129,42.9,2416,0,336,0.10738255,4842,-1713
ZCTA5 38357,1106,1492,-386,3220,42.6,3068,0,67,0.020807453,3693,-473
ZCTA5 38358,4402,595,3807,12364,37,9523,19,2069,0.167340666,1713,10651
ZCTA5 38359,127,258,-131,286,46.3,274,0,12,0.041958042,784,-498
ZCTA5 38361,530,993,-463,1351,53.4,1262,4,41,0.03034789,2412,-1061
ZCTA5 38362,444,377,67,1069,41.4,590,17,306,0.286248831,1091,-22
ZCTA5 38363,2102,92,2010,5556,41.8,5178,6,139,0.025017999,286,5270
ZCTA5 38365,0,513,-513,0,-,0,0,0,#DIV/0!,1213,-1213
ZCTA5 38366,883,8844,-7961,2201,48.7,1981,1,138,0.062698773,26028,-23827
ZCTA5 38367,1079,650,429,2741,46.8,2550,0,165,0.060197008,1574,1167
ZCTA5 38368,714,1523,-809,1863,33.5,1771,0,0,0,4823,-2960
ZCTA5 38369,665,172,493,1640,43.3,1490,17,38,0.023170732,365,1275
ZCTA5 38370,414,158,256,960,48,829,0,105,0.109375,446,514
ZCTA5 38371,385,17,368,833,44.7,782,0,0,0,17,816
ZCTA5 38372,6678,159,6519,17347,41,16191,97,573,0.033031648,399,16948
ZCTA5 38374,825,246,579,1982,51.6,1934,0,4,0.002018163,570,1412
ZCTA5 38375,3238,740,2498,7927,44.2,6790,130,843,0.106345402,1883,6044
ZCTA5 38376,158,54,104,319,55.4,254,0,65,0.203761755,140,179
ZCTA5 38379,602,90,512,1708,42,1703,2,0,0,247,1461
ZCTA5 38380,188,530,-342,427,53.8,385,0,0,0,1491,-1064
ZCTA5 38381,612,223,389,1769,32.9,1126,0,623,0.352176371,767,1002
ZCTA5 38382,3478,377,3101,8548,43.6,6112,13,1472,0.172204024,1237,7311
ZCTA5 38387,183,534,-351,345,51.6,325,0,0,0,1171,-826
ZCTA5 38388,644,234,410,1881,31.9,1760,2,111,0.059011164,579,1302
ZCTA5 38389,17,12,5,50,59.7,45,0,0,0,30,20
ZCTA5 38390,443,309,134,1238,50.9,977,17,197,0.159127625,905,333
ZCTA5 38391,438,63,375,1107,50.3,405,0,660,0.596205962,77,1030
ZCTA5 38392,264,835,-571,766,40.9,647,0,119,0.15535248,5063,-4297
ZCTA5 38401,24948,64,24884,64681,38.8,52200,360,8328,0.128754967,269,64412
ZCTA5 38425,667,3263,-2596,3668,44.8,2844,0,620,0.169029444,8595,-4927
ZCTA5 38449,1182,350,832,2901,46.2,2673,17,127,0.043778008,996,1905
ZCTA5 38450,1106,2667,-1561,2613,41.5,2535,0,12,0.004592423,7519,-4906
ZCTA5 38451,1569,2147,-578,3866,42.1,3685,0,92,0.023797206,6702,-2836
ZCTA5 38452,389,749,-360,1187,43.9,1110,0,65,0.054759899,1993,-806
ZCTA5 38453,123,1299,-1176,409,34.5,405,0,0,0,3531,-3122
ZCTA5 38454,391,1296,-905,848,41.3,826,0,22,0.025943396,3680,-2832
ZCTA5 38455,44,12679,-12635,149,43.5,100,0,49,0.32885906,34594,-34445
ZCTA5 38456,1374,1318,56,4815,32,4737,0,0,0,3588,1227
ZCTA5 38457,237,343,-106,671,38.5,655,0,0,0,1445,-774
ZCTA5 38459,147,9122,-8975,409,31.7,349,0,0,0,26475,-26066
ZCTA5 38460,614,14399,-13785,1503,48.4,1475,0,12,0.007984032,37728,-36225
ZCTA5 38461,551,5807,-5256,1284,53,1245,0,29,0.02258567,16659,-15375
ZCTA5 38462,3966,138,3828,10230,43.1,9546,122,53,0.005180841,519,9711
ZCTA5 38463,988,9316,-8328,2406,45.6,2320,0,0,0,26061,-23655
ZCTA5 38464,9339,668,8671,23422,39.5,21405,157,610,0.02604389,2034,21388
ZCTA5 38468,1949,3952,-2003,5560,37.8,5362,21,96,0.017266187,11303,-5743
ZCTA5 38469,1605,37,1568,4298,42.1,4121,0,0,0,206,4092
ZCTA5 38471,113,188,-75,279,43.1,279,0,0,0,460,-181
ZCTA5 38472,1150,1190,-40,3116,39.8,3018,28,8,0.002567394,3472,-356
ZCTA5 38473,359,1649,-1290,1068,31.6,1018,5,11,0.010299625,4504,-3436
ZCTA5 38474,3053,633,2420,8203,41.8,6756,9,1109,0.135194441,1495,6708
ZCTA5 38475,310,1942,-1632,909,45.1,909,0,0,0,6433,-5524
ZCTA5 38476,352,1974,-1622,1297,43.3,1297,0,0,0,5023,-3726
ZCTA5 38477,1220,7354,-6134,3427,47.1,3104,0,277,0.080828713,19811,-16384
ZCTA5 38478,6901,5292,1609,17954,43,14110,14,2662,0.148267795,15395,2559
ZCTA5 38481,389,291,98,899,44,884,12,0,0,810,89
ZCTA5 38482,600,586,14,1582,40.8,1518,5,9,0.005689001,2112,-530
ZCTA5 38483,2078,460,1618,6077,34.9,5863,0,68,0.011189732,911,5166
ZCTA5 38485,2510,4031,-1521,6354,46.2,5832,63,258,0.040604344,11474,-5120
ZCTA5 38486,504,687,-183,1165,51.1,1142,0,0,0,2204,-1039
ZCTA5 38487,373,65,308,927,54.7,767,27,85,0.091693635,195,732
ZCTA5 38488,956,4952,-3996,2197,51,2098,21,0,0,13631,-11434
ZCTA5 38501,16743,1121,15622,40513,32.5,35609,627,1567,0.038678943,3147,37366
ZCTA5 38503,0,1586,-1586,0,-,0,0,0,#DIV/0!,4419,-4419
ZCTA5 38504,243,2496,-2253,649,51.7,589,0,6,0.009244992,7071,-6422
ZCTA5 38505,0,371,-371,1061,19.3,893,28,107,0.100848256,1401,-340
ZCTA5 38506,12114,251,11863,28803,42,27436,205,149,0.005173072,548,28255
ZCTA5 38541,687,692,-5,1592,50.3,1577,0,0,0,1697,-105
ZCTA5 38542,8,13292,-13284,17,-,17,0,0,0,36954,-36937
ZCTA5 38543,142,3520,-3378,342,51.1,319,0,0,0,9547,-9205
ZCTA5 38544,2707,163,2544,7552,38.9,7173,17,28,0.003707627,691,6861
ZCTA5 38545,526,3860,-3334,1220,37.8,1023,0,15,0.012295082,10307,-9087
ZCTA5 38547,770,43,727,1834,46.1,1759,0,12,0.006543075,137,1697
ZCTA5 38548,392,1076,-684,1153,40.5,1132,10,6,0.005203816,2882,-1729
ZCTA5 38549,1669,3554,-1885,4115,47.4,3959,0,5,0.001215067,9646,-5531
ZCTA5 38550,0,2094,-2094,0,-,0,0,0,#DIV/0!,5917,-5917
ZCTA5 38551,1636,12289,-10653,4109,46.6,3789,44,149,0.036261864,32536,-28427
ZCTA5 38552,98,814,-716,245,45.5,226,0,0,0,2249,-2004
ZCTA5 38553,1075,450,625,2723,46,2570,16,0,0,1152,1571
ZCTA5 38554,332,1934,-1602,734,54.6,694,0,0,0,5052,-4318
ZCTA5 38555,8871,1073,7798,20970,41,19909,27,305,0.014544588,2708,18262
ZCTA5 38556,5050,549,4501,11172,48.5,10756,40,36,0.003222342,1882,9290
ZCTA5 38558,4699,1983,2716,9014,70.2,8701,46,0,0,5623,3391
ZCTA5 38559,549,425,124,1425,44.1,1365,0,0,0,1216,209
ZCTA5 38560,420,1330,-910,1467,38.3,1416,23,0,0,3619,-2152
ZCTA5 38562,2477,3502,-1025,6758,46.9,6502,0,43,0.006362829,10365,-3607
ZCTA5 38563,895,135,760,2470,33,2197,6,48,0.019433198,318,2152
ZCTA5 38564,293,10758,-10465,469,63.2,400,0,0,0,24585,-24116
ZCTA5 38565,291,1205,-914,1004,35.9,988,0,0,0,3126,-2122
ZCTA5 38567,319,1158,-839,724,55.2,654,0,0,0,3234,-2510
ZCTA5 38568,739,60,679,1669,47.7,1617,0,0,0,103,1566
ZCTA5 38569,69,174,-105,223,32.2,223,0,0,0,494,-271
ZCTA5 38570,4119,0,4119,10062,45.9,9588,51,148,0.014708805,0,10062
ZCTA5 38571,5811,2443,3368,14131,48.8,13876,41,30,0.002122992,6809,7322
ZCTA5 38572,5015,1125,3890,11684,50.8,11226,13,169,0.014464225,3175,8509
ZCTA5 38573,869,3480,-2611,2096,48.2,2096,0,0,0,9205,-7109
ZCTA5 38574,3221,92,3129,8805,38.6,8429,7,39,0.004429302,641,8164
ZCTA5 38575,375,1820,-1445,1004,36.5,900,0,0,0,4807,-3803
ZCTA5 38577,532,748,-216,1548,31.4,1539,0,0,0,2262,-714
ZCTA5 38578,86,25,61,186,73.3,154,0,9,0.048387097,60,126
ZCTA5 38579,444,316,128,1466,31.2,1340,0,0,0,733,733
ZCTA5 38580,524,12793,-12269,1652,37.4,1568,0,0,0,33555,-31903
ZCTA5 38581,1485,5774,-4289,3616,45.3,3404,44,19,0.005254425,14546,-10930
ZCTA5 38582,696,1293,-597,1820,42.3,1812,0,0,0,4584,-2764
ZCTA5 38583,9474,2316,7158,24927,43.6,23615,83,510,0.020459742,6699,18228
ZCTA5 38585,1858,526,1332,4810,42.9,4631,0,7,0.001455301,1218,3592
ZCTA5 38587,570,0,570,1286,47.6,1205,0,0,0,989,297
ZCTA5 38588,388,6116,-5728,1093,42.9,1088,0,0,0,21538,-20445
ZCTA5 38589,111,204,-93,248,52.4,248,0,0,0,436,-188
ZCTA5 38601,776,3675,-2899,2211,39.3,1349,15,798,0.360922659,8808,-6597
ZCTA5 38603,1125,2012,-887,2527,50.8,2014,48,352,0.139295607,7147,-4620
ZCTA5 38606,5193,6330,-1137,14657,37.6,7461,91,6777,0.462372928,18964,-4307
ZCTA5 38610,959,9268,-8309,3311,39.2,2077,0,1020,0.308064029,24705,-21394
ZCTA5 38611,5848,10348,-4500,16114,40.5,10836,1,4443,0.275722974,28990,-12876
ZCTA5 38614,6412,10166,-3754,17011,35.7,3157,109,13092,0.769619658,30391,-13380
ZCTA5 38617,283,10006,-9723,670,37.5,83,0,587,0.876119403,24713,-24043
ZCTA5 38618,4663,11070,-6407,11656,44.7,7325,6,3848,0.330130405,33294,-21638
ZCTA5 38619,1906,8476,-6570,5339,47.4,2382,0,2776,0.519947556,22700,-17361
ZCTA5 38620,1267,1562,-295,3626,32.4,1566,0,1890,0.521235521,3141,485
ZCTA5 38621,669,0,669,2031,28.6,562,0,1449,0.713441654,661,1370
ZCTA5 38622,282,2853,-2571,761,29.8,387,0,374,0.491458607,7398,-6637
ZCTA5 38623,72,2861,-2789,119,43.6,20,0,99,0.831932773,7099,-6980
ZCTA5 38625,595,0,595,1514,43.2,1502,0,0,0,0,1514
ZCTA5 38626,392,4476,-4084,786,58.1,567,0,215,0.273536896,13364,-12578
ZCTA5 38627,644,10038,-9394,1588,43.7,1395,0,193,0.121536524,27139,-25551
ZCTA5 38629,658,8090,-7432,2134,32.8,1996,0,53,0.024835989,20319,-18185
ZCTA5 38631,497,6382,-5885,1234,29.3,19,0,1215,0.984602917,18377,-17143
ZCTA5 38632,10426,11,10415,28361,40.6,23775,204,3494,0.123197348,651,27710
ZCTA5 38633,918,696,222,2433,41.3,2274,0,106,0.043567612,1952,481
ZCTA5 38635,5165,782,4383,15086,39.6,3780,0,10986,0.728224844,1867,13219
ZCTA5 38637,9449,391,9058,26623,33.8,11623,195,11998,0.450662961,1071,25552
ZCTA5 38639,197,2313,-2116,606,38.4,0,0,606,1,5978,-5372
ZCTA5 38641,787,359,428,2022,42.1,1234,5,533,0.263600396,1151,871
ZCTA5 38642,924,1454,-530,2454,37.8,810,0,1477,0.601874491,4332,-1878
ZCTA5 38643,644,1720,-1076,1406,39.3,264,0,1114,0.792318634,4977,-3571
ZCTA5 38644,33,1011,-978,158,41.8,0,0,158,1,2495,-2337
ZCTA5 38645,447,764,-317,1212,41.2,522,0,646,0.5330033,2046,-834
ZCTA5 38646,1115,1299,-184,2822,42.3,715,7,2035,0.721119773,3401,-579
ZCTA5 38647,240,467,-227,715,28.5,269,0,216,0.302097902,1114,-399
ZCTA5 38650,1476,759,717,4549,39,3708,23,661,0.145306661,1870,2679
ZCTA5 38651,2955,1244,1711,8906,35.5,6869,1,1724,0.193577364,3089,5817
ZCTA5 38652,5886,6081,-195,15042,40.5,10673,55,2810,0.186810265,15654,-612
ZCTA5 38654,20009,2348,17661,55132,38.6,34841,1064,15644,0.283755351,6586,48546
ZCTA5 38655,16617,504,16113,45150,32.4,31383,904,11135,0.24662237,1284,43866
ZCTA5 38658,979,2361,-1382,2958,35,2180,0,655,0.221433401,6190,-3232
ZCTA5 38659,951,939,12,2484,37.4,1853,0,406,0.163446055,2752,-268
ZCTA5 38661,855,677,178,2183,51.1,1463,0,427,0.195602382,1655,528
ZCTA5 38663,4491,167,4324,11853,40.4,8849,6,1750,0.147641947,287,11566
ZCTA5 38664,1229,8876,-7647,3163,29,451,0,2570,0.81251976,25375,-22212
ZCTA5 38665,994,238,756,2666,36.3,2655,0,0,0,692,1974
ZCTA5 38666,2584,586,1998,6281,44,3245,0,2800,0.445788887,1280,5001
ZCTA5 38668,4849,2560,2289,14208,34.1,9230,29,4615,0.324817005,6341,7867
ZCTA5 38670,370,304,66,918,41.5,113,0,799,0.87037037,648,270
ZCTA5 38671,14273,576,13697,36166,33.8,20717,249,12917,0.357158657,1756,34410
ZCTA5 38672,5422,76,5346,15839,40.6,10384,697,4388,0.277037692,181,15658
ZCTA5 38673,470,1686,-1216,1359,40.5,720,87,413,0.303899926,4663,-3304
ZCTA5 38674,513,804,-291,1505,35.7,923,0,528,0.350830565,1906,-401
ZCTA5 38676,2130,1121,1009,6166,36.4,1087,0,5072,0.822575414,3127,3039
ZCTA5 38677,0,738,-738,3679,19.3,2945,71,439,0.119325904,1742,1937
ZCTA5 38680,2545,1263,1282,6571,39.8,3099,39,2786,0.423984173,3473,3098
ZCTA5 38683,1456,2804,-1348,3531,45.5,3395,6,63,0.017841971,7359,-3828
ZCTA5 38685,594,475,119,1430,58.4,1078,0,352,0.246153846,1317,113
ZCTA5 38701,8653,5936,2717,22123,38.4,6239,347,15345,0.693622022,14372,7751
ZCTA5 38703,4512,16833,-12321,12421,38.4,1697,9,10394,0.836808631,43639,-31218
ZCTA5 38720,278,15549,-15271,659,35.9,405,0,222,0.336874052,38401,-37742
ZCTA5 38721,378,0,378,948,42.6,240,0,697,0.735232068,2124,-1176
ZCTA5 38722,61,1167,-1106,246,35.2,9,0,237,0.963414634,3413,-3167
ZCTA5 38723,32,1975,-1943,58,-,58,0,0,0,5307,-5249
ZCTA5 38725,339,1113,-774,1218,37.7,570,26,600,0.492610837,2652,-1434
ZCTA5 38726,180,610,-430,450,41.2,41,0,401,0.891111111,1681,-1231
ZCTA5 38730,687,5516,-4829,1810,35.1,1436,0,288,0.159116022,15403,-13593
ZCTA5 38731,5,509,-504,10,-,10,0,0,0,1178,-1168
ZCTA5 38732,6008,3452,2556,16600,34.6,6063,196,9038,0.544457831,9659,6941
ZCTA5 38733,0,6372,-6372,41,20.3,25,0,16,0.390243902,17718,-17677
ZCTA5 38736,149,4265,-4116,629,31,254,0,375,0.59618442,12657,-12028
ZCTA5 38737,1157,1798,-641,3041,34.8,485,0,2512,0.826044064,4447,-1406
ZCTA5 38738,24,7724,-7700,3425,39.9,1058,8,2313,0.675328467,20520,-17095
ZCTA5 38740,144,8556,-8412,406,45.2,125,6,266,0.655172414,22842,-22436
ZCTA5 38744,240,1507,-1267,603,20.9,153,0,265,0.43946932,7118,-6515
ZCTA5 38745,33,9523,-9490,213,42.9,2,0,211,0.990610329,27041,-26828
ZCTA5 38746,183,3355,-3172,457,37,17,0,392,0.857768053,9231,-8774
ZCTA5 38748,1042,457,585,2992,35.9,902,0,2088,0.697860963,1325,1667
ZCTA5 38751,3778,1305,2473,10579,35,2104,0,8395,0.793553266,3751,6828
ZCTA5 38753,520,269,251,1372,36.9,519,0,829,0.604227405,649,723
ZCTA5 38754,508,544,-36,1171,47.3,291,0,879,0.750640478,1599,-428
ZCTA5 38756,2588,928,1660,6318,36.1,2294,14,3705,0.586419753,2536,3782
ZCTA5 38759,555,7688,-7133,1364,40.9,666,0,673,0.49340176,21719,-20355
ZCTA5 38760,305,10971,-10666,938,23.1,25,0,912,0.97228145,28673,-27735
ZCTA5 38761,679,4854,-4175,2212,29.2,530,11,1664,0.752260398,13607,-11395
ZCTA5 38762,882,2557,-1675,2405,35.8,0,0,2393,0.995010395,6050,-3645
ZCTA5 38764,132,4425,-4293,302,46.4,123,13,166,0.549668874,12120,-11818
ZCTA5 38765,40,2479,-2439,40,-,0,0,40,1,6637,-6597
ZCTA5 38767,21,255,-234,91,28.3,20,0,71,0.78021978,627,-536
ZCTA5 38768,26,751,-725,45,46.4,18,0,27,0.6,2036,-1991
ZCTA5 38769,760,1853,-1093,2014,34.3,278,0,1690,0.839126117,5055,-3041
ZCTA5 38771,880,1130,-250,2877,31.7,408,0,2466,0.857142857,2934,-57
ZCTA5 38772,33,790,-757,61,79.5,0,0,61,1,2042,-1981
ZCTA5 38773,1181,3515,-2334,2975,43,647,0,2290,0.769747899,9320,-6345
ZCTA5 38774,664,2376,-1712,1663,42.4,95,0,1540,0.926037282,6183,-4520
ZCTA5 38776,6,8299,-8293,16,-,0,0,16,1,21740,-21724
ZCTA5 38778,499,16766,-16267,1295,33.9,213,0,1054,0.813899614,46548,-45253
ZCTA5 38781,59,6711,-6652,117,61.3,0,0,117,1,15719,-15602
ZCTA5 38801,11672,6190,5482,29901,35.2,14944,210,13267,0.443697535,14850,15051
ZCTA5 38804,6666,3660,3006,15714,41.8,10493,46,4635,0.294959908,8546,7168
ZCTA5 38821,4884,3439,1445,11828,41,9310,22,2087,0.176445722,8143,3685
ZCTA5 38824,2941,7789,-4848,8099,42.7,5477,134,1925,0.237683665,17266,-9167
ZCTA5 38826,2157,12876,-10719,5357,35.9,3363,121,1354,0.252753407,34252,-28895
ZCTA5 38827,1469,0,1469,3472,36.7,3041,18,0,0,2179,1293
ZCTA5 38828,1443,3267,-1824,5032,34,4114,0,869,0.172694754,8749,-3717
ZCTA5 38829,6592,6367,225,17625,39.2,14928,524,1697,0.096283688,17543,82
ZCTA5 38833,888,2631,-1743,2291,35.3,2124,0,16,0.00698385,7337,-5046
ZCTA5 38834,11324,6277,5047,27818,39.7,22812,146,3282,0.117981163,16553,11265
ZCTA5 38838,453,716,-263,1279,52.2,1258,0,0,0,2155,-876
ZCTA5 38839,17,6229,-6212,29,64.8,14,0,15,0.517241379,17486,-17457
ZCTA5 38841,1325,5220,-3895,3750,33,2421,0,511,0.136266667,13842,-10092
ZCTA5 38843,4060,13757,-9697,11468,40.5,9681,60,1475,0.128618765,38000,-26532
ZCTA5 38844,119,6009,-5890,241,48.1,241,0,0,0,18689,-18448
ZCTA5 38846,725,4244,-3519,1728,49.1,1702,5,0,0,10529,-8801
ZCTA5 38847,1417,4817,-3400,3625,42.9,3604,0,5,0.00137931,13069,-9444
ZCTA5 38848,330,460,-130,802,54,749,17,36,0.044887781,1032,-230
ZCTA5 38849,1918,2896,-978,5599,37.2,4547,14,845,0.150919807,8325,-2726
ZCTA5 38850,1015,4491,-3476,2675,43.7,1734,12,852,0.318504673,12840,-10165
ZCTA5 38851,3627,2304,1323,8983,40.4,4745,18,3458,0.384949349,5781,3202
ZCTA5 38852,3773,3498,275,8446,49.1,8121,0,155,0.018351883,10600,-2154
ZCTA5 38855,1991,4262,-2271,5202,41,4885,0,114,0.021914648,11956,-6754
ZCTA5 38856,616,9360,-8744,1812,35.8,1812,0,0,0,24780,-22968
ZCTA5 38857,1344,2288,-944,4515,35.5,4387,42,47,0.010409745,6054,-1539
ZCTA5 38858,2296,541,1755,6953,36.7,4972,0,1955,0.281173594,1260,5693
ZCTA5 38859,194,1475,-1281,595,36,595,0,0,0,3766,-3171
ZCTA5 38860,2174,500,1674,6425,28.8,3105,0,3270,0.508949416,1441,4984
ZCTA5 38862,995,98,897,2504,47,1466,0,960,0.383386581,244,2260
ZCTA5 38863,6852,1225,5627,18692,36.9,13850,0,3199,0.171142735,3114,15578
ZCTA5 38864,692,1654,-962,2208,25.7,2143,0,0,0,4526,-2318
ZCTA5 38865,1820,360,1460,5229,36.3,3977,1,555,0.106138841,829,4400
ZCTA5 38866,4559,1955,2604,12560,37.1,11037,329,916,0.072929936,4753,7807
ZCTA5 38868,2083,236,1847,5721,32.4,2954,0,2576,0.450270932,582,5139
ZCTA5 38869,129,8348,-8219,319,48.6,303,0,14,0.043887147,22395,-22076
ZCTA5 38870,1074,3055,-1981,2843,37.1,2736,0,86,0.030249736,8821,-5978
ZCTA5 38871,693,1292,-599,1955,33,1840,0,0,0,3169,-1214
ZCTA5 38873,1180,2195,-1015,3028,39.3,2634,46,210,0.069352708,5732,-2704
ZCTA5 38876,475,382,93,1205,38.3,1203,0,0,0,1055,150
ZCTA5 38878,1029,733,296,2545,40.3,1745,0,372,0.146168959,1885,660
ZCTA5 38879,44,967,-923,58,70.9,18,0,40,0.689655172,2707,-2649
ZCTA5 38901,7464,482,6982,18794,37.7,9342,41,9080,0.483132915,1160,17634
ZCTA5 38913,148,1012,-864,373,43.3,353,0,0,0,2749,-2376
ZCTA5 38914,277,898,-621,814,47.6,563,0,249,0.305896806,2127,-1313
ZCTA5 38915,1647,426,1221,3433,43.7,2329,26,1020,0.297116225,1180,2253
ZCTA5 38916,1896,3479,-1583,4752,39.8,2589,0,1840,0.387205387,9232,-4480
ZCTA5 38917,1314,4452,-3138,3832,42.9,2635,0,1197,0.31236952,12727,-8895
ZCTA5 38920,277,252,25,579,52.6,369,0,193,0.333333333,422,157
ZCTA5 38921,1507,1955,-448,4847,35.5,1804,14,3001,0.619145863,5715,-868
ZCTA5 38922,1214,5838,-4624,2986,41.4,1699,11,1199,0.401540522,14097,-11111
ZCTA5 38923,506,8608,-8102,816,54.2,457,0,359,0.43995098,22418,-21602
ZCTA5 38924,152,5628,-5476,315,44.5,105,0,208,0.66031746,14023,-13708
ZCTA5 38925,902,4658,-3756,2163,44.9,1181,0,910,0.420711974,12223,-10060
ZCTA5 38927,293,1610,-1317,795,40.5,588,0,207,0.260377358,4180,-3385
ZCTA5 38928,108,99,9,331,45.2,0,0,331,1,303,28
ZCTA5 38929,696,205,491,1867,50.5,1348,0,492,0.263524371,585,1282
ZCTA5 38930,8118,1051,7067,23908,35,5731,118,17181,0.718629747,3094,20814
ZCTA5 38940,601,1902,-1301,1632,38.1,1393,0,195,0.119485294,5490,-3858
ZCTA5 38941,1184,602,582,3664,28.9,328,0,3303,0.901473799,1438,2226
ZCTA5 38943,234,598,-364,692,37.3,289,0,403,0.582369942,1492,-800
ZCTA5 38944,61,2381,-2320,197,42.3,106,0,91,0.461928934,5628,-5431
ZCTA5 38946,85,227,-142,254,36.4,17,0,237,0.933070866,759,-505
ZCTA5 38947,27,1225,-1198,30,63.5,30,0,0,0,3094,-3064
ZCTA5 38948,944,836,108,2130,46,1387,6,725,0.340375587,1886,244
ZCTA5 38949,139,1045,-906,335,54.6,284,0,21,0.062686567,2641,-2306
ZCTA5 38950,224,475,-251,765,29.4,356,0,409,0.534640523,1286,-521
ZCTA5 38951,399,1052,-653,812,49,525,0,221,0.272167488,2729,-1917
ZCTA5 38952,168,356,-188,412,47.5,227,0,177,0.42961165,889,-477
ZCTA5 38953,190,833,-643,357,52.3,224,0,72,0.201680672,2331,-1974
ZCTA5 38954,306,17016,-16710,830,48.2,510,0,320,0.385542169,41887,-41057
ZCTA5 38957,212,0,212,497,36.7,198,6,281,0.565392354,0,497
ZCTA5 38961,250,40,210,789,47.7,655,0,134,0.169835234,2238,-1449
ZCTA5 38962,0,1028,-1028,0,-,0,0,0,#DIV/0!,2526,-2526
ZCTA5 38963,1035,264,771,3924,37.8,547,24,2934,0.747706422,540,3384
ZCTA5 38964,19,926,-907,80,23.6,22,0,58,0.725,2075,-1995
ZCTA5 38965,3528,80,3448,9022,41.5,5896,0,2916,0.323209931,226,8796
ZCTA5 38966,232,759,-527,542,33.6,87,0,455,0.839483395,1676,-1134
ZCTA5 38967,2513,6292,-3779,7123,38.5,3605,0,3276,0.459918574,16699,-9576
ZCTA5 39038,2012,556,1456,5580,36.5,863,13,4596,0.823655914,1465,4115
ZCTA5 39039,1314,853,461,3143,35.4,1502,0,1407,0.44766147,2103,1040
ZCTA5 39040,1527,612,915,3710,34.8,1962,0,1629,0.439083558,1666,2044
ZCTA5 39041,1390,4078,-2688,3452,48.1,552,4,2797,0.810254925,11597,-8145
ZCTA5 39042,13576,4300,9276,37515,41.7,29966,61,6858,0.182806877,10654,26861
ZCTA5 39044,1149,3276,-2127,3030,41.1,1888,0,1126,0.371617162,8687,-5657
ZCTA5 39045,808,178,630,1779,44.4,143,0,1636,0.919617763,478,1301
ZCTA5 39046,11397,507,10890,28747,36.2,10001,217,17926,0.623578112,1283,27464
ZCTA5 39047,15175,223,14952,39931,37.8,31739,779,5798,0.145200471,702,39229
ZCTA5 39051,5551,1573,3978,15710,39.4,7580,110,6510,0.414385742,4157,11553
ZCTA5 39054,113,5677,-5564,417,29.9,92,0,306,0.73381295,14993,-14576
ZCTA5 39056,10573,877,9696,28330,37.2,15344,1033,11385,0.401870808,2218,26112
ZCTA5 39057,764,248,516,2197,29.8,1064,0,77,0.035047792,669,1528
ZCTA5 39058,0,2499,-2499,69,18.8,7,0,62,0.898550725,6112,-6043
ZCTA5 39059,4248,1967,2281,11893,43.4,5046,14,6447,0.542083579,5366,6527
ZCTA5 39061,0,245,-245,0,-,0,0,0,#DIV/0!,676,-676
ZCTA5 39062,166,2941,-2775,520,38.1,382,0,136,0.261538462,8110,-7590
ZCTA5 39063,1116,2926,-1810,3498,38.9,738,0,2751,0.7864494,7653,-4155
ZCTA5 39066,1975,715,1260,5095,42.2,1316,0,3670,0.720314033,1617,3478
ZCTA5 39067,400,936,-536,1145,40.4,986,0,128,0.111790393,2419,-1274
ZCTA5 39069,1478,1001,477,4920,38,334,26,4479,0.910365854,2591,2329
ZCTA5 39071,2499,483,2016,6777,39.5,3482,34,3201,0.472332891,1469,5308
ZCTA5 39073,7771,414,7357,21347,39.8,16873,0,3665,0.171686888,1065,20282
ZCTA5 39074,4867,555,4312,13623,36.7,7568,69,5173,0.379725464,1133,12490
ZCTA5 39078,289,184,105,921,46.7,435,0,462,0.501628664,2961,-2040
ZCTA5 39079,386,129,257,1647,20.8,543,9,1061,0.644201579,204,1443
ZCTA5 39082,332,979,-647,761,57.6,368,88,305,0.400788436,2469,-1708
ZCTA5 39083,3330,191,3139,9547,39.3,2945,0,6112,0.64020111,479,9068
ZCTA5 39086,441,46,395,1603,35.6,113,0,1445,0.90143481,155,1448
ZCTA5 39088,10,666,-656,39,79.1,39,0,0,0,1717,-1678
ZCTA5 39090,4673,1337,3336,12653,38.5,6222,38,5838,0.461392555,3632,9021
ZCTA5 39092,1307,704,603,3695,41.1,1881,0,1439,0.389445196,1962,1733
ZCTA5 39094,1468,10638,-9170,3657,38.8,2159,0,1227,0.335520919,27806,-24149
ZCTA5 39095,2050,1990,60,5594,40.6,868,29,4676,0.835895602,5068,526
ZCTA5 39096,532,69,463,2181,23.1,155,0,2020,0.926180651,178,2003
ZCTA5 39097,160,1474,-1314,273,50.4,28,9,222,0.813186813,3930,-3657
ZCTA5 39108,612,517,95,1572,52.6,784,0,641,0.407760814,1408,164
ZCTA5 39110,15947,160,15787,44451,40.2,34810,1945,6757,0.152010079,560,43891
ZCTA5 39111,3021,897,2124,9246,38.7,6650,0,2404,0.260004326,2351,6895
ZCTA5 39113,114,203,-89,193,49.7,10,0,182,0.943005181,457,-264
ZCTA5 39114,3415,2109,1306,9936,39.3,5272,99,4409,0.443739936,5825,4111
ZCTA5 39115,55,6957,-6902,129,9,10,0,119,0.92248062,19998,-19869
ZCTA5 39116,896,1314,-418,2506,41.9,2317,52,70,0.027932961,3384,-878
ZCTA5 39117,3512,39,3473,10747,37.3,6852,0,2820,0.262398809,92,10655
ZCTA5 39119,2028,309,1719,6148,38.9,3310,27,2811,0.457221861,836,5312
ZCTA5 39120,11482,1343,10139,30075,41,11831,190,16010,0.532335827,3732,26343
ZCTA5 39140,888,42,846,2397,34.5,1411,0,968,0.403838131,85,2312
ZCTA5 39144,245,1727,-1482,705,34.4,118,0,587,0.832624113,5107,-4402
ZCTA5 39145,2014,6538,-4524,5170,43.6,4551,4,522,0.100967118,22390,-17220
ZCTA5 39146,1135,4765,-3630,3428,35.5,320,0,3108,0.906651109,12225,-8797
ZCTA5 39148,0,113,-113,21,24.1,21,0,0,0,304,-283
ZCTA5 39149,629,1088,-459,1509,42.4,298,0,1211,0.802518224,2886,-1377
ZCTA5 39150,1796,180,1616,5675,38.1,765,45,4777,0.841762115,481,5194
ZCTA5 39152,377,159,218,984,35.8,783,0,201,0.204268293,381,603
ZCTA5 39153,1039,1340,-301,2623,38.8,1887,5,726,0.27678231,3380,-757
ZCTA5 39154,3382,737,2645,9929,39,5786,16,3946,0.397421694,1924,8005
ZCTA5 39156,268,7315,-7047,590,41.9,581,0,0,0,19531,-18941
ZCTA5 39157,10723,0,10723,25022,34.5,12740,704,10165,0.406242507,89,24933
ZCTA5 39159,942,0,942,3259,40.1,982,0,2247,0.689475299,109,3150
ZCTA5 39160,899,633,266,2843,44.4,997,0,1814,0.638058389,1644,1199
ZCTA5 39162,70,1802,-1732,199,39.9,122,0,77,0.386934673,4663,-4464
ZCTA5 39166,200,222,-22,662,36.1,313,0,349,0.527190332,706,-44
ZCTA5 39167,0,611,-611,0,-,0,0,0,#DIV/0!,1585,-1585
ZCTA5 39168,2441,1303,1138,5737,49.3,3089,0,2616,0.45598745,3680,2057
ZCTA5 39169,1046,1470,-424,3189,34.3,130,0,3056,0.958294136,3947,-758
ZCTA5 39170,3673,47,3626,9216,49.6,4830,3,4267,0.462999132,89,9127
ZCTA5 39173,0,6135,-6135,0,-,0,0,0,#DIV/0!,17195,-17195
ZCTA5 39174,39,424,-385,599,20.1,66,4,529,0.883138564,1099,-500
ZCTA5 39175,1414,204,1210,3492,47.1,1200,0,2149,0.615406644,482,3010
ZCTA5 39176,842,10,832,2268,49.5,1356,0,900,0.396825397,780,1488
ZCTA5 39177,51,10308,-10257,85,67.3,85,0,0,0,27823,-27738
ZCTA5 39179,582,1840,-1258,1456,40.7,367,0,1079,0.741071429,5606,-4150
ZCTA5 39180,11962,905,11057,31324,39.6,13694,149,16254,0.518899247,2140,29184
ZCTA5 39183,4861,3196,1665,13227,40,7139,115,5841,0.441596734,8315,4912
ZCTA5 39189,1153,186,967,3413,34.6,1518,0,1486,0.435394081,578,2835
ZCTA5 39191,2639,5219,-2580,8042,34.8,5930,34,1700,0.211390201,14635,-6593
ZCTA5 39192,456,498,-42,1915,29.6,986,0,927,0.484073107,1229,686
ZCTA5 39193,16,929,-913,847,53.5,431,0,375,0.442739079,2505,-1658
ZCTA5 39194,5041,212,4829,19284,36.5,6544,12,12164,0.630781995,538,18746
ZCTA5 39201,543,925,-382,697,27.7,143,14,540,0.774748924,2185,-1488
ZCTA5 39202,3568,471,3097,6790,33.6,2802,41,3762,0.554050074,1108,5682
ZCTA5 39203,2040,799,1241,5057,33.8,218,20,4789,0.947004153,1965,3092
ZCTA5 39204,5820,4008,1812,14713,31.3,872,0,13412,0.911574798,11394,3319
ZCTA5 39206,9720,874,8846,22763,37.7,2839,77,19560,0.859289197,2641,20122
ZCTA5 39208,12412,13,12399,33765,34.9,20477,436,11583,0.343047534,13,33752
ZCTA5 39209,9905,702,9203,26796,32.8,1537,75,24852,0.927451858,1712,25084
ZCTA5 39210,0,262,-262,625,19.8,237,2,374,0.5984,601,24
ZCTA5 39211,9832,753,9079,23051,33.9,9763,242,12619,0.547438289,2110,20941
ZCTA5 39212,10869,3554,7315,30662,32.1,3121,0,26738,0.872024004,9710,20952
ZCTA5 39213,8309,767,7542,20774,38.6,218,11,20103,0.96770001,1635,19139
ZCTA5 39216,1637,2473,-836,3401,37.9,2548,42,802,0.235812996,10946,-7545
ZCTA5 39217,78,243,-165,2210,19.8,183,10,2011,0.909954751,658,1552
ZCTA5 39218,2866,950,1916,6902,35.7,4799,76,1472,0.213271516,2405,4497
ZCTA5 39232,3870,2288,1582,9097,35,5383,571,2832,0.311311421,6466,2631
ZCTA5 39269,0,562,-562,0,-,0,0,0,#DIV/0!,1382,-1382
ZCTA5 39272,5294,359,4935,14367,36.2,2929,136,11034,0.768010023,1194,13173
ZCTA5 39301,9436,1557,7879,24129,38.3,13637,0,9931,0.411579427,4399,19730
ZCTA5 39305,8006,1501,6505,20860,36.1,12357,369,7477,0.3584372,3603,17257
ZCTA5 39307,6129,174,5955,16365,37.2,4586,70,11452,0.699786129,470,15895
ZCTA5 39309,0,477,-477,358,20,198,74,54,0.150837989,1246,-888
ZCTA5 39320,633,337,296,1894,46.7,1312,0,397,0.209609293,888,1006
ZCTA5 39322,625,8929,-8304,1775,48.1,1015,0,739,0.416338028,22999,-21224
ZCTA5 39323,489,27,462,1320,49.5,1296,0,0,0,73,1247
ZCTA5 39324,0,1996,-1996,0,-,0,0,0,#DIV/0!,5912,-5912
ZCTA5 39325,2216,12183,-9967,5995,44,5009,11,949,0.158298582,32875,-26880
ZCTA5 39326,92,110,-18,251,37,163,0,88,0.35059761,273,-22
ZCTA5 39327,1450,92,1358,4078,30.4,2655,8,1001,0.245463462,192,3886
ZCTA5 39328,1783,5005,-3222,4865,45.8,1786,0,3060,0.628982528,13318,-8453
ZCTA5 39330,983,387,596,2747,44.7,2033,15,633,0.2304332,1179,1568
ZCTA5 39332,640,672,-32,2199,36.5,1568,1,437,0.198726694,1553,646
ZCTA5 39335,875,140,735,1699,50.3,1372,14,255,0.150088287,464,1235
ZCTA5 39336,414,2643,-2229,1005,50.7,479,32,469,0.466666667,6429,-5424
ZCTA5 39337,668,8986,-8318,1649,45.5,1649,0,0,0,19270,-17621
ZCTA5 39338,1377,7083,-5706,3539,40.4,1435,1,2067,0.584063295,14480,-10941
ZCTA5 39339,5623,10485,-4862,14278,42.3,6634,12,7268,0.509034879,23483,-9205
ZCTA5 39341,2027,9150,-7123,6413,33,1437,0,4931,0.768906908,18474,-12061
ZCTA5 39342,673,13317,-12644,1882,29.6,668,0,1169,0.621147715,28989,-27107
ZCTA5 39345,2242,5260,-3018,5851,41.3,2158,0,3583,0.612373953,13727,-7876
ZCTA5 39346,824,255,569,2084,51.4,1351,0,729,0.349808061,683,1401
ZCTA5 39347,587,6072,-5485,1254,61.9,590,0,654,0.5215311,16230,-14976
ZCTA5 39348,170,8968,-8798,548,56.1,65,0,483,0.881386861,22770,-22222
ZCTA5 39350,8326,7137,1189,24842,36.1,12452,164,6508,0.261975686,18628,6214
ZCTA5 39352,203,7086,-6883,447,33.2,341,0,106,0.237136465,16008,-15561
ZCTA5 39354,800,18266,-17466,2436,32.3,976,0,1408,0.577996716,44880,-42444
ZCTA5 39355,2579,9211,-6632,5753,53.3,3870,0,1759,0.30575352,23450,-17697
ZCTA5 39356,265,16765,-16500,539,58,302,0,186,0.345083488,40697,-40158
ZCTA5 39358,282,5786,-5504,1191,22.2,401,7,783,0.65743073,12102,-10911
ZCTA5 39359,101,12672,-12571,258,41.2,215,0,39,0.151162791,29441,-29183
ZCTA5 39360,1220,15417,-14197,3685,35.3,1304,0,2370,0.643147897,38383,-34698
ZCTA5 39361,624,13981,-13357,1186,55.4,381,0,805,0.678752108,32610,-31424
ZCTA5 39362,1439,9924,-8485,3610,40.2,2127,0,1463,0.405263158,21922,-18312
ZCTA5 39363,514,8812,-8298,1422,45,963,0,457,0.32137834,21500,-20078
ZCTA5 39364,1317,6201,-4884,2795,50,1900,0,848,0.303398927,15897,-13102
ZCTA5 39365,2831,13321,-10490,8256,38.2,6252,49,1746,0.211482558,36630,-28374
ZCTA5 39366,333,0,333,977,25.9,170,0,807,0.825997953,0,977
ZCTA5 39367,5532,12155,-6623,14333,36.7,7883,19,5641,0.393567292,29260,-14927
ZCTA5 39401,16415,4428,11987,41293,31.8,16676,418,22264,0.539171288,10761,30532
ZCTA5 39402,17276,4386,12890,43628,36.1,28134,615,12920,0.296140094,10004,33624
ZCTA5 39406,0,11018,-11018,1671,20.3,753,78,764,0.457211251,30352,-28681
ZCTA5 39421,1179,10306,-9127,3215,46.2,945,0,2232,0.694245723,27304,-24089
ZCTA5 39422,1713,13933,-12220,4596,46.4,2290,0,2289,0.498041775,37826,-33230
ZCTA5 39423,1110,100,1010,2474,44.3,1489,156,821,0.331851253,406,2068
ZCTA5 39425,968,13598,-12630,2805,47.3,2765,0,31,0.011051693,33897,-31092
ZCTA5 39426,6450,14795,-8345,17616,43.7,16254,51,689,0.039112171,38833,-21217
ZCTA5 39427,461,242,219,1234,40.4,1118,0,92,0.074554295,681,553
ZCTA5 39428,3237,2865,372,8778,37.4,4909,0,3679,0.419115972,7406,1372
ZCTA5 39429,6224,2474,3750,15995,41.2,9913,41,5721,0.357674273,6801,9194
ZCTA5 39437,4251,1212,3039,13101,36.1,10175,4,2592,0.197847493,3867,9234
ZCTA5 39439,1734,129,1605,4680,36.8,1086,0,3309,0.707051282,394,4286
ZCTA5 39440,7496,1223,6273,20443,35.8,6514,173,13231,0.647214205,3258,17185
ZCTA5 39443,8167,15575,-7408,21973,40.4,18782,31,2483,0.113002321,41752,-19779
ZCTA5 39451,1106,386,720,7512,40.3,4689,0,2622,0.349041534,951,6561
ZCTA5 39452,10032,7723,2309,27607,37.3,24823,167,2003,0.072554062,19135,8472
ZCTA5 39455,3490,37,3453,9229,42.2,7552,23,1377,0.149203597,111,9118
ZCTA5 39456,245,5164,-4919,968,24.2,725,1,148,0.152892562,13081,-12113
ZCTA5 39459,1443,2049,-606,4354,34.2,4228,0,106,0.024345429,5736,-1382
ZCTA5 39461,351,0,351,644,33.3,618,0,0,0,0,644
ZCTA5 39462,436,8275,-7839,1139,39,981,0,117,0.102721686,21222,-20083
ZCTA5 39464,1033,276,757,3345,43.8,3019,0,23,0.006875934,769,2576
ZCTA5 39465,8157,1103,7054,23528,35.9,20210,135,2639,0.11216423,2937,20591
ZCTA5 39466,10748,260,10488,28862,38.4,22109,120,4870,0.168733975,680,28182
ZCTA5 39470,4179,54,4125,11979,38.8,10110,3,1644,0.13724017,128,11851
ZCTA5 39474,2143,6943,-4800,5413,47,1988,0,3406,0.629225938,19549,-14136
ZCTA5 39475,5429,7868,-2439,13635,39.4,11526,161,1744,0.127906124,20189,-6554
ZCTA5 39476,2292,15038,-12746,6654,42.5,6095,0,435,0.065374211,40082,-33428
ZCTA5 39477,239,383,-144,559,42.7,538,0,21,0.037567084,1228,-669
ZCTA5 39478,772,3186,-2414,2256,51.3,1691,0,565,0.250443262,7410,-5154
ZCTA5 39479,2213,2610,-397,5795,35.9,5073,0,507,0.087489215,6908,-1113
ZCTA5 39480,977,7198,-6221,2611,37.4,2472,6,121,0.046342398,18103,-15492
ZCTA5 39481,617,0,617,1652,40.4,1579,0,71,0.042978208,0,1652
ZCTA5 39482,4117,1011,3106,10551,41.6,9661,0,733,0.069472088,2900,7651
ZCTA5 39483,2034,951,1083,5926,36.5,4340,0,1228,0.20722241,2378,3548
ZCTA5 39501,8822,763,8059,23224,34,8704,141,12805,0.551369273,2143,21081
ZCTA5 39503,19976,700,19276,55332,35.2,33649,821,17585,0.317808863,1820,53512
ZCTA5 39507,7507,25,7482,18048,37.1,11637,347,4797,0.265791223,35,18013
ZCTA5 39520,6423,1193,5230,15201,46.7,11968,169,1830,0.120386817,3092,12109
ZCTA5 39525,4160,2179,1981,9417,50.5,8600,3,121,0.012849103,5802,3615
ZCTA5 39529,0,8778,-8778,0,-,0,0,0,#DIV/0!,21906,-21906
ZCTA5 39530,3632,1025,2607,8030,38.3,4480,469,2293,0.285554172,2906,5124
ZCTA5 39531,7821,740,7081,18458,35.8,11805,626,4457,0.241467115,1933,16525
ZCTA5 39532,13411,2722,10689,34540,40.1,26096,1430,4587,0.132802548,8001,26539
ZCTA5 39534,0,14402,-14402,2602,20.6,1695,118,415,0.159492698,35204,-32602
ZCTA5 39540,4764,958,3806,12736,36.5,8101,1213,2497,0.196058417,2102,10634
ZCTA5 39553,6638,9279,-2641,17786,38.4,10324,362,5581,0.313786124,24549,-6763
ZCTA5 39556,2725,0,2725,7949,39.6,7448,0,41,0.005157881,690,7259
ZCTA5 39560,7145,1384,5761,18141,43.6,16015,320,1162,0.064053801,3475,14666
ZCTA5 39561,651,1699,-1048,1257,46.6,1120,0,0,0,4109,-2852
ZCTA5 39562,6802,9424,-2622,17278,46,15756,18,1068,0.06181271,24410,-7132
ZCTA5 39563,4656,19,4637,12259,41.8,2243,10,9275,0.756586997,32,12227
ZCTA5 39564,16632,1988,14644,41615,39.1,32885,1899,3777,0.090760543,5400,36215
ZCTA5 39565,6905,946,5959,20112,37.5,17610,574,790,0.039280032,2422,17690
ZCTA5 39567,3617,365,3252,10213,35.8,6248,0,3067,0.300303535,993,9220
ZCTA5 39571,5216,5038,178,13396,42.2,10320,65,2256,0.16840848,13803,-407
ZCTA5 39572,564,376,188,1151,52.9,921,0,223,0.19374457,897,254
ZCTA5 39573,3347,3643,-296,8891,44.6,7917,105,421,0.047351254,8250,641
ZCTA5 39574,4480,0,4480,13203,38.5,12044,94,445,0.033704461,0,13203
ZCTA5 39576,2546,3615,-1069,6159,38,4964,0,869,0.141094333,9804,-3645
ZCTA5 39577,3489,468,3021,10808,35.3,7661,0,2559,0.23676906,1166,9642
ZCTA5 39581,4500,1408,3092,11777,34,4982,199,5060,0.429651015,3454,8323
ZCTA5 39595,0,399,-399,34,22.8,18,10,6,0.176470588,865,-831
ZCTA5 39601,8854,842,8012,24255,37.6,14796,138,9144,0.376994434,1889,22366
ZCTA5 39629,2442,658,1784,6107,44.9,5024,23,907,0.148518094,1596,4511
ZCTA5 39630,466,21065,-20599,1110,27.3,500,0,576,0.518918919,55310,-54200
ZCTA5 39631,1515,113,1402,3745,33.8,1004,0,2607,0.696128171,281,3464
ZCTA5 39633,278,4627,-4349,718,30.4,368,2,348,0.484679666,11434,-10716
ZCTA5 39635,103,1023,-920,235,37.1,235,0,0,0,2901,-2666
ZCTA5 39638,1520,1541,-21,3566,40.9,1503,0,2056,0.576556366,4299,-733
ZCTA5 39641,1842,12425,-10583,5212,33.7,3640,0,1509,0.289524175,26508,-21296
ZCTA5 39643,380,12271,-11891,1141,38.4,508,0,633,0.554776512,28245,-27104
ZCTA5 39645,2153,10688,-8535,4583,50.6,2739,0,1768,0.385773511,24988,-20405
ZCTA5 39647,233,10885,-10652,623,41.3,155,0,445,0.714285714,25849,-25226
ZCTA5 39648,8108,0,8108,20285,38.4,7538,139,12285,0.605619916,2195,18090
ZCTA5 39652,3143,1031,2112,8565,33.9,3299,12,4876,0.569293637,1455,7110
ZCTA5 39653,1031,9519,-8488,2457,46.9,1718,0,662,0.269434269,24718,-22261
ZCTA5 39654,1936,13959,-12023,5259,38.5,3283,27,1723,0.327628827,33265,-28006
ZCTA5 39656,236,326,-90,835,34.9,108,0,726,0.869461078,2103,-1268
ZCTA5 39657,693,11281,-10588,1465,54.7,693,15,650,0.443686007,30374,-28909
ZCTA5 39661,897,4123,-3226,2626,43.1,1756,0,864,0.329017517,11333,-8707
ZCTA5 39662,446,5632,-5186,1517,39,1242,0,233,0.153592617,15088,-13571
ZCTA5 39663,869,13739,-12870,2249,46.8,1090,0,1152,0.512227657,34420,-32171
ZCTA5 39664,813,1040,-227,1766,51.3,1601,0,165,0.093431484,2504,-738
ZCTA5 39665,404,16308,-15904,1077,36.1,672,0,350,0.324976787,34659,-33582
ZCTA5 39666,3791,21315,-17524,11675,37.1,6899,51,4574,0.391777302,49948,-38273
ZCTA5 39667,4460,0,4460,11070,42.7,5631,49,4911,0.443631436,488,10582
ZCTA5 39668,326,11372,-11046,963,38,356,0,607,0.630321911,28222,-27259
ZCTA5 39669,2038,2080,-42,5254,42.7,1602,0,3542,0.674153026,6101,-847
ZCTA5 39701,5321,1307,4014,12721,43,4241,16,8081,0.635248801,3066,9655
ZCTA5 39702,8268,468,7800,23390,35.7,11189,122,11908,0.509106456,1104,22286
ZCTA5 39705,5105,1094,4011,12597,36.4,7865,367,3620,0.287370009,3368,9229
ZCTA5 39730,4174,8821,-4647,11204,41.6,5922,0,5269,0.470278472,22700,-11496
ZCTA5 39735,1549,137,1412,3888,42.7,2670,1,1136,0.29218107,341,3547
ZCTA5 39736,173,6794,-6621,365,33.2,20,0,333,0.912328767,17338,-16973
ZCTA5 39737,77,1094,-1017,124,72.8,124,0,0,0,3258,-3134
ZCTA5 39739,989,243,746,2774,38.2,853,0,1834,0.661139149,747,2027
ZCTA5 39740,1983,6483,-4500,5777,37,4682,36,793,0.137268478,17667,-11890
ZCTA5 39741,651,425,226,1467,42.9,1006,0,461,0.314246762,1322,145
ZCTA5 39743,814,177,637,1990,44.9,321,0,1667,0.837688442,363,1627
ZCTA5 39744,2353,1131,1222,5793,39.8,4100,36,1643,0.28361816,3253,2540
ZCTA5 39745,265,230,35,701,41.6,412,45,222,0.316690442,440,261
ZCTA5 39746,1166,43,1123,2562,50.8,1978,88,487,0.19008587,180,2382
ZCTA5 39747,687,577,110,1487,53,828,0,612,0.411566913,1373,114
ZCTA5 39750,1432,267,1165,3552,37.9,2432,0,802,0.225788288,475,3077
ZCTA5 39751,518,548,-30,1390,43.5,897,0,487,0.350359712,1520,-130
ZCTA5 39752,957,32,925,2390,38.9,2278,10,88,0.036820084,36,2354
ZCTA5 39753,0,30,-30,0,-,0,0,0,#DIV/0!,48,-48
ZCTA5 39755,385,329,56,827,55.4,443,0,373,0.451027811,969,-142
ZCTA5 39756,540,155,385,1782,40.7,246,0,1536,0.861952862,351,1431
ZCTA5 39759,19247,1783,17464,43990,27.2,24441,1460,16427,0.373425779,4588,39402
ZCTA5 39762,0,243,-243,3541,19.4,2415,71,941,0.26574414,697,2844
ZCTA5 39766,1158,263,895,3165,38.2,2499,0,633,0.2,1054,2111
ZCTA5 39767,392,287,105,838,53.5,733,0,28,0.033412888,814,24
ZCTA5 39769,609,1222,-613,1287,44.8,1023,103,160,0.124320124,3390,-2103
ZCTA5 39771,49,78,-29,118,54.4,112,4,0,0,232,-114
ZCTA5 39772,787,103,684,1814,46,800,0,1007,0.555126792,430,1384
ZCTA5 39773,6090,1952,4138,15006,38.8,5711,12,9000,0.599760096,5104,9902
ZCTA5 39776,531,56,475,1186,51.8,812,0,355,0.299325464,129,1057
ZCTA5 39813,699,153,546,1841,37.8,631,127,1025,0.556762629,348,1493
ZCTA5 39815,499,18,481,1599,37.5,497,0,822,0.514071295,46,1553
ZCTA5 39817,3830,135,3695,11035,35.2,4900,0,5745,0.520616221,351,10684
ZCTA5 39819,4527,75,4452,12296,38.2,6332,129,5153,0.419079375,160,12136
ZCTA5 39823,3174,113,3061,8624,40.2,3712,0,4755,0.551368275,410,8214
ZCTA5 39824,259,469,-210,680,39.5,456,0,223,0.327941176,1193,-513
ZCTA5 39825,621,332,289,1733,45.8,1439,0,210,0.121177149,975,758
ZCTA5 39826,300,284,16,725,50.4,311,126,288,0.397241379,782,-57
ZCTA5 39827,1859,190,1669,4651,38.6,4196,0,385,0.082777897,509,4142
ZCTA5 39828,5336,290,5046,15148,36.3,7525,84,6186,0.408370742,769,14379
ZCTA5 39832,4,195,-191,4,-,4,0,0,0,484,-480
ZCTA5 39834,696,130,566,2207,39.6,1716,2,105,0.047575895,335,1872
ZCTA5 39836,140,386,-246,411,27.6,197,0,214,0.520681265,1108,-697
ZCTA5 39837,2591,160,2431,6171,43.7,4001,19,1866,0.30238211,394,5777
ZCTA5 39840,1732,733,999,4633,39.7,1347,7,3204,0.691560544,1885,2748
ZCTA5 39841,290,255,35,778,54.4,213,0,515,0.661953728,533,245
ZCTA5 39842,2720,462,2258,7659,39.6,2498,247,4680,0.611045828,1024,6635
ZCTA5 39845,3182,318,2864,8165,47.3,4997,72,2898,0.354929577,791,7374
ZCTA5 39846,616,4425,-3809,1686,42.2,607,0,991,0.587781732,11636,-9950
ZCTA5 39851,867,60,807,1800,49.7,487,49,1249,0.693888889,158,1642
ZCTA5 39854,1021,201,820,2392,57.5,1086,59,1164,0.486622074,565,1827
ZCTA5 39859,356,380,-24,1000,40.1,889,2,73,0.073,1441,-441
ZCTA5 39861,467,97,370,1063,37.9,763,0,223,0.209783631,265,798
ZCTA5 39862,431,289,142,1012,60.7,523,0,458,0.45256917,966,46
ZCTA5 39866,150,88,62,2125,40.4,690,0,1309,0.616,178,1947
ZCTA5 39867,126,1197,-1071,348,57.9,119,0,229,0.658045977,2920,-2572
ZCTA5 39870,766,134,632,1801,48.1,749,86,904,0.501943365,256,1545
ZCTA5 39877,231,219,12,511,56.1,262,0,237,0.463796477,572,-61
ZCTA5 39885,9,37,-28,23,55.8,4,0,11,0.47826087,113,-90
ZCTA5 39886,537,329,208,1525,36.9,608,0,681,0.446557377,822,703
ZCTA5 39897,1402,64,1338,3612,43.9,2845,16,641,0.177464009,92,3520
ZCTA5 40003,699,236,463,1971,50.2,1883,0,77,0.039066464,717,1254
ZCTA5 40004,11967,322,11645,30492,39.4,27192,175,2101,0.068903319,944,29548
ZCTA5 40006,1785,144,1641,5023,43.3,4826,0,15,0.002986263,407,4616
ZCTA5 40007,20,5968,-5948,20,-,20,0,0,0,18879,-18859
ZCTA5 40008,1529,120,1409,3747,52.4,3617,1,81,0.021617294,349,3398
ZCTA5 40009,572,5367,-4795,1460,43.7,1334,0,0,0,13790,-12330
ZCTA5 40010,181,383,-202,612,32.4,612,0,0,0,1110,-498
ZCTA5 40011,926,3821,-2895,2527,38.2,2380,9,54,0.021369213,10901,-8374
ZCTA5 40012,227,64,163,735,34.4,672,0,0,0,271,464
ZCTA5 40013,2275,139,2136,5839,40.1,5509,31,161,0.027573215,362,5477
ZCTA5 40014,7341,193,7148,22533,39.5,20708,363,332,0.014733946,751,21782
ZCTA5 40019,1411,225,1186,3935,35.1,3286,53,227,0.057687421,469,3466
ZCTA5 40020,135,7,128,227,59.8,224,0,0,0,13,214
ZCTA5 40022,291,147,144,876,47.3,747,0,122,0.139269406,417,459
ZCTA5 40023,2165,5581,-3416,5925,44.1,5357,165,344,0.058059072,16380,-10455
ZCTA5 40025,194,973,-779,460,54.8,422,24,0,0,2604,-2144
ZCTA5 40026,2032,838,1194,6400,37,5644,168,218,0.0340625,2177,4223
ZCTA5 40031,7995,1681,6314,25163,39.8,22007,123,1593,0.063307237,4448,20715
ZCTA5 40033,4834,8184,-3350,11827,41.1,10058,133,1170,0.098926186,24599,-12772
ZCTA5 40036,124,1791,-1667,291,52,291,0,0,0,4859,-4568
ZCTA5 40037,1064,1251,-187,2827,36.3,2758,0,17,0.006013442,3623,-796
ZCTA5 40040,180,3029,-2849,460,44.5,419,12,0,0,7602,-7142
ZCTA5 40041,259,1238,-979,361,81.9,349,0,11,0.030470914,3464,-3103
ZCTA5 40045,1340,11072,-9732,3124,43.9,2890,0,2,0.000640205,24974,-21850
ZCTA5 40046,516,3197,-2681,1504,43,1468,0,0,0,7916,-6412
ZCTA5 40047,8216,8231,-15,21971,38.7,20934,147,57,0.002594329,20928,1043
ZCTA5 40049,0,2593,-2593,107,81.1,107,0,0,0,5778,-5671
ZCTA5 40050,712,15074,-14362,1823,42.3,1770,5,26,0.014262205,39399,-37576
ZCTA5 40051,1768,10635,-8867,4739,39.4,4610,8,38,0.008018569,27168,-22429
ZCTA5 40052,194,2062,-1868,497,36.9,497,0,0,0,6013,-5516
ZCTA5 40055,858,6245,-5387,2364,45.2,2261,0,0,0,15896,-13532
ZCTA5 40056,1270,662,608,3453,44.3,3116,55,107,0.030987547,1577,1876
ZCTA5 40057,1575,425,1150,3894,38.1,3696,0,46,0.011813046,973,2921
ZCTA5 40058,17,3824,-3807,27,50.8,18,0,9,0.333333333,10923,-10896
ZCTA5 40059,7653,1022,6631,20205,47.2,17752,1278,622,0.030784459,2730,17475
ZCTA5 40060,500,2870,-2370,1304,35,1283,0,0,0,7778,-6474
ZCTA5 40061,0,2957,-2957,317,20.7,304,0,4,0.012618297,7868,-7551
ZCTA5 40062,77,19513,-19436,197,32.4,197,0,0,0,49097,-48900
ZCTA5 40063,0,541,-541,615,39.2,417,0,162,0.263414634,1368,-753
ZCTA5 40065,11420,391,11029,30682,39.9,24145,457,2505,0.081643961,1093,29589
ZCTA5 40067,2260,463,1797,6287,39.3,5532,39,264,0.041991411,1285,5002
ZCTA5 40068,964,555,409,2665,43.5,2584,0,62,0.02326454,1701,964
ZCTA5 40069,3259,4475,-1216,7843,42.4,6806,35,688,0.087721535,14704,-6861
ZCTA5 40070,162,654,-492,432,36.2,432,0,0,0,1882,-1450
ZCTA5 40071,5701,9056,-3355,16050,42.6,15191,80,329,0.020498442,27546,-11496
ZCTA5 40075,377,10,367,992,54.6,940,0,0,0,28,964
ZCTA5 40076,1128,672,456,3270,36,2927,0,11,0.003363914,2015,1255
ZCTA5 40077,266,5476,-5210,568,42.6,532,0,0,0,14112,-13544
ZCTA5 40078,967,1107,-140,2861,35.7,2742,0,3,0.001048584,3192,-331
ZCTA5 40104,390,9,381,1080,48.8,1039,0,0,0,22,1058
ZCTA5 40107,839,1149,-310,2269,40.9,2256,0,0,0,3036,-767
ZCTA5 40108,4517,680,3837,12717,44.4,11915,148,109,0.008571204,1811,10906
ZCTA5 40109,858,9092,-8234,2271,47.7,2229,0,0,0,20951,-18680
ZCTA5 40110,188,2531,-2343,459,35.5,459,0,0,0,5838,-5379
ZCTA5 40111,680,2029,-1349,1872,42.1,1842,0,2,0.001068376,5485,-3613
ZCTA5 40115,257,6572,-6315,853,39.8,711,0,0,0,16439,-15586
ZCTA5 40117,912,6773,-5861,2493,38.2,2420,0,66,0.026474128,16352,-13859
ZCTA5 40118,3880,640,3240,9751,40.7,8715,170,212,0.02174136,1479,8272
ZCTA5 40119,781,333,448,2045,49.7,1989,0,0,0,891,1154
ZCTA5 40121,2342,216,2126,8916,25.6,5422,264,1234,0.138402871,665,8251
ZCTA5 40140,269,992,-723,641,33,638,0,0,0,2881,-2240
ZCTA5 40142,763,5289,-4526,2104,41,1924,0,126,0.059885932,16355,-14251
ZCTA5 40143,2328,1310,1018,6352,37.9,6249,0,29,0.004565491,3950,2402
ZCTA5 40144,529,1020,-491,1102,50.2,1090,0,0,0,2701,-1599
ZCTA5 40145,205,4461,-4256,760,25.1,732,0,28,0.036842105,12784,-12024
ZCTA5 40146,1368,1315,53,3722,42.2,3317,0,247,0.066362171,3026,696
ZCTA5 40150,1745,2595,-850,4756,46.3,4412,53,57,0.011984861,7333,-2577
ZCTA5 40152,337,819,-482,847,51.6,828,0,0,0,1834,-987
ZCTA5 40155,461,0,461,1131,40.2,1058,0,27,0.023872679,1025,106
ZCTA5 40157,342,8044,-7702,909,34.6,820,0,2,0.00220022,19334,-18425
ZCTA5 40160,9047,7936,1111,23234,35.1,14296,666,5861,0.25225962,21106,2128
ZCTA5 40161,67,598,-531,173,46.9,173,0,0,0,1672,-1499
ZCTA5 40162,1935,427,1508,5223,46,4946,0,29,0.005552365,1326,3897
ZCTA5 40165,14077,3913,10164,37006,42.1,35247,254,435,0.011754851,10216,26790
ZCTA5 40170,159,207,-48,472,56.9,472,0,0,0,530,-58
ZCTA5 40171,114,80,34,181,61.4,181,0,0,0,260,-79
ZCTA5 40175,5328,3374,1954,15568,36.5,12690,167,1369,0.087936793,8211,7357
ZCTA5 40176,329,769,-440,896,36.7,896,0,0,0,2117,-1221
ZCTA5 40177,664,12,652,1632,39,1558,0,0,0,54,1578
ZCTA5 40178,182,5466,-5284,476,49.3,467,0,0,0,14403,-13927
ZCTA5 40202,3030,4032,-1002,7444,38.7,3356,293,3449,0.463326169,10663,-3219
ZCTA5 40203,8917,87,8830,17263,37.8,7604,103,8793,0.509355268,308,16955
ZCTA5 40204,7684,217,7467,14591,35.7,12774,314,1020,0.069906107,560,14031
ZCTA5 40205,10561,162,10399,25161,41.9,23606,220,580,0.023051548,437,24724
ZCTA5 40206,10524,4897,5627,20836,38.1,17126,730,2007,0.096323671,13268,7568
ZCTA5 40207,13688,281,13407,29359,42.5,26785,872,1041,0.035457611,808,28551
ZCTA5 40208,5090,1312,3778,15270,22,9819,260,3773,0.247085789,3129,12141
ZCTA5 40209,209,2233,-2024,465,39,385,0,0,0,5854,-5389
ZCTA5 40210,5733,1437,4296,14746,31.4,1533,11,12566,0.852163299,4879,9867
ZCTA5 40211,9315,441,8874,22167,35.7,731,8,20867,0.941354265,1256,20911
ZCTA5 40212,6745,2329,4416,16548,37.6,6384,0,9421,0.569313512,5665,10883
ZCTA5 40213,7116,2674,4442,15749,38.7,10831,92,3447,0.218871039,7425,8324
ZCTA5 40214,18396,433,17963,47339,36.4,29416,3891,9762,0.206214749,1111,46228
ZCTA5 40215,7845,590,7255,20042,34.3,11051,483,6633,0.330954995,1499,18543
ZCTA5 40216,17401,858,16543,43749,37.8,21405,796,18874,0.431415575,2068,41681
ZCTA5 40217,6053,97,5956,12029,35.5,10409,302,647,0.053786682,267,11762
ZCTA5 40218,13483,277,13206,33779,35,16520,1523,12526,0.370822108,616,33163
ZCTA5 40219,15565,236,15329,38589,36.3,23557,554,9754,0.252766332,854,37735
ZCTA5 40220,15339,191,15148,34723,40.3,27063,1551,4409,0.126976356,599,34124
ZCTA5 40221,0,403,-403,0,-,0,0,0,#DIV/0!,982,-982
ZCTA5 40222,10114,778,9336,21622,41.5,17345,1150,1836,0.084913514,1965,19657
ZCTA5 40223,10046,1184,8862,23739,43,20118,825,1939,0.081679936,3217,20522
ZCTA5 40228,7059,2140,4919,17852,40.7,13320,340,2698,0.151131526,6712,11140
ZCTA5 40229,14725,33,14692,39658,35.7,31152,900,4500,0.11347017,84,39574
ZCTA5 40231,0,4043,-4043,0,-,0,0,0,#DIV/0!,11345,-11345
ZCTA5 40241,12730,402,12328,30189,41.4,23559,1784,3028,0.100301434,863,29326
ZCTA5 40242,4522,252,4270,10982,38.2,8652,582,1259,0.114642142,599,10383
ZCTA5 40243,5445,182,5263,11953,48.1,10245,373,842,0.070442567,463,11490
ZCTA5 40245,13718,355,13363,37503,40.4,30620,2208,3325,0.088659574,997,36506
ZCTA5 40258,10565,3032,7533,27430,38.1,19245,104,6237,0.227378782,7199,20231
ZCTA5 40272,14523,410,14113,38815,38.8,32016,210,4359,0.112301945,1104,37711
ZCTA5 40280,8,192,-184,263,19.8,199,7,40,0.152091255,601,-338
ZCTA5 40291,15379,510,14869,39447,39,30007,731,6208,0.157375719,1163,38284
ZCTA5 40299,16654,864,15790,41448,40.4,33175,1223,5196,0.125361899,2035,39413
ZCTA5 40310,229,128,101,599,44.5,573,0,17,0.028380634,255,344
ZCTA5 40311,2710,344,2366,7472,40.4,7158,0,94,0.0125803,748,6724
ZCTA5 40312,2300,455,1845,5533,42.9,5280,0,0,0,1604,3929
ZCTA5 40313,1076,152,924,2733,39.7,2546,0,0,0,328,2405
ZCTA5 40316,166,131,35,549,42,549,0,0,0,233,316
ZCTA5 40322,1083,696,387,3023,39.8,2985,0,10,0.003307972,2051,972
ZCTA5 40324,18718,483,18235,49958,35,43292,506,2392,0.047880219,1223,48735
ZCTA5 40328,436,136,300,1020,47.1,1020,0,0,0,303,717
ZCTA5 40330,8169,116,8053,19992,43.2,18349,174,833,0.041666667,197,19795
ZCTA5 40334,6,202,-196,15,-,15,0,0,0,448,-433
ZCTA5 40336,4985,2324,2661,12644,42.9,12138,74,4,0.000316356,5855,6789
ZCTA5 40337,1955,2722,-767,5913,34.6,5763,4,3,0.000507357,7786,-1873
ZCTA5 40339,32,1895,-1863,243,58,25,0,218,0.897119342,5311,-5068
ZCTA5 40342,8804,71,8733,23073,41.6,21726,95,578,0.025050925,214,22859
ZCTA5 40346,213,495,-282,774,27.8,710,0,6,0.007751938,1395,-621
ZCTA5 40347,1362,4069,-2707,3802,42.6,3420,3,228,0.059968438,10328,-6526
ZCTA5 40348,352,528,-176,620,55.2,510,0,81,0.130645161,1654,-1034
ZCTA5 40350,65,237,-172,81,58.9,81,0,0,0,635,-554
ZCTA5 40351,7995,99,7896,22539,30.2,21652,188,461,0.020453436,540,21999
ZCTA5 40353,8734,158,8576,21942,41.1,20399,112,756,0.034454471,397,21545
ZCTA5 40355,71,0,71,112,81.1,112,0,0,0,0,112
ZCTA5 40356,16571,102,16469,44241,39.3,40167,562,1630,0.036843652,257,43984
ZCTA5 40357,64,99,-35,158,39.3,152,0,0,0,290,-132
ZCTA5 40358,474,16,458,1099,55.8,936,0,80,0.072793449,56,1043
ZCTA5 40359,2602,13,2589,6921,42,6688,0,46,0.006646438,13,6908
ZCTA5 40360,2685,146,2539,7055,39.9,6925,17,43,0.006094968,489,6566
ZCTA5 40361,7203,31,7172,18280,39.8,15919,23,947,0.051805252,50,18230
ZCTA5 40363,15,438,-423,15,-,15,0,0,0,1074,-1059
ZCTA5 40370,1047,258,789,2539,49.1,2536,0,0,0,671,1868
ZCTA5 40371,1100,4527,-3427,3023,38.3,3006,5,0,0,11998,-8975
ZCTA5 40372,834,3734,-2900,2580,40.6,2552,0,15,0.005813953,11480,-8900
ZCTA5 40374,724,10185,-9461,2198,37.4,2012,0,73,0.033212011,24575,-22377
ZCTA5 40376,15,330,-315,26,-,26,0,0,0,657,-631
ZCTA5 40379,1562,390,1172,3755,46.6,3560,0,34,0.009054594,1007,2748
ZCTA5 40380,2366,238,2128,7507,38.2,7078,99,35,0.004662315,467,7040
ZCTA5 40383,9447,1334,8113,24392,42.4,22215,109,879,0.036036405,3268,21124
ZCTA5 40385,962,35,927,2469,45.1,2431,0,38,0.015390846,76,2393
ZCTA5 40387,680,557,123,1887,46.4,1887,0,0,0,1249,638
ZCTA5 40390,2113,2176,-63,7372,29.2,6285,231,510,0.069180684,4966,2406
ZCTA5 40391,14703,173,14530,36388,41.5,33290,212,1580,0.043420908,373,36015
ZCTA5 40402,780,68,712,2069,44.4,2061,0,1,0.000483325,179,1890
ZCTA5 40403,9795,318,9477,25628,37,23974,64,426,0.016622444,839,24789
ZCTA5 40404,0,341,-341,1329,20.1,1010,23,236,0.177577126,662,667
ZCTA5 40409,1392,368,1024,3623,36.3,3535,0,0,0,847,2776
ZCTA5 40419,1583,79,1504,4478,39.6,4359,0,18,0.004019652,164,4314
ZCTA5 40422,9389,190,9199,25455,38.4,21253,236,2375,0.093301905,322,25133
ZCTA5 40434,0,2228,-2228,0,-,0,0,0,#DIV/0!,5653,-5653
ZCTA5 40437,1990,25,1965,5049,44.5,4912,9,0,0,45,5004
ZCTA5 40440,1146,685,461,2521,44.5,2301,0,8,0.003173344,1833,688
ZCTA5 40442,305,122,183,612,44.8,612,0,0,0,358,254
ZCTA5 40444,5425,167,5258,13965,43.3,12989,0,400,0.028643036,384,13581
ZCTA5 40445,263,330,-67,716,42.6,716,0,0,0,957,-241
ZCTA5 40447,3041,117,2924,7516,43.9,7268,0,44,0.005854178,277,7239
ZCTA5 40448,0,298,-298,0,-,0,0,0,#DIV/0!,590,-590
ZCTA5 40456,3622,1145,2477,8778,46,8502,12,16,0.001822739,2835,5943
ZCTA5 40460,352,491,-139,1109,40,1109,0,0,0,1294,-185
ZCTA5 40461,925,371,554,2410,45,2380,22,8,0.003319502,1025,1385
ZCTA5 40464,413,852,-439,930,51.2,930,0,0,0,2040,-1110
ZCTA5 40468,848,354,494,2138,42.3,2054,32,48,0.022450889,854,1284
ZCTA5 40472,607,176,431,1507,51.2,1488,4,4,0.00265428,458,1049
ZCTA5 40475,25087,98,24989,63835,33.5,57024,742,3104,0.048625362,226,63609
ZCTA5 40481,139,1112,-973,310,28.4,310,0,0,0,2760,-2450
ZCTA5 40484,5001,198,4803,12547,42.3,11460,46,433,0.034510241,583,11964
ZCTA5 40486,1024,433,591,3216,33.6,3192,0,0,0,1263,1953
ZCTA5 40489,1507,160,1347,4384,37.1,4384,0,0,0,461,3923
ZCTA5 40502,12866,65,12801,26996,38.6,24167,793,994,0.03682027,155,26841
ZCTA5 40503,12543,313,12230,28738,37.6,24407,1672,690,0.024010022,832,27906
ZCTA5 40504,11881,237,11644,26437,29.9,16605,512,5028,0.190187994,595,25842
ZCTA5 40505,11010,1326,9684,26081,40.6,18963,219,4906,0.188106284,3051,23030
ZCTA5 40507,1339,309,1030,1907,50.6,1620,18,239,0.12532774,619,1288
ZCTA5 40508,10190,228,9962,26175,23.5,16355,662,6710,0.25635148,550,25625
ZCTA5 40509,18044,514,17530,44352,35.6,31416,3014,6292,0.141865079,1551,42801
ZCTA5 40510,417,216,201,2024,35.8,1527,0,370,0.182806324,460,1564
ZCTA5 40511,13036,132,12904,33696,36.5,19811,772,9242,0.274275878,358,33338
ZCTA5 40513,4395,222,4173,10850,44.7,8282,1919,267,0.024608295,515,10335
ZCTA5 40514,6393,97,6296,17047,38,14477,884,738,0.043292075,287,16760
ZCTA5 40515,14686,19,14667,36251,37.2,29064,1646,2416,0.066646437,32,36219
ZCTA5 40516,1051,196,855,2773,40.6,2231,15,332,0.119725929,510,2263
ZCTA5 40517,16778,321,16457,37296,31.3,24703,664,8620,0.231123981,811,36485
ZCTA5 40526,0,221,-221,1832,19.4,1464,51,235,0.128275109,533,1299
ZCTA5 40536,0,144,-144,0,-,0,0,0,#DIV/0!,443,-443
ZCTA5 40601,22318,94,22224,51377,40.7,42081,937,4861,0.094614322,265,51112
ZCTA5 40701,11302,504,10798,30020,40.3,28971,18,80,0.00266489,1143,28877
ZCTA5 40729,2071,414,1657,5747,44.3,5603,0,31,0.005394119,1009,4738
ZCTA5 40734,1295,200,1095,3655,39.5,3594,0,13,0.003556772,560,3095
ZCTA5 40737,515,1272,-757,1560,40.2,1519,0,0,0,3010,-1450
ZCTA5 40740,1380,436,944,4060,39.6,4032,0,0,0,894,3166
ZCTA5 40741,9389,415,8974,25327,38.5,24445,101,310,0.012239902,966,24361
ZCTA5 40744,6729,268,6461,17938,39.7,17068,28,98,0.005463262,631,17307
ZCTA5 40759,793,40,753,2254,43.6,2244,0,0,0,180,2074
ZCTA5 40763,211,398,-187,449,56.2,449,0,0,0,1109,-660
ZCTA5 40769,5933,649,5284,17758,34.4,16992,63,299,0.016837482,1781,15977
ZCTA5 40771,608,1294,-686,1755,24.9,1640,0,0,0,3429,-1674
ZCTA5 40801,0,226,-226,0,-,0,0,0,#DIV/0!,467,-467
ZCTA5 40803,21,4970,-4949,76,63.2,76,0,0,0,12534,-12458
ZCTA5 40806,872,301,571,2102,44.2,2058,0,0,0,623,1479
ZCTA5 40807,217,199,18,545,44.5,498,0,0,0,454,91
ZCTA5 40808,17,333,-316,72,47.3,55,0,0,0,828,-756
ZCTA5 40810,494,217,277,1229,40.8,1210,0,4,0.003254679,566,663
ZCTA5 40813,121,370,-249,314,58.8,314,0,0,0,977,-663
ZCTA5 40815,372,246,126,911,45.5,803,11,97,0.1064764,675,236
ZCTA5 40816,0,281,-281,0,-,0,0,0,#DIV/0!,1172,-1172
ZCTA5 40818,38,6612,-6574,132,51,132,0,0,0,17153,-17021
ZCTA5 40819,367,166,201,840,50.7,799,0,0,0,333,507
ZCTA5 40820,145,34,111,369,54.2,369,0,0,0,34,335
ZCTA5 40823,1338,105,1233,3623,36,3355,3,19,0.005244273,231,3392
ZCTA5 40824,244,306,-62,713,32.6,681,0,32,0.044880785,721,-8
ZCTA5 40826,208,249,-41,497,38.8,402,0,0,0,676,-179
ZCTA5 40827,315,529,-214,867,50.9,867,0,0,0,1426,-559
ZCTA5 40828,1612,600,1012,4802,39.8,4589,0,138,0.028738026,1792,3010
ZCTA5 40829,42,43,-1,83,44,83,0,0,0,95,-12
ZCTA5 40830,126,229,-103,288,54.8,288,0,0,0,733,-445
ZCTA5 40831,1998,98,1900,4921,41.3,4654,51,164,0.03332656,307,4614
ZCTA5 40840,157,436,-279,510,52.3,495,0,15,0.029411765,1057,-547
ZCTA5 40843,47,96,-49,116,63.3,116,0,0,0,177,-61
ZCTA5 40844,51,47,4,95,64.8,95,0,0,0,115,-20
ZCTA5 40845,229,397,-168,609,51.9,587,0,0,0,787,-178
ZCTA5 40847,59,30,29,210,23.1,210,0,0,0,84,126
ZCTA5 40849,30,339,-309,56,64.7,56,0,0,0,850,-794
ZCTA5 40854,436,1341,-905,996,46.5,948,0,17,0.017068273,3189,-2193
ZCTA5 40855,352,111,241,779,59.4,597,0,133,0.170731707,248,531
ZCTA5 40856,329,183,146,908,35.2,905,0,0,0,569,339
ZCTA5 40858,75,125,-50,229,52.3,229,0,0,0,380,-151
ZCTA5 40862,194,14,180,473,47.2,473,0,0,0,24,449
ZCTA5 40863,184,64,120,424,52.1,424,0,0,0,148,276
ZCTA5 40865,140,221,-81,382,41.1,348,2,0,0,533,-151
ZCTA5 40868,376,254,122,925,42.2,925,0,0,0,665,260
ZCTA5 40870,239,87,152,619,51.4,619,0,0,0,262,357
ZCTA5 40873,798,147,651,2179,34,2143,36,0,0,331,1848
ZCTA5 40874,80,571,-491,137,30.4,137,0,0,0,1639,-1502
ZCTA5 40902,328,1041,-713,818,47.4,767,0,0,0,2577,-1759
ZCTA5 40903,262,34,228,795,41.9,795,0,0,0,80,715
ZCTA5 40906,4348,580,3768,11727,38.9,11236,0,275,0.023450158,1699,10028
ZCTA5 40913,114,411,-297,442,31.5,433,0,9,0.020361991,972,-530
ZCTA5 40914,313,397,-84,824,30.7,824,0,0,0,1263,-439
ZCTA5 40915,326,153,173,931,29.8,931,0,0,0,537,394
ZCTA5 40921,96,119,-23,286,35.9,278,0,0,0,267,19
ZCTA5 40923,239,128,111,697,43.6,697,0,0,0,300,397
ZCTA5 40927,250,137,113,684,38.9,684,0,0,0,365,319
ZCTA5 40935,878,138,740,2276,34.4,2258,0,0,0,298,1978
ZCTA5 40939,55,240,-185,151,37.7,151,0,0,0,619,-468
ZCTA5 40940,121,805,-684,260,54.6,260,0,0,0,2257,-1997
ZCTA5 40941,0,463,-463,0,-,0,0,0,#DIV/0!,1223,-1223
ZCTA5 40943,245,215,30,688,41.1,657,0,0,0,604,84
ZCTA5 40946,20,449,-429,71,74.7,71,0,0,0,1053,-982
ZCTA5 40949,82,353,-271,269,53.4,269,0,0,0,1179,-910
ZCTA5 40953,157,403,-246,344,54.9,344,0,0,0,1118,-774
ZCTA5 40958,209,181,28,549,45.6,549,0,0,0,595,-46
ZCTA5 40962,6081,123,5958,17743,40.9,16138,0,1076,0.060643634,202,17541
ZCTA5 40964,24,259,-235,24,67.2,19,0,0,0,786,-762
ZCTA5 40965,4792,314,4478,11661,39.9,10799,0,375,0.032158477,869,10792
ZCTA5 40972,530,302,228,1579,39.4,1529,0,0,0,855,724
ZCTA5 40977,3157,300,2857,8921,40.8,8559,0,146,0.016365878,548,8373
ZCTA5 40979,0,200,-200,0,-,0,0,0,#DIV/0!,530,-530
ZCTA5 40981,0,398,-398,0,-,0,0,0,#DIV/0!,974,-974
ZCTA5 40982,163,430,-267,604,30.2,440,0,0,0,1359,-755
ZCTA5 40983,83,331,-248,268,55.3,268,0,0,0,861,-593
ZCTA5 40988,182,392,-210,430,37.2,430,0,0,0,1770,-1340
ZCTA5 40995,6,88,-82,6,-,6,0,0,0,130,-124
ZCTA5 40997,130,230,-100,285,23.7,285,0,0,0,394,-109
ZCTA5 41001,6662,14,6648,18619,38,18066,161,60,0.003222515,29,18590
ZCTA5 41002,970,62,908,2599,43.7,2582,0,6,0.00230858,175,2424
ZCTA5 41003,843,227,616,2124,45.8,2018,0,0,0,683,1441
ZCTA5 41004,1303,3141,-1838,3531,41.7,3306,36,148,0.041914472,7627,-4096
ZCTA5 41005,8416,167,8249,25048,37,22546,462,841,0.033575535,397,24651
ZCTA5 41006,1433,89,1344,3563,49.6,3441,22,41,0.011507157,285,3278
ZCTA5 41007,1657,271,1386,4791,42.3,4693,17,7,0.001461073,828,3963
ZCTA5 41008,2775,11902,-9127,7224,38.1,6236,0,364,0.050387597,28218,-20994
ZCTA5 41010,1304,12334,-11030,3193,49,3049,0,0,0,29221,-26028
ZCTA5 41011,12605,792,11813,27115,36.8,20243,528,3443,0.126977688,2057,25058
ZCTA5 41014,2958,610,2348,6972,33.5,5406,64,569,0.081612163,1334,5638
ZCTA5 41015,8099,26,8073,20734,39.7,19152,39,476,0.022957461,52,20682
ZCTA5 41016,2770,1096,1674,6092,37.7,5541,0,109,0.017892318,2611,3481
ZCTA5 41017,15870,653,15217,40703,40.1,38270,548,909,0.022332506,1574,39129
ZCTA5 41018,11497,7591,3906,29041,34,25006,500,1669,0.057470473,19990,9051
ZCTA5 41030,1969,837,1132,5868,31.7,5802,23,0,0,2064,3804
ZCTA5 41031,6433,239,6194,16640,42.1,15714,0,295,0.017728365,627,16013
ZCTA5 41033,632,2510,-1878,2138,38.5,1806,19,0,0,6094,-3956
ZCTA5 41034,477,1414,-937,1075,48.1,1075,0,0,0,3538,-2463
ZCTA5 41035,4386,104,4282,11803,34.2,11085,32,0,0,275,11528
ZCTA5 41039,1009,322,687,2826,37.9,2652,0,36,0.012738854,964,1862
ZCTA5 41040,2869,507,2362,7484,39.5,7288,8,40,0.005344735,1229,6255
ZCTA5 41041,2939,0,2939,7691,38.9,7275,31,182,0.023664023,0,7691
ZCTA5 41042,22003,1813,20190,54363,40,44334,1593,3856,0.070930596,4899,49464
ZCTA5 41043,597,662,-65,1817,51.4,1757,16,20,0.011007155,1690,127
ZCTA5 41044,455,479,-24,1401,33.8,1343,0,0,0,1124,277
ZCTA5 41045,510,2104,-1594,1406,39.5,1336,0,0,0,4757,-3351
ZCTA5 41046,543,1264,-721,2013,30.3,2001,0,0,0,2922,-909
ZCTA5 41048,5390,783,4607,16013,37,15030,210,146,0.009117592,1975,14038
ZCTA5 41049,823,59,764,1915,53.8,1880,5,9,0.004699739,104,1811
ZCTA5 41051,10947,933,10014,31431,35.4,29940,396,401,0.012758105,2465,28966
ZCTA5 41052,89,747,-658,195,43.7,195,0,0,0,1845,-1650
ZCTA5 41055,734,1287,-553,1730,41.8,1603,0,22,0.012716763,2938,-1208
ZCTA5 41056,5345,1103,4242,13941,41.6,12081,156,1035,0.074241446,2640,11301
ZCTA5 41059,1175,1894,-719,3124,43.5,3047,0,12,0.003841229,4808,-1684
ZCTA5 41063,1011,410,601,2622,43.3,2536,34,0,0,1188,1434
ZCTA5 41064,794,1282,-488,2058,39.6,2044,0,6,0.002915452,2973,-915
ZCTA5 41071,9653,900,8753,19860,38.4,17475,160,1367,0.068831823,2356,17504
ZCTA5 41073,2683,787,1896,5578,36.3,5314,26,4,0.000717103,2338,3240
ZCTA5 41074,2564,54,2510,5641,37.6,5011,0,244,0.043254742,214,5427
ZCTA5 41075,6586,25,6561,17332,39.1,16094,286,167,0.009635357,54,17278
ZCTA5 41076,6658,3449,3209,17294,34.6,15930,287,525,0.030357349,8415,8879
ZCTA5 41080,603,9218,-8615,1548,42.5,1540,0,0,0,23792,-22244
ZCTA5 41083,475,451,24,1458,43.6,1440,0,12,0.008230453,1117,341
ZCTA5 41085,398,11818,-11420,1056,38.3,1033,6,3,0.002840909,29397,-28341
ZCTA5 41086,802,468,334,1995,39.8,1662,0,16,0.00802005,899,1096
ZCTA5 41091,7638,763,6875,23992,38,22371,724,107,0.00445982,2036,21956
ZCTA5 41092,1110,619,491,3201,44,3120,0,0,0,1533,1668
ZCTA5 41093,1074,889,185,3037,36.1,3012,5,0,0,2327,710
ZCTA5 41094,4841,688,4153,14313,34.3,13910,46,28,0.001956264,1489,12824
ZCTA5 41095,1359,173,1186,3916,36.1,3289,14,189,0.048263534,360,3556
ZCTA5 41097,2436,62,2374,7030,40.2,6242,7,40,0.0056899,80,6950
ZCTA5 41098,638,333,305,1617,36.9,1559,0,0,0,835,782
ZCTA5 41101,7714,1568,6146,19611,40.2,17560,300,375,0.019121921,3950,15661
ZCTA5 41102,7346,991,6355,19639,46,18519,60,480,0.024441163,2455,17184
ZCTA5 41121,632,953,-321,1881,38,1881,0,0,0,2636,-755
ZCTA5 41124,407,19755,-19348,1092,35.8,1088,0,0,0,53975,-52883
ZCTA5 41129,3511,33,3478,9093,45.6,8797,0,83,0.009127901,33,9060
ZCTA5 41132,168,7972,-7804,289,51.9,289,0,0,0,20109,-19820
ZCTA5 41135,107,12483,-12376,267,51.9,267,0,0,0,30763,-30496
ZCTA5 41139,3332,1015,2317,8378,43.5,8243,15,43,0.00513249,2786,5592
ZCTA5 41141,769,1579,-810,2167,44.8,2130,0,0,0,4114,-1947
ZCTA5 41142,28,417,-389,162,84,162,0,0,0,1095,-933
ZCTA5 41143,4706,37,4669,13774,39.1,13107,0,95,0.006897052,109,13665
ZCTA5 41144,3601,2537,1064,9670,46.1,9162,3,111,0.0114788,6019,3651
ZCTA5 41146,184,2651,-2467,522,39.3,522,0,0,0,6655,-6133
ZCTA5 41149,154,62,92,565,38.3,565,0,0,0,125,440
ZCTA5 41159,164,561,-397,552,37,552,0,0,0,1486,-934
ZCTA5 41164,4467,6410,-1943,12326,44.3,12004,0,3,0.000243388,16422,-4096
ZCTA5 41166,315,593,-278,1241,36.2,1241,0,0,0,1361,-120
ZCTA5 41168,981,12187,-11206,3643,29.6,3567,0,14,0.003842987,30653,-27010
ZCTA5 41169,2293,81,2212,5221,44.1,4986,6,35,0.006703697,197,5024
ZCTA5 41171,1310,77,1233,5009,40.6,4728,0,252,0.050309443,160,4849
ZCTA5 41174,400,312,88,913,52.2,913,0,0,0,814,99
ZCTA5 41175,2201,59,2142,5552,42.2,5437,0,4,0.000720461,152,5400
ZCTA5 41179,2752,138,2614,7189,43.8,6946,10,9,0.001251913,332,6857
ZCTA5 41180,355,535,-180,834,54.2,831,0,0,0,1354,-520
ZCTA5 41181,52,661,-609,125,4.8,125,0,0,0,1804,-1679
ZCTA5 41183,714,15,699,1673,41.3,1547,0,87,0.052002391,120,1553
ZCTA5 41189,709,6660,-5951,1872,39.6,1836,0,0,0,16530,-14658
ZCTA5 41201,71,887,-816,190,45.7,190,0,0,0,2600,-2410
ZCTA5 41203,269,3267,-2998,963,32.2,845,0,1,0.001038422,8065,-7102
ZCTA5 41204,286,465,-179,759,43.4,759,0,0,0,1203,-444
ZCTA5 41214,152,2557,-2405,1562,35.9,857,9,574,0.367477593,6811,-5249
ZCTA5 41216,549,1067,-518,1498,32.5,1472,0,0,0,2520,-1022
ZCTA5 41219,696,235,461,1844,40.7,1784,0,0,0,635,1209
ZCTA5 41222,995,2193,-1198,2783,45.6,2748,0,0,0,5665,-2882
ZCTA5 41224,1566,591,975,3775,44.9,3707,0,0,0,1399,2376
ZCTA5 41226,74,1681,-1607,250,34.3,250,0,0,0,3946,-3696
ZCTA5 41230,4281,5723,-1442,12639,43,12277,229,22,0.001740644,13314,-675
ZCTA5 41231,420,312,108,1019,52.1,1019,0,0,0,796,223
ZCTA5 41232,172,418,-246,504,41.7,504,0,0,0,1294,-790
ZCTA5 41234,202,1583,-1381,548,39.3,548,0,0,0,4117,-3569
ZCTA5 41238,341,2657,-2316,985,40,985,0,0,0,7093,-6108
ZCTA5 41240,2429,4215,-1786,6612,46.4,6519,0,36,0.005444646,19864,-13252
ZCTA5 41250,417,257,160,910,62.5,910,0,0,0,618,292
ZCTA5 41254,239,943,-704,724,23.5,724,0,0,0,2835,-2111
ZCTA5 41255,261,263,-2,663,41.4,641,0,0,0,589,74
ZCTA5 41256,848,17032,-16184,2318,40.8,2209,109,0,0,42928,-40610
ZCTA5 41257,238,102,136,725,42.1,725,0,0,0,252,473
ZCTA5 41260,258,1938,-1680,845,33.7,728,98,19,0.022485207,4681,-3836
ZCTA5 41262,317,381,-64,1061,43.1,1061,0,0,0,1098,-37
ZCTA5 41263,107,4254,-4147,394,39.7,394,0,0,0,10717,-10323
ZCTA5 41264,257,3030,-2773,934,41.1,934,0,0,0,8243,-7309
ZCTA5 41265,460,458,2,1092,42.5,861,0,134,0.122710623,1431,-339
ZCTA5 41267,291,846,-555,1529,25.8,1276,0,33,0.021582734,2425,-896
ZCTA5 41268,337,165,172,877,28.6,877,0,0,0,413,464
ZCTA5 41271,89,859,-770,259,28.6,259,0,0,0,2448,-2189
ZCTA5 41274,243,313,-70,461,36.6,461,0,0,0,826,-365
ZCTA5 41301,2143,5766,-3623,5731,41.2,5547,6,4,0.000697958,13581,-7850
ZCTA5 41310,0,205,-205,0,-,0,0,0,#DIV/0!,497,-497
ZCTA5 41311,2341,262,2079,6534,40,6179,8,94,0.014386287,533,6001
ZCTA5 41314,1577,452,1125,4535,49,4072,9,83,0.018302095,928,3607
ZCTA5 41317,224,17041,-16817,516,45.1,516,0,0,0,42749,-42233
ZCTA5 41332,305,14957,-14652,885,48.5,885,0,0,0,38337,-37452
ZCTA5 41339,4236,3070,1166,10706,41.4,10256,94,143,0.013356996,8341,2365
ZCTA5 41348,465,104,361,1129,42.5,1128,0,0,0,218,911
ZCTA5 41351,8,0,8,8,-,8,0,0,0,0,8
ZCTA5 41352,242,402,-160,520,57.9,520,0,0,0,904,-384
ZCTA5 41360,114,491,-377,363,30.8,349,0,2,0.005509642,1316,-953
ZCTA5 41364,65,911,-846,110,56.2,110,0,0,0,2599,-2489
ZCTA5 41365,303,200,103,650,46.6,650,0,0,0,506,144
ZCTA5 41366,22,1598,-1576,35,52.2,35,0,0,0,4182,-4147
ZCTA5 41367,98,539,-441,252,61.1,252,0,0,0,1424,-1172
ZCTA5 41385,248,3342,-3094,615,46.9,589,0,0,0,9300,-8685
ZCTA5 41386,11,70,-59,11,-,11,0,0,0,194,-183
ZCTA5 41390,38,402,-364,82,59.1,82,0,0,0,1077,-995
ZCTA5 41397,60,713,-653,133,57.5,133,0,0,0,1840,-1707
ZCTA5 41408,170,47,123,328,52.6,328,0,0,0,87,241
ZCTA5 41421,137,319,-182,294,50.1,294,0,0,0,868,-574
ZCTA5 41425,437,702,-265,1218,43.7,1138,0,0,0,1817,-599
ZCTA5 41464,137,367,-230,301,54.4,301,0,0,0,1014,-713
ZCTA5 41465,4134,4533,-399,10968,41.1,10728,52,4,0.000364697,11505,-537
ZCTA5 41472,3300,2186,1114,10811,41.8,9878,120,464,0.042919249,5869,4942
ZCTA5 41501,9306,1835,7471,22689,38.2,21753,269,203,0.008947067,5110,17579
ZCTA5 41503,149,459,-310,421,55.2,421,0,0,0,1255,-834
ZCTA5 41512,250,580,-330,630,50,576,0,54,0.085714286,1395,-765
ZCTA5 41513,196,1493,-1297,356,38.3,356,0,0,0,3896,-3540
ZCTA5 41514,1190,724,466,2721,46.9,2590,4,0,0,1878,843
ZCTA5 41517,22,113,-91,44,65.9,44,0,0,0,315,-271
ZCTA5 41519,312,697,-385,695,36,695,0,0,0,1763,-1068
ZCTA5 41522,2004,0,2004,5359,43.3,5152,0,142,0.026497481,121,5238
ZCTA5 41524,95,227,-132,241,53.3,241,0,0,0,652,-411
ZCTA5 41526,23,2085,-2062,47,-,47,0,0,0,5841,-5794
ZCTA5 41527,345,274,71,811,34,800,0,4,0.004932182,619,192
ZCTA5 41528,154,493,-339,429,42,376,0,0,0,1513,-1084
ZCTA5 41531,376,119,257,982,38.5,969,13,0,0,326,656
ZCTA5 41534,97,22,75,214,60.4,214,0,0,0,33,181
ZCTA5 41535,286,185,101,708,39.8,648,0,0,0,502,206
ZCTA5 41537,1620,686,934,4123,43.2,3871,3,30,0.007276255,1803,2320
ZCTA5 41538,115,87,28,307,61.5,307,0,0,0,158,149
ZCTA5 41539,693,2116,-1423,1425,50.7,1388,0,0,0,6049,-4624
ZCTA5 41540,95,1155,-1060,311,35.9,311,0,0,0,3216,-2905
ZCTA5 41543,252,1081,-829,577,50.5,516,0,0,0,3102,-2525
ZCTA5 41544,209,1265,-1056,553,47.8,539,14,0,0,3747,-3194
ZCTA5 41547,367,2510,-2143,726,52.7,726,0,0,0,6294,-5568
ZCTA5 41548,453,947,-494,1324,42.5,1298,0,0,0,2534,-1210
ZCTA5 41553,781,608,173,2357,41.9,2353,0,4,0.001697073,1610,747
ZCTA5 41554,296,700,-404,817,54,789,19,0,0,1706,-889
ZCTA5 41555,309,1229,-920,1095,38,1095,0,0,0,3324,-2229
ZCTA5 41557,858,15761,-14903,2053,44,1999,0,0,0,37632,-35579
ZCTA5 41558,310,10983,-10673,746,43.8,741,5,0,0,26647,-25901
ZCTA5 41559,184,415,-231,305,59.7,305,0,0,0,1117,-812
ZCTA5 41560,77,2837,-2760,195,55.1,195,0,0,0,8394,-8199
ZCTA5 41562,955,289,666,2237,39.9,2237,0,0,0,748,1489
ZCTA5 41563,114,607,-493,324,43.4,299,0,0,0,1597,-1273
ZCTA5 41564,241,1246,-1005,570,50.9,566,0,0,0,3397,-2827
ZCTA5 41566,199,4317,-4118,583,33.6,504,0,79,0.135506003,11146,-10563
ZCTA5 41567,33,1432,-1399,86,46.6,86,0,0,0,3694,-3608
ZCTA5 41568,350,502,-152,659,58.6,659,0,0,0,1352,-693
ZCTA5 41571,208,697,-489,651,44.7,651,0,0,0,2287,-1636
ZCTA5 41572,1375,218,1157,3165,50.8,3144,21,0,0,632,2533
ZCTA5 41601,288,1151,-863,527,44,512,5,0,0,3291,-2764
ZCTA5 41602,346,654,-308,1035,47.2,939,0,0,0,1755,-720
ZCTA5 41603,671,335,336,1795,40.1,1728,0,0,0,906,889
ZCTA5 41604,197,1776,-1579,542,50.3,485,0,0,0,4536,-3994
ZCTA5 41605,347,509,-162,767,56.5,767,0,0,0,1390,-623
ZCTA5 41606,251,442,-191,597,53.2,597,0,0,0,1200,-603
ZCTA5 41607,169,58,111,414,26.9,361,53,0,0,129,285
ZCTA5 41612,126,692,-566,194,52.2,194,0,0,0,1934,-1740
ZCTA5 41615,137,7634,-7497,407,31.5,407,0,0,0,18408,-18001
ZCTA5 41616,248,9663,-9415,585,41.2,585,0,0,0,23524,-22939
ZCTA5 41619,141,251,-110,323,38.9,265,58,0,0,702,-379
ZCTA5 41621,71,1296,-1225,170,20.9,170,0,0,0,2844,-2674
ZCTA5 41622,86,1213,-1127,132,61.1,132,0,0,0,2701,-2569
ZCTA5 41630,337,705,-368,798,42.3,798,0,0,0,1878,-1080
ZCTA5 41631,288,384,-96,831,30.4,831,0,0,0,978,-147
ZCTA5 41632,229,3793,-3564,506,52.6,499,0,0,0,9633,-9127
ZCTA5 41635,1263,269,994,3179,43.1,3066,0,0,0,726,2453
ZCTA5 41636,433,2464,-2031,1005,40.5,975,0,0,0,5826,-4821
ZCTA5 41640,441,1892,-1451,1096,48.5,1096,0,0,0,4474,-3378
ZCTA5 41642,315,300,15,1023,33.9,1023,0,0,0,798,225
ZCTA5 41643,65,168,-103,121,56.5,121,0,0,0,444,-323
ZCTA5 41645,299,2597,-2298,845,46.2,834,0,0,0,5876,-5031
ZCTA5 41647,502,3900,-3398,1184,55.2,1072,0,59,0.049831081,10354,-9170
ZCTA5 41649,950,81,869,2355,45.1,2350,5,0,0,143,2212
ZCTA5 41650,194,2274,-2080,510,38,510,0,0,0,5646,-5136
ZCTA5 41651,76,0,76,139,53.6,139,0,0,0,0,139
ZCTA5 41653,4135,7849,-3714,10136,42.5,9817,29,191,0.018843725,19822,-9686
ZCTA5 41655,477,528,-51,1266,44.9,1266,0,0,0,1599,-333
ZCTA5 41659,299,1251,-952,743,50.8,743,0,0,0,4777,-4034
ZCTA5 41660,102,102,0,492,19.2,492,0,0,0,149,343
ZCTA5 41663,115,5012,-4897,386,28.5,327,0,59,0.152849741,11757,-11371
ZCTA5 41666,375,1764,-1389,1309,31.5,1253,0,1,0.000763942,4363,-3054
ZCTA5 41667,115,989,-874,336,36,323,0,0,0,2279,-1943
ZCTA5 41669,256,1597,-1341,890,35,878,0,12,0.013483146,4902,-4012
ZCTA5 41701,6092,18727,-12635,15989,40.7,15091,275,118,0.007380074,47658,-31669
ZCTA5 41712,118,705,-587,378,34.5,378,0,0,0,1738,-1360
ZCTA5 41713,44,558,-514,335,25.3,335,0,0,0,1411,-1076
ZCTA5 41714,172,128,44,628,43,628,0,0,0,268,360
ZCTA5 41719,481,683,-202,1073,41.1,1040,0,0,0,1792,-719
ZCTA5 41721,327,2499,-2172,626,49.6,521,0,8,0.012779553,6726,-6100
ZCTA5 41722,509,9183,-8674,1160,41.8,1117,0,0,0,23805,-22645
ZCTA5 41723,465,1561,-1096,1284,34.9,1222,0,0,0,4187,-2903
ZCTA5 41725,181,256,-75,690,29.3,690,0,0,0,660,30
ZCTA5 41727,553,1694,-1141,1439,36.2,1433,0,0,0,4612,-3173
ZCTA5 41729,0,1905,-1905,0,-,0,0,0,#DIV/0!,4742,-4742
ZCTA5 41731,355,6075,-5720,786,56.6,786,0,0,0,15777,-14991
ZCTA5 41735,63,552,-489,125,59.1,125,0,0,0,1524,-1399
ZCTA5 41739,48,127,-79,125,29.7,125,0,0,0,172,-47
ZCTA5 41740,216,707,-491,786,36.7,786,0,0,0,1817,-1031
ZCTA5 41745,187,644,-457,692,29.1,692,0,0,0,1674,-982
ZCTA5 41746,261,781,-520,667,41,489,0,153,0.229385307,1975,-1308
ZCTA5 41749,939,239,700,2406,49.5,2346,32,23,0.009559435,511,1895
ZCTA5 41751,112,3511,-3399,294,57.4,278,0,0,0,8734,-8440
ZCTA5 41754,263,866,-603,597,56.6,597,0,0,0,2542,-1945
ZCTA5 41759,209,3115,-2906,536,45.8,487,0,49,0.09141791,8326,-7790
ZCTA5 41760,180,2010,-1830,370,51.4,370,0,0,0,4977,-4607
ZCTA5 41762,0,286,-286,0,-,0,0,0,#DIV/0!,750,-750
ZCTA5 41763,233,5828,-5595,725,35.5,725,0,0,0,15390,-14665
ZCTA5 41764,219,1292,-1073,452,52.5,418,0,0,0,3168,-2716
ZCTA5 41766,209,52,157,678,49,485,0,0,0,119,559
ZCTA5 41772,135,172,-37,505,20.8,481,0,0,0,415,90
ZCTA5 41773,504,214,290,1184,38.8,1143,0,32,0.027027027,598,586
ZCTA5 41774,1033,2217,-1184,2394,46.7,2266,0,0,0,5736,-3342
ZCTA5 41775,35,835,-800,76,-,76,0,0,0,2387,-2311
ZCTA5 41776,464,384,80,1992,25.9,1992,0,0,0,974,1018
ZCTA5 41777,382,954,-572,1032,36.8,1025,0,0,0,2654,-1622
ZCTA5 41778,108,113,-5,108,-,108,0,0,0,314,-206
ZCTA5 41804,343,868,-525,1235,26.9,1232,0,0,0,2227,-992
ZCTA5 41810,144,955,-811,362,50.6,362,0,0,0,1904,-1542
ZCTA5 41812,115,1012,-897,213,49.1,213,0,0,0,2681,-2468
ZCTA5 41815,282,8904,-8622,676,37.5,669,0,0,0,24288,-23612
ZCTA5 41817,227,50,177,619,33.6,619,0,0,0,141,478
ZCTA5 41819,201,172,29,343,59.1,325,0,0,0,678,-335
ZCTA5 41821,89,1120,-1031,249,42.1,249,0,0,0,2286,-2037
ZCTA5 41822,712,837,-125,1789,44.3,1725,18,35,0.019564002,2351,-562
ZCTA5 41824,331,111,220,769,44.1,769,0,0,0,343,426
ZCTA5 41825,115,2445,-2330,281,61.9,281,0,0,0,7008,-6727
ZCTA5 41826,233,414,-181,605,47,605,0,0,0,976,-371
ZCTA5 41828,223,1353,-1130,691,38.7,646,0,9,0.013024602,3848,-3157
ZCTA5 41831,474,18066,-17592,1008,50,1005,0,0,0,48166,-47158
ZCTA5 41832,141,13251,-13110,276,49.2,276,0,0,0,33056,-32780
ZCTA5 41833,69,13902,-13833,181,40.5,181,0,0,0,38081,-37900
ZCTA5 41834,142,3065,-2923,344,30.9,326,0,0,0,8908,-8564
ZCTA5 41835,276,3371,-3095,716,42,716,0,0,0,10268,-9552
ZCTA5 41836,344,1117,-773,897,56.8,897,0,0,0,4174,-3277
ZCTA5 41837,219,3821,-3602,807,38.2,807,0,0,0,12644,-11837
ZCTA5 41838,331,2329,-1998,1117,52,1117,0,0,0,5839,-4722
ZCTA5 41839,224,20807,-20583,673,45,673,0,0,0,56946,-56273
ZCTA5 41840,328,3062,-2734,1015,45.2,959,0,54,0.05320197,7771,-6756
ZCTA5 41843,209,181,28,346,48.7,346,0,0,0,605,-259
ZCTA5 41844,499,58,441,1497,24.7,1412,17,27,0.018036072,147,1350
ZCTA5 41845,141,4312,-4171,299,55.4,299,0,0,0,12114,-11815
ZCTA5 41847,113,59,54,210,72.7,188,0,21,0.1,137,73
ZCTA5 41848,0,146,-146,0,-,0,0,0,#DIV/0!,359,-359
ZCTA5 41849,73,8489,-8416,155,41.9,155,0,0,0,24722,-24567
ZCTA5 41855,304,98,206,680,54.6,680,0,0,0,311,369
ZCTA5 41858,3106,181,2925,7842,40.9,7727,55,6,0.000765111,422,7420
ZCTA5 41859,111,10848,-10737,232,59.3,232,0,0,0,31465,-31233
ZCTA5 41861,140,2074,-1934,393,49.1,386,0,0,0,5236,-4843
ZCTA5 41862,360,663,-303,854,44.9,830,0,3,0.003512881,1881,-1027
ZCTA5 42001,12874,1503,11371,30881,42.7,24945,501,3929,0.127230336,3442,27439
ZCTA5 42003,11256,11334,-78,28745,40.7,24366,147,3002,0.104435554,28706,39
ZCTA5 42020,777,7619,-6842,1914,40,1818,0,0,0,20738,-18824
ZCTA5 42021,530,24764,-24234,1374,48.5,1274,16,20,0.014556041,59996,-58622
ZCTA5 42022,28,6806,-6778,74,30.5,74,0,0,0,16898,-16824
ZCTA5 42023,829,891,-62,2287,43.8,2165,14,19,0.008307827,2191,96
ZCTA5 42024,426,1448,-1022,908,56.6,865,3,22,0.024229075,3992,-3084
ZCTA5 42025,8127,10123,-1996,19478,46.9,18760,0,192,0.009857275,26917,-7439
ZCTA5 42027,700,4686,-3986,1633,59.2,1591,14,0,0,13130,-11497
ZCTA5 42028,217,13840,-13623,655,37.7,655,0,0,0,39033,-38378
ZCTA5 42029,2634,509,2125,6223,42.2,6025,0,64,0.010284429,1390,4833
ZCTA5 42031,1218,395,823,3352,42.9,2878,5,355,0.105906921,1118,2234
ZCTA5 42032,105,20681,-20576,262,58,188,2,44,0.167938931,52177,-51915
ZCTA5 42035,353,30,323,1035,34.1,1009,0,0,0,58,977
ZCTA5 42036,516,797,-281,961,53.3,921,0,0,0,2316,-1355
ZCTA5 42037,0,2100,-2100,0,-,0,0,0,#DIV/0!,5895,-5895
ZCTA5 42038,2037,4690,-2653,6074,45.6,5574,9,335,0.055153112,12336,-6262
ZCTA5 42039,552,3564,-3012,1273,43.5,1248,6,0,0,8945,-7672
ZCTA5 42040,345,97,248,775,41.4,696,0,0,0,308,467
ZCTA5 42041,1667,8164,-6497,4909,38.3,3795,0,683,0.139132206,20931,-16022
ZCTA5 42044,1508,2069,-561,3870,38.1,3766,11,0,0,6105,-2235
ZCTA5 42045,904,21784,-20880,2291,53.7,2249,28,0,0,56157,-53866
ZCTA5 42047,72,10837,-10765,197,38.5,136,0,0,0,29995,-29798
ZCTA5 42048,721,339,382,1630,41.3,1606,7,3,0.001840491,838,792
ZCTA5 42049,617,9323,-8706,1682,38.2,1469,11,72,0.042806183,22822,-21140
ZCTA5 42050,1087,122,965,3045,39.3,2247,0,765,0.251231527,345,2700
ZCTA5 42051,981,1580,-599,2756,45.6,2644,0,0,0,4470,-1714
ZCTA5 42053,2056,3799,-1743,5423,45.5,5271,24,22,0.004056795,11217,-5794
ZCTA5 42054,493,3004,-2511,1084,37.2,1020,0,0,0,8434,-7350
ZCTA5 42055,1083,540,543,2396,58.7,2174,34,104,0.043405676,1588,808
ZCTA5 42056,555,1135,-580,1593,44.9,1384,13,148,0.092906466,3135,-1542
ZCTA5 42058,800,88,712,2155,39,2125,0,18,0.008352668,152,2003
ZCTA5 42060,0,12423,-12423,0,-,0,0,0,#DIV/0!,33742,-33742
ZCTA5 42061,56,67,-11,70,59.1,56,5,0,0,155,-85
ZCTA5 42064,3041,1512,1529,7966,43.3,7687,30,60,0.007532011,4341,3625
ZCTA5 42066,9457,9273,184,24295,38.7,20814,84,1492,0.061411813,23498,797
ZCTA5 42069,219,497,-278,572,22.9,565,0,7,0.012237762,1614,-1042
ZCTA5 42071,11690,410,11280,30509,33.5,27532,576,1250,0.040971517,1267,29242
ZCTA5 42076,485,0,485,910,58.6,868,0,0,0,0,910
ZCTA5 42078,770,9851,-9081,1846,47.5,1749,5,38,0.020585049,28055,-26209
ZCTA5 42079,460,21767,-21307,1436,42.7,1233,0,0,0,57901,-56465
ZCTA5 42081,761,4978,-4217,1782,47.9,1763,0,6,0.003367003,12192,-10410
ZCTA5 42082,867,183,684,2012,38,1870,41,19,0.00944334,427,1585
ZCTA5 42083,187,30,157,486,31.8,430,0,0,0,69,417
ZCTA5 42085,270,921,-651,696,38.7,686,3,0,0,2347,-1651
ZCTA5 42086,1540,23410,-21870,4167,43.2,3750,0,61,0.014638829,59904,-55737
ZCTA5 42087,1009,1694,-685,2858,44,2636,0,118,0.041287614,4900,-2042
ZCTA5 42088,835,184,651,2122,45.6,1917,0,26,0.012252592,516,1606
ZCTA5 42101,22496,786,21710,63469,27.1,47433,2125,8126,0.128031007,1891,61578
ZCTA5 42103,9100,7602,1498,21440,36.9,18015,1105,1388,0.064738806,18741,2699
ZCTA5 42104,15334,7532,7802,37912,37.6,31605,2901,1668,0.043996624,24185,13727
ZCTA5 42120,848,40,808,2843,33.9,2783,37,0,0,119,2724
ZCTA5 42122,2056,2161,-105,5669,41.7,5177,17,91,0.016052214,5526,143
ZCTA5 42123,438,180,258,1101,32.3,1006,0,0,0,419,682
ZCTA5 42124,30,582,-552,65,31.3,65,0,0,0,1634,-1569
ZCTA5 42127,2894,3385,-491,6960,42.7,6296,96,365,0.052442529,13079,-6119
ZCTA5 42129,2846,13453,-10607,7056,43.7,6848,8,47,0.006660998,38861,-31805
ZCTA5 42130,58,784,-726,148,58,148,0,0,0,2247,-2099
ZCTA5 42131,44,1055,-1011,142,54.6,142,0,0,0,2720,-2578
ZCTA5 42133,550,859,-309,1234,48.4,1217,4,4,0.003241491,2555,-1321
ZCTA5 42134,6876,92,6784,18704,39.3,16005,119,1749,0.09350941,281,18423
ZCTA5 42140,455,390,65,1115,39.7,1089,0,0,0,927,188
ZCTA5 42141,12262,314,11948,31230,40.5,28369,261,1079,0.034550112,1043,30187
ZCTA5 42151,67,1137,-1070,151,46.2,151,0,0,0,3407,-3256
ZCTA5 42153,31,955,-924,66,49.7,66,0,0,0,2219,-2153
ZCTA5 42154,193,95,98,471,47.6,471,0,0,0,252,219
ZCTA5 42156,159,204,-45,286,60.4,286,0,0,0,618,-332
ZCTA5 42157,168,103,65,685,24.4,685,0,0,0,338,347
ZCTA5 42159,723,9050,-8327,1485,44,1301,0,57,0.038383838,22268,-20783
ZCTA5 42160,618,2678,-2060,2068,34.2,1827,0,121,0.058510638,6855,-4787
ZCTA5 42163,21,797,-776,41,34.4,41,0,0,0,2702,-2661
ZCTA5 42164,6359,11883,-5524,16681,41.5,15989,0,109,0.00653438,30186,-13505
ZCTA5 42166,877,9263,-8386,2526,38.9,2476,0,0,0,19712,-17186
ZCTA5 42167,3460,3403,57,8485,41.8,7918,42,235,0.027695934,8170,315
ZCTA5 42170,580,15723,-15143,1280,52.1,1236,18,25,0.01953125,41210,-39930
ZCTA5 42171,2425,5090,-2665,6624,39.5,6134,41,143,0.021588164,11535,-4911
ZCTA5 42202,768,9868,-9100,1937,44.4,1596,10,163,0.084150749,22110,-20173
ZCTA5 42204,280,17104,-16824,624,32.5,562,0,30,0.048076923,45831,-45207
ZCTA5 42206,2128,11036,-8908,5673,40.7,5399,1,127,0.022386744,27479,-21806
ZCTA5 42207,451,241,210,1030,46.7,1023,0,0,0,10341,-9311
ZCTA5 42210,1970,8037,-6067,4772,43.2,4599,0,3,0.000628667,21558,-16786
ZCTA5 42211,5313,9168,-3855,13048,45.6,11901,33,662,0.050735745,18535,-5487
ZCTA5 42214,257,13018,-12761,561,53.6,503,9,0,0,30018,-29457
ZCTA5 42215,645,12214,-11569,1799,43.9,1284,5,396,0.22012229,25801,-24002
ZCTA5 42217,1270,7195,-5925,3294,42,3018,0,134,0.040680024,12123,-8829
ZCTA5 42220,2299,739,1560,6106,40.3,5391,16,324,0.053062561,2524,3582
ZCTA5 42223,4346,10691,-6345,21028,21.8,13969,665,2923,0.139005136,27064,-6036
ZCTA5 42232,210,11280,-11070,577,24.9,514,0,63,0.109185442,24513,-23936
ZCTA5 42234,893,13417,-12524,2368,38.4,1722,0,574,0.242398649,32785,-30417
ZCTA5 42236,240,1441,-1201,739,42.3,568,0,30,0.040595399,4285,-3546
ZCTA5 42240,16619,9220,7399,41318,36.5,28247,689,9641,0.23333656,26567,14751
ZCTA5 42252,26,14838,-14812,80,59.5,80,0,0,0,36303,-36223
ZCTA5 42254,117,8526,-8409,205,44.9,197,0,5,0.024390244,21969,-21764
ZCTA5 42256,1984,20859,-18875,4717,50.2,4598,25,18,0.003815985,52632,-47915
ZCTA5 42259,416,19091,-18675,1206,49.7,1060,0,96,0.07960199,46387,-45181
ZCTA5 42261,3551,21356,-17805,10046,40.8,9700,43,12,0.001194505,52442,-42396
ZCTA5 42262,3280,7606,-4326,9037,24.9,6265,31,2035,0.225185349,18784,-9747
ZCTA5 42265,329,16859,-16530,1012,43.5,942,0,70,0.06916996,42655,-41643
ZCTA5 42266,832,17169,-16337,2575,36.1,2308,39,156,0.060582524,39588,-37013
ZCTA5 42273,264,1585,-1321,633,55.4,621,0,0,0,3178,-2545
ZCTA5 42274,971,20196,-19225,2263,43.5,2215,0,13,0.005744587,54664,-52401
ZCTA5 42275,310,1250,-940,900,36.6,899,0,0,0,3298,-2398
ZCTA5 42276,6038,7819,-1781,15295,38,13367,93,1307,0.085452762,19369,-4074
ZCTA5 42280,146,1243,-1097,437,29.4,437,0,0,0,3150,-2713
ZCTA5 42285,167,2798,-2631,446,33.1,446,0,0,0,7277,-6831
ZCTA5 42286,495,2431,-1936,1968,26.5,1812,0,25,0.012703252,5854,-3886
ZCTA5 42301,18528,60,18468,45349,36.5,38100,1182,3101,0.06838078,183,45166
ZCTA5 42303,16483,1463,15020,41870,39.8,37743,812,1571,0.037520898,4317,37553
ZCTA5 42320,3341,393,2948,8888,37.7,8116,33,91,0.010238524,929,7959
ZCTA5 42321,160,552,-392,376,33.6,376,0,0,0,1329,-953
ZCTA5 42322,51,98,-47,137,44.4,118,0,19,0.138686131,265,-128
ZCTA5 42323,242,145,97,675,48.3,503,0,107,0.158518519,367,308
ZCTA5 42324,413,241,172,1042,43,1028,0,0,0,686,356
ZCTA5 42325,647,964,-317,1578,47.6,1525,1,0,0,2482,-904
ZCTA5 42326,101,5451,-5350,295,29.7,295,0,0,0,13701,-13406
ZCTA5 42327,1595,43,1552,4445,39.3,4326,1,73,0.016422947,84,4361
ZCTA5 42328,435,2119,-1684,1226,40.2,1184,9,0,0,4525,-3299
ZCTA5 42330,3501,773,2728,9710,41.9,9058,12,331,0.034088568,2049,7661
ZCTA5 42332,83,345,-262,134,48.5,119,0,0,0,929,-795
ZCTA5 42333,332,2458,-2126,956,34.5,877,0,66,0.069037657,6771,-5815
ZCTA5 42337,614,14,600,1927,46.7,1624,2,266,0.138038402,42,1885
ZCTA5 42338,21,487,-466,26,48.6,26,0,0,0,1385,-1359
ZCTA5 42339,312,4078,-3766,926,40.9,870,0,28,0.030237581,10694,-9768
ZCTA5 42343,532,614,-82,1622,33.9,1450,0,149,0.091861899,1965,-343
ZCTA5 42344,325,316,9,983,47.6,961,0,0,0,925,58
ZCTA5 42345,4513,1238,3275,11941,42.3,10851,79,661,0.055355498,2969,8972
ZCTA5 42347,2244,465,1779,5857,43,5703,7,25,0.004268397,1489,4368
ZCTA5 42348,1911,2153,-242,5014,39,4916,6,41,0.008177104,5719,-705
ZCTA5 42349,564,359,205,1835,42.4,1828,0,0,0,880,955
ZCTA5 42350,550,497,53,1434,44.1,1396,14,3,0.00209205,1446,-12
ZCTA5 42351,1716,834,882,4661,40.3,4391,22,123,0.026389187,2082,2579
ZCTA5 42352,756,4405,-3649,1700,48.2,1623,0,0,0,10374,-8674
ZCTA5 42354,87,479,-392,253,46.5,250,0,0,0,1358,-1105
ZCTA5 42355,570,1742,-1172,1335,53.5,1294,0,27,0.020224719,4764,-3429
ZCTA5 42356,0,1107,-1107,253,79,233,16,0,0,2997,-2744
ZCTA5 42361,233,308,-75,702,41.3,702,0,0,0,797,-95
ZCTA5 42366,1969,489,1480,5351,42.5,5302,0,30,0.005606429,1159,4192
ZCTA5 42367,307,13162,-12855,839,52.4,834,0,0,0,31372,-30533
ZCTA5 42368,438,0,438,1208,33.8,1134,0,9,0.007450331,5916,-4708
ZCTA5 42369,103,648,-545,298,40.1,298,0,0,0,1868,-1570
ZCTA5 42370,37,234,-197,87,39.1,87,0,0,0,784,-697
ZCTA5 42371,127,108,19,204,67.3,204,0,0,0,302,-98
ZCTA5 42372,671,4142,-3471,1452,49.5,1415,2,25,0.017217631,10179,-8727
ZCTA5 42374,58,1711,-1653,175,51.8,170,0,0,0,4302,-4127
ZCTA5 42376,2336,444,1892,6005,40.5,5710,0,93,0.015487094,1334,4671
ZCTA5 42378,1245,1105,140,3327,38.6,3259,0,11,0.003306282,2819,508
ZCTA5 42404,842,12539,-11697,2321,34.5,2253,0,4,0.001723395,30927,-28606
ZCTA5 42406,979,1927,-948,2452,51.3,2289,0,99,0.040375204,5054,-2602
ZCTA5 42408,2579,1671,908,6718,42.6,6497,0,69,0.010270914,4928,1790
ZCTA5 42409,814,368,446,2450,42.8,2353,6,60,0.024489796,1043,1407
ZCTA5 42410,403,22,381,1073,39.5,905,0,157,0.146318733,96,977
ZCTA5 42411,743,61,682,1737,38.9,1706,0,30,0.017271157,218,1519
ZCTA5 42413,1095,584,511,2522,52.5,2419,0,63,0.024980174,1378,1144
ZCTA5 42420,15524,165,15359,38471,39.5,32965,177,2852,0.074133763,478,37993
ZCTA5 42431,10884,99,10785,26871,37.6,22955,289,2375,0.088385248,203,26668
ZCTA5 42436,576,43,533,1522,39.8,1453,0,0,0,106,1416
ZCTA5 42437,2629,2384,245,7879,35.3,6091,81,1497,0.189998731,4942,2937
ZCTA5 42440,430,359,71,1056,43.4,992,0,43,0.040719697,863,193
ZCTA5 42441,579,651,-72,1519,44,1458,0,17,0.011191573,1679,-160
ZCTA5 42442,1194,456,738,3281,44.3,3118,0,68,0.020725389,1127,2154
ZCTA5 42444,0,76,-76,0,-,0,0,0,#DIV/0!,156,-156
ZCTA5 42445,4370,1358,3012,10289,45.8,9293,0,792,0.076975411,3634,6655
ZCTA5 42450,1636,3618,-1982,3890,45.9,3353,0,413,0.106169666,8800,-4910
ZCTA5 42451,222,1422,-1200,640,28.2,640,0,0,0,3950,-3310
ZCTA5 42452,861,391,470,2239,49.7,2012,1,186,0.0830728,1049,1190
ZCTA5 42453,211,6218,-6007,579,41.3,574,0,0,0,13498,-12919
ZCTA5 42455,1042,227,815,3380,28.5,2712,0,9,0.002662722,511,2869
ZCTA5 42456,641,492,149,1286,49.3,1243,2,0,0,1242,44
ZCTA5 42458,546,177,369,1281,51.8,1281,0,0,0,441,840
ZCTA5 42459,1514,2622,-1108,3726,46.6,3573,0,116,0.031132582,6327,-2601
ZCTA5 42461,528,441,87,1101,44.4,1022,0,67,0.060853769,969,132
ZCTA5 42462,421,0,421,1419,34.9,1065,0,335,0.236081748,0,1419
ZCTA5 42463,75,535,-460,160,52.2,160,0,0,0,1436,-1276
ZCTA5 42464,683,2295,-1612,1464,45.4,1444,0,5,0.003415301,5162,-3698
ZCTA5 42501,6471,840,5631,16629,40.5,15644,125,361,0.021709062,2334,14295
ZCTA5 42503,10033,25,10008,25707,42.8,24761,370,191,0.007429883,64,25643
ZCTA5 42516,221,125,96,610,54.4,610,0,0,0,419,191
ZCTA5 42518,1062,1073,-11,3173,39.8,3040,0,0,0,2784,389
ZCTA5 42519,1187,243,944,3156,43.3,3050,0,1,0.000316857,659,2497
ZCTA5 42528,654,2638,-1984,1842,37,1828,0,0,0,6834,-4992
ZCTA5 42533,351,518,-167,956,43.9,807,22,8,0.008368201,1251,-295
ZCTA5 42539,3710,42,3668,9816,42.8,9322,19,136,0.013854931,68,9748
ZCTA5 42541,112,6209,-6097,231,67.4,231,0,0,0,14562,-14331
ZCTA5 42544,2412,338,2074,5635,47.8,5531,0,28,0.004968944,774,4861
ZCTA5 42553,2197,11391,-9194,6076,36,5951,0,1,0.000164582,28837,-22761
ZCTA5 42565,239,3025,-2786,752,34.4,752,0,0,0,8280,-7528
ZCTA5 42566,107,1078,-971,344,35.6,344,0,0,0,2870,-2526
ZCTA5 42567,2159,1463,696,4838,44.9,4624,0,4,0.000826788,3594,1244
ZCTA5 42602,3754,1116,2638,9255,42.7,8870,108,35,0.00378174,2836,6419
ZCTA5 42603,194,20,174,521,44.5,521,0,0,0,48,473
ZCTA5 42629,2237,1186,1051,5398,47.2,5211,0,110,0.020377918,2783,2615
ZCTA5 42631,54,1306,-1252,191,21.6,191,0,0,0,3082,-2891
ZCTA5 42633,7333,0,7333,18385,42.9,17047,26,220,0.011966277,0,18385
ZCTA5 42634,564,454,110,1744,36.1,1676,0,43,0.024655963,1260,484
ZCTA5 42635,1615,394,1221,5433,42.8,4155,18,871,0.160316584,1145,4288
ZCTA5 42638,46,2243,-2197,157,57.1,157,0,0,0,5736,-5579
ZCTA5 42642,4726,917,3809,12317,40.7,11382,9,114,0.009255501,2343,9974
ZCTA5 42647,1225,6193,-4968,3535,40.1,3509,0,0,0,15418,-11883
ZCTA5 42649,634,78,556,1340,51.3,1340,0,0,0,211,1129
ZCTA5 42653,1380,77,1303,4120,35.7,3769,0,181,0.043932039,136,3984
ZCTA5 42701,21283,1512,19771,52279,38.5,43266,994,5182,0.099122018,4124,48155
ZCTA5 42712,648,547,101,1739,42,1711,0,0,0,1299,440
ZCTA5 42713,761,635,126,1796,42.3,1767,0,24,0.013363029,1718,78
ZCTA5 42715,91,347,-256,209,64.4,209,0,0,0,883,-674
ZCTA5 42716,669,172,497,1450,46.7,1377,0,28,0.019310345,370,1080
ZCTA5 42717,2448,10756,-8308,5953,45.8,5449,54,155,0.026037292,26599,-20646
ZCTA5 42718,9837,589,9248,26010,37.7,23792,224,1206,0.046366782,1603,24407
ZCTA5 42721,1277,43,1234,3676,40,3462,0,0,0,120,3556
ZCTA5 42722,198,1291,-1093,420,53.6,420,0,0,0,4194,-3774
ZCTA5 42724,1875,3094,-1219,5110,42,4426,17,44,0.008610568,8029,-2919
ZCTA5 42726,1791,5756,-3965,5149,39.7,5018,62,10,0.001942125,14231,-9082
ZCTA5 42728,6078,158,5920,16255,39.8,15019,68,433,0.026637958,416,15839
ZCTA5 42729,577,247,330,1368,47.7,1365,0,0,0,570,798
ZCTA5 42732,673,617,56,2325,32.9,2294,0,31,0.013333333,1734,591
ZCTA5 42733,589,15099,-14510,1758,29.5,1716,12,0,0,36721,-34963
ZCTA5 42740,961,92,869,2227,47,2139,62,12,0.005388415,210,2017
ZCTA5 42741,121,994,-873,564,37.5,564,0,0,0,2599,-2035
ZCTA5 42742,31,90,-59,109,20.9,109,0,0,0,140,-31
ZCTA5 42743,3558,703,2855,9076,45.7,8634,0,132,0.014543852,1969,7107
ZCTA5 42746,747,1046,-299,2351,31.8,2204,21,25,0.010633773,3295,-944
ZCTA5 42748,3444,5458,-2014,9164,40.8,8598,50,302,0.032955041,13374,-4210
ZCTA5 42749,2070,12115,-10045,5261,44.3,4238,28,714,0.135715643,32589,-27328
ZCTA5 42753,304,143,161,712,51.8,702,0,0,0,364,348
ZCTA5 42754,5816,2960,2856,15879,41,15279,16,153,0.009635367,7742,8137
ZCTA5 42757,1263,4873,-3610,3203,44.8,2925,0,178,0.0555729,13275,-10072
ZCTA5 42758,12,1120,-1108,36,45,36,0,0,0,2925,-2889
ZCTA5 42759,6,1289,-1283,36,30.1,36,0,0,0,3352,-3316
ZCTA5 42762,41,2435,-2394,178,22.5,59,0,0,0,6979,-6801
ZCTA5 42764,176,4170,-3994,402,40.9,336,0,0,0,8638,-8236
ZCTA5 42765,2278,10707,-8429,6829,35,6531,54,135,0.019768634,28801,-21972
ZCTA5 42776,768,10019,-9251,2205,37.8,2084,4,11,0.004988662,24642,-22437
ZCTA5 42782,289,9939,-9650,735,49.7,634,0,70,0.095238095,24363,-23628
ZCTA5 42784,1044,5768,-4724,2542,38.6,2452,0,30,0.011801731,16037,-13495
ZCTA5 42788,140,9147,-9007,269,41.7,220,15,34,0.126394052,23426,-23157
ZCTA5 43001,1072,1831,-759,2586,53.7,2542,0,2,0.000773395,4510,-1924
ZCTA5 43002,319,7905,-7586,441,69.4,441,0,0,0,19653,-19212
ZCTA5 43003,1095,11993,-10898,2749,45.2,2567,0,31,0.011276828,31067,-28318
ZCTA5 43004,10941,13363,-2422,30901,33.2,17061,2976,8109,0.262418692,32263,-1362
ZCTA5 43005,168,13243,-13075,463,29.7,463,0,0,0,30042,-29579
ZCTA5 43006,156,17725,-17569,351,58.2,316,0,0,0,39719,-39368
ZCTA5 43007,31,8583,-8552,47,68.2,47,0,0,0,20947,-20900
ZCTA5 43008,1036,2713,-1677,2428,49.8,2388,0,0,0,7221,-4793
ZCTA5 43009,680,2959,-2279,2008,45.3,1998,0,7,0.003486056,7661,-5653
ZCTA5 43010,102,2736,-2634,239,49.2,237,0,0,0,6072,-5833
ZCTA5 43011,2485,8972,-6487,7200,38.7,6935,21,21,0.002916667,20263,-13063
ZCTA5 43013,521,22735,-22214,1547,42.1,1538,0,0,0,55815,-54268
ZCTA5 43014,1194,0,1194,3668,28,3617,19,0,0,0,3668
ZCTA5 43015,21467,3066,18401,56671,38,49009,2087,2467,0.043531965,7560,49111
ZCTA5 43016,18509,708,17801,44597,37.7,30041,10837,1912,0.042872839,1662,42935
ZCTA5 43017,15888,85,15803,41569,38.6,31312,4687,2267,0.054535832,234,41335
ZCTA5 43018,25,1284,-1259,48,34.3,48,0,0,0,3649,-3601
ZCTA5 43019,3392,942,2450,9656,39.3,9454,0,8,0.0008285,2598,7058
ZCTA5 43021,4392,454,3938,13239,40.2,11747,443,292,0.022056047,895,12344
ZCTA5 43022,929,27,902,3979,21.1,3646,29,105,0.02638854,43,3936
ZCTA5 43023,4485,170,4315,14574,36.3,13682,395,54,0.003705228,376,14198
ZCTA5 43025,2059,1854,205,5160,42.1,4925,13,57,0.011046512,4787,373
ZCTA5 43026,24574,2799,21775,63295,35.4,51114,4125,3585,0.056639545,9418,53877
ZCTA5 43027,54,8501,-8447,188,11.5,188,0,0,0,20362,-20174
ZCTA5 43028,2802,551,2251,7828,42.7,7566,0,29,0.00370465,1596,6232
ZCTA5 43029,135,430,-295,468,33.9,416,0,9,0.019230769,1008,-540
ZCTA5 43030,104,901,-797,215,55.3,215,0,0,0,2413,-2198
ZCTA5 43031,5125,2266,2859,13549,40.2,13045,28,31,0.002287992,6031,7518
ZCTA5 43032,0,752,-752,0,-,0,0,0,#DIV/0!,1997,-1997
ZCTA5 43033,192,68,124,503,53.5,482,1,5,0.009940358,307,196
ZCTA5 43035,11235,452,10783,33238,35.5,23901,5531,1996,0.060051748,1180,32058
ZCTA5 43036,146,161,-15,341,40.6,332,0,0,0,345,-4
ZCTA5 43037,62,48,14,204,31.8,198,0,0,0,72,132
ZCTA5 43040,12645,39,12606,35695,38.4,32459,604,1137,0.031853201,112,35583
ZCTA5 43044,1967,710,1257,5087,42.7,4890,11,46,0.009042658,2159,2928
ZCTA5 43045,641,135,506,1899,35.2,1740,3,35,0.018430753,388,1511
ZCTA5 43046,1463,633,830,3445,49,3350,0,9,0.002612482,1561,1884
ZCTA5 43047,9,332,-323,22,54.7,22,0,0,0,788,-766
ZCTA5 43050,12151,1161,10990,30680,41.9,28721,270,346,0.011277705,2957,27723
ZCTA5 43054,10624,841,9783,28174,36.2,20584,2276,2646,0.093916377,2173,26001
ZCTA5 43055,24398,80,24318,62187,38.9,57356,385,1641,0.026388152,172,62015
ZCTA5 43056,6957,597,6360,17893,42.9,16660,246,475,0.026546694,1556,16337
ZCTA5 43060,1050,644,406,2675,40.4,2595,0,33,0.012336449,1490,1185
ZCTA5 43061,1601,2325,-724,5085,40,4965,0,0,0,5223,-138
ZCTA5 43062,11281,1431,9850,31479,38.2,26511,1635,1813,0.057593952,3538,27941
ZCTA5 43064,5711,22,5689,16900,37.4,14778,1274,324,0.019171598,40,16860
ZCTA5 43065,15864,578,15286,44363,41.1,37696,4108,742,0.01672565,1451,42912
ZCTA5 43066,465,37,428,1033,44.9,982,0,12,0.011616651,100,933
ZCTA5 43067,439,1829,-1390,1199,45.5,1090,0,32,0.026688907,5904,-4705
ZCTA5 43068,23078,3093,19985,58426,34.9,30210,4421,17957,0.307346045,8309,50117
ZCTA5 43070,32,662,-630,69,22.9,69,0,0,0,1592,-1523
ZCTA5 43071,790,498,292,2205,49.4,2159,12,0,0,1470,735
ZCTA5 43072,2312,98,2214,5579,43.5,5263,31,29,0.005198064,261,5318
ZCTA5 43074,5485,744,4741,15057,39.9,13751,341,260,0.017267716,1940,13117
ZCTA5 43076,3331,657,2674,8401,49.6,8081,26,17,0.002023569,1754,6647
ZCTA5 43077,61,1078,-1017,265,23.7,256,0,4,0.01509434,3161,-2896
ZCTA5 43078,8360,1777,6583,20509,40.6,18621,133,609,0.029694281,4371,16138
ZCTA5 43080,1604,513,1091,4765,36.9,4290,0,402,0.084365163,1668,3097
ZCTA5 43081,26339,411,25928,64387,36.3,50403,2996,6907,0.107273207,878,63509
ZCTA5 43082,11822,678,11144,33123,42.3,29446,995,1267,0.038251366,1707,31416
ZCTA5 43084,227,266,-39,813,35,789,0,3,0.003690037,639,174
ZCTA5 43085,10399,1664,8735,26575,37.9,20714,1094,2819,0.10607714,5198,21377
ZCTA5 43101,147,15,132,335,35.1,313,9,0,0,35,300
ZCTA5 43102,1577,1166,411,3861,47.8,3716,0,18,0.004662005,2689,1172
ZCTA5 43103,4076,305,3771,11963,36,11421,0,158,0.013207389,970,10993
ZCTA5 43105,3225,2155,1070,8731,39.1,8379,31,31,0.003550567,5055,3676
ZCTA5 43106,614,358,256,1770,36.3,1670,0,6,0.003389831,1041,729
ZCTA5 43107,1301,885,416,3320,42.8,3162,50,5,0.001506024,4050,-730
ZCTA5 43109,81,26,55,162,39.6,131,0,28,0.172839506,59,103
ZCTA5 43110,15795,288,15507,38123,34.4,22120,1428,12684,0.332712536,799,37324
ZCTA5 43111,41,8148,-8107,94,57.1,94,0,0,0,19380,-19286
ZCTA5 43112,1613,1759,-146,5092,44.4,5065,0,5,0.000981932,4438,654
ZCTA5 43113,9721,1905,7816,24585,40.9,23585,21,405,0.016473459,5214,19371
ZCTA5 43115,538,1107,-569,1883,34,1849,0,13,0.006903877,3365,-1482
ZCTA5 43116,783,2222,-1439,2607,34.6,2297,45,28,0.010740315,6191,-3584
ZCTA5 43117,29,2983,-2954,69,12.7,69,0,0,0,7756,-7687
ZCTA5 43119,10988,66,10922,28432,37.3,22882,1051,1907,0.067072313,136,28296
ZCTA5 43123,26411,681,25730,66351,40.5,58802,1478,3184,0.047987219,1737,64614
ZCTA5 43125,5496,471,5025,13756,42.4,9583,193,3217,0.233861588,1220,12536
ZCTA5 43126,152,54,98,376,48.7,331,0,0,0,161,215
ZCTA5 43127,110,365,-255,367,22.8,367,0,0,0,1043,-676
ZCTA5 43128,906,1480,-574,2177,41.3,2071,0,16,0.007349564,3827,-1650
ZCTA5 43130,23921,1775,22146,61558,40.4,57021,212,1493,0.024253549,4642,56916
ZCTA5 43135,1743,1016,727,3922,49.7,3810,0,0,0,2484,1438
ZCTA5 43136,798,100,698,2255,33.9,2033,25,62,0.027494457,207,2048
ZCTA5 43137,929,937,-8,2233,41.8,2014,12,159,0.071204657,2127,106
ZCTA5 43138,7426,64,7362,19017,38.9,18191,56,108,0.005679129,170,18847
ZCTA5 43140,7806,3693,4113,23966,41.8,20048,261,2538,0.105900025,8553,15413
ZCTA5 43142,60,2388,-2328,112,41.5,91,6,0,0,5936,-5824
ZCTA5 43143,2042,672,1370,5616,38.2,5496,0,30,0.00534188,1707,3909
ZCTA5 43144,181,1456,-1275,425,40.7,419,4,0,0,3641,-3216
ZCTA5 43145,815,3159,-2344,2017,42.8,1934,0,16,0.007932573,7074,-5057
ZCTA5 43146,3655,637,3018,12940,39.6,10704,192,1291,0.099768161,1608,11332
ZCTA5 43147,14796,7,14789,44699,37.2,32737,1374,8022,0.179467102,14,44685
ZCTA5 43148,689,658,31,1870,40,1721,0,9,0.004812834,1585,285
ZCTA5 43149,1074,1288,-214,2654,49.2,2628,0,0,0,3071,-417
ZCTA5 43150,893,9563,-8670,2367,38,2271,0,1,0.000422476,23416,-21049
ZCTA5 43151,86,12,74,233,38.9,226,0,0,0,12,221
ZCTA5 43152,310,107,203,563,57.2,552,0,0,0,237,326
ZCTA5 43153,363,20,343,1006,54.1,828,0,1,0.000994036,46,960
ZCTA5 43154,1247,29,1218,3878,36.7,3858,0,0,0,104,3774
ZCTA5 43155,982,277,705,2322,49.7,2233,3,6,0.002583979,779,1543
ZCTA5 43156,83,93,-10,193,45.6,190,0,0,0,318,-125
ZCTA5 43157,193,321,-128,626,32.6,551,0,0,0,926,-300
ZCTA5 43158,132,794,-662,416,22.9,319,0,0,0,1943,-1527
ZCTA5 43160,8956,122,8834,21933,42,20125,209,706,0.032188939,170,21763
ZCTA5 43162,2681,3768,-1087,6842,45.6,6690,10,12,0.001753873,8625,-1783
ZCTA5 43164,824,2321,-1497,2222,36.3,2075,18,40,0.0180018,5557,-3335
ZCTA5 43201,14156,205,13951,33816,23.3,23917,2512,4869,0.143985096,512,33304
ZCTA5 43202,9384,182,9202,20226,29.2,15928,1995,823,0.040690201,492,19734
ZCTA5 43203,4122,979,3143,9144,32.2,2494,72,5758,0.629702537,2486,6658
ZCTA5 43204,17589,1425,16164,43647,34.4,30278,1157,5924,0.13572525,3339,40308
ZCTA5 43205,5415,1099,4316,12343,33.7,5477,103,5909,0.478732885,2723,9620
ZCTA5 43206,11090,1186,9904,22488,33.8,12274,175,8304,0.369263607,3120,19368
ZCTA5 43207,18992,1068,17924,46038,39,28938,761,12690,0.275641861,2411,43627
ZCTA5 43209,12061,2298,9763,28867,38.3,19325,617,7140,0.247341255,5257,23610
ZCTA5 43210,148,215,-67,12962,19.4,9837,1949,722,0.055701281,517,12445
ZCTA5 43211,8696,6244,2452,22553,32.3,6023,158,14118,0.625992107,17015,5538
ZCTA5 43212,11970,126,11844,22160,30.4,19145,921,719,0.032445848,179,21981
ZCTA5 43213,15582,7437,8145,35954,35.8,14604,673,16618,0.462201702,18556,17398
ZCTA5 43214,12859,5307,7552,26453,40.9,22580,951,1520,0.057460401,11981,14472
ZCTA5 43215,10221,152,10069,15317,30.5,12180,975,1347,0.087941503,294,15023
ZCTA5 43217,738,48,690,2172,24.2,1601,23,336,0.154696133,127,2045
ZCTA5 43218,0,570,-570,0,-,0,0,0,#DIV/0!,1348,-1348
ZCTA5 43219,11826,3870,7956,32130,30.2,6282,1290,21535,0.670245876,9536,22594
ZCTA5 43220,13230,0,13230,29294,36,23044,3199,1293,0.044138731,0,29294
ZCTA5 43221,14627,3091,11536,35172,37.1,30153,2331,588,0.016717844,7326,27846
ZCTA5 43222,1657,0,1657,4303,43,2212,43,867,0.201487334,0,4303
ZCTA5 43223,9103,528,8575,27458,32.7,19004,192,5623,0.204785491,1220,26238
ZCTA5 43224,18098,42,18056,44877,35.4,19623,1911,18750,0.417808677,92,44785
ZCTA5 43227,9985,811,9174,24779,36.1,5829,398,15864,0.640219541,2263,22516
ZCTA5 43228,22983,38,22945,56440,33.1,34542,2163,12953,0.229500354,73,56367
ZCTA5 43229,21939,618,21321,55435,33.1,21759,3473,23798,0.429295571,1453,53982
ZCTA5 43230,24594,1084,23510,58956,36.6,39993,3075,11354,0.1925843,2406,56550
ZCTA5 43231,8528,124,8404,23066,32.8,9692,1239,10062,0.436226481,275,22791
ZCTA5 43232,18943,69,18874,47471,34,15496,566,27061,0.570053296,183,47288
ZCTA5 43235,19107,804,18303,44036,36,34333,3810,3369,0.076505586,2296,41740
ZCTA5 43240,3554,1016,2538,6772,32.3,4073,1872,607,0.089633786,2532,4240
ZCTA5 43302,19972,7725,12247,55090,40,48151,462,3387,0.061481213,20411,34679
ZCTA5 43310,1142,1808,-666,2734,40.1,2696,0,2,0.000731529,4949,-2215
ZCTA5 43311,8089,13716,-5627,19944,39.3,18371,147,634,0.031789009,33727,-13783
ZCTA5 43314,1173,658,515,2943,44.6,2918,2,0,0,1996,947
ZCTA5 43315,2746,7555,-4809,6974,45.6,6725,0,63,0.009033553,20925,-13951
ZCTA5 43316,2514,8900,-6386,6251,41,5970,148,3,0.000479923,22515,-16264
ZCTA5 43317,60,7328,-7268,175,41.4,156,7,0,0,19292,-19117
ZCTA5 43318,1628,2127,-499,3887,46,3715,5,21,0.005402624,5959,-2072
ZCTA5 43319,406,6851,-6445,1010,45.6,841,39,51,0.05049505,16663,-15653
ZCTA5 43320,516,6539,-6023,1258,44,1124,0,5,0.003974563,17298,-16040
ZCTA5 43321,120,8966,-8846,346,38.1,346,0,0,0,23503,-23157
ZCTA5 43322,126,4395,-4269,349,44.6,339,0,0,0,11055,-10706
ZCTA5 43323,312,2990,-2678,646,46.9,609,0,0,0,8126,-7480
ZCTA5 43324,1074,6165,-5091,2503,48.6,2408,51,0,0,16785,-14282
ZCTA5 43325,24,580,-556,111,6.5,111,0,0,0,1872,-1761
ZCTA5 43326,5297,26790,-21493,12927,41.2,12418,54,85,0.006575385,64105,-51178
ZCTA5 43330,32,11817,-11785,56,42.5,51,0,0,0,29676,-29620
ZCTA5 43331,2025,1237,788,4147,52.8,4059,19,4,0.000964553,3013,1134
ZCTA5 43332,677,5839,-5162,1482,43.1,1440,0,0,0,14814,-13332
ZCTA5 43333,285,4290,-4005,872,39.5,821,0,0,0,15790,-14918
ZCTA5 43334,2466,148,2318,6329,45.1,6184,14,20,0.003160057,408,5921
ZCTA5 43336,0,805,-805,0,-,0,0,0,#DIV/0!,2077,-2077
ZCTA5 43337,398,3595,-3197,836,54,815,0,2,0.002392344,9319,-8483
ZCTA5 43338,3757,982,2775,10163,42.9,9465,122,139,0.013677064,2590,7573
ZCTA5 43340,703,121,582,2210,33.1,2183,0,0,0,310,1900
ZCTA5 43341,419,2286,-1867,946,52.1,939,0,0,0,6205,-5259
ZCTA5 43342,1275,12127,-10852,3465,44.4,3401,14,0,0,30891,-27426
ZCTA5 43343,632,7733,-7101,1173,47.1,1166,0,0,0,17788,-16615
ZCTA5 43344,2260,5141,-2881,5908,36.4,5693,23,11,0.001861882,12656,-6748
ZCTA5 43345,356,7329,-6973,970,38.9,968,0,2,0.002061856,19498,-18528
ZCTA5 43346,15,4333,-4318,70,13.6,70,0,0,0,11196,-11126
ZCTA5 43347,474,7584,-7110,1381,35.9,1336,0,0,0,19902,-18521
ZCTA5 43348,1001,24679,-23678,2019,45.4,1799,65,74,0.036651808,60850,-58831
ZCTA5 43350,101,4080,-3979,242,42.6,161,7,0,0,15353,-15111
ZCTA5 43351,4456,693,3763,10748,40.9,10252,8,21,0.001953852,1863,8885
ZCTA5 43356,429,1656,-1227,1003,47.6,747,3,0,0,4487,-3484
ZCTA5 43357,1672,8397,-6725,4422,41.6,4315,0,7,0.001582994,20346,-15924
ZCTA5 43358,1006,13653,-12647,2525,39.4,2273,23,0,0,32830,-30305
ZCTA5 43359,251,1770,-1519,663,45,639,0,0,0,4346,-3683
ZCTA5 43360,676,3891,-3215,1861,36.1,1726,0,0,0,11882,-10021
ZCTA5 43402,14033,1589,12444,31939,26.6,27984,373,1147,0.035912208,4714,27225
ZCTA5 43403,6,21590,-21584,4775,19.4,3764,83,616,0.129005236,56017,-51242
ZCTA5 43406,698,83,615,1710,36.1,1567,0,2,0.001169591,272,1438
ZCTA5 43407,207,2504,-2297,556,56.8,549,0,0,0,6797,-6241
ZCTA5 43408,104,495,-391,376,32.4,370,0,3,0.007978723,1365,-989
ZCTA5 43410,3931,1506,2425,9805,47.6,9110,32,98,0.009994901,3923,5882
ZCTA5 43412,1528,1139,389,3810,51.5,3555,0,8,0.002099738,2832,978
ZCTA5 43413,384,955,-571,982,42,904,13,0,0,2320,-1338
ZCTA5 43414,93,7900,-7807,181,36.3,112,0,0,0,19864,-19683
ZCTA5 43416,1242,6723,-5481,2970,43.8,2671,10,62,0.020875421,15979,-13009
ZCTA5 43420,12191,4181,8010,29798,40.6,25051,177,1416,0.047519968,11405,18393
ZCTA5 43430,1934,7650,-5716,4948,38.2,4536,16,4,0.000808407,16750,-11802
ZCTA5 43431,1762,414,1348,4840,38.8,4420,20,32,0.00661157,984,3856
ZCTA5 43432,425,15490,-15065,1164,51.2,1093,0,0,0,35309,-34145
ZCTA5 43433,24,14656,-14632,45,-,24,0,0,0,33691,-33646
ZCTA5 43434,37,624,-587,150,27.4,123,0,0,0,2004,-1854
ZCTA5 43435,405,0,405,1069,40.8,1029,3,11,0.010289991,732,337
ZCTA5 43436,0,18600,-18600,0,-,0,0,0,#DIV/0!,44496,-44496
ZCTA5 43437,152,7643,-7491,480,30,455,0,2,0.004166667,18745,-18265
ZCTA5 43438,149,9101,-8952,289,65.9,285,0,0,0,23181,-22892
ZCTA5 43439,44,15308,-15264,55,72.1,55,0,0,0,38515,-38460
ZCTA5 43440,2262,11399,-9137,4193,62,4100,17,3,0.000715478,26768,-22575
ZCTA5 43442,356,24750,-24394,881,40.5,840,7,2,0.002270148,52101,-51220
ZCTA5 43443,699,10607,-9908,1858,35.8,1696,0,0,0,26387,-24529
ZCTA5 43445,462,16707,-16245,1048,47.7,1021,0,0,0,41882,-40834
ZCTA5 43446,43,9144,-9101,78,67.3,64,0,8,0.102564103,21012,-20934
ZCTA5 43447,1193,17317,-16124,3214,39.8,3040,56,6,0.001866833,40881,-37667
ZCTA5 43449,3481,9917,-6436,8330,44.5,7848,37,71,0.008523409,23193,-14863
ZCTA5 43450,1466,8804,-7338,3572,48.1,3324,31,35,0.009798432,18650,-15078
ZCTA5 43451,458,2667,-2209,1223,43,1043,0,84,0.068683565,4378,-3155
ZCTA5 43452,6676,3418,3258,14011,53,13129,22,278,0.019841553,7510,6501
ZCTA5 43456,179,8732,-8553,495,51,475,17,3,0.006060606,20206,-19711
ZCTA5 43457,544,4776,-4232,1418,41.5,1255,53,4,0.002820874,10001,-8583
ZCTA5 43458,153,15951,-15798,344,45.1,322,0,0,0,39548,-39204
ZCTA5 43460,2580,5361,-2781,6243,35.9,5881,46,62,0.009931123,12077,-5834
ZCTA5 43462,418,16956,-16538,1012,44.9,965,0,0,0,37763,-36751
ZCTA5 43463,204,13845,-13641,468,52.9,446,0,0,0,33556,-33088
ZCTA5 43464,860,13774,-12914,1935,38.8,1847,0,11,0.005684755,33662,-31727
ZCTA5 43465,2292,7447,-5155,5664,38.9,5123,58,0,0,17281,-11617
ZCTA5 43466,851,17076,-16225,2455,35.8,2387,15,3,0.001221996,38113,-35658
ZCTA5 43467,45,11467,-11422,102,44.2,100,0,0,0,28740,-28638
ZCTA5 43468,215,7540,-7325,702,49.8,690,0,12,0.017094017,16694,-15992
ZCTA5 43469,1170,2011,-841,2805,48,2712,0,33,0.011764706,4544,-1739
ZCTA5 43501,319,12598,-12279,932,38.5,912,0,0,0,30139,-29207
ZCTA5 43502,2594,11638,-9044,6769,44,6106,0,75,0.011079923,29323,-22554
ZCTA5 43504,393,22263,-21870,1050,52.5,1039,6,0,0,50585,-49535
ZCTA5 43505,30,8239,-8209,88,25.7,77,0,0,0,20338,-20250
ZCTA5 43506,6431,6253,178,14620,43.7,14053,79,112,0.007660739,14798,-178
ZCTA5 43510,60,12351,-12291,226,42.8,206,0,0,0,30229,-30003
ZCTA5 43511,418,15881,-15463,1083,37.8,1031,0,0,0,37983,-36900
ZCTA5 43512,11550,11651,-101,28624,42.5,25170,125,650,0.022708217,28024,600
ZCTA5 43515,2970,10082,-7112,7641,41.3,7058,2,13,0.001701348,25689,-18048
ZCTA5 43516,1036,9405,-8369,2696,37.9,2529,10,3,0.00111276,23255,-20559
ZCTA5 43517,1482,8695,-7213,3748,41.8,3393,46,32,0.008537887,21909,-18161
ZCTA5 43518,1100,8535,-7435,2937,36.4,2801,31,22,0.007490637,24036,-21099
ZCTA5 43519,124,6091,-5967,328,31.9,328,0,0,0,15589,-15261
ZCTA5 43520,11,5119,-5108,23,-,23,0,0,0,13843,-13820
ZCTA5 43521,1175,7602,-6427,2931,39.2,2738,15,5,0.001705902,19199,-16268
ZCTA5 43522,1391,10532,-9141,3477,42,3232,30,3,0.000862813,24284,-20807
ZCTA5 43523,28,9399,-9371,47,57.5,34,0,0,0,21906,-21859
ZCTA5 43524,437,13282,-12845,1126,39.4,1059,0,0,0,32519,-31393
ZCTA5 43525,412,13607,-13195,1105,36.4,1023,0,20,0.018099548,29734,-28629
ZCTA5 43526,2035,7464,-5429,5412,35.4,4995,0,17,0.003141168,19196,-13784
ZCTA5 43527,930,7106,-6176,2338,44.9,2192,1,4,0.001710864,18879,-16541
ZCTA5 43528,6602,2433,4169,16660,43.8,13409,598,987,0.059243697,6390,10270
ZCTA5 43529,95,7414,-7319,330,32.3,229,12,10,0.03030303,19506,-19176
ZCTA5 43530,0,16708,-16708,0,-,0,0,0,#DIV/0!,41125,-41125
ZCTA5 43531,124,16602,-16478,339,24.8,339,0,0,0,43699,-43360
ZCTA5 43532,1274,713,561,3428,41.3,3356,6,0,0,2019,1409
ZCTA5 43533,569,949,-380,1418,42.4,1250,0,3,0.002115656,2367,-949
ZCTA5 43534,669,3527,-2858,1694,35.6,1539,30,0,0,9674,-7980
ZCTA5 43535,239,1565,-1326,557,39.6,456,30,0,0,4041,-3484
ZCTA5 43536,104,13655,-13551,204,24,204,0,0,0,29858,-29654
ZCTA5 43537,12484,7640,4844,30075,40.9,26463,348,1562,0.051936825,18428,11647
ZCTA5 43540,550,15276,-14726,1423,35.4,1334,0,0,0,38312,-36889
ZCTA5 43541,59,3235,-3176,155,40,149,1,0,0,8193,-8038
ZCTA5 43542,1491,3206,-1715,4293,40.7,3997,0,66,0.015373864,8616,-4323
ZCTA5 43543,3267,2704,563,7465,43.8,7073,14,33,0.00442063,7662,-197
ZCTA5 43545,5890,1322,4568,14573,41.7,13262,6,110,0.007548206,3986,10587
ZCTA5 43547,143,631,-488,510,49.3,510,0,0,0,2132,-1622
ZCTA5 43548,314,8807,-8493,753,43.6,676,11,20,0.026560425,25373,-24620
ZCTA5 43549,529,16422,-15893,1368,44.2,1296,2,1,0.000730994,39412,-38044
ZCTA5 43551,17755,6313,11442,42570,40.1,38143,1496,630,0.014799154,16029,26541
ZCTA5 43553,185,0,185,501,42.5,437,10,17,0.033932136,4139,-3638
ZCTA5 43554,875,506,369,2018,39.8,1906,15,14,0.006937562,1265,753
ZCTA5 43555,117,384,-267,262,36.8,262,0,0,0,894,-632
ZCTA5 43556,603,1251,-648,1712,33.9,1624,0,3,0.001752336,3215,-1503
ZCTA5 43557,960,2100,-1140,3201,36,2668,13,189,0.059044049,4782,-1581
ZCTA5 43558,5558,3150,2408,13392,44.6,12571,141,155,0.011574074,8373,5019
ZCTA5 43560,12007,23473,-11466,32149,42.8,28268,1221,953,0.029643224,62319,-30170
ZCTA5 43565,155,4954,-4799,422,41.3,352,5,1,0.002369668,12955,-12533
ZCTA5 43566,3475,2091,1384,8128,49,7531,11,71,0.008735236,4990,3138
ZCTA5 43567,4997,938,4059,13147,39.4,11642,111,30,0.002281889,2522,10625
ZCTA5 43569,1088,0,1088,2887,34.4,2586,8,13,0.004502944,0,2887
ZCTA5 43570,1222,13044,-11822,3386,37,3036,16,3,0.000886001,33715,-30329
ZCTA5 43571,2725,3488,-763,7109,42,6780,38,13,0.001828668,9134,-2025
ZCTA5 43604,4949,1863,3086,9811,34.7,3118,60,5851,0.59637142,5048,4763
ZCTA5 43605,10059,2418,7641,25359,32.9,15895,128,3808,0.15016365,6471,18888
ZCTA5 43606,9963,66,9897,25111,33.5,15222,659,7457,0.296961491,109,25002
ZCTA5 43607,8968,1150,7818,20732,32.9,5948,676,12243,0.590536369,3109,17623
ZCTA5 43608,5455,606,4849,14702,33.4,4212,224,8703,0.591960278,1735,12967
ZCTA5 43609,8468,7026,1442,20327,35.1,11252,146,6173,0.303684754,17795,2532
ZCTA5 43610,1770,1712,58,4505,38.7,1236,0,3080,0.683684795,4453,52
ZCTA5 43611,7705,11431,-3726,18635,36.9,14335,45,2311,0.124013952,29997,-11362
ZCTA5 43612,11577,24,11553,28384,34.6,18944,231,5994,0.21117531,105,28279
ZCTA5 43613,13404,2158,11246,32385,34.9,24323,206,4578,0.141361742,5950,26435
ZCTA5 43614,13744,2731,11013,29394,37.7,23129,349,4304,0.14642444,7648,21746
ZCTA5 43615,17948,1461,16487,39618,38.6,27168,1145,9003,0.227245192,4043,35575
ZCTA5 43616,8509,6265,2244,20366,45.2,18136,246,393,0.019296867,15748,4618
ZCTA5 43617,2973,2891,82,8525,40.8,7712,125,287,0.033665689,6113,2412
ZCTA5 43619,3063,3491,-428,7104,41.9,6821,0,0,0,7354,-250
ZCTA5 43620,2290,1523,767,5315,33.7,1949,8,2909,0.547318909,5656,-341
ZCTA5 43623,9027,9303,-276,19749,42,16513,569,1138,0.057623171,21947,-2198
ZCTA5 43701,22739,9118,13621,55406,40.3,49345,307,2226,0.040176154,22622,32784
ZCTA5 43711,12,3227,-3215,63,41.8,63,0,0,0,6606,-6543
ZCTA5 43713,2415,350,2065,6653,44.3,6285,77,26,0.003908011,684,5969
ZCTA5 43716,833,9743,-8910,1665,57.1,1589,0,1,0.000600601,23289,-21624
ZCTA5 43717,60,3042,-2982,140,62.1,130,0,10,0.071428571,8985,-8845
ZCTA5 43718,1101,13561,-12460,2724,46.8,2667,0,1,0.000367107,32364,-29640
ZCTA5 43719,1021,11546,-10525,2599,40.7,2569,6,15,0.005771451,24454,-21855
ZCTA5 43720,454,7817,-7363,1096,54.6,1070,0,0,0,18805,-17709
ZCTA5 43721,89,9679,-9590,305,42.1,305,0,0,0,22564,-22259
ZCTA5 43722,139,8688,-8549,719,17.7,719,0,0,0,20675,-19956
ZCTA5 43723,1911,5625,-3714,4606,39.9,4459,40,5,0.001085541,15077,-10471
ZCTA5 43724,2737,7614,-4877,9188,48.9,8287,0,678,0.073791902,18825,-9637
ZCTA5 43725,8414,1119,7295,20072,39.7,18484,84,756,0.037664408,2939,17133
ZCTA5 43727,575,1244,-669,1323,42.6,1290,0,15,0.011337868,3166,-1843
ZCTA5 43728,501,1692,-1191,1330,49.2,948,13,159,0.119548872,3938,-2608
ZCTA5 43730,842,636,206,2696,40.8,2633,0,9,0.003338279,1448,1248
ZCTA5 43731,1948,3424,-1476,5011,40.7,4860,0,0,0,8218,-3207
ZCTA5 43732,605,8416,-7811,1421,50.7,1374,0,0,0,21769,-20348
ZCTA5 43733,12,4069,-4057,64,-,64,0,0,0,10261,-10197
ZCTA5 43734,598,7397,-6799,1912,41.3,1912,0,0,0,17585,-15673
ZCTA5 43735,62,892,-830,225,37.8,205,20,0,0,2221,-1996
ZCTA5 43736,12,1017,-1005,22,49,19,0,3,0.136363636,2733,-2711
ZCTA5 43738,51,2973,-2922,106,45.9,93,0,13,0.122641509,7401,-7295
ZCTA5 43739,810,641,169,2684,35.3,2639,0,0,0,1546,1138
ZCTA5 43740,94,531,-437,216,41,216,0,0,0,1517,-1301
ZCTA5 43746,312,6576,-6264,658,54.8,658,0,0,0,15423,-14765
ZCTA5 43747,522,1192,-670,1434,37.7,1434,0,0,0,2837,-1403
ZCTA5 43748,1061,6477,-5416,2938,34.6,2845,7,0,0,14680,-11742
ZCTA5 43749,936,613,323,1787,56.5,1752,0,0,0,1572,215
ZCTA5 43750,29,1119,-1090,118,28.1,109,0,0,0,2838,-2720
ZCTA5 43754,466,1163,-697,1386,41,1382,0,2,0.001443001,2519,-1133
ZCTA5 43755,745,1620,-875,1687,49.7,1648,0,9,0.005334914,5734,-4047
ZCTA5 43756,2168,1863,305,5185,47.1,4725,12,142,0.027386692,4695,490
ZCTA5 43758,1102,4125,-3023,2776,41.8,2593,0,171,0.061599424,13169,-10393
ZCTA5 43759,68,1526,-1458,222,41.8,222,0,0,0,3835,-3613
ZCTA5 43760,558,1633,-1075,1485,33.2,1374,0,0,0,4330,-2845
ZCTA5 43761,45,2042,-1997,99,73.4,99,0,0,0,4792,-4693
ZCTA5 43762,1721,15,1706,5296,32,5006,3,142,0.026812689,62,5234
ZCTA5 43764,2867,1744,1123,7808,40.2,7565,0,70,0.008965164,4692,3116
ZCTA5 43766,513,638,-125,1171,48.9,1128,7,0,0,1720,-549
ZCTA5 43767,490,1728,-1238,1010,50.2,969,0,0,0,3993,-2983
ZCTA5 43768,158,808,-650,484,35.1,324,0,17,0.035123967,2085,-1601
ZCTA5 43771,871,4583,-3712,2157,43.9,2137,0,0,0,10673,-8516
ZCTA5 43772,743,1402,-659,1796,40.5,1771,0,13,0.007238307,3360,-1564
ZCTA5 43773,1061,9048,-7987,2896,39,2844,0,0,0,20692,-17796
ZCTA5 43777,1940,468,1472,5187,42.4,4979,4,12,0.002313476,1302,3885
ZCTA5 43778,479,834,-355,1285,42.8,1257,0,0,0,2631,-1346
ZCTA5 43779,213,1168,-955,585,51.6,573,0,0,0,2925,-2340
ZCTA5 43780,909,1110,-201,1934,52.5,1898,8,7,0.003619442,2813,-879
ZCTA5 43782,226,373,-147,733,42.6,733,0,0,0,817,-84
ZCTA5 43783,1898,679,1219,5340,34.6,5073,0,59,0.011048689,1902,3438
ZCTA5 43786,33,11007,-10974,78,56.6,78,0,0,0,26796,-26718
ZCTA5 43787,1152,1511,-359,3200,42.8,3107,0,49,0.0153125,3779,-579
ZCTA5 43788,324,4569,-4245,720,52.9,720,0,0,0,11099,-10379
ZCTA5 43791,62,1686,-1624,198,25.8,198,0,0,0,3817,-3619
ZCTA5 43793,1956,4003,-2047,4474,48.4,4254,15,28,0.006258382,10094,-5620
ZCTA5 43802,381,11178,-10797,1445,28,1358,0,0,0,26921,-25476
ZCTA5 43804,1064,9739,-8675,3833,29.1,3758,1,0,0,22557,-18724
ZCTA5 43805,95,6952,-6857,259,62.9,259,0,0,0,15967,-15708
ZCTA5 43811,290,340,-50,623,50.9,615,0,0,0,858,-235
ZCTA5 43812,7767,1030,6737,18495,42.3,17460,21,352,0.019032171,3203,15292
ZCTA5 43821,1606,17,1589,4300,42.7,4099,28,86,0.02,34,4266
ZCTA5 43822,1876,3879,-2003,4862,40.7,4776,1,24,0.00493624,10228,-5366
ZCTA5 43824,1370,410,960,4202,33.9,4115,0,57,0.013564969,929,3273
ZCTA5 43830,2124,2057,67,6220,38.1,5741,0,61,0.009807074,6018,202
ZCTA5 43832,3328,7381,-4053,7535,44.6,7407,6,50,0.0066357,20130,-12595
ZCTA5 43836,59,972,-913,115,55.3,113,0,0,0,2266,-2151
ZCTA5 43837,728,2239,-1511,1854,48.7,1714,0,26,0.014023732,5360,-3506
ZCTA5 43840,399,5098,-4699,1235,34.8,1230,0,0,0,12079,-10844
ZCTA5 43842,107,1016,-909,188,56.2,188,0,0,0,2447,-2259
ZCTA5 43843,401,8970,-8569,842,60.7,842,0,0,0,20282,-19440
ZCTA5 43844,1652,15252,-13600,4324,41.5,4147,108,4,0.000925069,33741,-29417
ZCTA5 43845,1808,9194,-7386,4860,38.1,4726,7,9,0.001851852,22484,-17624
ZCTA5 43901,800,12115,-11315,1915,48.9,1839,0,3,0.00156658,27712,-25797
ZCTA5 43902,58,13443,-13385,223,23.1,223,0,0,0,34622,-34399
ZCTA5 43903,778,2144,-1366,2034,46.3,2005,0,0,0,7423,-5389
ZCTA5 43905,173,69,104,463,50.6,463,0,0,0,204,259
ZCTA5 43906,3177,1016,2161,8121,46.9,7475,33,310,0.038172639,2834,5287
ZCTA5 43907,2052,1614,438,5028,49.3,4377,0,453,0.090095465,4022,1006
ZCTA5 43908,455,123,332,1120,51.4,1115,0,0,0,486,634
ZCTA5 43909,25,755,-730,39,55.7,39,0,0,0,2177,-2138
ZCTA5 43910,1428,2093,-665,3447,51.7,3326,34,42,0.012184508,5295,-1848
ZCTA5 43912,2696,856,1840,6175,46.4,5491,0,316,0.051174089,2186,3989
ZCTA5 43913,500,4573,-4073,1192,39.7,1146,0,0,0,12497,-11305
ZCTA5 43914,20,4332,-4312,29,46.7,29,0,0,0,11324,-11295
ZCTA5 43915,548,2392,-1844,1170,53.7,1164,0,0,0,6986,-5816
ZCTA5 43917,1242,719,523,2934,54.1,2862,0,64,0.021813224,1762,1172
ZCTA5 43920,9058,1753,7305,21686,44.5,19573,69,884,0.040763626,4613,17073
ZCTA5 43925,85,7380,-7295,220,44.3,220,0,0,0,18352,-18132
ZCTA5 43926,99,1476,-1377,209,47.6,208,0,0,0,5564,-5355
ZCTA5 43928,43,466,-423,130,33.2,130,0,0,0,1301,-1171
ZCTA5 43930,377,1143,-766,1102,41,1102,0,0,0,3035,-1933
ZCTA5 43931,94,1575,-1481,165,63.6,165,0,0,0,7430,-7265
ZCTA5 43932,375,323,52,927,43.8,890,0,0,0,931,-4
ZCTA5 43933,745,987,-242,2013,44.3,1977,0,0,0,2755,-742
ZCTA5 43934,112,3599,-3487,189,62,189,0,0,0,10166,-9977
ZCTA5 43935,3431,871,2560,8178,40.3,7324,118,290,0.035460993,2690,5488
ZCTA5 43938,2400,859,1541,5810,43.4,5604,0,33,0.005679862,2192,3618
ZCTA5 43939,130,967,-837,271,58.4,265,0,3,0.011070111,2400,-2129
ZCTA5 43940,145,566,-421,368,34.3,368,0,0,0,1489,-1121
ZCTA5 43942,979,92,887,2732,43.4,2685,0,16,0.005856515,312,2420
ZCTA5 43943,1346,7907,-6561,3227,49.9,3207,0,0,0,20320,-17093
ZCTA5 43944,913,1152,-239,2317,49.7,2238,0,40,0.017263703,2907,-590
ZCTA5 43945,1177,1922,-745,3139,44,2841,0,219,0.069767442,4682,-1543
ZCTA5 43946,840,913,-73,2025,46.3,1918,0,0,0,2395,-370
ZCTA5 43947,2026,19121,-17095,5072,45.2,4907,24,0,0,46305,-41233
ZCTA5 43948,245,7603,-7358,691,46.2,671,0,11,0.015918958,18815,-18124
ZCTA5 43950,5257,299,4958,16532,44.7,14668,107,1092,0.066053714,830,15702
ZCTA5 43951,31,14,17,71,62.2,60,0,6,0.084507042,56,15
ZCTA5 43952,6910,220,6690,17428,36.6,13521,203,2485,0.142586642,635,16793
ZCTA5 43953,4876,5648,-772,11928,47.3,10975,124,554,0.046445339,19339,-7411
ZCTA5 43961,129,1151,-1022,289,45.2,284,0,5,0.017301038,2958,-2669
ZCTA5 43962,32,4067,-4035,74,34.4,74,0,0,0,10762,-10688
ZCTA5 43963,615,66,549,1339,45.2,1300,0,1,0.000746826,172,1167
ZCTA5 43964,3946,78,3868,9411,45.3,9003,36,221,0.023483158,261,9150
ZCTA5 43967,51,3682,-3631,223,41.1,182,0,0,0,9311,-9088
ZCTA5 43968,2595,10326,-7731,6068,46,5795,0,166,0.027356625,25241,-19173
ZCTA5 43971,470,1029,-559,1003,48,944,0,4,0.003988036,2901,-1898
ZCTA5 43972,71,5356,-5285,102,83.9,102,0,0,0,14082,-13980
ZCTA5 43973,833,510,323,2295,35.5,2289,0,0,0,1315,980
ZCTA5 43974,35,111,-76,83,51.2,83,0,0,0,217,-134
ZCTA5 43976,612,134,478,1560,50,1516,0,6,0.003846154,276,1284
ZCTA5 43977,809,2199,-1390,2062,40.5,1966,29,9,0.004364694,4776,-2714
ZCTA5 43981,117,921,-804,241,46.9,241,0,0,0,2180,-1939
ZCTA5 43983,149,1672,-1523,316,54.8,316,0,0,0,4728,-4412
ZCTA5 43985,90,897,-807,238,32,238,0,0,0,2438,-2200
ZCTA5 43986,698,32,666,1870,47.9,1843,0,0,0,63,1807
ZCTA5 43988,916,1661,-745,2277,38.9,2255,0,0,0,4285,-2008
ZCTA5 44001,8316,2475,5841,21143,45.8,19742,259,271,0.012817481,7830,13313
ZCTA5 44003,1566,319,1247,4926,31.5,4730,3,139,0.028217621,820,4106
ZCTA5 44004,13221,3490,9731,31469,44.1,26967,197,1929,0.061298421,8305,23164
ZCTA5 44010,558,10468,-9910,1671,49.8,1542,0,17,0.010173549,28157,-26486
ZCTA5 44011,9137,11,9126,24542,41.4,21632,822,1117,0.045513813,161,24381
ZCTA5 44012,10311,1197,9114,25005,45,23083,730,233,0.009318136,3206,21799
ZCTA5 44017,6978,283,6695,18724,35.9,15406,367,1549,0.08272805,788,17936
ZCTA5 44021,2046,88,1958,5706,40.9,5588,0,40,0.007010165,166,5540
ZCTA5 44022,6846,16945,-10099,16675,49.9,15208,399,725,0.043478261,43057,-26382
ZCTA5 44023,7277,38,7239,18842,47.5,17507,251,442,0.023458232,74,18768
ZCTA5 44024,8896,683,8213,24211,45.6,22726,82,183,0.007558548,1684,22527
ZCTA5 44026,4343,82,4261,10772,52.5,10315,155,105,0.009747494,177,10595
ZCTA5 44028,3626,345,3281,9316,47.7,9032,39,15,0.001610133,899,8417
ZCTA5 44030,6020,534,5486,16159,42.9,14537,72,1024,0.063370258,1081,15078
ZCTA5 44032,404,3655,-3251,1284,38.1,1284,0,0,0,8942,-7658
ZCTA5 44035,26894,1686,25208,61921,41.3,47782,394,7951,0.128405549,4052,57869
ZCTA5 44039,13297,7125,6172,35064,40.4,32394,176,578,0.016484143,18709,16355
ZCTA5 44040,1117,7148,-6031,3086,50.1,2812,113,80,0.025923526,18672,-15586
ZCTA5 44041,5974,3880,2094,14002,48.5,13181,43,319,0.02278246,8883,5119
ZCTA5 44044,4281,10839,-6558,15053,45.6,12180,100,1738,0.115458713,25628,-10575
ZCTA5 44045,289,8074,-7785,680,50.6,652,1,14,0.020588235,18682,-18002
ZCTA5 44046,732,3870,-3138,2231,39,2153,0,27,0.012102196,9844,-7613
ZCTA5 44047,3680,4178,-498,8751,44,8330,38,31,0.003542452,9498,-747
ZCTA5 44048,831,5019,-4188,2332,50.1,2015,46,40,0.017152659,11640,-9308
ZCTA5 44049,76,16148,-16072,198,44.5,160,0,0,0,39054,-38856
ZCTA5 44050,2484,4687,-2203,6867,43.9,6366,11,10,0.00145624,13016,-6149
ZCTA5 44052,11689,2367,9322,28841,36.7,18899,241,6003,0.208141188,6152,22689
ZCTA5 44053,8495,371,8124,20588,39.1,15003,359,2397,0.116427045,941,19647
ZCTA5 44054,5359,412,4947,12642,46.6,11706,55,195,0.015424775,1086,11556
ZCTA5 44055,8108,12756,-4648,19513,38.7,11751,147,2657,0.136165633,32530,-13017
ZCTA5 44056,4733,925,3808,12083,44,9851,688,1186,0.098154432,2455,9628
ZCTA5 44057,7599,78,7521,19384,44.3,18486,121,201,0.010369377,182,19202
ZCTA5 44060,25494,4997,20497,60278,46.6,55702,1339,885,0.014681974,13071,47207
ZCTA5 44062,4275,2963,1312,15858,27,15551,2,137,0.008639173,7622,8236
ZCTA5 44064,683,1020,-337,1447,45.9,1340,5,56,0.03870076,2703,-1256
ZCTA5 44065,1648,287,1361,4020,51.5,3795,0,55,0.013681592,591,3429
ZCTA5 44067,8392,27,8365,20037,46.3,17490,834,1244,0.062085142,39,19998
ZCTA5 44068,84,616,-532,219,48.1,219,0,0,0,1778,-1559
ZCTA5 44070,13289,972,12317,32371,44.5,28430,1019,838,0.025887368,2394,29977
ZCTA5 44072,1999,7531,-5532,5059,48.1,4704,0,3,0.000593003,18081,-13022
ZCTA5 44074,3803,1116,2687,11648,32.7,9247,356,893,0.076665522,3153,8495
ZCTA5 44076,1784,1514,270,5085,37.1,4896,0,85,0.016715831,3759,1326
ZCTA5 44077,23080,11,23069,57759,41.8,48987,345,3587,0.062102876,23,57736
ZCTA5 44080,92,644,-552,145,56.5,145,0,0,0,1819,-1674
ZCTA5 44081,2572,2925,-353,7118,41,6320,18,25,0.003512223,7279,-161
ZCTA5 44082,622,8,614,1874,37.3,1860,0,0,0,22,1852
ZCTA5 44084,1465,7540,-6075,3993,42,3802,5,45,0.011269722,18585,-14592
ZCTA5 44085,1270,6806,-5536,3195,45.7,3108,0,72,0.022535211,16670,-13475
ZCTA5 44086,887,854,33,2286,40.6,2209,0,0,0,2588,-302
ZCTA5 44087,9021,1542,7479,22195,42.1,15063,1546,4685,0.211083577,4281,17914
ZCTA5 44089,6702,93,6609,15597,48.6,15099,120,125,0.008014362,197,15400
ZCTA5 44090,3977,5302,-1325,10920,41.7,10594,16,30,0.002747253,12789,-1869
ZCTA5 44092,7594,1194,6400,16934,40.7,13780,299,2206,0.130270462,3481,13453
ZCTA5 44093,465,259,206,978,39.5,963,15,0,0,726,252
ZCTA5 44094,16940,2126,14814,37049,44.9,33377,796,1949,0.052606008,5459,31590
ZCTA5 44095,14517,956,13561,32748,43.9,29202,169,1720,0.052522291,2502,30246
ZCTA5 44099,692,220,472,2618,25.9,2532,0,0,0,629,1989
ZCTA5 44101,0,1179,-1179,647,33.5,424,0,138,0.213292117,3166,-2519
ZCTA5 44102,19366,1452,17914,42640,34.4,24416,605,8455,0.198287992,3769,38871
ZCTA5 44103,6921,909,6012,14797,41.1,2264,397,11069,0.748057039,2462,12335
ZCTA5 44104,8283,40,8243,18830,31.9,562,56,17978,0.954753054,51,18779
ZCTA5 44105,14859,1934,12925,34339,39.4,8311,106,23721,0.690788899,5345,28994
ZCTA5 44106,10934,481,10453,24824,31.3,10429,2685,10014,0.403399936,1365,23459
ZCTA5 44107,26319,748,25571,50900,34.6,44218,1008,2838,0.055756385,1808,49092
ZCTA5 44108,9143,444,8699,21711,36.7,1365,64,19239,0.886140666,1299,20412
ZCTA5 44109,16769,46,16723,39502,35.9,24487,504,6329,0.160219736,73,39429
ZCTA5 44110,9303,9349,-46,18449,40.8,2852,32,14030,0.760474822,23583,-5134
ZCTA5 44111,17718,490,17228,42366,36.5,28597,1338,6507,0.153590143,1266,41100
ZCTA5 44112,8236,33,8203,18945,40.9,1436,104,16965,0.895486936,62,18883
ZCTA5 44113,9718,1243,8475,19165,32.4,13065,466,3652,0.1905557,3498,15667
ZCTA5 44114,3847,1233,2614,7004,32.3,3223,1824,1617,0.230868075,3546,3458
ZCTA5 44115,4494,700,3794,8960,27.1,2132,447,5428,0.605803571,2279,6681
ZCTA5 44116,9704,930,8774,21549,44,20172,344,294,0.013643325,2513,19036
ZCTA5 44117,4932,17290,-12358,9970,51,2806,33,6571,0.659077232,41212,-31242
ZCTA5 44118,16477,119,16358,40881,34.2,24329,973,14131,0.345661799,413,40468
ZCTA5 44119,6140,5672,468,12921,41.1,4297,47,7936,0.614193948,13911,-990
ZCTA5 44120,16790,1116,15674,34629,41.1,7380,1156,23760,0.686130122,3075,31554
ZCTA5 44121,13489,1011,12478,33011,35.8,12527,588,18092,0.548059738,3097,29914
ZCTA5 44122,15039,19,15020,36212,45.2,22217,1904,10359,0.286065393,62,36150
ZCTA5 44123,8530,1151,7379,18445,39.7,5613,67,11845,0.642179452,2850,15595
ZCTA5 44124,18946,11481,7465,40326,42.9,30415,2085,5516,0.136785201,29681,10645
ZCTA5 44125,12080,357,11723,29367,39.8,12871,101,14490,0.493410971,1071,28296
ZCTA5 44126,7575,2477,5098,17133,39.6,15245,413,342,0.019961478,7115,10018
ZCTA5 44127,1882,4291,-2409,4573,33.8,1677,0,2478,0.54187623,11255,-6682
ZCTA5 44128,12606,0,12606,28405,41.2,1373,286,26049,0.917056856,2566,25839
ZCTA5 44129,11988,2072,9916,28697,40.4,23150,795,2146,0.074781336,5550,23147
ZCTA5 44130,22822,10031,12791,51451,43.8,41894,2413,3892,0.075644788,25156,26295
ZCTA5 44131,8348,5787,2561,20650,49.5,18924,666,273,0.013220339,14437,6213
ZCTA5 44132,6749,4667,2082,14678,36.8,5073,138,9016,0.614252623,13899,779
ZCTA5 44133,13515,7305,6210,31191,43.8,27281,1447,971,0.031130775,16962,14229
ZCTA5 44134,16107,6538,9569,37631,43.5,33170,880,1126,0.029922139,14626,23005
ZCTA5 44135,11349,186,11163,26836,39.2,15406,1015,5421,0.20200477,538,26298
ZCTA5 44136,10527,4720,5807,25179,45.9,21874,1703,826,0.032805115,13213,11966
ZCTA5 44137,10298,271,10027,23636,40.1,5837,79,17119,0.724276527,682,22954
ZCTA5 44138,9477,11662,-2185,23090,43,21408,511,301,0.013035946,30092,-7002
ZCTA5 44139,8926,22959,-14033,25009,43.8,17005,3149,3246,0.129793274,68127,-43118
ZCTA5 44140,6065,21062,-14997,16051,42.7,15248,50,191,0.01189957,54097,-38046
ZCTA5 44141,5509,17807,-12298,13836,49.5,12157,575,634,0.045822492,44152,-30316
ZCTA5 44142,7671,4786,2885,18592,42,15820,645,800,0.04302926,11316,7276
ZCTA5 44143,10996,6564,4432,24411,48.1,14639,877,7843,0.321289583,17662,6749
ZCTA5 44144,9483,149,9334,22281,40.9,15374,1003,2289,0.10273327,328,21953
ZCTA5 44145,14446,89,14357,34049,46.3,29600,2020,914,0.026843666,341,33708
ZCTA5 44146,14260,407,13853,29686,45.2,10645,74,17402,0.58620225,1204,28482
ZCTA5 44147,8110,12406,-4296,19820,44.4,17344,1053,727,0.036680121,37983,-18163
ZCTA5 44149,8330,8496,-166,21046,47,19126,917,218,0.010358263,22500,-1454
ZCTA5 44201,2513,17475,-14962,6867,45.5,6696,20,24,0.003494976,50859,-43992
ZCTA5 44202,8485,0,8485,21857,44.4,18899,1414,871,0.039849934,0,21857
ZCTA5 44203,16455,10874,5581,38940,43.5,34513,135,2805,0.072033898,26484,12456
ZCTA5 44212,18167,19277,-1110,45835,39.8,42486,510,847,0.018479328,52627,-6792
ZCTA5 44214,749,3136,-2387,2325,39.3,2290,0,6,0.002580645,8282,-5957
ZCTA5 44215,929,5,924,2363,41.9,2190,11,14,0.005924672,165,2198
ZCTA5 44216,3577,1686,1891,9148,46.8,8994,0,15,0.001639703,4671,4477
ZCTA5 44217,1358,1241,117,3548,41.1,3485,0,0,0,3229,319
ZCTA5 44221,13659,888,12771,29721,36.2,25927,1600,1272,0.042798022,2377,27344
ZCTA5 44223,8395,8049,346,18240,45.8,16576,392,564,0.030921053,27484,-9244
ZCTA5 44224,16150,258,15892,39244,39.7,34119,1137,1978,0.050402609,592,38652
ZCTA5 44230,3524,1034,2490,8186,48.6,8047,0,94,0.01148302,2873,5313
ZCTA5 44231,3124,1924,1200,8890,34.5,8565,26,5,0.00056243,5074,3816
ZCTA5 44232,0,8121,-8121,0,-,0,0,0,#DIV/0!,24150,-24150
ZCTA5 44233,2910,4939,-2029,8011,46.5,7534,98,2,0.000249657,13863,-5852
ZCTA5 44234,1259,3707,-2448,3834,41.1,3329,13,310,0.080855503,10300,-6466
ZCTA5 44235,538,17693,-17155,1539,43.7,1539,0,0,0,49401,-47862
ZCTA5 44236,9612,77,9535,26216,43.4,23626,1038,745,0.02841776,204,26012
ZCTA5 44240,16928,954,15974,38844,33,32786,1209,2392,0.061579652,2556,36288
ZCTA5 44241,7225,8489,-1264,17549,41.4,15146,328,1160,0.066100633,22520,-4971
ZCTA5 44243,0,11865,-11865,5394,19.4,4688,99,459,0.085094549,31766,-26372
ZCTA5 44250,586,4414,-3828,1345,52.5,1301,0,0,0,12496,-11151
ZCTA5 44251,400,3361,-2961,924,49.8,856,0,0,0,8858,-7934
ZCTA5 44253,1257,129,1128,3291,49.2,3207,1,29,0.008811911,378,2913
ZCTA5 44254,1961,27,1934,4867,41.6,4713,35,15,0.003081981,63,4804
ZCTA5 44255,2847,1166,1681,7697,45,7350,0,138,0.017929063,3295,4402
ZCTA5 44256,25207,32,25175,64568,43.7,60064,859,982,0.015208772,53,64515
ZCTA5 44260,5126,1339,3787,13181,43.8,12454,0,8,0.000606934,3848,9333
ZCTA5 44262,2142,1297,845,4999,48.4,4488,230,55,0.0110022,3370,1629
ZCTA5 44264,1200,3611,-2411,3072,42.1,2572,415,26,0.008463542,9193,-6121
ZCTA5 44266,13723,4098,9625,32210,43.3,28737,320,1785,0.055417572,11644,20566
ZCTA5 44270,3281,3320,-39,8153,41.1,7677,74,94,0.011529498,8419,-266
ZCTA5 44272,2184,1290,894,5558,39.7,5135,43,107,0.019251529,3697,1861
ZCTA5 44273,2819,112,2707,7217,44.8,7022,0,14,0.001939864,261,6956
ZCTA5 44274,97,91,6,325,36.4,324,0,0,0,242,83
ZCTA5 44275,1120,9337,-8217,2893,46.2,2693,0,53,0.018320083,22966,-20073
ZCTA5 44276,624,1869,-1245,1861,34.3,1792,0,4,0.002149382,5136,-3275
ZCTA5 44278,7384,18542,-11158,18577,46.6,16586,788,804,0.043279324,52009,-33432
ZCTA5 44280,2019,1613,406,5301,48.2,5187,0,13,0.002452367,4573,728
ZCTA5 44281,13504,1765,11739,33297,40.1,31888,399,463,0.013905157,4423,28874
ZCTA5 44285,45,0,45,107,52.2,107,0,0,0,0,107
ZCTA5 44286,2584,586,1998,6402,55,5669,129,168,0.026241799,1732,4670
ZCTA5 44287,2896,89,2807,7980,41.1,7844,23,1,0.000125313,237,7743
ZCTA5 44288,1214,508,706,3164,43.6,2884,0,18,0.005689001,1553,1611
ZCTA5 44301,5811,12350,-6539,13852,35.5,9102,311,3359,0.242492059,31916,-18064
ZCTA5 44302,2575,4020,-1445,4379,44.1,2503,228,1357,0.309888102,11474,-7095
ZCTA5 44303,3659,651,3008,7434,44.7,5786,203,1210,0.162765671,1822,5612
ZCTA5 44304,1296,3142,-1846,3577,23.7,2073,328,1010,0.282359519,9408,-5831
ZCTA5 44305,9193,105,9088,21024,36.7,13652,611,4619,0.219701294,337,20687
ZCTA5 44306,8986,37,8949,21606,33.4,10717,714,8039,0.372072572,108,21498
ZCTA5 44307,2844,3556,-712,5883,36,1061,15,4527,0.769505354,9758,-3875
ZCTA5 44308,443,136,307,1723,21.9,964,73,551,0.319791062,391,1332
ZCTA5 44310,10167,1207,8960,24958,35.1,10843,4472,7370,0.295296097,3531,21427
ZCTA5 44311,2826,317,2509,7200,24.9,3652,169,2597,0.360694444,742,6458
ZCTA5 44312,13474,850,12624,30769,45.2,28693,385,692,0.022490169,2344,28425
ZCTA5 44313,12603,97,12506,27342,38.3,18207,283,6489,0.237327189,324,27018
ZCTA5 44314,8104,73,8031,18391,38,13216,474,3237,0.176010005,222,18169
ZCTA5 44319,9589,1380,8209,22146,45.9,20539,298,615,0.027770252,3453,18693
ZCTA5 44320,8817,573,8244,19104,40.3,5232,259,12419,0.650073283,1634,17470
ZCTA5 44321,6467,1762,4705,16102,42,12241,1393,1475,0.091603528,4652,11450
ZCTA5 44325,0,2379,-2379,1202,19.8,887,23,221,0.183860233,6415,-5213
ZCTA5 44333,7786,42,7744,19031,47.4,16359,457,1184,0.062214282,120,18911
ZCTA5 44401,958,777,181,2459,45.7,2441,0,0,0,2294,165
ZCTA5 44402,1104,2985,-1881,2882,46.9,2804,0,0,0,8757,-5875
ZCTA5 44403,1805,8847,-7042,3756,52.3,3680,16,29,0.00772098,22190,-18434
ZCTA5 44404,603,5965,-5362,1737,45.7,1693,0,17,0.009786989,12044,-10307
ZCTA5 44405,3289,1106,2183,7846,41.4,4454,0,1788,0.227886821,2156,5690
ZCTA5 44406,8888,2601,6287,22579,47.1,20093,849,442,0.019575712,6989,15590
ZCTA5 44408,4652,7508,-2856,10631,43.6,9994,141,0,0,20954,-10323
ZCTA5 44410,7471,5368,2103,16861,48.9,15829,0,347,0.020580037,10157,6704
ZCTA5 44411,798,2543,-1745,2266,38.5,2131,0,0,0,8139,-5873
ZCTA5 44412,979,8605,-7626,2497,45.8,2386,0,2,0.000800961,18480,-15983
ZCTA5 44413,2871,5518,-2647,7024,40.9,6644,20,28,0.003986333,9810,-2786
ZCTA5 44415,0,15552,-15552,0,-,0,0,0,#DIV/0!,36096,-36096
ZCTA5 44417,608,9703,-9095,1426,57,1331,0,0,0,22072,-20646
ZCTA5 44418,483,5328,-4845,1136,62.6,1111,0,8,0.007042254,12147,-11011
ZCTA5 44420,6354,3606,2748,15217,38.6,13677,0,736,0.048366958,8482,6735
ZCTA5 44423,884,12240,-11356,2455,33.8,2418,16,0,0,30014,-27559
ZCTA5 44424,24,3853,-3829,54,53.8,54,0,0,0,9216,-9162
ZCTA5 44425,5826,2858,2968,13331,46.8,12601,80,455,0.034130973,7286,6045
ZCTA5 44427,545,1488,-943,1211,44.3,1211,0,0,0,3814,-2603
ZCTA5 44428,1314,5683,-4369,3154,50.7,3009,13,13,0.00412175,16648,-13494
ZCTA5 44429,1135,6693,-5558,2674,46.1,2541,0,0,0,14268,-11594
ZCTA5 44430,1371,5192,-3821,4980,40.6,3931,0,783,0.157228916,12096,-7116
ZCTA5 44431,1859,8716,-6857,4659,44.9,4560,39,0,0,20129,-15470
ZCTA5 44432,4173,3527,646,12655,43.5,11338,147,822,0.064954563,8964,3691
ZCTA5 44436,1488,2493,-1005,3615,50.7,3523,0,29,0.00802213,5472,-1857
ZCTA5 44437,1740,7994,-6254,4068,44,3826,0,73,0.017944936,18714,-14646
ZCTA5 44438,2358,5764,-3406,5007,42.8,4565,0,41,0.008188536,12698,-7691
ZCTA5 44439,137,11880,-11743,393,31.9,393,0,0,0,27810,-27417
ZCTA5 44440,1887,16263,-14376,4821,47.9,4613,0,31,0.006430201,40393,-35572
ZCTA5 44441,755,2470,-1715,1990,41.5,1780,23,0,0,6672,-4682
ZCTA5 44442,1622,5616,-3994,3977,50.6,3915,0,19,0.00477747,15809,-11832
ZCTA5 44443,736,10863,-10127,2159,40.6,2159,0,0,0,24159,-22000
ZCTA5 44444,4253,8800,-4547,9595,48.6,9283,87,86,0.008963002,19762,-10167
ZCTA5 44445,1226,18083,-16857,3153,43.4,3068,13,27,0.008563273,45802,-42649
ZCTA5 44446,9223,11931,-2708,20241,45.8,18449,236,1029,0.050837409,28727,-8486
ZCTA5 44449,622,9972,-9350,1495,39.2,1495,0,0,0,27450,-25955
ZCTA5 44450,651,9753,-9102,2081,33.4,1856,0,9,0.004324844,23359,-21278
ZCTA5 44451,1205,8705,-7500,2995,46.6,2930,0,20,0.006677796,21945,-18950
ZCTA5 44452,1403,5432,-4029,3383,59.2,3311,17,49,0.014484186,14353,-10970
ZCTA5 44454,286,10124,-9838,690,53.5,690,0,0,0,28580,-27890
ZCTA5 44455,527,7630,-7103,1583,40.6,1551,0,4,0.002526848,18601,-17018
ZCTA5 44460,10505,5698,4807,25080,45.2,24329,28,176,0.007017544,15067,10013
ZCTA5 44470,1595,8601,-7006,4107,48.1,3886,135,22,0.005356708,21605,-17498
ZCTA5 44471,4344,9874,-5530,10492,40.4,9056,150,379,0.03612276,25954,-15462
ZCTA5 44473,1736,5179,-3443,4102,48.1,4019,0,4,0.000975134,13195,-9093
ZCTA5 44481,3729,8047,-4318,9657,43.8,9120,97,223,0.023092058,21485,-11828
ZCTA5 44483,11003,1902,9101,24889,42.9,20383,158,2853,0.114628953,4905,19984
ZCTA5 44484,9094,8571,523,21999,44.8,19064,338,1736,0.078912678,21761,238
ZCTA5 44485,6946,53,6893,15625,40.6,8648,13,5960,0.38144,110,15515
ZCTA5 44490,351,1283,-932,898,40.3,852,0,14,0.0155902,4188,-3290
ZCTA5 44491,1115,823,292,3372,35,3327,0,7,0.002075919,1937,1435
ZCTA5 44493,54,2889,-2835,130,45.1,130,0,0,0,7591,-7461
ZCTA5 44502,3488,3889,-401,9147,31.2,4435,49,3344,0.365584345,11089,-1942
ZCTA5 44503,516,962,-446,1072,50.1,438,8,560,0.52238806,2389,-1317
ZCTA5 44504,2003,103,1900,5031,42.5,2122,215,2492,0.49532896,282,4749
ZCTA5 44505,6788,1610,5178,16835,36,6894,110,7206,0.428036828,4550,12285
ZCTA5 44506,1287,5013,-3726,2762,38.9,703,0,1220,0.441708907,12302,-9540
ZCTA5 44507,1876,97,1779,4804,36,1195,75,2955,0.615112406,213,4591
ZCTA5 44509,5114,2589,2525,11310,39.3,6925,49,3152,0.278691424,6737,4573
ZCTA5 44510,865,448,417,2173,33.7,415,0,1552,0.714219972,1364,809
ZCTA5 44511,8880,1474,7406,19380,46.3,13550,29,4512,0.232817337,5977,13403
ZCTA5 44512,14304,1545,12759,32643,43.3,28064,295,2696,0.082590448,3969,28674
ZCTA5 44514,9504,82,9422,22193,45.7,20467,357,306,0.013788131,199,21994
ZCTA5 44515,12574,399,12175,27620,42.1,23921,105,1909,0.069116582,1140,26480
ZCTA5 44555,0,2013,-2013,206,20,180,0,26,0.126213592,5208,-5002
ZCTA5 44601,13481,130,13351,33396,41.5,30001,75,1846,0.055276081,326,33070
ZCTA5 44606,2478,5970,-3492,8684,27,8509,5,8,0.000921234,15272,-6588
ZCTA5 44607,13,362,-349,85,20.7,85,0,0,0,946,-861
ZCTA5 44608,865,8767,-7902,2367,34.8,2349,8,0,0,21830,-19463
ZCTA5 44609,1488,2324,-836,3432,49.5,3380,0,6,0.001748252,5195,-1763
ZCTA5 44610,95,16577,-16482,264,29,264,0,0,0,40063,-39799
ZCTA5 44611,907,911,-4,2425,40,2297,0,0,0,2308,117
ZCTA5 44612,2233,429,1804,5516,46,5394,0,73,0.013234228,1103,4413
ZCTA5 44613,739,3493,-2754,1850,51.3,1792,0,23,0.012432432,9143,-7293
ZCTA5 44614,5479,205,5274,13243,47,12976,59,36,0.002718417,660,12583
ZCTA5 44615,4135,275,3860,9785,45,9480,0,80,0.008175779,746,9039
ZCTA5 44618,2534,9687,-7153,7077,36.4,6970,10,39,0.00551081,22703,-15626
ZCTA5 44619,94,291,-197,155,60.6,155,0,0,0,656,-501
ZCTA5 44620,761,430,331,1889,40.3,1751,0,19,0.010058232,1176,713
ZCTA5 44621,1714,811,903,4487,37.9,4437,0,8,0.001782928,2197,2290
ZCTA5 44622,7281,2547,4734,18705,39.9,17989,58,51,0.002726544,6921,11784
ZCTA5 44624,1675,55,1620,5795,31.7,5764,0,1,0.000172563,175,5620
ZCTA5 44625,467,631,-164,1405,39.3,1369,0,0,0,1494,-89
ZCTA5 44626,1181,2024,-843,2767,46.5,2609,9,5,0.001807011,5201,-2434
ZCTA5 44627,1759,514,1245,7105,26.2,7072,7,2,0.000281492,1291,5814
ZCTA5 44628,415,277,138,1028,44.7,997,0,0,0,800,228
ZCTA5 44629,1048,1565,-517,2877,33.1,2841,0,12,0.004171011,3501,-624
ZCTA5 44630,34,15377,-15343,152,43.9,152,0,0,0,36328,-36176
ZCTA5 44632,3785,6253,-2468,10548,41,9944,17,196,0.018581722,17123,-6575
ZCTA5 44633,689,2490,-1801,2406,32.5,2390,0,9,0.003740648,6412,-4006
ZCTA5 44634,863,731,132,1829,54.2,1816,0,3,0.001640241,2114,-285
ZCTA5 44637,933,1747,-814,2255,43.1,2243,0,0,0,4523,-2268
ZCTA5 44638,421,280,141,1149,34.1,1128,0,0,0,763,386
ZCTA5 44639,116,144,-28,297,54.5,297,0,0,0,482,-185
ZCTA5 44640,75,33,42,201,29.8,200,0,0,0,114,87
ZCTA5 44641,7916,89,7827,19737,44.3,19103,83,172,0.008714597,220,19517
ZCTA5 44643,1455,70,1385,3913,44.1,3866,0,0,0,168,3745
ZCTA5 44644,2193,59,2134,4782,47.9,4544,0,119,0.024884985,130,4652
ZCTA5 44645,1075,262,813,2995,41.7,2805,7,2,0.00066778,542,2453
ZCTA5 44646,19606,10522,9084,48377,42.1,42476,369,2994,0.061888914,25486,22891
ZCTA5 44647,7885,140,7745,18209,43.9,16935,28,352,0.0193311,407,17802
ZCTA5 44651,323,684,-361,1025,27.9,922,0,0,0,1947,-922
ZCTA5 44652,191,178,13,556,32.3,483,0,24,0.043165468,473,83
ZCTA5 44653,257,91,166,719,41.3,704,0,0,0,301,418
ZCTA5 44654,6191,453,5738,20044,31.2,19572,127,64,0.003192975,1145,18899
ZCTA5 44656,1049,576,473,2508,40.4,2480,0,0,0,1665,843
ZCTA5 44657,4116,11657,-7541,9732,46.7,9118,0,51,0.005240444,30761,-21029
ZCTA5 44659,56,1884,-1828,140,31.6,127,0,0,0,4620,-4480
ZCTA5 44660,42,1342,-1300,112,57.8,112,0,0,0,3677,-3565
ZCTA5 44661,108,833,-725,373,30.2,365,0,0,0,2252,-1879
ZCTA5 44662,3931,7420,-3489,10867,41.8,10613,28,86,0.007913868,18848,-7981
ZCTA5 44663,11177,162,11015,24630,44.9,23024,223,514,0.020868859,438,24192
ZCTA5 44665,82,14160,-14078,186,32.5,186,0,0,0,34910,-34724
ZCTA5 44666,1049,6335,-5286,2596,49,2529,0,0,0,14896,-12300
ZCTA5 44667,5040,138,4902,13643,36.2,11983,338,368,0.02697354,376,13267
ZCTA5 44669,587,2063,-1476,1666,39.6,1601,0,50,0.030012005,5570,-3904
ZCTA5 44670,23,2199,-2176,42,59.3,42,0,0,0,5520,-5478
ZCTA5 44671,39,436,-397,126,35.6,126,0,0,0,1429,-1303
ZCTA5 44672,2168,2966,-798,4750,50.2,4561,22,11,0.002315789,7182,-2432
ZCTA5 44675,837,76,761,1898,54.8,1866,0,0,0,1340,558
ZCTA5 44676,1854,15173,-13319,5494,39.4,5379,0,0,0,38332,-32838
ZCTA5 44677,1000,2324,-1324,2391,43.7,2305,12,21,0.008782936,5311,-2920
ZCTA5 44678,89,303,-214,225,42.6,225,0,0,0,917,-692
ZCTA5 44680,1799,188,1611,4396,43.5,4168,0,15,0.003412193,431,3965
ZCTA5 44681,2664,1327,1337,9081,30.6,8739,59,59,0.006497082,3406,5675
ZCTA5 44682,469,4842,-4373,1354,37.2,1286,0,6,0.004431315,10535,-9181
ZCTA5 44683,3039,5966,-2927,7903,37.4,7670,13,69,0.008730862,14789,-6886
ZCTA5 44685,10888,4566,6322,28404,43.4,26589,421,312,0.010984368,10918,17486
ZCTA5 44687,127,8274,-8147,473,66.9,473,0,0,0,18659,-18186
ZCTA5 44688,1253,9091,-7838,2831,49.5,2693,14,29,0.01024373,20717,-17886
ZCTA5 44689,157,3054,-2897,521,27.8,508,0,8,0.015355086,17048,-16527
ZCTA5 44690,52,6530,-6478,86,63,86,0,0,0,15209,-15123
ZCTA5 44691,18109,8853,9256,44755,40.7,41376,819,889,0.019863702,20780,23975
ZCTA5 44693,11,5377,-5366,41,34.4,41,0,0,0,12359,-12318
ZCTA5 44695,447,2265,-1818,1323,47.4,1300,0,2,0.001511716,6545,-5222
ZCTA5 44697,125,12591,-12466,240,65.5,240,0,0,0,30871,-30631
ZCTA5 44699,298,454,-156,631,60.8,631,0,0,0,1465,-834
ZCTA5 44702,534,6530,-5996,975,57.3,589,4,289,0.296410256,15083,-14108
ZCTA5 44703,3668,11755,-8087,7961,35.8,4940,9,1527,0.191810074,26376,-18415
ZCTA5 44704,1428,19174,-17746,3329,35,1155,0,2002,0.601381796,50226,-46897
ZCTA5 44705,7239,6582,657,18985,32.1,11825,71,5130,0.270213326,14459,4526
ZCTA5 44706,7044,0,7044,16315,41.9,13974,61,1282,0.078577996,342,15973
ZCTA5 44707,3555,11839,-8284,9290,32.6,5574,0,2588,0.278579117,25122,-15832
ZCTA5 44708,10803,2975,7828,24584,44.1,20458,884,1886,0.076716564,7735,16849
ZCTA5 44709,8648,11187,-2539,18778,43.2,15100,278,2267,0.120726382,26828,-8050
ZCTA5 44710,3415,6025,-2610,8424,36.6,6627,34,1130,0.134140551,14759,-6335
ZCTA5 44714,4234,697,3537,9912,38.5,7420,63,1870,0.18866021,2372,7540
ZCTA5 44718,5715,4434,1281,12720,46.1,11355,208,527,0.041430818,11728,992
ZCTA5 44720,16856,4274,12582,40218,42.7,37373,781,604,0.015018151,9648,30570
ZCTA5 44721,5366,9122,-3756,13543,45.7,12454,27,265,0.019567304,20752,-7209
ZCTA5 44730,2532,8422,-5890,6202,41.1,5878,18,246,0.039664624,18816,-12614
ZCTA5 44802,365,12208,-11843,952,48,864,45,0,0,29801,-28849
ZCTA5 44804,536,12410,-11874,1605,34.2,1575,1,9,0.005607477,27472,-25867
ZCTA5 44805,12550,6196,6354,32029,37.9,30419,197,411,0.012832121,15961,16068
ZCTA5 44807,885,13911,-13026,1874,47.1,1756,0,16,0.008537887,33728,-31854
ZCTA5 44809,69,7016,-6947,126,32.2,126,0,0,0,18478,-18352
ZCTA5 44811,5281,8096,-2815,12874,40.2,12274,34,87,0.006757806,19338,-6464
ZCTA5 44813,2918,5446,-2528,7806,42.8,7689,4,32,0.004099411,13883,-6077
ZCTA5 44814,869,20132,-19263,2224,45.1,2136,0,37,0.016636691,57082,-54858
ZCTA5 44815,292,2080,-1788,688,43.5,591,0,4,0.005813953,5345,-4657
ZCTA5 44817,544,1308,-764,1524,45.3,1389,1,4,0.002624672,3849,-2325
ZCTA5 44818,885,1655,-770,2254,45,2205,0,9,0.003992902,4568,-2314
ZCTA5 44820,7500,538,6962,17239,42.4,16493,231,151,0.008759209,1399,15840
ZCTA5 44822,1111,26,1085,3418,31.6,3384,0,0,0,119,3299
ZCTA5 44824,1417,11,1406,3682,44.6,3237,47,7,0.001901141,20,3662
ZCTA5 44825,71,2892,-2821,233,32.4,232,0,0,0,7743,-7510
ZCTA5 44826,585,351,234,1432,43.6,1416,0,0,0,809,623
ZCTA5 44827,3046,119,2927,7003,46.9,6571,0,208,0.029701556,339,6664
ZCTA5 44828,60,111,-51,169,53.3,138,0,6,0.035502959,274,-105
ZCTA5 44830,7283,1188,6095,17974,38.8,15557,203,818,0.045510181,2946,15028
ZCTA5 44833,7131,12,7119,16537,42.5,16040,45,141,0.008526335,26,16511
ZCTA5 44836,945,1868,-923,2435,46.7,2356,0,6,0.002464066,4587,-2152
ZCTA5 44837,1440,1288,152,4132,38.4,3989,0,6,0.001452081,3818,314
ZCTA5 44838,88,104,-16,176,48,173,0,3,0.017045455,254,-78
ZCTA5 44839,5642,6289,-647,12576,54.9,11473,100,118,0.009382952,15815,-3239
ZCTA5 44840,1142,898,244,3013,44.8,2941,0,0,0,2271,742
ZCTA5 44841,268,54,214,679,40.6,642,0,0,0,186,493
ZCTA5 44842,2116,8340,-6224,5244,46.5,5156,38,0,0,21782,-16538
ZCTA5 44843,1114,6794,-5680,2667,44.3,2444,0,57,0.021372328,16959,-14292
ZCTA5 44844,270,0,270,595,52.9,567,0,0,0,0,595
ZCTA5 44846,1312,1740,-428,3419,46.7,3331,5,23,0.006727113,4263,-844
ZCTA5 44847,1444,1233,211,3663,39,3566,0,8,0.002184002,2957,706
ZCTA5 44849,881,160,721,2303,41.5,2189,0,0,0,339,1964
ZCTA5 44850,9,1056,-1047,29,44.4,29,0,0,0,3183,-3154
ZCTA5 44851,2088,4378,-2290,4995,42.4,4843,20,23,0.004604605,12817,-7822
ZCTA5 44853,547,103,444,1458,44.4,1396,5,2,0.001371742,294,1164
ZCTA5 44854,672,2310,-1638,1445,42.8,1440,0,0,0,5671,-4226
ZCTA5 44855,449,1338,-889,1475,37.7,1438,0,15,0.010169492,3528,-2053
ZCTA5 44856,92,1568,-1476,190,31.8,188,0,2,0.010526316,4174,-3984
ZCTA5 44857,9916,346,9570,23446,40.7,21858,0,316,0.013477779,826,22620
ZCTA5 44859,849,2515,-1666,2418,41.9,2383,35,0,0,6085,-3667
ZCTA5 44861,71,1017,-946,167,43.2,130,0,9,0.053892216,3172,-3005
ZCTA5 44864,1255,868,387,3198,44.3,3027,38,40,0.012507817,2164,1034
ZCTA5 44865,1142,1059,83,3411,40.3,3140,0,125,0.036646145,2981,430
ZCTA5 44866,775,3126,-2351,2192,41.1,2148,3,0,0,8312,-6120
ZCTA5 44867,980,2374,-1394,2632,38.6,2590,0,0,0,6813,-4181
ZCTA5 44870,17030,11773,5257,40018,40.3,29687,403,6526,0.163076616,29861,10157
ZCTA5 44874,124,2500,-2376,301,44.4,233,0,0,0,6709,-6408
ZCTA5 44875,5549,4253,1296,13815,43.5,13413,175,88,0.006369888,10899,2916
ZCTA5 44878,944,203,741,3028,33.4,2966,0,0,0,659,2369
ZCTA5 44880,1027,604,423,3043,43,2901,34,36,0.01183043,1619,1424
ZCTA5 44881,27,117,-90,98,51.6,92,0,0,0,256,-158
ZCTA5 44882,1093,112,981,2514,46.8,2465,10,3,0.001193317,676,1838
ZCTA5 44883,11548,545,11003,28566,41.2,26484,241,955,0.033431352,1421,27145
ZCTA5 44887,316,1206,-890,1036,35.1,943,0,0,0,2955,-1919
ZCTA5 44889,2774,4966,-2192,7173,44.4,6924,12,4,0.000557647,12685,-5512
ZCTA5 44890,4062,681,3381,10679,38.4,9589,68,131,0.012267066,1937,8742
ZCTA5 44901,0,956,-956,0,-,0,0,0,#DIV/0!,2517,-2517
ZCTA5 44902,1939,747,1192,5458,31,3140,0,1872,0.342982778,1951,3507
ZCTA5 44903,9636,535,9101,25012,40,20264,263,2179,0.087118183,1370,23642
ZCTA5 44904,6158,1394,4764,14389,45.9,14092,28,100,0.006949753,3516,10873
ZCTA5 44905,5175,179,4996,16693,39.8,13094,53,2632,0.15767088,476,16217
ZCTA5 44906,7624,5756,1868,16461,45.5,14540,380,718,0.043618249,14499,1962
ZCTA5 44907,7148,3457,3691,15615,41.6,11900,116,2599,0.166442523,8319,7296
ZCTA5 45001,304,3202,-2898,869,28.2,679,0,112,0.128883774,8538,-7669
ZCTA5 45002,4945,4625,320,13627,38.2,12934,75,52,0.003815954,12164,1463
ZCTA5 45003,211,296,-85,508,38,487,0,0,0,731,-223
ZCTA5 45005,12328,418,11910,31294,40.6,29085,526,150,0.004793251,1306,29988
ZCTA5 45011,25726,1923,23803,72971,38.7,55892,3356,8175,0.112030807,5461,67510
ZCTA5 45013,20307,170,20137,53463,37.4,48351,301,1423,0.026616539,416,53047
ZCTA5 45014,18753,10410,8343,45695,39.3,32665,2487,6941,0.151898457,33528,12167
ZCTA5 45015,4892,2198,2694,11838,35.4,9829,38,328,0.027707383,5618,6220
ZCTA5 45030,8443,433,8010,21129,40.8,20584,0,126,0.005963368,1124,20005
ZCTA5 45032,267,4401,-4134,655,35.3,609,0,8,0.01221374,9750,-9095
ZCTA5 45033,177,1066,-889,460,49.4,460,0,0,0,2811,-2351
ZCTA5 45034,427,176,251,1059,42.9,1049,0,0,0,436,623
ZCTA5 45036,13068,419,12649,41330,37.5,35934,490,4241,0.102613114,1108,40222
ZCTA5 45039,10825,10,10815,28089,39.5,25838,893,265,0.009434298,10,28079
ZCTA5 45040,20573,1496,19077,56659,39.9,40442,11414,2423,0.042764609,4002,52657
ZCTA5 45041,130,711,-581,130,-,130,0,0,0,1941,-1811
ZCTA5 45042,11315,137,11178,28216,40.1,25565,214,755,0.026757868,423,27793
ZCTA5 45044,19913,478,19435,54339,37.6,43001,939,6039,0.111135648,1475,52864
ZCTA5 45050,4406,1724,2682,12042,35.4,10780,114,647,0.053728617,4487,7555
ZCTA5 45051,47,214,-167,372,76.5,349,10,13,0.034946237,571,-199
ZCTA5 45052,1644,745,899,4111,51.5,4026,2,0,0,1799,2312
ZCTA5 45053,1120,171,949,3707,36.7,3366,0,0,0,557,3150
ZCTA5 45054,1079,377,702,2837,44.2,2814,0,0,0,863,1974
ZCTA5 45055,49,1212,-1163,149,52.6,149,0,0,0,3143,-2994
ZCTA5 45056,8413,551,7862,28153,21.6,22845,2265,1366,0.048520584,1504,26649
ZCTA5 45062,277,1006,-729,707,52.7,696,0,0,0,2596,-1889
ZCTA5 45064,1231,585,646,3274,46.2,3207,8,16,0.004886988,1568,1706
ZCTA5 45065,2133,160,1973,6366,38.6,5475,61,238,0.037386114,350,6016
ZCTA5 45066,9194,11248,-2054,26175,37.9,24195,621,302,0.011537727,27662,-1487
ZCTA5 45067,4897,1599,3298,14879,35.3,14520,0,96,0.006452047,3874,11005
ZCTA5 45068,4475,793,3682,11624,46.2,11069,102,6,0.000516173,2027,9597
ZCTA5 45069,20251,3005,17246,54521,39.3,42519,4724,4708,0.086352048,8938,45583
ZCTA5 45070,54,595,-541,115,34.9,115,0,0,0,1508,-1393
ZCTA5 45101,798,1040,-242,1893,51.1,1796,0,12,0.006339144,2311,-418
ZCTA5 45102,9190,731,8459,23767,34.7,22641,151,278,0.011696891,1788,21979
ZCTA5 45103,13761,2646,11115,34948,37.8,32186,1075,670,0.01917134,6582,28366
ZCTA5 45105,62,168,-106,62,-,62,0,0,0,484,-422
ZCTA5 45106,4444,1487,2957,11492,42.1,11374,0,13,0.001131222,3381,8111
ZCTA5 45107,3645,823,2822,9497,40,9222,0,30,0.003158892,2036,7461
ZCTA5 45111,143,72,71,336,54.8,296,0,40,0.119047619,168,168
ZCTA5 45112,13,526,-513,37,49.2,37,0,0,0,1353,-1316
ZCTA5 45113,1573,265,1308,3916,42.3,3845,0,0,0,630,3286
ZCTA5 45115,121,319,-198,241,27.8,241,0,0,0,592,-351
ZCTA5 45118,1384,281,1103,3865,41.5,3772,0,8,0.002069858,736,3129
ZCTA5 45119,0,1475,-1475,0,-,0,0,0,#DIV/0!,3444,-3444
ZCTA5 45120,1067,116,951,2639,45.3,2570,0,0,0,398,2241
ZCTA5 45121,3591,1189,2402,8997,41.4,8638,39,138,0.015338446,3234,5763
ZCTA5 45122,4157,1122,3035,11514,37.5,11137,0,17,0.001476463,3151,8363
ZCTA5 45123,3298,7,3291,8702,37.6,8309,4,127,0.014594346,54,8648
ZCTA5 45130,1469,515,954,4083,41.6,4013,0,3,0.000734754,1317,2766
ZCTA5 45131,97,72,25,307,34.3,291,0,0,0,173,134
ZCTA5 45132,106,8729,-8623,204,40.7,188,0,0,0,24924,-24720
ZCTA5 45133,9078,6278,2800,23369,42.3,22118,48,291,0.012452394,15846,7523
ZCTA5 45135,1975,9308,-7333,5668,35.5,5521,0,15,0.002646436,22931,-17263
ZCTA5 45140,21116,4478,16638,54686,40.4,49355,1920,1247,0.022802911,10993,43693
ZCTA5 45142,1518,4686,-3168,3943,38.4,3900,0,0,0,11571,-7628
ZCTA5 45144,1517,147,1370,3732,45.1,3651,14,0,0,349,3383
ZCTA5 45146,425,50,375,1279,33.1,1269,0,5,0.003909304,123,1156
ZCTA5 45147,82,2824,-2742,240,44.3,240,0,0,0,8388,-8148
ZCTA5 45148,662,612,50,1753,48,1648,0,1,0.000570451,1716,37
ZCTA5 45150,13560,1442,12118,33394,43.6,30936,449,848,0.025393783,3583,29811
ZCTA5 45152,4405,1019,3386,13689,37.1,12872,101,143,0.010446344,2656,11033
ZCTA5 45153,761,143,618,1893,52.3,1870,17,0,0,343,1550
ZCTA5 45154,3109,2456,653,8710,36.1,8522,38,79,0.009070034,6501,2209
ZCTA5 45155,150,103,47,489,31.9,456,0,0,0,242,247
ZCTA5 45156,18,177,-159,78,46.7,78,0,0,0,417,-339
ZCTA5 45157,3821,593,3228,10320,44,9839,10,87,0.008430233,1371,8949
ZCTA5 45158,297,8064,-7767,827,48.5,778,0,33,0.039903265,19392,-18565
ZCTA5 45159,1454,120,1334,3765,40.9,3367,0,266,0.07065073,309,3456
ZCTA5 45160,316,781,-465,624,51.5,604,1,7,0.011217949,2252,-1628
ZCTA5 45162,992,2252,-1260,2562,46.7,2534,21,0,0,6201,-3639
ZCTA5 45164,108,2512,-2404,302,32.4,295,0,1,0.003311258,6694,-6392
ZCTA5 45166,42,1222,-1180,69,28.6,69,0,0,0,3235,-3166
ZCTA5 45167,1415,1214,201,3416,42.9,3234,13,33,0.009660422,3172,244
ZCTA5 45168,545,4050,-3505,1295,53,1239,0,6,0.004633205,10477,-9182
ZCTA5 45169,1750,148,1602,4432,42.8,4335,0,0,0,286,4146
ZCTA5 45171,2144,550,1594,5324,45.5,5194,0,35,0.006574005,1513,3811
ZCTA5 45172,92,11,81,294,23.6,267,0,0,0,35,259
ZCTA5 45174,655,22702,-22047,2023,37,1938,6,0,0,54696,-52673
ZCTA5 45176,3990,258,3732,10250,44.4,9943,50,68,0.006634146,730,9520
ZCTA5 45177,9002,1481,7521,22011,41.1,20044,295,652,0.029621553,3890,18121
ZCTA5 45202,8867,1334,7533,15293,32.9,10019,641,3750,0.245210227,3287,12006
ZCTA5 45203,1293,1104,189,2828,32.3,794,160,1799,0.636138614,3042,-214
ZCTA5 45204,2705,1413,1292,6680,32.7,3773,60,2005,0.300149701,4295,2385
ZCTA5 45205,7080,421,6659,18314,32.5,7978,397,7770,0.424265589,1150,17164
ZCTA5 45206,6149,1402,4747,10231,39.7,5170,126,4025,0.393412179,3767,6464
ZCTA5 45207,2435,202,2233,7363,23.8,2920,88,4027,0.546923808,684,6679
ZCTA5 45208,8426,427,7999,18317,37.1,16057,727,723,0.039471529,1033,17284
ZCTA5 45209,6078,180,5898,10692,32,8827,411,988,0.092405537,477,10215
ZCTA5 45211,15479,90,15389,37399,34.4,20925,423,13437,0.359287681,216,37183
ZCTA5 45212,9756,1920,7836,21424,33.4,16918,268,3329,0.155386482,5070,16354
ZCTA5 45213,5554,1142,4412,11795,36.3,6284,197,4551,0.385841458,3239,8556
ZCTA5 45214,4170,147,4023,9536,30.9,2742,85,6236,0.653942953,463,9073
ZCTA5 45215,12854,645,12209,31022,38.6,19457,561,8827,0.284540004,2197,28825
ZCTA5 45216,3612,77,3535,9209,38.3,5160,66,2794,0.303398849,169,9040
ZCTA5 45217,2676,537,2139,6317,46.4,3763,68,2141,0.338926706,1426,4891
ZCTA5 45218,1503,461,1042,3913,38.4,3019,17,498,0.127268081,1226,2687
ZCTA5 45219,6761,70,6691,19436,21.5,13462,1181,3399,0.174881663,146,19290
ZCTA5 45220,6570,1814,4756,14375,27.9,9061,1893,2718,0.189078261,4800,9575
ZCTA5 45223,5652,107,5545,12237,33.3,6364,194,4874,0.398300237,234,12003
ZCTA5 45224,9411,412,8999,21504,44.6,8836,82,11472,0.533482143,1131,20373
ZCTA5 45225,4143,203,3940,9899,24.3,1739,7,7414,0.748964542,533,9366
ZCTA5 45226,3036,1748,1288,5973,34.9,5392,164,123,0.020592667,4526,1447
ZCTA5 45227,8712,49,8663,18874,36.2,13035,226,4667,0.247271379,194,18680
ZCTA5 45229,6547,687,5860,13997,37,3984,121,9181,0.65592627,1799,12198
ZCTA5 45230,11536,1706,9830,27628,39.3,24914,524,960,0.034747358,4269,23359
ZCTA5 45231,16877,899,15978,42808,40.1,20724,1031,17897,0.418076061,2200,40608
ZCTA5 45232,3166,700,2466,8080,23.2,1372,0,5946,0.735891089,1732,6348
ZCTA5 45233,5583,4308,1275,15024,45.1,14152,44,520,0.034611289,11254,3770
ZCTA5 45236,11371,275,11096,24349,41.5,18336,1295,3393,0.139348639,703,23646
ZCTA5 45237,9739,823,8916,21669,40.1,5289,443,14998,0.692140846,2316,19353
ZCTA5 45238,19751,2500,17251,48218,35.3,34847,282,11064,0.229457879,6258,41960
ZCTA5 45239,11945,968,10977,29208,34.7,15534,1345,10406,0.356272254,2516,26692
ZCTA5 45240,10596,617,9979,28312,36.9,9344,1024,15793,0.557820006,1902,26410
ZCTA5 45241,9900,1170,8730,23270,47.8,19367,1258,1355,0.05822948,2997,20273
ZCTA5 45242,8862,1337,7525,21992,42.5,17023,1840,1688,0.076755184,3821,18171
ZCTA5 45243,6167,56,6111,16278,43.2,14550,1020,209,0.012839415,132,16146
ZCTA5 45244,10376,5213,5163,28109,40.1,26332,385,619,0.022021417,12773,15336
ZCTA5 45245,8602,248,8354,20880,40,18830,272,271,0.012978927,732,20148
ZCTA5 45246,5705,1713,3992,13530,40.7,7500,494,4431,0.327494457,4643,8887
ZCTA5 45247,9311,121,9190,23246,43.5,21210,252,700,0.030112708,213,23033
ZCTA5 45248,9420,517,8903,24006,38.5,22747,140,448,0.018662001,1524,22482
ZCTA5 45249,5541,285,5256,14131,39.7,11005,1508,299,0.021159154,787,13344
ZCTA5 45251,8113,6076,2037,20940,39,13009,625,6399,0.305587393,15432,5508
ZCTA5 45252,1981,250,1731,5111,48.8,4187,9,754,0.147524946,783,4328
ZCTA5 45255,9229,7231,1998,21752,43.9,19469,518,1037,0.047673777,18253,3499
ZCTA5 45267,0,750,-750,4,30,2,0,2,0.5,2093,-2089
ZCTA5 45301,78,62,16,276,37,276,0,0,0,199,77
ZCTA5 45302,1545,486,1059,4601,30.5,4479,54,0,0,1150,3451
ZCTA5 45303,906,119,787,2209,38.6,2194,0,0,0,288,1921
ZCTA5 45304,2720,4413,-1693,7315,37.1,7122,0,61,0.008339029,10690,-3375
ZCTA5 45305,4497,6656,-2159,11048,41.6,9718,542,177,0.016020999,16817,-5769
ZCTA5 45306,827,7616,-6789,2303,34.1,2221,5,0,0,19865,-17562
ZCTA5 45307,115,8485,-8370,299,39.2,282,0,2,0.006688963,18663,-18364
ZCTA5 45308,1627,7036,-5409,4629,41.1,4540,0,9,0.001944264,18282,-13653
ZCTA5 45309,4710,2390,2320,11680,47.1,10354,407,173,0.014811644,5592,6088
ZCTA5 45310,83,1240,-1157,218,42.8,218,0,0,0,3270,-3052
ZCTA5 45311,2360,874,1486,6335,44.8,6305,7,2,0.000315706,2445,3890
ZCTA5 45312,424,16370,-15946,1068,50.4,1058,0,0,0,42542,-41474
ZCTA5 45314,1275,11950,-10675,6300,21,5475,140,462,0.073333333,35326,-29026
ZCTA5 45315,1768,2972,-1204,4121,48.9,2966,81,750,0.181994661,7012,-2891
ZCTA5 45316,50,399,-349,128,39.3,115,0,2,0.015625,1080,-952
ZCTA5 45317,402,4504,-4102,1080,55.4,1033,0,0,0,11805,-10725
ZCTA5 45318,2181,11797,-9616,5254,46.8,5050,0,52,0.009897221,34602,-29348
ZCTA5 45319,115,14746,-14631,313,42.5,309,0,0,0,38838,-38525
ZCTA5 45320,6501,334,6167,15508,44.5,14692,77,111,0.007157596,960,14548
ZCTA5 45321,430,3659,-3229,1139,30.4,1093,0,6,0.005267779,11112,-9973
ZCTA5 45322,9164,8401,763,21494,44,18014,143,2566,0.119382153,23728,-2234
ZCTA5 45323,2150,1023,1127,5114,43.3,4911,16,55,0.010754791,2675,2439
ZCTA5 45324,17681,104,17577,40944,34.3,32983,873,3672,0.08968347,374,40570
ZCTA5 45325,1024,20,1004,2521,46.3,2409,12,0,0,89,2432
ZCTA5 45326,491,697,-206,1316,43.9,1311,0,0,0,2099,-783
ZCTA5 45327,3537,386,3151,9000,44.1,8838,0,22,0.002444444,924,8076
ZCTA5 45328,177,656,-479,561,36.9,558,0,0,0,1978,-1417
ZCTA5 45330,340,1203,-863,859,30.8,859,0,0,0,3023,-2164
ZCTA5 45331,9630,9115,515,22354,44.4,21376,29,281,0.012570457,22067,287
ZCTA5 45332,241,3153,-2912,664,26.4,630,0,0,0,9130,-8466
ZCTA5 45333,482,866,-384,1701,37.7,1498,0,0,0,2489,-788
ZCTA5 45334,862,344,518,2048,41.3,1958,0,0,0,989,1059
ZCTA5 45335,2833,741,2092,6996,46.1,6759,6,57,0.008147513,2099,4897
ZCTA5 45336,34,13125,-13091,85,35.2,85,0,0,0,34390,-34305
ZCTA5 45337,666,11212,-10546,1874,38.3,1848,0,24,0.01280683,30358,-28484
ZCTA5 45338,1929,107,1822,4741,39.2,4635,34,0,0,443,4298
ZCTA5 45339,470,4926,-4456,1189,49.9,1154,0,1,0.000841043,15992,-14803
ZCTA5 45340,139,1249,-1110,326,54.3,326,0,0,0,3506,-3180
ZCTA5 45341,1672,1126,546,3736,48.1,3495,0,0,0,2383,1353
ZCTA5 45342,14681,2567,12114,36087,38.2,30832,1696,1779,0.049297531,6599,29488
ZCTA5 45344,6559,801,5758,16606,40.4,15740,21,27,0.001625918,2136,14470
ZCTA5 45345,2571,1377,1194,6555,40.6,6199,41,32,0.00488177,3795,2760
ZCTA5 45346,918,3979,-3061,2192,46.6,2146,0,0,0,9590,-7398
ZCTA5 45347,1735,9283,-7548,4047,44.3,3983,2,21,0.005189029,26896,-22849
ZCTA5 45348,250,1158,-908,818,36,818,0,0,0,2982,-2164
ZCTA5 45349,117,690,-573,314,43.2,310,0,0,0,1686,-1372
ZCTA5 45350,22,8480,-8458,59,26.3,50,0,0,0,24300,-24241
ZCTA5 45351,117,69,48,346,30.4,346,0,0,0,226,120
ZCTA5 45352,91,277,-186,217,37.8,211,5,0,0,791,-574
ZCTA5 45353,60,689,-629,197,39.1,175,0,16,0.081218274,2154,-1957
ZCTA5 45354,267,2013,-1746,656,47.6,656,0,0,0,5173,-4517
ZCTA5 45356,10502,5078,5424,24779,42.1,23095,207,575,0.023205133,12801,11978
ZCTA5 45358,126,210,-84,300,35.8,295,0,0,0,564,-264
ZCTA5 45359,694,154,540,1903,45.3,1781,0,0,0,402,1501
ZCTA5 45360,202,12096,-11894,438,43,429,3,0,0,33705,-33267
ZCTA5 45361,104,4827,-4723,302,34.9,300,0,0,0,15037,-14735
ZCTA5 45362,501,762,-261,1216,50,1162,2,52,0.042763158,2077,-861
ZCTA5 45363,600,181,419,1680,37.5,1612,22,6,0.003571429,397,1283
ZCTA5 45365,11557,2106,9451,29325,41.1,26847,329,913,0.031133845,5297,24028
ZCTA5 45368,1782,2424,-642,4215,42.2,4055,9,53,0.01257414,6182,-1967
ZCTA5 45369,1638,1880,-242,4206,48.2,4034,0,0,0,5270,-1064
ZCTA5 45370,1044,5238,-4194,3080,47.9,2722,128,12,0.003896104,14363,-11283
ZCTA5 45371,8898,11255,-2357,22175,40.6,20546,125,682,0.030755355,31365,-9190
ZCTA5 45372,132,2752,-2620,299,40.4,288,2,9,0.030100334,7893,-7594
ZCTA5 45373,14377,19,14358,37211,39.2,33055,1309,853,0.022923329,19,37192
ZCTA5 45377,6287,1719,4568,14614,39.4,12736,154,864,0.05912139,4610,10004
ZCTA5 45378,200,143,57,497,37.7,489,0,0,0,311,186
ZCTA5 45380,2257,630,1627,5852,40.9,5814,0,11,0.001879699,1776,4076
ZCTA5 45381,2308,1047,1261,5692,44.2,5418,20,129,0.022663387,2830,2862
ZCTA5 45382,412,11295,-10883,1124,40.2,1000,0,23,0.020462633,30925,-29801
ZCTA5 45383,2724,337,2387,6325,44.3,6090,13,16,0.002529644,1010,5315
ZCTA5 45384,240,6147,-5907,2348,20,789,21,1481,0.630749574,20390,-18042
ZCTA5 45385,15670,14702,968,39178,42,33257,736,2775,0.070830568,38876,302
ZCTA5 45387,2586,11323,-8737,5399,53.7,4787,63,333,0.061678089,28980,-23581
ZCTA5 45388,221,18940,-18719,755,29.9,752,0,2,0.002649007,50241,-49486
ZCTA5 45389,203,48,155,499,37.4,489,0,3,0.006012024,108,391
ZCTA5 45390,1193,63,1130,3202,38.8,2904,20,98,0.030605871,109,3093
ZCTA5 45402,4544,1267,3277,10447,37.3,3216,36,6451,0.617497846,3280,7167
ZCTA5 45403,6118,2127,3991,13523,36.1,10410,61,1680,0.124232789,5625,7898
ZCTA5 45404,3901,783,3118,10715,31.5,8204,56,1824,0.170228651,2148,8567
ZCTA5 45405,8890,246,8644,19363,35.7,4236,23,13412,0.692661261,661,18702
ZCTA5 45406,8855,11408,-2553,19830,39.5,3129,55,15020,0.757438225,30317,-10487
ZCTA5 45409,2902,45,2857,16224,20.9,14605,441,594,0.036612426,149,16075
ZCTA5 45410,7020,560,6460,16442,31.2,11783,362,2493,0.15162389,1566,14876
ZCTA5 45414,9517,1358,8159,20392,44.9,16187,318,2327,0.114113378,3927,16465
ZCTA5 45415,5770,8596,-2826,13119,43.2,6376,192,5971,0.455141398,22231,-9112
ZCTA5 45416,1930,2450,-520,4873,47.8,1188,16,3487,0.715575621,6846,-1973
ZCTA5 45417,11451,919,10532,28059,39.4,5282,21,20888,0.744431377,2309,25750
ZCTA5 45419,7010,123,6887,16262,36.1,14359,523,384,0.023613332,279,15983
ZCTA5 45420,11579,4297,7282,24249,39.1,20660,831,1546,0.063755206,12028,12221
ZCTA5 45423,0,1661,-1661,0,-,0,0,0,#DIV/0!,4091,-4091
ZCTA5 45424,20219,592,19627,50798,38.4,38093,1488,7765,0.152860349,1606,49192
ZCTA5 45426,6566,878,5688,13933,45.4,3206,39,9900,0.710543314,2316,11617
ZCTA5 45428,0,2224,-2224,285,76.5,179,0,96,0.336842105,6455,-6170
ZCTA5 45429,12085,10979,1106,26618,42.3,23857,583,1016,0.03816966,30729,-4111
ZCTA5 45430,2976,575,2401,6910,46.3,6185,229,46,0.006657019,1570,5340
ZCTA5 45431,11912,896,11016,26630,34.1,22543,1294,1041,0.03909125,2540,24090
ZCTA5 45432,6313,4472,1841,14786,41.7,13306,193,314,0.021236305,11349,3437
ZCTA5 45433,402,237,165,1835,22.5,1168,65,419,0.228337875,671,1164
ZCTA5 45434,4569,10926,-6357,12371,42.8,11030,431,428,0.034597041,27834,-15463
ZCTA5 45435,0,403,-403,130,20,87,3,35,0.269230769,1306,-1176
ZCTA5 45439,4638,1542,3096,12235,36.4,10030,324,1150,0.093992644,4359,7876
ZCTA5 45440,9355,699,8656,22507,40.4,18875,754,1388,0.061669703,1754,20753
ZCTA5 45449,8478,45,8433,18946,36.5,14693,333,2270,0.119814209,247,18699
ZCTA5 45458,14502,4363,10139,36487,42.6,29351,2302,2512,0.068846438,12532,23955
ZCTA5 45459,12712,679,12033,27616,50,24051,822,1435,0.05196263,1802,25814
ZCTA5 45469,5,11688,-11683,293,19.8,288,0,0,0,30487,-30194
ZCTA5 45501,0,7731,-7731,0,-,0,0,0,#DIV/0!,16021,-16021
ZCTA5 45502,6886,14070,-7184,17179,48.2,16415,43,199,0.011583911,38313,-21134
ZCTA5 45503,14121,2578,11543,32669,41.8,27798,364,2493,0.076310876,5903,26766
ZCTA5 45504,6127,11344,-5217,16397,37.9,14570,116,684,0.041714948,26351,-9954
ZCTA5 45505,7960,8911,-951,20464,34.7,15882,197,2956,0.144448788,23312,-2848
ZCTA5 45506,5593,10296,-4703,13624,37.8,8056,16,4493,0.329785672,23747,-10123
ZCTA5 45601,21554,861,20693,56915,41.9,49874,283,4241,0.074514627,1496,55419
ZCTA5 45612,1791,11664,-9873,4335,44.1,4138,65,17,0.003921569,29558,-25223
ZCTA5 45613,1217,12031,-10814,3082,49.2,2928,10,54,0.01752109,30516,-27434
ZCTA5 45614,1564,13883,-12319,4897,40.3,4259,46,293,0.059832551,33646,-28749
ZCTA5 45616,657,15649,-14992,1734,47.1,1681,0,3,0.001730104,33833,-32099
ZCTA5 45617,0,9557,-9557,0,-,0,0,0,#DIV/0!,27054,-27054
ZCTA5 45618,0,12221,-12221,0,-,0,0,0,#DIV/0!,33061,-33061
ZCTA5 45619,2904,14612,-11708,7364,41.9,7006,0,110,0.014937534,35177,-27813
ZCTA5 45620,277,2648,-2371,694,49.5,676,4,0,0,6524,-5830
ZCTA5 45621,179,17468,-17289,389,53,389,0,0,0,45998,-45609
ZCTA5 45622,114,22544,-22430,326,30.8,326,0,0,0,56449,-56123
ZCTA5 45623,1175,5887,-4712,3408,40.5,3310,27,0,0,14876,-11468
ZCTA5 45624,0,10260,-10260,0,-,0,0,0,#DIV/0!,27913,-27913
ZCTA5 45628,2097,3600,-1503,5438,35.8,5259,0,42,0.007723428,11440,-6002
ZCTA5 45629,1013,9352,-8339,3009,39.7,2810,0,66,0.021934197,25002,-21993
ZCTA5 45630,164,10671,-10507,467,30.7,467,0,0,0,29507,-29040
ZCTA5 45631,5976,9756,-3780,13288,45.6,12380,98,195,0.014674895,26751,-13463
ZCTA5 45634,726,15509,-14783,1873,46.6,1735,54,8,0.004271223,39803,-37930
ZCTA5 45636,87,8520,-8433,271,40.8,263,0,0,0,24348,-24077
ZCTA5 45638,7954,9030,-1076,21081,39.1,20055,24,287,0.013614155,18817,2264
ZCTA5 45640,6026,11298,-5272,15732,41.3,15078,82,173,0.010996695,30918,-15186
ZCTA5 45642,0,8952,-8952,0,-,0,0,0,#DIV/0!,18545,-18545
ZCTA5 45644,1968,14852,-12884,4617,46.1,4561,0,5,0.001082954,36530,-31913
ZCTA5 45645,1085,9821,-8736,2963,46.7,2963,0,0,0,23541,-20578
ZCTA5 45646,159,3907,-3748,599,33,599,0,0,0,11777,-11178
ZCTA5 45647,1132,13836,-12704,2811,42.2,2806,0,0,0,32779,-29968
ZCTA5 45648,3994,11170,-7176,11507,43.5,11257,91,31,0.002694012,26411,-14904
ZCTA5 45650,159,2897,-2738,421,46.5,385,0,0,0,7968,-7547
ZCTA5 45651,1937,2840,-903,5304,36.6,5121,1,0,0,6595,-1291
ZCTA5 45652,1404,127,1277,3497,45.7,3318,0,10,0.002859594,297,3200
ZCTA5 45653,1255,267,988,3487,37.3,3379,0,6,0.001720677,571,2916
ZCTA5 45654,407,4955,-4548,884,51.3,884,0,0,0,13631,-12747
ZCTA5 45656,2540,9209,-6669,6729,40.9,6455,40,66,0.009808292,24618,-17889
ZCTA5 45657,691,21571,-20880,1496,48.4,1487,0,0,0,59749,-58253
ZCTA5 45658,881,4701,-3820,2754,35.3,2609,45,5,0.001815541,13085,-10331
ZCTA5 45659,959,7354,-6395,2788,41.6,2743,0,23,0.008249641,21373,-18585
ZCTA5 45660,2797,9653,-6856,7611,40.4,7122,106,13,0.001708054,29789,-22178
ZCTA5 45661,2505,7032,-4527,7042,33.8,6599,0,212,0.030105084,18086,-11044
ZCTA5 45662,11002,5534,5468,27538,38.2,24726,217,1226,0.044520299,15215,12323
ZCTA5 45663,2684,8647,-5963,6359,38.6,6127,4,0,0,23460,-17101
ZCTA5 45669,3984,9648,-5664,9763,46.6,9357,267,44,0.004506811,23646,-13883
ZCTA5 45671,102,8338,-8236,348,42.3,344,0,0,0,22618,-22270
ZCTA5 45672,487,8239,-7752,1252,41.9,1252,0,0,0,22944,-21692
ZCTA5 45673,144,3893,-3749,337,28.4,266,0,0,0,12272,-11935
ZCTA5 45674,189,384,-195,956,20,860,13,66,0.069037657,1083,-127
ZCTA5 45677,20,3900,-3880,56,52.1,56,0,0,0,10610,-10554
ZCTA5 45678,446,11817,-11371,1051,35.4,1051,0,0,0,31077,-30026
ZCTA5 45679,1061,104,957,2763,40.7,2704,0,11,0.00398118,293,2470
ZCTA5 45680,4684,560,4124,12458,41.6,11206,0,379,0.030422219,1539,10919
ZCTA5 45681,627,1648,-1021,1575,46.2,1414,56,0,0,4844,-3269
ZCTA5 45682,936,417,519,1977,47.1,1896,0,4,0.002023268,1014,963
ZCTA5 45684,714,1240,-526,1823,43.6,1823,0,0,0,3302,-1479
ZCTA5 45685,398,17060,-16662,1629,28.6,1589,0,0,0,43249,-41620
ZCTA5 45686,1330,5857,-4527,3704,39.7,3488,0,61,0.016468683,17541,-13837
ZCTA5 45688,149,17877,-17728,308,46.7,308,0,0,0,44106,-43798
ZCTA5 45690,5597,367,5230,13873,41.2,13542,16,20,0.001441649,1151,12722
ZCTA5 45692,3283,2252,1031,8367,35.3,8040,0,4,0.000478069,5573,2794
ZCTA5 45693,3194,14976,-11782,8911,42.6,8544,18,66,0.007406576,38310,-29399
ZCTA5 45694,4667,1274,3393,12593,41.9,12420,38,6,0.000476455,3559,9034
ZCTA5 45695,301,4691,-4390,765,43.4,765,0,0,0,13694,-12929
ZCTA5 45696,462,356,106,741,54.6,710,0,0,0,959,-218
ZCTA5 45697,2048,9391,-7343,6051,40.2,5924,0,23,0.003801025,23752,-17701
ZCTA5 45698,182,142,40,460,59.9,439,0,0,0,398,62
ZCTA5 45699,0,118,-118,1337,30.9,529,0,738,0.551982049,350,987
ZCTA5 45701,11093,105,10988,34895,22.8,30382,1658,1286,0.036853417,291,34604
ZCTA5 45710,2178,122,2056,5142,43.8,5000,0,9,0.001750292,420,4722
ZCTA5 45711,412,883,-471,1040,44.1,1039,0,0,0,2212,-1172
ZCTA5 45714,4078,14714,-10636,9127,48.5,8634,52,81,0.008874767,39202,-30075
ZCTA5 45715,956,13792,-12836,2433,37.6,2381,0,0,0,38335,-35902
ZCTA5 45716,181,1066,-885,457,47.7,358,0,3,0.006564551,2541,-2084
ZCTA5 45719,332,2246,-1914,744,42.9,727,0,1,0.001344086,10153,-9409
ZCTA5 45720,0,2851,-2851,0,-,0,0,0,#DIV/0!,7856,-7856
ZCTA5 45721,12,107,-95,33,46.8,33,0,0,0,337,-304
ZCTA5 45723,1454,4874,-3420,3631,51.6,3553,8,12,0.003304875,12606,-8975
ZCTA5 45724,979,2645,-1666,2382,42.6,2141,0,170,0.071368598,6692,-4310
ZCTA5 45727,241,5234,-4993,781,67.3,781,0,0,0,12938,-12157
ZCTA5 45729,680,6605,-5925,1909,38,1899,0,0,0,16888,-14979
ZCTA5 45732,1732,4251,-2519,4309,45.3,4184,2,5,0.001160362,11854,-7545
ZCTA5 45734,159,3613,-3454,320,52.3,315,0,0,0,9876,-9556
ZCTA5 45735,653,5191,-4538,1444,43.6,1411,16,0,0,13076,-11632
ZCTA5 45739,13,5970,-5957,45,40.7,45,0,0,0,16577,-16532
ZCTA5 45740,146,3095,-2949,322,59.5,319,0,0,0,9799,-9477
ZCTA5 45741,217,14958,-14741,412,37.2,412,0,0,0,38990,-38578
ZCTA5 45742,1196,1307,-111,3233,46.8,3115,21,0,0,3858,-625
ZCTA5 45743,472,139,333,1218,39.3,1190,0,0,0,454,764
ZCTA5 45744,955,1356,-401,2338,49.1,2253,9,0,0,3490,-1152
ZCTA5 45745,510,3758,-3248,1370,43.5,1285,0,84,0.061313869,10223,-8853
ZCTA5 45746,102,3521,-3419,259,49.3,248,0,0,0,8963,-8704
ZCTA5 45750,11087,73,11014,26695,44.5,25181,313,489,0.018318037,202,26493
ZCTA5 45760,1494,1259,235,3730,39.5,3521,0,32,0.008579088,3178,552
ZCTA5 45761,737,1812,-1075,1325,53.5,1290,0,0,0,4589,-3264
ZCTA5 45764,2630,15960,-13330,7917,36.5,7367,6,267,0.033724896,39298,-31381
ZCTA5 45766,471,11787,-11316,1189,35.4,1160,0,4,0.003364172,34309,-33120
ZCTA5 45767,956,7907,-6951,2725,37,2716,0,0,0,22970,-20245
ZCTA5 45768,626,818,-192,1597,46,1507,0,52,0.032561052,2581,-984
ZCTA5 45769,2246,11355,-9109,6276,43.1,6068,0,24,0.003824092,32644,-26368
ZCTA5 45770,349,8209,-7860,912,38.9,912,0,0,0,24966,-24054
ZCTA5 45771,1455,10343,-8888,3562,43,3514,0,0,0,29892,-26330
ZCTA5 45772,537,520,17,1435,46.2,1409,0,0,0,1498,-63
ZCTA5 45773,44,778,-734,142,44.6,131,0,0,0,2031,-1889
ZCTA5 45775,700,4424,-3724,1925,49.9,1914,0,0,0,11393,-9468
ZCTA5 45776,331,1365,-1034,896,45,881,0,0,0,3369,-2473
ZCTA5 45778,329,174,155,936,34.7,787,0,80,0.085470085,396,540
ZCTA5 45779,342,1592,-1250,760,43.7,760,0,0,0,3841,-3081
ZCTA5 45780,1535,706,829,2791,54.1,2613,0,19,0.006807596,1897,894
ZCTA5 45782,125,3763,-3638,434,38.1,432,0,1,0.002304147,11501,-11067
ZCTA5 45783,114,1427,-1313,236,38.9,236,0,0,0,4041,-3805
ZCTA5 45784,1404,1068,336,3365,42.3,3338,0,0,0,4022,-657
ZCTA5 45786,1123,12686,-11563,2797,49,2794,0,0,0,30761,-27964
ZCTA5 45788,290,10834,-10544,1003,33.4,965,0,0,0,25090,-24087
ZCTA5 45789,61,4016,-3955,147,38.8,147,0,0,0,12568,-12421
ZCTA5 45801,8464,2582,5882,21788,38.5,15952,110,3364,0.154396916,6891,14897
ZCTA5 45804,6175,1141,5034,14962,39.1,10282,5,3409,0.227843871,3567,11395
ZCTA5 45805,9538,1751,7787,23726,36.1,18235,169,3503,0.147643935,4698,19028
ZCTA5 45806,4440,1273,3167,11265,42.2,10105,155,517,0.045894363,2829,8436
ZCTA5 45807,4747,139,4608,11761,42.8,10426,274,709,0.060283989,7207,4554
ZCTA5 45808,153,4699,-4546,384,45.5,367,0,0,0,13801,-13417
ZCTA5 45809,32,1766,-1734,83,50.4,76,0,0,0,4848,-4765
ZCTA5 45810,2428,8918,-6490,7714,25.3,6795,130,301,0.039019964,23347,-15633
ZCTA5 45812,727,2279,-1552,1876,33.3,1856,0,3,0.001599147,7802,-5926
ZCTA5 45813,1352,3938,-2586,3538,40.8,3298,1,18,0.00508762,9335,-5797
ZCTA5 45814,1069,473,596,2753,40.2,2675,0,25,0.009081003,1330,1423
ZCTA5 45815,29,1693,-1664,91,46.2,34,0,0,0,6458,-6367
ZCTA5 45816,197,1219,-1022,593,35.3,588,5,0,0,3518,-2925
ZCTA5 45817,2468,2999,-531,6236,43.6,5899,139,22,0.003527903,7551,-1315
ZCTA5 45819,106,8570,-8464,271,33.9,268,0,1,0.003690037,21210,-20939
ZCTA5 45820,231,4793,-4562,723,29.9,716,2,0,0,12116,-11393
ZCTA5 45821,348,1745,-1397,746,54.2,726,0,0,0,4862,-4116
ZCTA5 45822,8059,19,8040,19290,42.3,17930,186,230,0.011923276,66,19224
ZCTA5 45826,120,2392,-2272,297,38.5,297,0,0,0,6094,-5797
ZCTA5 45827,822,3725,-2903,2002,47.5,1982,0,2,0.000999001,11193,-9191
ZCTA5 45828,2328,12866,-10538,6866,32.7,6822,3,17,0.002475969,30730,-23864
ZCTA5 45830,2081,6454,-4373,5332,39.9,5026,0,31,0.005813953,15167,-9835
ZCTA5 45831,1388,2205,-817,3706,43.2,3635,0,18,0.004856989,5593,-1887
ZCTA5 45832,1188,3814,-2626,3207,35.8,3043,5,17,0.005300904,10190,-6983
ZCTA5 45833,4431,7548,-3117,10816,40.1,10415,13,117,0.010817308,21229,-10413
ZCTA5 45835,207,10331,-10124,473,48.9,463,5,4,0.00845666,26702,-26229
ZCTA5 45836,607,2271,-1664,1417,40.5,1344,12,10,0.007057163,5641,-4224
ZCTA5 45838,45,5724,-5679,100,43.5,100,0,0,0,14532,-14432
ZCTA5 45840,22985,2926,20059,54624,38.3,48933,1320,1101,0.020155975,7724,46900
ZCTA5 45841,419,914,-495,936,44.1,899,0,1,0.001068376,2241,-1305
ZCTA5 45843,1440,6959,-5519,3733,42.5,3693,4,0,0,17894,-14161
ZCTA5 45844,1130,76,1054,2808,45.3,2783,7,4,0.001424501,179,2629
ZCTA5 45845,1159,724,435,3062,39.2,3017,0,0,0,1876,1186
ZCTA5 45846,1529,7504,-5975,4453,38.3,4440,0,7,0.001571974,18998,-14545
ZCTA5 45848,45,1812,-1767,99,60.8,99,0,0,0,4564,-4465
ZCTA5 45849,348,2548,-2200,991,36,932,6,6,0.00605449,7686,-6695
ZCTA5 45850,1239,5831,-4592,3652,36.7,3522,0,33,0.009036145,14478,-10826
ZCTA5 45851,233,1894,-1661,623,35,606,0,0,0,5028,-4405
ZCTA5 45853,597,2796,-2199,1577,37,1549,0,0,0,7259,-5682
ZCTA5 45854,153,9259,-9106,382,32.4,369,0,0,0,22979,-22597
ZCTA5 45855,54,546,-492,164,38.5,133,0,7,0.042682927,1350,-1186
ZCTA5 45856,1885,191,1694,5075,36.6,4089,0,31,0.006108374,566,4509
ZCTA5 45858,1042,1016,26,2540,43.2,2369,28,2,0.000787402,2922,-382
ZCTA5 45859,208,7606,-7398,494,40.5,465,0,0,0,18896,-18402
ZCTA5 45860,833,3061,-2228,2632,37.4,2570,62,0,0,7112,-4480
ZCTA5 45861,139,3038,-2899,427,29.7,399,19,5,0.011709602,7913,-7486
ZCTA5 45862,661,1178,-517,1489,45.3,1456,0,0,0,4113,-2624
ZCTA5 45863,513,1413,-900,1236,42.2,1220,0,0,0,4748,-3512
ZCTA5 45864,70,1451,-1381,165,46.7,159,2,4,0.024242424,3539,-3374
ZCTA5 45865,2077,594,1483,5599,40.1,5548,11,29,0.005179496,1824,3775
ZCTA5 45866,58,677,-619,99,59.4,99,0,0,0,1940,-1841
ZCTA5 45867,448,1436,-988,1031,39.2,1018,0,0,0,3985,-2954
ZCTA5 45868,273,1097,-824,904,38.7,871,0,0,0,2503,-1599
ZCTA5 45869,1773,1764,9,4461,39.7,4305,70,36,0.008069939,5374,-913
ZCTA5 45870,108,10433,-10325,447,29.9,447,0,0,0,27475,-27028
ZCTA5 45871,711,6018,-5307,1916,43.1,1849,6,23,0.012004175,15203,-13287
ZCTA5 45872,1782,212,1570,4330,40.9,4194,3,17,0.003926097,612,3718
ZCTA5 45873,873,556,317,1933,50.1,1875,0,0,0,1564,369
ZCTA5 45874,941,3811,-2870,2302,44.2,2147,0,0,0,11503,-9201
ZCTA5 45875,4056,639,3417,11216,37.9,10523,18,120,0.010699001,1712,9504
ZCTA5 45876,413,587,-174,980,38.5,980,0,0,0,1495,-515
ZCTA5 45877,977,1800,-823,2305,43.9,2237,0,13,0.005639913,5602,-3297
ZCTA5 45879,2506,327,2179,6054,43,5554,9,35,0.005781302,832,5222
ZCTA5 45880,1013,2575,-1562,2923,36.4,2775,16,13,0.004447485,8436,-5513
ZCTA5 45881,664,1140,-476,1556,46,1492,0,57,0.036632391,2809,-1253
ZCTA5 45882,1023,14,1009,2813,45.7,2768,0,20,0.007109847,43,2770
ZCTA5 45883,1144,913,231,3882,31.1,3862,0,0,0,3426,456
ZCTA5 45884,49,1374,-1325,166,43.1,155,0,7,0.042168675,3886,-3720
ZCTA5 45885,5457,6192,-735,12791,39.9,12266,61,39,0.003049019,16244,-3453
ZCTA5 45886,232,639,-407,566,44.9,538,0,0,0,1492,-926
ZCTA5 45887,1748,2458,-710,4297,39.9,4162,0,35,0.008145218,6274,-1977
ZCTA5 45888,156,838,-682,289,55.8,289,0,0,0,2142,-1853
ZCTA5 45889,569,355,214,1573,36.9,1556,0,0,0,915,658
ZCTA5 45890,343,2128,-1785,907,38.3,851,0,10,0.011025358,5888,-4981
ZCTA5 45891,6183,868,5315,15330,41.5,14608,46,115,0.007501631,2072,13258
ZCTA5 45893,126,676,-550,201,65.8,201,0,0,0,1926,-1725
ZCTA5 45894,281,68,213,762,37.5,715,0,0,0,238,524
ZCTA5 45895,7410,1423,5987,17816,41.6,17095,0,45,0.002525819,4000,13816
ZCTA5 45896,749,866,-117,1901,42.9,1840,9,11,0.005786428,2628,-727
ZCTA5 45897,25,289,-264,94,18.5,94,0,0,0,761,-667
ZCTA5 45898,355,1295,-940,755,53.1,723,7,2,0.002649007,3451,-2696
ZCTA5 45899,79,1549,-1470,188,49.3,180,0,0,0,4495,-4307
ZCTA5 46001,4011,718,3293,10126,40.6,9932,0,95,0.009381789,2121,8005
ZCTA5 46011,6935,2277,4658,17790,41.7,14376,86,2525,0.141933671,5699,12091
ZCTA5 46012,8579,1484,7095,19794,41.8,17504,286,970,0.049004749,3961,15833
ZCTA5 46013,7881,754,7127,16398,43.8,13857,62,1394,0.085010367,2156,14242
ZCTA5 46016,6816,55,6761,18412,33.6,12970,153,3467,0.188301108,162,18250
ZCTA5 46017,2413,4473,-2060,5660,45.6,4958,40,302,0.05335689,10976,-5316
ZCTA5 46030,1122,3329,-2207,2995,39.6,2703,3,27,0.009015025,8932,-5937
ZCTA5 46031,727,10994,-10267,1954,38.9,1938,4,2,0.001023541,26719,-24765
ZCTA5 46032,19911,9024,10887,50309,39.3,41491,4674,1771,0.035202449,21462,28847
ZCTA5 46033,14444,8541,5903,40003,42.1,33537,3466,472,0.011799115,23990,16013
ZCTA5 46034,2854,5973,-3119,6959,40.2,6802,37,58,0.008334531,15632,-8673
ZCTA5 46035,437,7825,-7388,1363,33.5,1315,0,39,0.028613353,19495,-18132
ZCTA5 46036,4479,3693,786,11316,44.3,10938,22,87,0.007688229,8230,3086
ZCTA5 46037,16129,4138,11991,45306,37.5,38503,3705,1688,0.037257758,12883,32423
ZCTA5 46038,16229,10011,6218,43067,35.1,35418,2664,2891,0.067127963,26936,16131
ZCTA5 46039,233,7382,-7149,657,47.2,657,0,0,0,19003,-18346
ZCTA5 46040,5446,7039,-1593,15813,37.8,13456,346,1260,0.079681275,18998,-3185
ZCTA5 46041,8704,3741,4963,23126,36.7,19587,116,62,0.002680965,8865,14261
ZCTA5 46044,1157,12181,-11024,2964,46.2,2800,37,7,0.002361673,28901,-25937
ZCTA5 46045,19,13608,-13589,43,65.3,34,9,0,0,32278,-32235
ZCTA5 46047,18,7318,-7300,48,35.7,48,0,0,0,21406,-21358
ZCTA5 46048,785,15986,-15201,2239,34.8,2108,0,66,0.029477445,38946,-36707
ZCTA5 46049,469,15005,-14536,1127,45.2,1083,0,0,0,35497,-34370
ZCTA5 46050,739,1274,-535,2073,35.9,1981,7,13,0.006271105,3463,-1390
ZCTA5 46051,1191,565,626,2882,40,2815,0,13,0.004510756,1580,1302
ZCTA5 46052,9452,455,8997,23133,39.6,21777,56,200,0.008645658,1210,21923
ZCTA5 46055,5249,808,4441,14197,38.3,10939,357,1461,0.102909065,1945,12252
ZCTA5 46056,859,370,489,2432,42.1,2372,0,0,0,800,1632
ZCTA5 46057,421,786,-365,1169,35.8,1142,0,6,0.005132592,1900,-731
ZCTA5 46058,760,968,-208,1970,48.6,1879,10,7,0.003553299,2660,-690
ZCTA5 46060,17212,402,16810,47214,33.4,40426,1493,2310,0.048926166,1144,46070
ZCTA5 46062,12928,0,12928,35633,37.6,32657,750,1410,0.039570061,0,35633
ZCTA5 46063,138,3063,-2925,382,35,346,0,0,0,7773,-7391
ZCTA5 46064,5322,618,4704,16779,39.6,14956,65,1091,0.065021753,1725,15054
ZCTA5 46065,1066,1901,-835,3347,34.2,3181,9,92,0.027487302,4793,-1446
ZCTA5 46068,1045,1305,-260,2799,46.9,2758,17,1,0.00035727,3385,-586
ZCTA5 46069,2868,56,2812,6813,46.1,6545,41,0,0,153,6660
ZCTA5 46070,835,37,798,2344,41.1,2237,0,16,0.006825939,101,2243
ZCTA5 46071,1308,1457,-149,3367,47.5,3315,23,0,0,3921,-554
ZCTA5 46072,3708,2560,1148,8696,46.4,8390,26,47,0.005404784,6623,2073
ZCTA5 46074,14376,2264,12112,41248,36.3,33352,3204,1173,0.028437742,6046,35202
ZCTA5 46075,2489,1149,1340,7816,28.9,6307,372,527,0.067425793,3167,4649
ZCTA5 46076,547,814,-267,1492,33.8,1414,8,0,0,2139,-647
ZCTA5 46077,11609,1025,10584,32916,39,29056,2163,710,0.021570057,2711,30205
ZCTA5 46102,156,372,-216,397,47.1,393,0,0,0,931,-534
ZCTA5 46103,119,60,59,386,31,375,0,1,0.002590674,216,170
ZCTA5 46104,375,8,367,928,47.7,917,0,0,0,14,914
ZCTA5 46105,732,10813,-10081,1847,43,1783,30,0,0,28817,-26970
ZCTA5 46106,3122,275,2847,8905,39.8,8383,145,23,0.002582819,590,8315
ZCTA5 46107,5163,784,4379,13118,37.3,12104,174,344,0.02622351,1662,11456
ZCTA5 46110,225,8749,-8524,883,32.5,857,0,0,0,19790,-18907
ZCTA5 46111,162,9106,-8944,435,32.8,401,0,0,0,24444,-24009
ZCTA5 46112,14366,237,14129,40574,37.4,34928,408,3961,0.097624094,580,39994
ZCTA5 46113,6084,214,5870,15798,38.2,13574,43,1847,0.116913533,454,15344
ZCTA5 46115,638,188,450,1785,38.6,1768,0,0,0,523,1262
ZCTA5 46117,211,376,-165,512,59,343,0,0,0,1057,-545
ZCTA5 46118,1852,40,1812,4485,40.1,4243,30,91,0.020289855,74,4411
ZCTA5 46120,2487,3587,-1100,5660,46.7,5460,4,0,0,10041,-4381
ZCTA5 46121,1818,34,1784,4983,33.9,4949,0,0,0,111,4872
ZCTA5 46122,5876,66,5810,15945,40.5,15074,162,334,0.020947005,108,15837
ZCTA5 46123,15114,8498,6616,41124,37.5,33309,1543,3513,0.08542457,24112,17012
ZCTA5 46124,3049,635,2414,8428,38.9,7631,22,400,0.047460845,1822,6606
ZCTA5 46125,16,6129,-6113,44,-,44,0,0,0,14685,-14641
ZCTA5 46126,1669,829,840,3823,46.2,3782,0,0,0,2039,1784
ZCTA5 46127,123,1912,-1789,355,35.3,355,0,0,0,5298,-4943
ZCTA5 46128,833,1077,-244,1712,52,1687,0,4,0.002336449,2692,-980
ZCTA5 46130,916,105,811,2707,38.7,2408,0,18,0.006649427,163,2544
ZCTA5 46131,11907,478,11429,33754,36.2,31670,273,882,0.026130236,1083,32671
ZCTA5 46133,381,756,-375,892,53.3,892,0,0,0,2083,-1191
ZCTA5 46135,6591,225,6366,19580,35.6,17263,791,951,0.048569969,476,19104
ZCTA5 46140,16570,397,16173,41214,39.5,39314,396,408,0.009899549,1083,40131
ZCTA5 46142,13485,1376,12109,34982,39.1,31041,1739,941,0.026899548,5196,29786
ZCTA5 46143,21861,418,21443,57265,37,47989,4031,2004,0.034995198,1051,56214
ZCTA5 46144,122,636,-514,392,36.8,392,0,0,0,1842,-1450
ZCTA5 46146,96,6857,-6761,346,24.1,337,0,0,0,16787,-16441
ZCTA5 46147,983,933,50,2687,36.9,2493,2,31,0.01153703,2480,207
ZCTA5 46148,2008,2785,-777,5454,40.4,5338,0,0,0,7253,-1799
ZCTA5 46149,740,58,682,2327,33.3,2297,15,0,0,74,2253
ZCTA5 46150,327,3881,-3554,859,31.8,833,0,0,0,9802,-8943
ZCTA5 46151,11951,432,11519,32233,40.4,30875,336,142,0.004405423,914,31319
ZCTA5 46154,151,4354,-4203,413,18.7,413,0,0,0,11902,-11489
ZCTA5 46155,88,73,15,214,31.5,214,0,0,0,213,1
ZCTA5 46156,464,341,123,942,56.5,898,0,0,0,868,74
ZCTA5 46157,1270,3905,-2635,3717,36.1,3561,11,27,0.007263923,10393,-6676
ZCTA5 46158,9057,361,8696,24405,44.2,22945,263,29,0.001188281,1100,23305
ZCTA5 46160,2565,209,2356,6552,43.5,6175,32,33,0.00503663,493,6059
ZCTA5 46161,796,1539,-743,2097,43.1,2049,0,43,0.020505484,4306,-2209
ZCTA5 46162,167,633,-466,319,44,289,0,0,0,1782,-1463
ZCTA5 46163,5092,1133,3959,13948,42.8,13245,204,0,0,3293,10655
ZCTA5 46164,1627,650,977,4205,45.4,4055,18,26,0.006183115,1881,2324
ZCTA5 46165,731,1246,-515,2055,41.8,1855,60,0,0,3313,-1258
ZCTA5 46166,944,8531,-7587,2622,37.5,2559,0,0,0,23153,-20531
ZCTA5 46167,2606,514,2092,7141,41.7,6541,0,125,0.017504551,1453,5688
ZCTA5 46168,13973,2023,11950,37058,37.9,30522,1486,2448,0.066058611,5245,31813
ZCTA5 46170,0,1110,-1110,0,-,0,0,0,#DIV/0!,3108,-3108
ZCTA5 46171,798,69,729,2143,37.6,2122,0,0,0,161,1982
ZCTA5 46172,926,167,759,2285,48.3,2285,0,0,0,410,1875
ZCTA5 46173,4050,291,3759,10049,42.1,9689,16,97,0.009652702,956,9093
ZCTA5 46175,200,1700,-1500,588,25,588,0,0,0,4632,-4044
ZCTA5 46176,11536,511,11025,28455,38.6,26389,157,434,0.015252153,1396,27059
ZCTA5 46180,362,2236,-1874,786,51.6,776,0,0,0,5675,-4889
ZCTA5 46181,1858,2105,-247,5151,44.1,5034,28,6,0.001164822,6386,-1235
ZCTA5 46182,695,1575,-880,1723,47.8,1720,0,0,0,4040,-2317
ZCTA5 46183,0,2056,-2056,0,-,0,0,0,#DIV/0!,5145,-5145
ZCTA5 46184,4554,2529,2025,12544,38.7,12051,62,258,0.020567602,6200,6344
ZCTA5 46186,764,2732,-1968,1788,50.2,1788,0,0,0,7676,-5888
ZCTA5 46201,13652,0,13652,31193,34.4,19659,169,7726,0.247683775,0,31193
ZCTA5 46202,10289,1611,8678,21039,29.6,13242,1702,4661,0.221540948,4387,16652
ZCTA5 46203,15047,936,14111,38829,35,27714,581,7452,0.191918411,2427,36402
ZCTA5 46204,5058,150,4908,10246,31.6,6717,568,2124,0.20730041,254,9992
ZCTA5 46205,11919,5447,6472,28000,32.4,14696,804,10300,0.367857143,14654,13346
ZCTA5 46206,0,6116,-6116,0,-,0,0,0,#DIV/0!,16519,-16519
ZCTA5 46208,8843,117,8726,21908,31.7,9604,324,10411,0.475214534,326,21582
ZCTA5 46214,10101,1098,9003,23377,35.6,11354,477,8156,0.348889935,2684,20693
ZCTA5 46216,1274,352,922,2206,39.6,1153,12,840,0.380779692,971,1235
ZCTA5 46217,13545,1506,12039,39000,35.5,27185,6207,3659,0.093820513,4397,34603
ZCTA5 46218,12795,1477,11318,29254,38.7,6736,148,20438,0.698639502,3402,25852
ZCTA5 46219,15848,3942,11906,38174,36,26450,125,7365,0.192932362,11060,27114
ZCTA5 46220,16775,367,16408,36760,35.5,28950,674,4622,0.125734494,929,35831
ZCTA5 46221,10008,3819,6189,27018,34.5,21184,135,3596,0.133096454,10205,16813
ZCTA5 46222,12834,74,12760,38053,30.1,14000,787,14509,0.381283999,153,37900
ZCTA5 46224,15314,1515,13799,39490,32,18085,459,14344,0.363231198,4748,34742
ZCTA5 46225,2158,658,1500,4997,33,3889,35,593,0.118671203,1665,3332
ZCTA5 46226,18971,1433,17538,44764,33.8,14836,571,24006,0.536279153,3969,40795
ZCTA5 46227,23132,8133,14999,57359,33.6,40862,8896,3782,0.065935599,20007,37352
ZCTA5 46228,5724,17631,-11907,16947,35,7246,696,6896,0.406915678,44354,-27407
ZCTA5 46229,11418,463,10955,28062,36.7,11886,545,14018,0.49953674,1220,26842
ZCTA5 46231,3463,1567,1896,10824,36.9,5988,524,3561,0.328991131,4070,6754
ZCTA5 46234,10091,527,9564,27238,39.9,19426,1510,4102,0.150598429,1493,25745
ZCTA5 46235,12194,1707,10487,33715,29.2,10748,210,18828,0.558445796,4489,29226
ZCTA5 46236,10147,1028,9119,28163,38.7,20153,453,4164,0.147853567,2485,25678
ZCTA5 46237,16543,697,15846,40725,36.8,33448,3052,1887,0.046335175,1969,38756
ZCTA5 46239,11076,404,10672,33456,33.9,22968,1311,6800,0.203252033,984,32472
ZCTA5 46240,10050,1177,8873,19682,40.7,14652,953,2525,0.128289808,3082,16600
ZCTA5 46241,11278,721,10557,33756,30.5,22758,410,4823,0.142878303,1939,31817
ZCTA5 46250,8909,379,8530,17443,37.7,13254,286,2528,0.144929198,906,16537
ZCTA5 46254,16076,19401,-3325,40540,31.6,10835,887,24335,0.600271337,47415,-6875
ZCTA5 46256,9647,52,9595,21916,39.5,16893,951,2716,0.123927724,177,21739
ZCTA5 46259,4767,1353,3414,14955,37.4,12656,1073,58,0.003878302,4014,10941
ZCTA5 46260,14641,326,14315,35529,35.3,17408,877,14057,0.395648625,836,34693
ZCTA5 46268,10905,564,10341,24753,36.7,11189,553,10584,0.427584535,1375,23378
ZCTA5 46278,3252,1196,2056,8932,45,6073,391,2179,0.243954322,3361,5571
ZCTA5 46280,3447,2429,1018,7273,43,5914,238,567,0.077959577,6686,587
ZCTA5 46290,45,557,-512,67,39.7,67,0,0,0,1459,-1392
ZCTA5 46301,293,5649,-5356,588,64.6,563,0,19,0.032312925,14724,-14136
ZCTA5 46302,33,5552,-5519,55,70.1,55,0,0,0,14521,-14466
ZCTA5 46303,5860,5934,-74,16073,38.8,15305,101,1,6.22E-05,15761,312
ZCTA5 46304,10606,390,10216,26476,39.2,23884,473,503,0.018998338,982,25494
ZCTA5 46307,24846,493,24353,70253,40.7,58622,1076,4558,0.064879792,1411,68842
ZCTA5 46310,5063,16007,-10944,13468,43.3,12355,61,60,0.004455004,41832,-28364
ZCTA5 46311,8274,10504,-2230,22578,42.5,19525,654,871,0.038577376,26216,-3638
ZCTA5 46312,9953,2138,7815,26502,35.8,5754,22,9804,0.369934345,5106,21396
ZCTA5 46319,7341,565,6776,18012,37.7,12394,407,2878,0.159782367,1619,16393
ZCTA5 46320,5491,294,5197,13653,34.1,3082,180,6395,0.468395224,645,13008
ZCTA5 46321,9070,99,8971,23717,44.6,19293,1144,1093,0.046085087,304,23413
ZCTA5 46322,9922,606,9316,23607,43.2,18033,590,1690,0.071588935,1492,22115
ZCTA5 46323,8062,1272,6790,23690,36.1,11974,440,4379,0.184845927,3191,20499
ZCTA5 46324,8642,761,7881,21894,37.5,11140,280,5010,0.228829816,1744,20150
ZCTA5 46327,3845,359,3486,10877,32.8,4280,19,1115,0.102509883,987,9890
ZCTA5 46340,534,1268,-734,1301,56.5,1174,0,0,0,3660,-2359
ZCTA5 46341,3856,500,3356,10477,41.4,9786,76,0,0,1539,8938
ZCTA5 46342,12658,784,11874,31707,39.8,25655,368,2357,0.074336897,2243,29464
ZCTA5 46345,43,8262,-8219,75,70.6,75,0,0,0,21155,-21080
ZCTA5 46346,531,1943,-1412,1471,37,1195,7,114,0.0774983,6064,-4593
ZCTA5 46347,1743,392,1351,4773,40.1,4734,0,3,0.000628536,889,3884
ZCTA5 46348,459,1705,-1246,1108,47.3,1078,0,8,0.007220217,4372,-3264
ZCTA5 46349,1097,54,1043,2838,42.7,2832,0,0,0,106,2732
ZCTA5 46350,18092,8867,9225,44473,40.3,38835,107,1205,0.027095091,21801,22672
ZCTA5 46356,6755,702,6053,18538,40,16917,0,23,0.001240695,1990,16548
ZCTA5 46360,17680,74,17606,43888,39.8,30840,446,9219,0.210057419,217,43671
ZCTA5 46365,286,724,-438,598,61.3,598,0,0,0,1918,-1320
ZCTA5 46366,2116,7844,-5728,5955,36.5,5737,56,18,0.00302267,20518,-14563
ZCTA5 46368,15466,261,15205,39599,37.1,32033,526,3539,0.089370944,659,38940
ZCTA5 46371,1221,701,520,3828,41.3,3761,0,18,0.004702194,2027,1801
ZCTA5 46373,6187,675,5512,17253,44.5,15047,348,471,0.0272996,1734,15519
ZCTA5 46374,278,11219,-10941,978,31.9,894,0,0,0,28475,-27497
ZCTA5 46375,9528,246,9282,23796,45.3,19074,754,1746,0.073373676,525,23271
ZCTA5 46376,69,638,-569,198,34.5,192,0,0,0,1518,-1320
ZCTA5 46377,68,80,-12,259,36.1,259,0,0,0,187,72
ZCTA5 46379,177,1030,-853,316,57.9,298,0,0,0,2826,-2510
ZCTA5 46381,197,11763,-11566,480,56.1,425,25,0,0,27938,-27458
ZCTA5 46382,800,10254,-9454,2144,46.4,2132,0,0,0,25466,-23322
ZCTA5 46383,17053,13012,4041,42279,37.4,37697,551,1346,0.031836136,30369,11910
ZCTA5 46385,15329,1783,13546,40955,43.5,36917,735,908,0.022170675,4570,36385
ZCTA5 46390,1258,0,1258,3156,39.6,2822,68,138,0.043726236,5508,-2352
ZCTA5 46391,1976,1719,257,9340,38.1,7535,48,1396,0.149464668,4240,5100
ZCTA5 46392,2858,69,2789,7827,38.1,7408,0,49,0.006260381,175,7652
ZCTA5 46393,114,269,-155,217,56.4,205,0,0,0,685,-468
ZCTA5 46394,4827,588,4239,11948,39.8,7756,69,416,0.034817543,2002,9946
ZCTA5 46402,2385,2000,385,6105,33.4,297,59,5392,0.883210483,4812,1293
ZCTA5 46403,4827,2088,2739,11337,42.8,3097,14,7056,0.622386875,5494,5843
ZCTA5 46404,6502,9278,-2776,16702,35.8,239,55,15440,0.924440187,23165,-6463
ZCTA5 46405,4283,1355,2928,12101,36.3,8848,34,603,0.049830593,3246,8855
ZCTA5 46406,3149,274,2875,8453,31.7,2129,5,5189,0.6138649,693,7760
ZCTA5 46407,4126,1402,2724,9733,36.9,319,63,9167,0.941847324,3854,5879
ZCTA5 46408,5951,67,5884,14884,39.2,5863,64,7051,0.47373018,159,14725
ZCTA5 46409,2629,1090,1539,6986,37.1,671,0,5224,0.747781277,2631,4355
ZCTA5 46410,16272,353,15919,38873,39.5,14994,716,18001,0.463072055,850,38023
ZCTA5 46501,1268,1174,94,3697,38.6,3565,25,7,0.001893427,3131,566
ZCTA5 46502,0,859,-859,0,-,0,0,0,#DIV/0!,2207,-2207
ZCTA5 46504,1177,1112,65,3423,36.4,3208,29,40,0.011685656,3062,361
ZCTA5 46506,3659,87,3572,10070,39.9,9531,109,100,0.009930487,242,9828
ZCTA5 46507,3253,609,2644,9813,35.3,8016,32,45,0.004585754,1655,8158
ZCTA5 46508,91,1599,-1508,178,53.3,170,0,8,0.04494382,3755,-3577
ZCTA5 46510,1255,4103,-2848,3239,40.9,3075,6,7,0.002161161,10022,-6783
ZCTA5 46511,1662,201,1461,3921,50.4,3884,7,20,0.00510074,614,3307
ZCTA5 46513,0,263,-263,0,-,0,0,0,#DIV/0!,686,-686
ZCTA5 46514,16320,2294,14026,41503,40.1,35202,485,2256,0.054357516,5934,35569
ZCTA5 46516,11892,442,11450,31544,34.9,23526,229,4600,0.14582805,1095,30449
ZCTA5 46517,8859,1131,7728,26197,36.2,19377,141,1939,0.074016109,2970,23227
ZCTA5 46524,849,2229,-1380,2877,26.3,2870,0,0,0,5852,-2975
ZCTA5 46526,11372,507,10865,32874,37.2,26891,365,781,0.023757377,1374,31500
ZCTA5 46528,7873,418,7455,27437,31.7,23245,464,695,0.025330758,1198,26239
ZCTA5 46530,11540,1206,10334,31861,39.9,26975,2324,626,0.019647845,2873,28988
ZCTA5 46531,623,619,4,1658,57.6,1615,0,2,0.001206273,1805,-147
ZCTA5 46532,523,53,470,1567,37.7,1528,0,0,0,138,1429
ZCTA5 46534,3921,11336,-7415,10939,40,10484,14,9,0.000822744,29687,-18748
ZCTA5 46536,1147,38,1109,2843,48,2662,50,5,0.001758706,123,2720
ZCTA5 46537,260,962,-702,521,52.1,486,0,12,0.02303263,2351,-1830
ZCTA5 46538,1573,556,1017,4292,39.4,3996,27,0,0,1483,2809
ZCTA5 46539,1003,5015,-4012,2359,40.8,2328,0,8,0.003391267,12495,-10136
ZCTA5 46540,4130,858,3272,12825,34.2,12366,64,143,0.011150097,2088,10737
ZCTA5 46542,1609,19393,-17784,4643,33.5,4349,17,0,0,46669,-42026
ZCTA5 46543,866,723,143,3857,21.4,3697,0,2,0.000518538,1939,1918
ZCTA5 46544,12816,67,12749,31503,34.7,25965,223,2884,0.091546837,213,31290
ZCTA5 46545,12071,73,11998,26448,36.3,21308,868,1882,0.0711585,154,26294
ZCTA5 46550,4148,1068,3080,12158,32.4,11214,168,35,0.002878763,2852,9306
ZCTA5 46552,2443,742,1701,6542,40.9,6216,41,1,0.000152858,1780,4762
ZCTA5 46553,1119,708,411,3662,29.9,3495,12,0,0,1989,1673
ZCTA5 46554,1767,501,1266,4448,45.1,4357,20,10,0.002248201,1307,3141
ZCTA5 46555,1152,300,852,2278,53.5,2216,0,4,0.001755926,758,1520
ZCTA5 46556,174,105,69,8030,20.1,6634,401,333,0.041469489,279,7751
ZCTA5 46561,5338,2195,3143,14500,41.2,13165,178,303,0.020896552,5280,9220
ZCTA5 46562,1971,599,1372,4761,43.1,4429,38,8,0.001680319,1634,3127
ZCTA5 46563,8526,3340,5186,23677,38.9,21674,103,199,0.008404781,8337,15340
ZCTA5 46565,2416,2697,-281,8645,28.6,8251,23,8,0.00092539,6751,1894
ZCTA5 46567,3843,17475,-13632,9596,45.9,9016,10,51,0.005314714,41444,-31848
ZCTA5 46570,400,13132,-12732,1149,41.7,1094,26,29,0.025239339,30104,-28955
ZCTA5 46571,1572,8764,-7192,6071,24.2,5813,0,6,0.000988305,20730,-14659
ZCTA5 46572,43,0,43,140,39.5,140,0,0,0,5100,-4960
ZCTA5 46573,1299,0,1299,4034,38.1,3745,71,46,0.011403074,4422,-388
ZCTA5 46574,3246,10164,-6918,7756,43.5,7579,18,0,0,25147,-17391
ZCTA5 46580,8266,17,8249,22083,38.9,19298,229,214,0.009690712,49,22034
ZCTA5 46582,5814,11495,-5681,14470,33.3,12330,795,239,0.016516932,28064,-13594
ZCTA5 46590,1651,3594,-1943,5059,27.9,4645,45,53,0.010476379,8833,-3774
ZCTA5 46595,15,504,-489,51,47.7,51,0,0,0,1306,-1255
ZCTA5 46601,2189,3067,-878,5382,38.2,2633,124,2094,0.389074693,7999,-2617
ZCTA5 46613,3919,474,3445,11931,28.2,6621,124,2633,0.220685609,1370,10561
ZCTA5 46614,12285,1752,10533,29451,41.1,22417,464,4135,0.140402703,4441,25010
ZCTA5 46615,6224,1592,4632,13949,36.6,10276,500,1711,0.122661123,4115,9834
ZCTA5 46616,2352,32,2320,5666,33,3606,15,1118,0.197317331,103,5563
ZCTA5 46617,4343,601,3742,10630,34.7,7383,223,2090,0.196613358,1627,9003
ZCTA5 46619,7451,0,7451,20916,36.6,11221,98,4660,0.222795946,0,20916
ZCTA5 46624,34,1745,-1711,56,86.2,56,0,0,0,4511,-4455
ZCTA5 46628,11030,3852,7178,26955,39,16527,387,7664,0.284325728,9340,17615
ZCTA5 46635,2646,372,2274,6596,44.6,5845,202,334,0.05063675,1010,5586
ZCTA5 46637,7171,4206,2965,16028,38.4,12078,633,2302,0.143623659,10142,5886
ZCTA5 46701,3031,2980,51,8135,40.9,7794,2,81,0.009956976,7249,886
ZCTA5 46702,858,214,644,1989,46.1,1873,16,0,0,587,1402
ZCTA5 46703,7204,648,6556,18421,40.8,17378,158,92,0.0049943,1324,17097
ZCTA5 46704,30,1834,-1804,57,54.2,57,0,0,0,5169,-5112
ZCTA5 46705,703,182,521,1862,38.9,1658,30,0,0,546,1316
ZCTA5 46706,7750,3065,4685,19442,37,18982,54,26,0.001337311,7765,11677
ZCTA5 46710,1745,38,1707,4506,43.9,4199,6,3,0.000665779,48,4458
ZCTA5 46711,2417,380,2037,8009,28.8,7655,28,213,0.026595081,1122,6887
ZCTA5 46714,5984,14,5970,15254,38.6,14182,114,229,0.015012456,29,15225
ZCTA5 46721,1902,0,1902,5251,39.3,5084,47,13,0.002475719,0,5251
ZCTA5 46723,2949,1484,1465,7422,42.7,7205,38,1,0.000134735,4042,3380
ZCTA5 46725,9736,4740,4996,23423,42.6,22370,51,103,0.004397387,11489,11934
ZCTA5 46730,312,1836,-1524,808,54.1,796,0,0,0,4956,-4148
ZCTA5 46731,263,65,198,972,37.7,951,0,0,0,119,853
ZCTA5 46732,1010,247,763,2445,40.6,2309,0,0,0,684,1761
ZCTA5 46733,7682,18,7664,19313,40.8,18381,0,79,0.004090509,36,19277
ZCTA5 46737,3038,545,2493,7262,49,6888,77,0,0,1245,6017
ZCTA5 46738,3355,686,2669,8388,38.6,7989,92,60,0.007153076,1798,6590
ZCTA5 46740,1187,723,464,4516,24.4,4317,0,8,0.001771479,1809,2707
ZCTA5 46741,1381,1049,332,4811,29.7,4703,1,81,0.016836417,2756,2055
ZCTA5 46742,1342,6671,-5329,3237,45.2,3157,10,2,0.000617856,17689,-14452
ZCTA5 46743,991,1562,-571,2620,39.7,2573,0,0,0,3914,-1294
ZCTA5 46745,704,785,-81,1874,40.1,1867,0,0,0,1886,-12
ZCTA5 46746,1430,122,1308,4360,34.4,4169,9,20,0.004587156,1673,2687
ZCTA5 46747,945,349,596,2429,43.3,2408,0,0,0,962,1467
ZCTA5 46748,2256,590,1666,6691,32.7,5956,148,244,0.036466896,1373,5318
ZCTA5 46750,10793,164,10629,27247,39.2,26027,245,278,0.010202958,448,26799
ZCTA5 46755,6094,1186,4908,15419,40.7,14523,235,30,0.001945651,2972,12447
ZCTA5 46759,158,233,-75,390,42.3,366,0,0,0,649,-259
ZCTA5 46760,506,110,396,1289,40.8,1268,0,4,0.003103181,262,1027
ZCTA5 46761,4021,1431,2590,12225,31.5,11507,0,9,0.000736196,3488,8737
ZCTA5 46763,550,268,282,1264,51.2,1264,0,0,0,600,664
ZCTA5 46764,439,110,329,1502,34.1,1245,10,11,0.007323569,188,1314
ZCTA5 46765,1932,666,1266,5700,44.2,5472,17,23,0.004035088,1615,4085
ZCTA5 46766,180,250,-70,419,50.7,419,0,0,0,692,-273
ZCTA5 46767,2815,374,2441,8796,30.2,7626,50,14,0.001591633,874,7922
ZCTA5 46770,1079,284,795,2749,44.1,2691,2,3,0.001091306,745,2004
ZCTA5 46771,39,1700,-1661,112,28.6,58,0,0,0,5046,-4934
ZCTA5 46772,839,178,661,3312,24.4,3101,0,13,0.003925121,339,2973
ZCTA5 46773,1309,11,1298,3317,43.9,3216,0,0,0,23,3294
ZCTA5 46774,7041,275,6766,17560,40,16364,244,409,0.023291572,792,16768
ZCTA5 46776,654,413,241,1512,43.2,1407,6,0,0,1085,427
ZCTA5 46777,2634,3396,-762,6198,41.5,5904,0,0,0,9779,-3581
ZCTA5 46778,44,8380,-8336,84,62,84,0,0,0,21167,-21083
ZCTA5 46779,889,294,595,2250,46,2193,0,3,0.001333333,772,1478
ZCTA5 46781,312,344,-32,752,37.6,735,0,0,0,839,-87
ZCTA5 46783,2858,44,2814,7228,42,6694,23,34,0.004703929,104,7124
ZCTA5 46784,819,3101,-2282,2024,49.2,1952,0,9,0.00444664,8560,-6536
ZCTA5 46785,592,536,56,1887,32,1726,0,0,0,1345,542
ZCTA5 46786,17,1249,-1232,26,73.5,26,0,0,0,4977,-4951
ZCTA5 46787,1535,583,952,4177,36.8,4039,24,11,0.002633469,1594,2583
ZCTA5 46788,963,1557,-594,3353,29.3,3102,0,0,0,4259,-906
ZCTA5 46789,86,626,-540,161,35.1,161,0,0,0,1702,-1541
ZCTA5 46791,388,2260,-1872,969,34,952,2,0,0,5588,-4619
ZCTA5 46792,1530,215,1315,3482,50.5,3402,0,0,0,673,2809
ZCTA5 46793,1710,44,1666,4421,38.9,4200,20,0,0,120,4301
ZCTA5 46794,587,428,159,1443,52.8,1288,0,19,0.013167013,995,448
ZCTA5 46795,2493,122,2371,6918,42.6,6731,4,22,0.00318011,359,6559
ZCTA5 46796,46,395,-349,103,-,103,0,0,0,992,-889
ZCTA5 46797,1263,256,1007,4091,34,3889,2,12,0.002933268,659,3432
ZCTA5 46798,410,1100,-690,1049,37.2,947,0,0,0,2896,-1847
ZCTA5 46799,184,191,-7,443,45.5,423,0,0,0,567,-124
ZCTA5 46802,4887,1545,3342,10413,33.5,7271,101,1770,0.169979833,3812,6601
ZCTA5 46803,3912,70,3842,10327,27.6,4058,157,4409,0.426939092,135,10192
ZCTA5 46804,12346,222,12124,28635,40.6,24633,589,1733,0.060520342,536,28099
ZCTA5 46805,9524,4804,4720,22309,35.2,16301,1169,3304,0.148101663,11363,10946
ZCTA5 46806,8505,281,8224,23381,31.3,8089,1582,9608,0.410931953,601,22780
ZCTA5 46807,6165,313,5852,15941,30.6,10234,655,1850,0.116052945,703,15238
ZCTA5 46808,8471,10339,-1868,19433,36.2,15484,393,1505,0.077445582,27040,-7607
ZCTA5 46809,4089,90,3999,8944,39.3,6999,47,1080,0.120751342,140,8804
ZCTA5 46814,5255,368,4887,16180,36.5,13223,1555,548,0.033868974,932,15248
ZCTA5 46815,10246,1528,8718,27883,35.7,22115,1607,2709,0.097155973,3596,24287
ZCTA5 46816,7193,5506,1687,19421,33.5,7632,3838,6169,0.317645847,13941,5480
ZCTA5 46818,7933,1821,6112,21532,36.2,18739,432,509,0.023639235,5298,16234
ZCTA5 46819,4242,550,3692,9584,41.6,7614,82,1198,0.125,1191,8393
ZCTA5 46825,12623,387,12236,29109,38.1,21734,2640,2601,0.089353808,1101,28008
ZCTA5 46835,14475,995,13480,35610,33.8,29035,937,2403,0.067481045,2647,32963
ZCTA5 46845,10003,554,9449,27626,40.9,24373,1095,826,0.02989937,1553,26073
ZCTA5 46901,16251,135,16116,39015,40.6,33465,156,3570,0.091503268,409,38606
ZCTA5 46902,15522,599,14923,36233,40.1,30143,881,3245,0.089559242,1449,34784
ZCTA5 46910,1140,5255,-4115,3203,37.3,2658,0,4,0.001248829,13216,-10013
ZCTA5 46911,576,12777,-12201,1618,35.5,1551,1,8,0.004944376,34483,-32865
ZCTA5 46913,449,817,-368,1207,35.6,1207,0,0,0,1931,-724
ZCTA5 46914,960,1017,-57,3075,43.2,2545,188,174,0.056585366,2592,483
ZCTA5 46915,324,1027,-703,760,41.5,737,0,0,0,2298,-1538
ZCTA5 46917,700,2149,-1449,1752,44,1631,0,3,0.001712329,5898,-4146
ZCTA5 46919,776,558,218,1878,42.8,1774,17,22,0.01171459,1415,463
ZCTA5 46920,458,1266,-808,1251,36.1,1241,0,0,0,3117,-1866
ZCTA5 46922,0,1529,-1529,0,-,0,0,0,#DIV/0!,4424,-4424
ZCTA5 46923,3149,392,2757,8200,44.2,7720,35,5,0.000609756,1019,7181
ZCTA5 46926,573,1820,-1247,1576,46,1513,0,0,0,4696,-3120
ZCTA5 46928,1935,635,1300,4632,44.8,4414,0,0,0,1498,3134
ZCTA5 46929,1329,44,1285,3177,43.4,2973,0,93,0.029272899,120,3057
ZCTA5 46930,70,1991,-1921,183,48.4,183,0,0,0,4895,-4712
ZCTA5 46931,117,1413,-1296,220,58.6,218,0,0,0,3643,-3423
ZCTA5 46932,1386,582,804,3088,47.8,2954,0,65,0.021049223,1491,1597
ZCTA5 46933,2635,4771,-2136,6397,41.2,6078,114,120,0.018758793,12162,-5765
ZCTA5 46936,2206,57,2149,5814,43.3,5672,27,18,0.003095975,151,5663
ZCTA5 46937,29,243,-214,59,-,59,0,0,0,465,-406
ZCTA5 46938,1152,8509,-7357,2365,46.6,2286,0,30,0.012684989,19288,-16923
ZCTA5 46939,766,12763,-11997,1717,50.3,1601,4,32,0.018637158,30806,-29089
ZCTA5 46940,1104,10219,-9115,2878,42.9,2730,26,12,0.004169562,26603,-23725
ZCTA5 46941,335,4637,-4302,852,47.6,782,0,0,0,10367,-9515
ZCTA5 46943,45,13497,-13452,183,22.6,100,0,0,0,34114,-33931
ZCTA5 46945,19,12775,-12756,19,-,19,0,0,0,27313,-27294
ZCTA5 46946,39,6857,-6818,99,34.6,99,0,0,0,18111,-18012
ZCTA5 46947,11071,5973,5098,28847,39.7,22610,608,318,0.011023677,15805,13042
ZCTA5 46950,237,12415,-12178,449,62.2,449,0,0,0,33880,-33431
ZCTA5 46951,745,8435,-7690,2093,44.7,1923,2,3,0.001433349,21258,-19165
ZCTA5 46952,8085,4426,3659,18145,46,15409,261,1099,0.060567649,11312,6833
ZCTA5 46953,8361,4886,3475,23359,33.5,18450,72,3349,0.143370863,12891,10468
ZCTA5 46957,201,5083,-4882,436,52.7,425,0,0,0,13189,-12753
ZCTA5 46958,354,0,354,712,44.7,712,0,0,0,2761,-2049
ZCTA5 46959,236,328,-92,456,44.4,456,0,0,0,881,-425
ZCTA5 46960,470,515,-45,1219,45.9,1068,6,0,0,1466,-247
ZCTA5 46961,32,7430,-7398,73,64.1,73,0,0,0,19771,-19698
ZCTA5 46962,3167,0,3167,8596,40.5,8210,50,192,0.02233597,0,8596
ZCTA5 46965,0,441,-441,0,-,0,0,0,#DIV/0!,1139,-1139
ZCTA5 46967,57,788,-731,168,35,160,1,0,0,4134,-3966
ZCTA5 46968,57,589,-532,138,45.2,138,0,0,0,1706,-1568
ZCTA5 46970,8487,807,7680,23372,39.7,20287,45,1392,0.059558446,1905,21467
ZCTA5 46971,0,3920,-3920,0,-,0,0,0,#DIV/0!,9927,-9927
ZCTA5 46974,686,248,438,1782,41.3,1625,5,27,0.015151515,558,1224
ZCTA5 46975,5602,390,5212,14267,41.9,13637,25,69,0.004836336,875,13392
ZCTA5 46978,919,726,193,2189,44,2125,0,4,0.001827318,1744,445
ZCTA5 46979,1781,118,1663,5302,40.9,5105,11,9,0.001697473,296,5006
ZCTA5 46980,31,915,-884,185,18.9,185,0,0,0,2201,-2016
ZCTA5 46982,1036,47,989,2571,51.1,2538,2,1,0.000388954,100,2471
ZCTA5 46984,17,467,-450,26,33.4,26,0,0,0,1153,-1127
ZCTA5 46985,462,206,256,1186,52.2,1163,0,0,0,547,639
ZCTA5 46986,688,171,517,1661,39.9,1594,4,14,0.008428657,583,1078
ZCTA5 46987,472,416,56,1208,44.5,1185,9,7,0.005794702,1094,114
ZCTA5 46988,337,439,-102,715,42.9,671,0,0,0,1600,-885
ZCTA5 46989,1467,111,1356,5613,23.4,5140,172,102,0.0181721,291,5322
ZCTA5 46990,214,165,49,497,53.3,478,8,0,0,387,110
ZCTA5 46991,823,542,281,1807,45.5,1785,0,0,0,1448,359
ZCTA5 46992,7168,79,7089,16663,42.9,15892,72,104,0.006241373,276,16387
ZCTA5 46994,957,26,931,2298,51.1,2228,30,0,0,42,2256
ZCTA5 46996,2561,139,2422,5994,43.6,5514,45,17,0.00283617,250,5744
ZCTA5 46998,102,1160,-1058,252,34.4,215,0,0,0,3042,-2790
ZCTA5 47001,4353,28,4325,10404,45.5,9683,42,33,0.003171857,112,10292
ZCTA5 47003,475,92,383,1063,48.6,1032,4,16,0.01505174,216,847
ZCTA5 47006,4809,2656,2153,12394,41.5,11860,172,32,0.002581894,8220,4174
ZCTA5 47010,54,1417,-1363,214,37.4,214,0,0,0,3236,-3022
ZCTA5 47011,291,0,291,695,47.2,694,0,0,0,426,269
ZCTA5 47012,4110,1391,2719,10253,38.9,9902,72,0,0,3386,6867
ZCTA5 47016,369,11,358,819,49.6,819,0,0,0,11,808
ZCTA5 47017,251,152,99,567,51.2,556,0,0,0,482,85
ZCTA5 47018,1642,3466,-1824,4524,41.3,4350,21,59,0.013041556,8474,-3950
ZCTA5 47020,400,72,328,1076,31.7,1076,0,0,0,178,898
ZCTA5 47021,0,3284,-3284,0,-,0,0,0,#DIV/0!,9068,-9068
ZCTA5 47022,1159,1975,-816,2958,50.1,2954,0,0,0,3489,-531
ZCTA5 47023,872,6620,-5748,2170,46.7,2080,0,19,0.00875576,15033,-12863
ZCTA5 47024,1235,16383,-15148,3145,33.7,2998,0,11,0.003497615,40191,-37046
ZCTA5 47025,8681,22411,-13730,22993,39.4,22619,20,129,0.005610403,67388,-44395
ZCTA5 47030,679,0,679,2227,33.4,2223,0,0,0,0,2227
ZCTA5 47031,1992,15588,-13596,5230,41.7,5105,65,16,0.003059273,39902,-34672
ZCTA5 47032,1222,34,1188,3307,42.8,3265,0,0,0,77,3230
ZCTA5 47033,0,181,-181,0,-,0,0,0,#DIV/0!,509,-509
ZCTA5 47034,64,2403,-2339,134,32.6,134,0,0,0,6027,-5893
ZCTA5 47035,103,893,-790,188,76.2,188,0,0,0,2276,-2088
ZCTA5 47036,369,469,-100,1065,44.2,1010,50,0,0,1148,-83
ZCTA5 47037,1700,573,1127,4464,37.9,4284,25,3,0.000672043,1676,2788
ZCTA5 47038,348,1391,-1043,1040,35.6,1021,0,6,0.005769231,3518,-2478
ZCTA5 47040,2281,82,2199,5291,46.1,5023,25,12,0.002268002,205,5086
ZCTA5 47041,2279,92,2187,6312,38.9,6185,0,0,0,395,5917
ZCTA5 47042,1653,384,1269,4071,46.1,3982,0,12,0.002947679,1031,3040
ZCTA5 47043,1996,835,1161,5005,44.2,4716,67,27,0.005394605,1960,3045
ZCTA5 47060,2479,249,2230,6440,46.3,6027,236,19,0.002950311,694,5746
ZCTA5 47102,2670,427,2243,6662,44.6,6193,0,0,0,1069,5593
ZCTA5 47104,9,2116,-2107,9,-,9,0,0,0,5436,-5427
ZCTA5 47106,1558,10745,-9187,4534,39.1,4466,0,5,0.001102779,28036,-23502
ZCTA5 47108,907,470,437,2279,47.3,2136,0,15,0.006581834,1226,1053
ZCTA5 47110,202,398,-196,645,38.4,645,0,0,0,1002,-357
ZCTA5 47111,6372,284,6088,18169,37.2,16299,34,482,0.026528703,681,17488
ZCTA5 47112,6406,279,6127,16949,44.2,16115,41,96,0.005664051,1007,15942
ZCTA5 47114,189,1384,-1195,516,41.8,516,0,0,0,3431,-2915
ZCTA5 47115,1037,712,325,3259,35.1,3097,11,0,0,1915,1344
ZCTA5 47116,195,575,-380,446,54.3,446,0,0,0,1511,-1065
ZCTA5 47117,1550,595,955,4392,40.9,4220,26,103,0.02345173,1660,2732
ZCTA5 47118,1270,312,958,3341,39.6,3175,0,2,0.000598623,1027,2314
ZCTA5 47119,4214,907,3307,11412,44.9,10733,78,45,0.003943218,2130,9282
ZCTA5 47120,322,1179,-857,744,46.2,731,0,0,0,2722,-1978
ZCTA5 47122,3895,930,2965,11523,38.5,11140,116,37,0.003210969,2485,9038
ZCTA5 47123,54,464,-410,188,24.4,149,0,0,0,1220,-1032
ZCTA5 47124,1780,777,1003,5456,42.8,5212,92,85,0.015579179,2310,3146
ZCTA5 47125,614,96,518,1527,38.7,1483,0,0,0,198,1329
ZCTA5 47126,1521,1034,487,4234,38.3,4161,0,18,0.004251299,2718,1516
ZCTA5 47129,8304,6259,2045,19635,40.8,17027,104,1373,0.069926152,14945,4690
ZCTA5 47130,19235,796,18439,47894,38.6,37136,773,5839,0.121915062,2005,45889
ZCTA5 47135,341,60,281,971,39,779,0,0,0,165,806
ZCTA5 47136,1498,272,1226,4494,42.5,4133,180,56,0.012461059,771,3723
ZCTA5 47137,608,207,401,1627,45.6,1561,0,4,0.002458513,475,1152
ZCTA5 47138,1859,296,1563,5289,41.1,5156,46,8,0.001512573,976,4313
ZCTA5 47140,1108,284,824,2619,40,2481,0,0,0,652,1967
ZCTA5 47141,607,59,548,1490,47.5,1483,0,0,0,144,1346
ZCTA5 47142,238,755,-517,501,48.2,501,0,0,0,2078,-1577
ZCTA5 47143,1266,749,517,3675,34.5,3597,0,23,0.006258503,1957,1718
ZCTA5 47145,848,469,379,2086,45.9,2016,0,43,0.020613615,1253,833
ZCTA5 47147,433,226,207,1013,52.8,1013,0,0,0,491,522
ZCTA5 47150,19462,853,18609,49332,38.6,41927,648,3762,0.076258818,2312,47020
ZCTA5 47160,31,4292,-4261,88,28.5,81,0,7,0.079545455,11491,-11403
ZCTA5 47161,1163,431,732,3410,43.6,3405,0,1,0.000293255,1251,2159
ZCTA5 47162,202,375,-173,585,35.4,585,0,0,0,1060,-475
ZCTA5 47163,367,56,311,789,54.9,761,0,0,0,110,679
ZCTA5 47164,1444,88,1356,3391,42,3328,10,4,0.001179593,343,3048
ZCTA5 47165,2679,1609,1070,7026,40.1,6909,8,0,0,3802,3224
ZCTA5 47166,479,524,-45,1275,42.1,1251,8,0,0,1363,-88
ZCTA5 47167,5756,588,5168,15265,39.6,14764,45,2,0.000131019,1439,13826
ZCTA5 47170,5834,472,5362,14544,40.9,14069,0,45,0.003094059,1134,13410
ZCTA5 47172,6969,529,6440,19135,41.1,17664,226,366,0.019127254,1217,17918
ZCTA5 47174,24,1545,-1521,37,55.5,37,0,0,0,4297,-4260
ZCTA5 47175,315,151,164,777,47.5,777,0,0,0,304,473
ZCTA5 47177,682,609,73,2166,34.7,2061,0,42,0.019390582,1469,697
ZCTA5 47201,18539,39,18500,47089,36.5,38279,4697,1048,0.022255729,106,46983
ZCTA5 47203,10549,5131,5418,25626,40.5,21588,1738,232,0.009053305,12075,13551
ZCTA5 47220,2139,1189,950,5682,46.1,5531,26,46,0.008095741,3286,2396
ZCTA5 47223,371,2206,-1835,997,45.3,969,0,0,0,5951,-4954
ZCTA5 47224,153,1831,-1678,545,33.3,533,0,0,0,5390,-4845
ZCTA5 47225,35,1419,-1384,49,65.6,49,0,0,0,4049,-4000
ZCTA5 47226,96,8824,-8728,243,39.8,232,0,11,0.04526749,20153,-19910
ZCTA5 47227,624,1487,-863,1453,54.1,1453,0,0,0,4410,-2957
ZCTA5 47229,1013,3670,-2657,2872,38.1,2794,0,0,0,8289,-5417
ZCTA5 47230,761,5255,-4494,1796,42.4,1772,6,0,0,11885,-10089
ZCTA5 47231,243,12599,-12356,876,26.5,812,0,34,0.038812785,32454,-31578
ZCTA5 47232,869,948,-79,2435,42.9,2318,0,40,0.016427105,2647,-212
ZCTA5 47234,592,2174,-1582,1625,38.4,1493,0,0,0,5250,-3625
ZCTA5 47235,605,5545,-4940,1593,38.8,1593,0,0,0,14610,-13017
ZCTA5 47236,68,5999,-5931,284,21.2,284,0,0,0,14563,-14279
ZCTA5 47240,8545,1243,7302,21892,40.1,20780,342,40,0.001827151,3243,18649
ZCTA5 47243,1854,571,1283,5989,32,5595,31,93,0.015528469,1158,4831
ZCTA5 47244,191,6768,-6577,499,43.8,492,2,0,0,16579,-16080
ZCTA5 47246,1406,803,603,4121,38.3,3912,82,10,0.002426595,2237,1884
ZCTA5 47247,73,7498,-7425,188,29.8,151,0,0,0,16258,-16070
ZCTA5 47250,9313,6457,2856,22703,43,21066,208,537,0.023653262,13296,9407
ZCTA5 47260,713,14130,-13417,1867,46.8,1854,0,0,0,34667,-32800
ZCTA5 47263,71,9082,-9011,187,37.9,182,0,0,0,21240,-21053
ZCTA5 47264,532,18174,-17642,1417,42.2,1243,0,0,0,41391,-39974
ZCTA5 47265,7584,3143,4441,20738,38.8,19595,71,221,0.010656765,7817,12921
ZCTA5 47270,185,4202,-4017,405,45.5,405,0,0,0,9933,-9528
ZCTA5 47272,642,1607,-965,1606,40.4,1490,1,29,0.018057285,4392,-2786
ZCTA5 47273,924,8908,-7984,2490,37.1,2490,0,0,0,26680,-24190
ZCTA5 47274,12352,7019,5333,33157,37.9,28282,816,552,0.016648068,16345,16812
ZCTA5 47280,306,17527,-17221,668,48.6,659,0,0,0,52258,-51590
ZCTA5 47281,513,10989,-10476,1352,41,1352,0,0,0,24680,-23328
ZCTA5 47282,91,14571,-14480,177,50.9,176,0,0,0,39232,-39055
ZCTA5 47283,1294,2573,-1279,3747,40.4,3694,0,0,0,8225,-4478
ZCTA5 47302,10774,2034,8740,25093,40.2,22094,58,1793,0.07145419,5563,19530
ZCTA5 47303,10043,606,9437,24139,29.2,19898,158,3207,0.132855545,1430,22709
ZCTA5 47304,13663,5695,7968,31830,36.1,28160,1138,1187,0.037291863,16634,15196
ZCTA5 47305,1675,2845,-1170,3120,42.2,2386,19,438,0.140384615,7321,-4201
ZCTA5 47306,0,6307,-6307,4596,19.4,3616,102,517,0.112489121,15098,-10502
ZCTA5 47320,1873,16210,-14337,4413,47.9,4223,18,14,0.003172445,40784,-36371
ZCTA5 47324,73,3557,-3484,217,34.1,214,0,0,0,9409,-9192
ZCTA5 47325,181,1487,-1306,571,49.3,571,0,0,0,4090,-3519
ZCTA5 47326,583,1458,-875,2104,24.9,2092,0,0,0,4151,-2047
ZCTA5 47327,1779,3894,-2115,4261,44.9,4189,0,0,0,10593,-6332
ZCTA5 47330,2116,19893,-17777,5527,39.8,5167,32,21,0.00379953,47542,-42015
ZCTA5 47331,9493,11963,-2470,22813,44,21576,23,341,0.014947618,24457,-1644
ZCTA5 47334,1295,1114,181,3067,42.3,3003,15,15,0.004890773,2541,526
ZCTA5 47335,293,2313,-2020,626,45,621,0,0,0,6236,-5610
ZCTA5 47336,1211,12751,-11540,2738,48.5,2641,0,50,0.018261505,29854,-27116
ZCTA5 47337,63,6578,-6515,172,36.3,172,0,0,0,15034,-14862
ZCTA5 47338,1068,16300,-15232,2433,42.7,2342,0,0,0,33321,-30888
ZCTA5 47339,182,3696,-3514,533,41.3,530,0,0,0,9313,-8780
ZCTA5 47340,1255,8949,-7694,3300,36,2994,1,0,0,21684,-18384
ZCTA5 47341,968,10020,-9052,2443,41.4,2414,7,0,0,25141,-22698
ZCTA5 47342,939,4746,-3807,2383,41.5,2325,4,0,0,12307,-9924
ZCTA5 47344,73,10735,-10662,179,50.9,178,0,0,0,23019,-22840
ZCTA5 47345,521,8929,-8408,1521,41,1433,10,0,0,20700,-19179
ZCTA5 47346,1430,7171,-5741,3749,41.9,3647,0,0,0,16225,-12476
ZCTA5 47348,3870,8930,-5060,9195,42.9,8934,0,57,0.006199021,23265,-14070
ZCTA5 47351,176,6039,-5863,612,30.8,547,0,15,0.024509804,14440,-13828
ZCTA5 47352,279,8385,-8106,793,37.3,778,0,0,0,24362,-23569
ZCTA5 47353,2148,9253,-7105,5346,42.8,5125,124,5,0.000935279,22953,-17607
ZCTA5 47354,559,11360,-10801,1317,46.5,1291,6,0,0,30197,-28880
ZCTA5 47355,1336,12135,-10799,2969,48.5,2686,0,12,0.004041765,31229,-28260
ZCTA5 47356,2360,10302,-7942,5560,45.3,5263,38,26,0.004676259,26508,-20948
ZCTA5 47357,309,10058,-9749,701,50,692,0,4,0.005706134,23663,-22962
ZCTA5 47358,381,6519,-6138,1003,41.6,942,0,0,0,17730,-16727
ZCTA5 47359,1219,1791,-572,3531,40.6,3349,34,6,0.001699235,4906,-1375
ZCTA5 47360,568,1465,-897,1369,46.4,1280,4,6,0.004382761,3810,-2441
ZCTA5 47361,96,1912,-1816,232,48.1,231,0,0,0,5249,-5017
ZCTA5 47362,10731,6992,3739,29463,42,27151,97,1151,0.039065947,19240,10223
ZCTA5 47366,14,11062,-11048,29,50.8,13,9,0,0,28072,-28043
ZCTA5 47367,42,23342,-23300,53,65.7,53,0,0,0,54256,-54203
ZCTA5 47368,804,14535,-13731,1892,47.3,1857,0,0,0,39094,-37202
ZCTA5 47369,778,14248,-13470,1621,48.2,1548,2,0,0,33127,-31506
ZCTA5 47370,93,11172,-11079,166,45.5,166,0,0,0,26549,-26383
ZCTA5 47371,4840,0,4840,12032,40.3,11472,70,40,0.003324468,7585,4447
ZCTA5 47373,873,16643,-15770,2261,42.4,2148,20,0,0,42366,-40105
ZCTA5 47374,18684,7351,11333,45433,40.6,38765,773,3126,0.068804613,20406,25027
ZCTA5 47380,667,10486,-9819,1579,46.6,1506,0,0,0,25969,-24390
ZCTA5 47381,71,3894,-3823,182,35,168,0,0,0,10328,-10146
ZCTA5 47382,62,5041,-4979,178,29.5,176,0,0,0,12494,-12316
ZCTA5 47383,1110,2320,-1210,3047,39.4,2850,0,1,0.000328192,7388,-4341
ZCTA5 47384,760,4271,-3511,1977,38.9,1939,0,0,0,10676,-8699
ZCTA5 47385,739,13352,-12613,1876,38.6,1831,0,3,0.001599147,32356,-30480
ZCTA5 47386,494,7759,-7265,1140,52.2,1108,0,2,0.001754386,20569,-19429
ZCTA5 47387,240,13311,-13071,582,42.5,561,0,2,0.003436426,47394,-46812
ZCTA5 47388,173,13181,-13008,395,45.1,393,0,2,0.005063291,36885,-36490
ZCTA5 47390,2236,4098,-1862,5085,42.7,4512,22,0,0,10371,-5286
ZCTA5 47392,74,5190,-5116,173,53.3,173,0,0,0,14580,-14407
ZCTA5 47393,517,2550,-2033,1783,33.3,1740,0,0,0,6501,-4718
ZCTA5 47394,3291,2323,968,8489,41.6,8243,81,52,0.006125574,5516,2973
ZCTA5 47396,2724,7621,-4897,7476,39.4,6890,156,36,0.004815409,20718,-13242
ZCTA5 47401,18464,10198,8266,40195,35.6,33559,3989,764,0.019007339,27639,12556
ZCTA5 47403,14581,1780,12801,33444,35.1,28886,660,2027,0.060608779,4688,28756
ZCTA5 47404,10798,4095,6703,23910,32.5,20672,922,964,0.040317859,10354,13556
ZCTA5 47405,0,99,-99,2007,19.5,1527,372,36,0.01793722,248,1759
ZCTA5 47406,5,1081,-1076,8777,19.2,7232,1024,202,0.023014698,3088,5689
ZCTA5 47408,8966,9754,-788,21752,24.5,17749,2089,765,0.03516918,25455,-3703
ZCTA5 47420,81,0,81,133,69.4,133,0,0,0,0,133
ZCTA5 47421,11967,3692,8275,27509,45.2,26258,118,70,0.002544622,10301,17208
ZCTA5 47424,3358,1425,1933,8545,46.6,8340,10,62,0.007255705,3561,4984
ZCTA5 47427,277,14170,-13893,809,48.2,769,0,0,0,37836,-37027
ZCTA5 47429,3002,10390,-7388,7408,40.3,6986,123,28,0.003779698,27241,-19833
ZCTA5 47431,546,12442,-11896,1751,34.1,1643,0,0,0,31060,-29309
ZCTA5 47432,1834,14319,-12485,4502,40.6,3896,21,307,0.068191915,38331,-33829
ZCTA5 47433,1411,627,784,3543,49,3517,0,0,0,1454,2089
ZCTA5 47434,10,2896,-2886,10,-,10,0,0,0,7486,-7476
ZCTA5 47435,69,844,-775,120,68.8,111,0,0,0,2304,-2184
ZCTA5 47436,582,4725,-4143,1534,44.7,1492,24,0,0,13842,-12308
ZCTA5 47437,68,10509,-10441,120,66.9,120,0,0,0,27035,-26915
ZCTA5 47438,1562,11748,-10186,3910,40.7,3792,0,26,0.006649616,28861,-24951
ZCTA5 47441,3861,3252,609,8987,40.9,8702,1,19,0.002114165,9755,-768
ZCTA5 47443,455,2375,-1920,1257,45.3,1162,32,0,0,5888,-4631
ZCTA5 47445,32,4208,-4176,61,39.3,61,0,0,0,11473,-11412
ZCTA5 47446,3740,9239,-5499,9418,39.2,9066,156,51,0.005415162,22089,-12671
ZCTA5 47448,3115,7526,-4411,7153,54,6894,71,54,0.00754928,22004,-14851
ZCTA5 47449,150,7806,-7656,387,44.1,337,0,0,0,20698,-20311
ZCTA5 47451,548,15960,-15412,1538,41.6,1361,2,0,0,39459,-37921
ZCTA5 47452,1972,4658,-2686,5138,45.4,5032,37,11,0.002140911,12515,-7377
ZCTA5 47453,175,11777,-11602,372,41.6,367,0,0,0,31558,-31186
ZCTA5 47454,3047,7766,-4719,7427,42.7,6996,22,12,0.001615726,20443,-13016
ZCTA5 47455,27,102,-75,39,59.4,39,0,0,0,302,-263
ZCTA5 47456,553,11364,-10811,1345,47.1,1303,0,0,0,29729,-28384
ZCTA5 47457,9,1236,-1227,35,13.9,35,0,0,0,3215,-3180
ZCTA5 47458,17,23463,-23446,48,46.5,48,0,0,0,62916,-62868
ZCTA5 47459,1383,8037,-6654,3677,43.5,3602,0,30,0.008158825,21579,-17902
ZCTA5 47460,4641,16705,-12064,11247,46.7,10761,87,8,0.000711301,42225,-30978
ZCTA5 47462,1732,6915,-5183,4862,38.1,4684,14,0,0,17585,-12723
ZCTA5 47464,155,21028,-20873,323,41,290,0,0,0,47519,-47196
ZCTA5 47465,153,13237,-13084,386,37.5,383,0,0,0,36251,-35865
ZCTA5 47467,0,16702,-16702,0,-,0,0,0,#DIV/0!,47914,-47914
ZCTA5 47468,634,13990,-13356,1316,57.7,1298,0,0,0,41190,-39874
ZCTA5 47469,697,5355,-4658,1806,38,1760,22,0,0,13414,-11608
ZCTA5 47470,588,28,560,1434,42.8,1434,0,0,0,56,1378
ZCTA5 47471,1220,1284,-64,3228,36,3097,0,1,0.000309789,3781,-553
ZCTA5 47501,6965,10665,-3700,17936,38,16144,25,540,0.030107047,25839,-7903
ZCTA5 47512,1713,5765,-4052,4023,39.2,3887,0,0,0,15520,-11497
ZCTA5 47513,708,12878,-12170,1895,36.8,1827,0,0,0,29879,-27984
ZCTA5 47514,131,24128,-23997,1689,38.3,1245,0,395,0.233866193,61339,-59650
ZCTA5 47515,333,15386,-15053,945,32,918,5,0,0,37995,-37050
ZCTA5 47516,438,6052,-5614,1134,41.8,1124,0,0,0,11033,-9899
ZCTA5 47519,197,7196,-6999,611,34.7,611,0,0,0,16265,-15654
ZCTA5 47520,1158,10547,-9389,2662,43.8,2585,0,15,0.005634861,28577,-25915
ZCTA5 47521,341,10118,-9777,766,42.5,766,0,0,0,28011,-27245
ZCTA5 47522,131,13358,-13227,425,34.9,416,5,0,0,41947,-41522
ZCTA5 47523,1311,7918,-6607,3647,36.4,3458,0,0,0,22436,-18789
ZCTA5 47524,189,10517,-10328,439,37.3,428,0,0,0,20085,-19646
ZCTA5 47525,117,4315,-4198,239,68.7,239,0,0,0,10084,-9845
ZCTA5 47527,833,9601,-8768,2401,40.2,2294,0,51,0.02124115,34583,-32182
ZCTA5 47528,209,9111,-8902,492,51.1,491,0,0,0,31141,-30649
ZCTA5 47529,389,2087,-1698,1132,30.8,1113,0,12,0.010600707,6318,-5186
ZCTA5 47531,342,11241,-10899,781,50.1,781,0,0,0,39592,-38811
ZCTA5 47532,1666,9143,-7477,4310,48.9,4230,0,11,0.002552204,28729,-24419
ZCTA5 47535,278,9450,-9172,752,41.4,637,0,0,0,22673,-21921
ZCTA5 47537,335,5137,-4802,734,58.6,734,0,0,0,14568,-13834
ZCTA5 47541,438,2066,-1628,1132,39.1,1077,2,1,0.000883392,5117,-3985
ZCTA5 47542,3969,3238,731,9800,39.7,8036,0,309,0.031530612,8159,1641
ZCTA5 47546,9025,2901,6124,22396,39.5,20880,168,167,0.007456689,7951,14445
ZCTA5 47550,232,17479,-17247,564,40.1,533,0,0,0,48391,-47827
ZCTA5 47551,184,10341,-10157,538,38.5,538,0,0,0,22761,-22223
ZCTA5 47552,95,14604,-14509,299,51.3,299,0,0,0,40152,-39853
ZCTA5 47553,3076,9009,-5933,8383,38.8,8172,0,20,0.002385781,24185,-15802
ZCTA5 47557,573,14792,-14219,1455,35.4,1429,0,0,0,45296,-43841
ZCTA5 47558,1349,5935,-4586,5245,26.3,5236,0,0,0,14532,-9287
ZCTA5 47561,675,3044,-2369,1509,43.6,1486,2,0,0,5232,-3723
ZCTA5 47562,1685,16345,-14660,4979,32.1,4789,17,11,0.002209279,47007,-42028
ZCTA5 47564,573,18660,-18087,1278,50.3,1248,0,0,0,53145,-51867
ZCTA5 47567,2545,3579,-1034,6193,45.5,6065,0,45,0.007266268,9707,-3514
ZCTA5 47568,224,6388,-6164,658,33.2,564,0,2,0.003039514,16920,-16262
ZCTA5 47573,15,0,15,34,69.3,34,0,0,0,0,34
ZCTA5 47574,83,12536,-12453,181,51.9,181,0,0,0,36211,-36030
ZCTA5 47575,383,17597,-17214,1014,45,1014,0,0,0,46133,-45119
ZCTA5 47576,152,11790,-11638,457,42.3,422,0,0,0,30528,-30071
ZCTA5 47577,428,11507,-11079,1158,52.9,1091,42,6,0.005181347,29523,-28365
ZCTA5 47578,253,12018,-11765,477,65.2,472,0,0,0,33116,-32639
ZCTA5 47579,1064,13623,-12559,2791,44.8,2736,0,27,0.009673952,35738,-32947
ZCTA5 47580,147,6698,-6551,312,62.3,312,0,0,0,17649,-17337
ZCTA5 47581,1370,0,1370,3294,51.1,3194,0,19,0.005768063,0,3294
ZCTA5 47584,75,0,75,157,30.3,157,0,0,0,0,157
ZCTA5 47585,263,5328,-5065,613,48.5,392,0,45,0.073409462,13839,-13226
ZCTA5 47586,4862,6207,-1345,11087,42.8,10574,121,150,0.013529359,15240,-4153
ZCTA5 47588,343,6368,-6025,990,34.3,958,0,0,0,16652,-15662
ZCTA5 47590,200,9426,-9226,447,42.7,447,0,0,0,27433,-26986
ZCTA5 47591,10501,17127,-6626,25333,39,22880,331,922,0.036395216,40691,-15358
ZCTA5 47596,28,10950,-10922,71,43.4,71,0,0,0,28838,-28767
ZCTA5 47597,319,14906,-14587,778,39.5,768,4,0,0,42868,-42090
ZCTA5 47598,1213,13350,-12137,2835,41,2753,38,0,0,32955,-30120
ZCTA5 47601,5410,13287,-7877,13351,44.6,12667,18,55,0.004119542,33599,-20248
ZCTA5 47610,2028,7943,-5915,5160,36.5,5017,0,13,0.00251938,20465,-15305
ZCTA5 47611,349,9854,-9505,953,42.1,946,0,0,0,26766,-25813
ZCTA5 47612,253,9755,-9502,704,41.1,690,0,2,0.002840909,25543,-24839
ZCTA5 47613,974,10603,-9629,2982,33.7,2840,0,0,0,26275,-23293
ZCTA5 47615,721,1965,-1244,1766,42.9,1702,2,17,0.009626274,4390,-2624
ZCTA5 47616,82,11768,-11686,291,22.7,291,0,0,0,31532,-31241
ZCTA5 47619,713,6147,-5434,1708,43.6,1679,0,3,0.00175644,17373,-15665
ZCTA5 47620,5379,6389,-1010,12656,41.6,11831,38,326,0.025758534,17393,-4737
ZCTA5 47630,14441,8985,5456,38200,40.8,34282,1522,1167,0.030549738,20988,17212
ZCTA5 47631,859,9319,-8460,2177,52.5,2113,20,0,0,22026,-19849
ZCTA5 47633,982,10549,-9567,2356,44.8,2327,0,0,0,25142,-22786
ZCTA5 47634,891,9331,-8440,2392,33.8,2252,0,4,0.001672241,24489,-22097
ZCTA5 47635,2303,8666,-6363,5525,47.8,5287,29,84,0.01520362,21913,-16388
ZCTA5 47637,584,7484,-6900,1527,45.8,1492,0,3,0.001964637,16966,-15439
ZCTA5 47638,1275,10597,-9322,3346,41.3,3243,0,43,0.012851166,23001,-19655
ZCTA5 47639,1636,10736,-9100,4684,37.8,4572,6,5,0.001067464,26516,-21832
ZCTA5 47640,360,9739,-9379,933,50,860,0,11,0.011789925,25089,-24156
ZCTA5 47648,1926,6569,-4643,4314,39.1,4108,30,33,0.007649513,16937,-12623
ZCTA5 47649,594,7199,-6605,1266,54.5,1189,0,17,0.01342812,18541,-17275
ZCTA5 47654,11,9052,-9041,26,41.3,26,0,0,0,22823,-22797
ZCTA5 47660,1822,7936,-6114,4955,40.5,4786,28,33,0.006659939,23376,-18421
ZCTA5 47665,1503,2565,-1062,4088,39.1,3955,15,21,0.005136986,6989,-2901
ZCTA5 47666,573,2285,-1712,1622,35.1,1439,0,16,0.009864365,6345,-4723
ZCTA5 47670,4618,3104,1514,11553,41.8,10073,85,658,0.056954903,8366,3187
ZCTA5 47683,36,3013,-2977,80,55.1,78,0,0,0,8488,-8408
ZCTA5 47708,336,3044,-2708,609,48.2,560,26,21,0.034482759,7784,-7175
ZCTA5 47710,8023,4308,3715,18296,39.7,15869,205,1427,0.07799519,11847,6449
ZCTA5 47711,13338,5600,7738,32051,42,27863,353,2005,0.06255655,15431,16620
ZCTA5 47712,9726,1782,7944,25621,34.3,23921,470,431,0.016822138,4776,20845
ZCTA5 47713,4475,1736,2739,9498,39.1,4817,13,3806,0.40071594,4584,4914
ZCTA5 47714,14425,578,13847,34596,36,25530,367,6175,0.178488843,1788,32808
ZCTA5 47715,13255,7944,5311,27170,38.5,22091,445,3489,0.128413692,22187,4983
ZCTA5 47720,6724,4618,2106,16654,41.5,16101,109,51,0.003062327,14229,2425
ZCTA5 47725,7442,8695,-1253,18873,40,17535,500,326,0.017273353,21461,-2588
ZCTA5 47802,13048,7822,5226,33393,37.6,27822,1038,2919,0.08741353,15165,18228
ZCTA5 47803,9032,2517,6515,21068,36.9,18495,907,922,0.043763053,7244,13824
ZCTA5 47804,4662,4921,-259,11146,37,9607,31,708,0.063520545,12677,-1531
ZCTA5 47805,5488,7543,-2055,12601,46.7,11922,57,110,0.008729466,21532,-8931
ZCTA5 47807,5286,4410,876,12674,25.1,9156,106,2332,0.183998738,12534,140
ZCTA5 47809,0,6777,-6777,2043,19.3,1473,43,445,0.217816936,17579,-15536
ZCTA5 47831,0,9592,-9592,0,-,0,0,0,#DIV/0!,23002,-23002
ZCTA5 47832,487,6810,-6323,1232,52.1,1203,0,0,0,16512,-15280
ZCTA5 47833,311,0,311,615,55,605,0,0,0,0,615
ZCTA5 47834,7724,629,7095,19165,41.9,18204,47,141,0.007357161,1710,17455
ZCTA5 47836,0,33,-33,0,-,0,0,0,#DIV/0!,81,-81
ZCTA5 47837,360,2088,-1728,942,40.6,932,0,0,0,5662,-4720
ZCTA5 47838,766,2995,-2229,3942,39.9,3048,0,654,0.165905632,7478,-3536
ZCTA5 47840,798,1021,-223,2363,35.5,2356,0,0,0,2986,-623
ZCTA5 47841,1032,3447,-2415,2535,38.1,2476,0,0,0,9707,-7172
ZCTA5 47842,4179,1775,2404,9759,42.9,9452,0,60,0.006148171,4976,4783
ZCTA5 47845,70,1038,-968,104,54.1,104,0,0,0,2830,-2726
ZCTA5 47846,215,1536,-1321,635,40.6,635,0,0,0,4573,-3938
ZCTA5 47847,424,1069,-645,1009,39.8,987,0,0,0,2716,-1707
ZCTA5 47848,543,8302,-7759,1367,45.8,1352,0,0,0,21868,-20501
ZCTA5 47849,166,2363,-2197,552,26.6,373,0,60,0.108695652,6800,-6248
ZCTA5 47850,905,2277,-1372,2273,50.1,2237,0,7,0.00307963,6147,-3874
ZCTA5 47851,0,13479,-13479,0,-,0,0,0,#DIV/0!,32457,-32457
ZCTA5 47853,66,395,-329,146,47.3,140,0,0,0,1079,-933
ZCTA5 47854,244,1109,-865,609,39.8,609,0,0,0,3001,-2392
ZCTA5 47855,392,1863,-1471,981,35.1,974,0,0,0,5044,-4063
ZCTA5 47857,105,3394,-3289,350,55.1,340,0,6,0.017142857,8403,-8053
ZCTA5 47858,438,14200,-13762,1240,27.3,1240,0,0,0,36668,-35428
ZCTA5 47859,305,279,26,893,34.4,806,0,71,0.079507279,646,247
ZCTA5 47860,166,10260,-10094,540,23.9,487,0,0,0,26551,-26011
ZCTA5 47861,210,30,180,611,34.5,594,0,0,0,68,543
ZCTA5 47862,565,707,-142,1382,49.1,1218,0,8,0.005788712,1934,-552
ZCTA5 47863,94,1323,-1229,228,43.2,180,0,48,0.210526316,3707,-3479
ZCTA5 47865,1,200,-199,4,-,4,0,0,0,392,-388
ZCTA5 47866,168,2415,-2247,483,33.6,428,0,49,0.101449275,6975,-6492
ZCTA5 47868,1251,19024,-17773,2989,46.6,2932,0,0,0,48992,-46003
ZCTA5 47869,18,100,-82,36,54.9,36,0,0,0,395,-359
ZCTA5 47870,0,1705,-1705,0,-,0,0,0,#DIV/0!,3930,-3930
ZCTA5 47871,210,7721,-7511,552,33.8,539,0,0,0,21404,-20852
ZCTA5 47872,2362,3313,-951,8022,40.9,7572,0,106,0.013213662,9276,-1254
ZCTA5 47874,1233,552,681,3275,44.8,3182,0,0,0,1380,1895
ZCTA5 47875,0,11997,-11997,0,-,0,0,0,#DIV/0!,30874,-30874
ZCTA5 47876,0,1080,-1080,333,51.1,309,0,8,0.024024024,2922,-2589
ZCTA5 47879,1431,1977,-546,3347,38.8,3084,0,12,0.0035853,4719,-1372
ZCTA5 47880,41,5265,-5224,79,43.2,79,0,0,0,14672,-14593
ZCTA5 47881,75,1905,-1830,210,36.7,210,0,0,0,5107,-4897
ZCTA5 47882,3216,478,2738,7794,40.9,7501,18,3,0.000384911,1424,6370
ZCTA5 47884,152,3029,-2877,374,40.1,362,0,0,0,8021,-7647
ZCTA5 47885,3535,361,3174,9205,43.4,8871,11,113,0.012275937,935,8270
ZCTA5 47901,2512,2937,-425,4169,28.6,3170,215,658,0.157831614,8519,-4350
ZCTA5 47904,7211,8172,-961,16748,33.7,13958,194,995,0.059410079,21737,-4989
ZCTA5 47905,17398,837,16561,42047,34.6,34670,1352,2840,0.067543463,2302,39745
ZCTA5 47906,25144,3016,22128,73068,22.5,52571,12293,3126,0.042782066,8917,64151
ZCTA5 47907,0,4720,-4720,0,-,0,0,0,#DIV/0!,13702,-13702
ZCTA5 47909,16631,1725,14906,42548,34.2,36050,645,3051,0.071707248,4216,38332
ZCTA5 47916,13,725,-712,46,28,46,0,0,0,2003,-1957
ZCTA5 47917,177,258,-81,401,43.9,358,0,0,0,589,-188
ZCTA5 47918,2212,568,1644,5313,45.2,5139,0,36,0.006775833,1615,3698
ZCTA5 47920,962,1135,-173,2717,41.2,2675,0,0,0,2286,431
ZCTA5 47921,423,638,-215,1241,31.2,1094,8,36,0.029008864,1371,-130
ZCTA5 47922,556,539,17,1527,46.5,1437,0,0,0,1166,361
ZCTA5 47923,1359,294,1065,3391,44.3,3313,13,0,0,797,2594
ZCTA5 47924,109,2290,-2181,183,55.6,150,0,0,0,5765,-5582
ZCTA5 47925,7,685,-678,34,8.9,34,0,0,0,1903,-1869
ZCTA5 47926,416,8282,-7866,1167,40.6,1124,2,6,0.005141388,21778,-20611
ZCTA5 47928,705,1017,-312,1947,42.4,1902,30,0,0,2629,-682
ZCTA5 47929,263,236,27,626,45.3,584,0,0,0,668,-42
ZCTA5 47930,461,214,247,1151,38.3,1118,0,0,0,1091,60
ZCTA5 47932,2233,10956,-8723,5358,42.4,5105,77,38,0.007092199,25180,-19822
ZCTA5 47933,11509,11743,-234,27788,40.7,25708,172,306,0.011011948,30329,-2541
ZCTA5 47940,610,9369,-8759,1694,38.5,1616,0,0,0,25258,-23564
ZCTA5 47941,490,11574,-11084,1128,37.2,1054,0,21,0.018617021,30181,-29053
ZCTA5 47942,297,12903,-12606,722,44.6,693,0,3,0.004155125,30974,-30252
ZCTA5 47943,296,3868,-3572,791,33,662,0,0,0,9973,-9182
ZCTA5 47944,1347,3167,-1820,3399,41.8,3324,0,4,0.001176817,7758,-4359
ZCTA5 47946,741,3488,-2747,2219,42.1,1969,15,0,0,9487,-7268
ZCTA5 47948,552,8341,-7789,1479,39.7,1355,0,0,0,20014,-18535
ZCTA5 47949,515,0,515,1427,30.8,1388,0,0,0,0,1427
ZCTA5 47950,287,0,287,810,36.3,591,0,0,0,0,810
ZCTA5 47951,1135,0,1135,2460,42.9,2141,0,148,0.060162602,0,2460
ZCTA5 47952,1253,14708,-13455,2808,50.2,2769,1,1,0.000356125,38877,-36069
ZCTA5 47954,858,11445,-10587,2270,37,2054,134,31,0.013656388,29656,-27386
ZCTA5 47955,383,11820,-11437,935,38.1,918,0,6,0.006417112,26802,-25867
ZCTA5 47957,714,4633,-3919,2145,33.1,1971,0,0,0,13083,-10938
ZCTA5 47958,50,703,-653,124,44.5,122,0,0,0,1628,-1504
ZCTA5 47959,841,4802,-3961,2561,35.7,1726,0,28,0.010933229,12157,-9596
ZCTA5 47960,6188,1459,4729,15142,47.6,14040,51,61,0.00402853,3298,11844
ZCTA5 47963,887,2602,-1715,2283,42.8,2165,0,0,0,7085,-4802
ZCTA5 47964,38,3957,-3919,118,37.7,118,0,0,0,9248,-9130
ZCTA5 47965,234,449,-215,588,44.9,585,0,0,0,1121,-533
ZCTA5 47966,169,478,-309,324,54.5,293,0,0,0,1387,-1063
ZCTA5 47967,301,1203,-902,741,44.2,713,18,6,0.008097166,3168,-2427
ZCTA5 47968,423,2852,-2429,1195,39.9,1192,0,0,0,7575,-6380
ZCTA5 47969,118,3385,-3267,295,39.5,281,0,3,0.010169492,8803,-8508
ZCTA5 47970,763,2201,-1438,1881,43.7,1744,7,20,0.010632642,5624,-3743
ZCTA5 47971,719,214,505,1994,38.1,1951,0,16,0.008024072,420,1574
ZCTA5 47974,412,527,-115,977,42.8,886,0,7,0.00716479,1167,-190
ZCTA5 47975,338,2567,-2229,863,34.9,797,7,0,0,6254,-5391
ZCTA5 47977,936,4632,-3696,2470,47.8,2302,0,105,0.042510121,13663,-11193
ZCTA5 47978,4165,6903,-2738,10878,38.9,9764,34,136,0.012502298,16052,-5174
ZCTA5 47980,448,6031,-5583,1119,44.3,1050,6,4,0.00357462,13642,-12523
ZCTA5 47981,299,2337,-2038,1038,31.3,996,0,0,0,6113,-5075
ZCTA5 47982,57,73,-16,120,55.8,114,0,0,0,111,9
ZCTA5 47983,32,825,-793,122,23.7,116,0,0,0,1993,-1871
ZCTA5 47986,0,3647,-3647,0,-,0,0,0,#DIV/0!,7691,-7691
ZCTA5 47987,1545,50,1495,3846,43.6,3765,0,20,0.005200208,144,3702
ZCTA5 47989,417,1759,-1342,978,37,927,3,0,0,4526,-3548
ZCTA5 47990,619,2190,-1571,1696,34.6,1576,0,13,0.007665094,4902,-3206
ZCTA5 47991,475,115,360,1185,46.4,1169,0,8,0.006751055,236,949
ZCTA5 47992,568,1779,-1211,1333,41.4,1235,0,0,0,4607,-3274
ZCTA5 47993,1418,702,716,3564,41.9,3486,14,4,0.001122334,1676,1888
ZCTA5 47994,180,451,-271,391,53.9,391,0,0,0,831,-440
ZCTA5 47995,665,1261,-596,1989,34,1864,10,44,0.022121669,3181,-1192
ZCTA5 47997,58,5586,-5528,155,34.2,153,0,1,0.006451613,12980,-12825
ZCTA5 48001,5142,12989,-7847,11724,49.6,11083,146,42,0.003582395,32229,-20505
ZCTA5 48002,1226,13091,-11865,3120,44.6,3063,0,0,0,32792,-29672
ZCTA5 48003,2185,1876,309,5839,42.7,5543,82,0,0,4602,1237
ZCTA5 48005,1823,551,1272,5336,42.7,5225,3,13,0.002436282,1569,3767
ZCTA5 48006,1411,2764,-1353,3922,41.5,3780,3,10,0.00254972,6894,-2972
ZCTA5 48009,9383,2275,7108,21728,42.3,19255,933,488,0.022459499,4787,16941
ZCTA5 48014,1718,616,1102,4351,42.4,3972,0,8,0.001838658,1517,2834
ZCTA5 48015,3664,4496,-832,8515,41,5318,478,2369,0.278214915,10293,-1778
ZCTA5 48017,5854,961,4893,11427,44,10623,253,105,0.009188763,2393,9034
ZCTA5 48021,13351,2457,10894,34040,38.1,14744,217,17478,0.513454759,6304,27736
ZCTA5 48022,1064,2028,-964,2527,46.4,2496,0,13,0.00514444,4144,-1617
ZCTA5 48023,1959,3251,-1292,4969,41.6,4731,0,68,0.013684846,7918,-2949
ZCTA5 48025,5679,2075,3604,14886,48.7,12090,706,1269,0.085247884,5578,9308
ZCTA5 48026,6337,995,5342,14703,39.1,12795,230,775,0.052710331,2686,12017
ZCTA5 48027,1206,3957,-2751,3163,46.3,2852,0,47,0.014859311,10210,-7047
ZCTA5 48028,490,541,-51,918,65.3,908,0,0,0,1489,-571
ZCTA5 48030,6801,0,6801,15213,37.1,12064,272,1549,0.101820811,0,15213
ZCTA5 48032,771,564,207,1864,49.3,1772,24,0,0,1306,558
ZCTA5 48033,7628,1384,6244,17154,44.2,4040,175,11581,0.675119506,3058,14096
ZCTA5 48034,7619,189,7430,15656,39.3,2472,559,11379,0.726814001,435,15221
ZCTA5 48035,14668,16935,-2267,35345,38.9,25098,1145,7261,0.205432169,40144,-4799
ZCTA5 48036,9024,11153,-2129,21028,42.4,14645,658,4017,0.191031006,27493,-6465
ZCTA5 48038,20491,0,20491,43982,41.5,35341,1371,4727,0.107475786,0,43982
ZCTA5 48039,3333,459,2874,7480,47.8,7421,0,0,0,1055,6425
ZCTA5 48040,4371,164,4207,9925,44.6,9642,63,40,0.004030227,366,9559
ZCTA5 48041,1667,1289,378,4289,46.7,4182,0,11,0.0025647,3234,1055
ZCTA5 48042,11216,4842,6374,31885,42,30054,765,410,0.012858711,12156,19729
ZCTA5 48043,6506,116,6390,15735,40.8,10395,16,4137,0.262917064,266,15469
ZCTA5 48044,19402,1213,18189,58933,38.4,50739,2048,3892,0.066041098,2575,56358
ZCTA5 48045,11738,2365,9373,24416,46.5,20757,246,2606,0.10673329,6417,17999
ZCTA5 48047,15562,483,15079,39642,41.9,34523,387,2593,0.065410423,1304,38338
ZCTA5 48048,3183,180,3003,10455,35.1,7942,1,1318,0.126064084,315,10140
ZCTA5 48049,2229,585,1644,5493,46.4,5342,0,6,0.001092299,1540,3953
ZCTA5 48050,574,2116,-1542,1520,52.3,1444,0,0,0,4504,-2984
ZCTA5 48051,6576,676,5900,17850,35.5,15048,44,1365,0.076470588,1799,16051
ZCTA5 48054,2928,4827,-1899,7216,51.7,6994,12,68,0.009423503,11581,-4365
ZCTA5 48059,6130,726,5404,15243,46.9,14351,47,153,0.010037394,1889,13354
ZCTA5 48060,16558,3067,13491,39800,39.6,33195,296,3034,0.076231156,7729,32071
ZCTA5 48062,3387,357,3030,9497,39.1,8255,0,417,0.043908603,960,8537
ZCTA5 48063,1545,563,982,4085,45,3883,0,0,0,1287,2798
ZCTA5 48064,1422,568,854,3977,40,3890,9,0,0,1267,2710
ZCTA5 48065,4623,1706,2917,11341,46.9,10612,9,225,0.01983952,4302,7039
ZCTA5 48066,21020,1079,19941,47800,40.8,34272,765,10152,0.212384937,2528,45272
ZCTA5 48067,12556,778,11778,24107,35.2,21204,814,787,0.032646119,2165,21942
ZCTA5 48069,1175,699,476,2610,45.1,2363,58,7,0.002681992,1620,990
ZCTA5 48070,2363,3,2360,6382,44.7,5973,147,59,0.009244751,3,6379
ZCTA5 48071,13487,1779,11708,28719,41,23081,2056,2229,0.077614123,4786,23933
ZCTA5 48072,7067,526,6541,15234,37.2,13406,195,485,0.031836681,1419,13815
ZCTA5 48073,16458,3092,13366,34316,36.3,29077,1344,2462,0.071744959,8751,25565
ZCTA5 48074,3634,582,3052,9534,43.9,8975,6,6,0.000629327,1454,8080
ZCTA5 48075,9654,782,8872,23433,38.4,5766,119,15951,0.680706696,1836,21597
ZCTA5 48076,9996,468,9528,24069,45.3,7723,445,14643,0.608375919,1090,22979
ZCTA5 48079,4950,3758,1192,12507,43.1,12019,104,99,0.007915567,8731,3776
ZCTA5 48080,10882,346,10536,22317,45.2,18770,311,2045,0.09163418,928,21389
ZCTA5 48081,8968,1388,7580,20469,45,19130,142,522,0.025501979,3124,17345
ZCTA5 48082,7183,1752,5431,16196,41.5,14887,90,614,0.037910595,4606,11590
ZCTA5 48083,9677,1632,8045,23682,39.8,15576,5624,1028,0.043408496,3946,19736
ZCTA5 48084,6646,1422,5224,15775,38.2,8681,5409,844,0.053502377,3277,12498
ZCTA5 48085,9111,490,8621,27213,43.1,19735,5589,866,0.031823026,1274,25939
ZCTA5 48088,9641,455,9186,24264,42.1,18779,1186,3188,0.131388065,1008,23256
ZCTA5 48089,12774,505,12269,32593,34.9,18557,1785,10490,0.32184825,1133,31460
ZCTA5 48091,11388,2069,9319,30140,37.3,15093,5194,8254,0.273855342,5355,24785
ZCTA5 48092,10510,315,10195,27637,41.3,18986,4614,2976,0.107681731,722,26915
ZCTA5 48093,10189,524,9665,24362,42.5,17306,1804,4042,0.165914129,1326,23036
ZCTA5 48094,7749,818,6931,19862,43.9,18243,269,387,0.019484443,2210,17652
ZCTA5 48095,1983,3675,-1692,5789,43.7,5545,67,92,0.015892209,9794,-4005
ZCTA5 48096,1612,710,902,3791,49.5,3597,22,1,0.000263783,1972,1819
ZCTA5 48097,2182,4672,-2490,5473,40.7,5250,20,16,0.002923442,13114,-7641
ZCTA5 48098,7315,613,6702,20242,46.6,13252,5765,406,0.020057307,1698,18544
ZCTA5 48101,11796,319,11477,28431,43.1,24449,386,1262,0.044388168,800,27631
ZCTA5 48103,23876,2294,21582,55935,38.9,43055,5477,2703,0.048323947,5769,50166
ZCTA5 48104,17660,4130,13530,44269,23.3,33912,6225,2153,0.048634485,11041,33228
ZCTA5 48105,15170,1331,13839,37899,29.8,21538,11290,2237,0.059025304,5602,32297
ZCTA5 48108,11879,8044,3835,27474,35.5,17328,4082,4103,0.149341195,21121,6353
ZCTA5 48109,114,900,-786,5627,19.2,3935,1088,359,0.063799538,2438,3189
ZCTA5 48111,18131,15,18116,43910,40.1,29801,776,10528,0.239763152,31,43879
ZCTA5 48114,8013,2548,5465,21633,44,20275,329,164,0.00758101,6597,15036
ZCTA5 48116,11092,904,10188,26966,45.9,25838,238,150,0.00556256,2220,24746
ZCTA5 48117,4210,918,3292,10383,48.4,9626,23,288,0.027737648,2763,7620
ZCTA5 48118,5433,6456,-1023,13022,48,12554,65,84,0.006450622,17227,-4205
ZCTA5 48120,2610,2352,258,8836,29.5,6659,528,392,0.044363966,5862,2974
ZCTA5 48122,4536,1017,3519,12534,35.5,9367,31,1749,0.13954045,2666,9868
ZCTA5 48124,13389,19544,-6155,33054,39.8,28854,410,1452,0.043928118,48961,-15907
ZCTA5 48125,8133,8,8125,21910,37.5,17886,101,2163,0.098722045,14344,7566
ZCTA5 48126,14607,5716,8891,53658,27.2,48307,1291,1405,0.026184353,16063,37595
ZCTA5 48127,13804,1346,12458,40424,34.9,34527,875,3389,0.083836335,3309,37115
ZCTA5 48128,4343,1257,3086,12437,36.5,11732,240,239,0.019216853,3473,8964
ZCTA5 48130,5913,499,5414,16011,42.5,14668,346,32,0.001998626,1234,14777
ZCTA5 48131,3441,832,2609,7616,39,7310,15,41,0.005383403,2207,5409
ZCTA5 48133,2135,883,1252,5849,39.4,5280,0,112,0.019148572,2691,3158
ZCTA5 48134,8825,4973,3852,23960,40.3,19553,520,2581,0.107721202,13600,10360
ZCTA5 48135,10979,7590,3389,27268,41.4,23878,315,1362,0.049948658,18511,8757
ZCTA5 48137,1926,6941,-5015,4762,47.4,4628,2,20,0.004199916,17774,-13012
ZCTA5 48138,4241,5690,-1449,10682,52.2,10026,313,82,0.007676465,12952,-2270
ZCTA5 48139,61,335,-274,81,69.9,81,0,0,0,936,-855
ZCTA5 48140,1286,8165,-6879,3663,38.3,3659,1,2,0.000546001,20297,-16634
ZCTA5 48141,9031,15965,-6934,25849,31.1,4138,204,19893,0.769584897,43422,-17573
ZCTA5 48143,64,339,-275,186,60.5,186,0,0,0,940,-754
ZCTA5 48144,3999,6400,-2401,9826,45.2,8891,112,122,0.012416039,20611,-10785
ZCTA5 48145,1231,2396,-1165,3101,46.1,2975,3,6,0.00193486,5886,-2785
ZCTA5 48146,15284,2728,12556,39741,35.3,27729,225,3876,0.097531517,7306,32435
ZCTA5 48150,10405,2167,8238,27153,40.1,23590,737,1091,0.040179722,5727,21426
ZCTA5 48152,12454,1658,10796,30954,48.3,25751,2063,1604,0.051818828,4460,26494
ZCTA5 48154,14593,957,13636,37187,46.8,32965,732,1490,0.040067766,2621,34566
ZCTA5 48157,591,35,556,1146,53.8,1092,3,0,0,75,1071
ZCTA5 48158,3145,252,2893,7871,48.7,7360,14,112,0.01422945,594,7277
ZCTA5 48159,986,6849,-5863,2612,42.6,2419,23,117,0.044793262,18277,-15665
ZCTA5 48160,4920,5264,-344,14039,40.1,11930,57,1134,0.080774984,14251,-212
ZCTA5 48161,11207,314,10893,26901,41.2,24085,186,1070,0.039775473,938,25963
ZCTA5 48162,11908,909,10999,28647,44.1,26366,101,859,0.029985688,2489,26158
ZCTA5 48164,3194,17131,-13937,9108,46.6,8347,77,193,0.021190162,49470,-40362
ZCTA5 48165,3221,453,2768,8866,35.6,7471,723,92,0.01037672,1238,7628
ZCTA5 48166,4739,585,4154,12727,36.9,11962,0,233,0.018307535,1652,11075
ZCTA5 48167,9904,8044,1860,23139,46.9,18858,2498,771,0.033320368,19547,3592
ZCTA5 48168,8844,663,8181,25057,44.5,18949,4304,493,0.019675141,1693,23364
ZCTA5 48169,8307,1794,6513,21018,48,20364,154,83,0.003948996,5076,15942
ZCTA5 48170,17498,11359,6139,40882,47.2,36992,1342,875,0.021403062,27928,12954
ZCTA5 48173,4892,48,4844,13119,44.1,11517,196,507,0.038646238,190,12929
ZCTA5 48174,11897,703,11194,32255,38.6,18427,688,11093,0.343915672,2001,30254
ZCTA5 48176,8372,2921,5451,22980,44.4,20293,908,509,0.022149695,7534,15446
ZCTA5 48177,113,583,-470,387,34.4,336,0,0,0,1443,-1056
ZCTA5 48178,13451,103,13348,36684,42.7,34066,978,209,0.005697307,268,36416
ZCTA5 48179,1419,3788,-2369,3685,43,3405,42,67,0.018181818,10458,-6773
ZCTA5 48180,24643,1618,23025,63071,38.7,45621,746,12448,0.197364875,3966,59105
ZCTA5 48182,8443,949,7494,21626,44.8,20575,226,152,0.007028577,2521,19105
ZCTA5 48183,17721,601,17120,42338,46.5,37480,1052,1918,0.045302093,1645,40693
ZCTA5 48184,7025,6817,208,17847,39.4,12643,63,3803,0.213089035,18143,-296
ZCTA5 48185,21729,2891,18838,48828,39.5,32379,2651,10441,0.213832227,10531,38297
ZCTA5 48186,13534,1882,11652,36133,37.5,23833,719,8518,0.235740182,5151,30982
ZCTA5 48187,19352,2661,16691,52304,39.9,36774,8034,4933,0.09431401,7303,45001
ZCTA5 48188,16136,1666,14470,45287,39.9,26701,10998,4775,0.105438647,4429,40858
ZCTA5 48189,6064,376,5688,14130,42.7,13604,135,92,0.00651097,1051,13079
ZCTA5 48190,76,869,-793,211,54.1,211,0,0,0,2128,-1917
ZCTA5 48191,1487,2451,-964,4090,48,3182,45,146,0.035696822,6316,-2226
ZCTA5 48192,10922,545,10377,24992,39.7,22869,111,477,0.019086108,1444,23548
ZCTA5 48193,6490,727,5763,17078,40.1,13205,839,1951,0.114240543,1933,15145
ZCTA5 48195,12566,1122,11444,29990,42.1,25223,753,1860,0.062020674,2987,27003
ZCTA5 48197,26626,1665,24961,67037,31.5,41573,3508,15880,0.236884109,4597,62440
ZCTA5 48198,16542,2078,14464,40248,34.4,21258,789,14037,0.348762671,5412,34836
ZCTA5 48201,7741,699,7042,14930,31.8,3932,1263,9044,0.605760214,2083,12847
ZCTA5 48202,7202,4334,2868,15029,34.8,3944,919,9339,0.621398629,11490,3539
ZCTA5 48203,8873,58,8815,21253,41.4,2145,57,18196,0.856161483,179,21074
ZCTA5 48204,8929,598,8331,22218,40.3,697,16,20244,0.911153119,1652,20566
ZCTA5 48205,12504,10598,1906,31721,30.2,1105,81,30335,0.956306548,25729,5992
ZCTA5 48206,6325,15113,-8788,15271,41.4,1312,70,13410,0.878135027,35035,-19764
ZCTA5 48207,10718,16091,-5373,20142,43.2,3576,496,15404,0.764770132,40732,-20590
ZCTA5 48208,3904,7776,-3872,8357,39.2,1793,65,6156,0.736627977,17665,-9308
ZCTA5 48209,9081,3549,5532,28480,28.6,11428,13,2654,0.093188202,8759,19721
ZCTA5 48210,8031,14625,-6594,27127,28.8,12243,65,4596,0.169425296,32142,-5015
ZCTA5 48211,1855,0,1855,6060,32.2,2655,179,2692,0.444224422,0,6060
ZCTA5 48212,11484,1628,9856,42899,29.6,18054,11783,9544,0.222476048,2506,40393
ZCTA5 48213,7572,9146,-1574,20900,37.3,626,31,19998,0.956842105,22219,-1319
ZCTA5 48214,9542,8180,1362,19817,45,2814,34,16126,0.813745774,19581,236
ZCTA5 48215,4534,6301,-1767,10542,40.7,965,30,9260,0.878391197,15613,-5071
ZCTA5 48216,2504,9877,-7373,5497,35.5,2158,19,2363,0.429870839,26733,-21236
ZCTA5 48217,2707,4202,-1495,6820,38.1,688,0,5043,0.739442815,9509,-2689
ZCTA5 48218,2894,6786,-3892,7278,36.1,2736,0,3587,0.49285518,17500,-10222
ZCTA5 48219,17738,17360,378,43749,40.1,2549,67,39276,0.897757663,42595,1154
ZCTA5 48220,11317,6893,4424,21859,34.8,16760,433,3305,0.151196304,17558,4301
ZCTA5 48221,15383,833,14550,41203,39,3217,699,35902,0.87134432,2187,39016
ZCTA5 48223,9482,1334,8148,25037,34.9,1667,23,22256,0.888924392,3346,21691
ZCTA5 48224,13189,1783,11406,38824,31.3,3206,7,34550,0.889913456,4785,34039
ZCTA5 48225,5660,7985,-2325,16201,35.4,4645,54,10557,0.651626443,22088,-5887
ZCTA5 48226,3880,10967,-7087,6668,33.3,2939,577,2683,0.402369526,26684,-20016
ZCTA5 48227,15118,8385,6733,39974,39.6,510,19,38229,0.956346625,20243,19731
ZCTA5 48228,19253,2241,17012,57005,29.6,10686,101,41671,0.731006052,6053,50952
ZCTA5 48229,3421,12247,-8826,9307,36,3032,0,4038,0.433866982,31782,-22475
ZCTA5 48230,6919,11343,-4424,17340,43.3,14998,270,993,0.057266436,28190,-10850
ZCTA5 48233,0,810,-810,0,-,0,0,0,#DIV/0!,2289,-2289
ZCTA5 48234,12432,35,12397,33555,34,1086,158,31900,0.950677991,106,33449
ZCTA5 48235,17830,2188,15642,45558,37.5,905,99,43228,0.948856403,6164,39394
ZCTA5 48236,12209,583,11626,31134,43.2,26602,716,2689,0.0863686,1628,29506
ZCTA5 48237,12262,817,11445,29677,38,10650,747,16467,0.554874145,2367,27310
ZCTA5 48238,10052,2981,7071,24927,36.6,473,72,23346,0.936574798,7507,17420
ZCTA5 48239,13866,1111,12755,37571,36.9,14814,203,20884,0.555854249,3753,33818
ZCTA5 48240,6566,729,5837,17213,39.4,8532,36,7575,0.440074362,2127,15086
ZCTA5 48242,0,851,-851,0,-,0,0,0,#DIV/0!,2129,-2129
ZCTA5 48243,0,8489,-8489,0,-,0,0,0,#DIV/0!,24311,-24311
ZCTA5 48301,5879,9191,-3312,15251,47.3,12548,975,478,0.031342207,22581,-7330
ZCTA5 48302,6558,3595,2963,17244,45.1,13357,1474,1471,0.085305034,9005,8239
ZCTA5 48304,6556,1193,5363,16963,51.5,13656,1429,1076,0.063432176,3285,13678
ZCTA5 48306,9666,1725,7941,27916,43.7,23419,2293,654,0.023427425,4614,23302
ZCTA5 48307,17983,890,17093,43978,38.7,34416,5848,1456,0.033107463,2719,41259
ZCTA5 48309,11203,2174,9029,30622,41.9,24724,3279,986,0.032199073,6087,24535
ZCTA5 48310,14882,3019,11863,43963,38.8,35785,4496,1708,0.038850852,7352,36611
ZCTA5 48312,13677,5693,7984,34666,41.6,27423,2783,3000,0.086540126,14851,19815
ZCTA5 48313,13724,10061,3663,34147,41.4,29826,674,2417,0.070782206,25399,8748
ZCTA5 48314,8846,603,8243,21286,45.5,17214,2342,879,0.041294748,1697,19589
ZCTA5 48315,10696,1050,9646,27799,49,25052,1085,660,0.023741861,2704,25095
ZCTA5 48316,11122,442,10680,28227,45.4,26268,704,407,0.014418819,1160,27067
ZCTA5 48317,12256,2522,9734,28416,37.7,22536,2458,1262,0.044411599,6648,21768
ZCTA5 48320,2106,2622,-516,4401,42.5,3837,63,190,0.043172006,6368,-1967
ZCTA5 48322,12610,1363,11247,32861,45.4,21705,3759,6076,0.184900033,4481,28380
ZCTA5 48323,6191,2352,3839,16816,48.6,13377,1172,1659,0.098656042,6930,9886
ZCTA5 48324,6515,7273,-758,17929,46.3,14692,1255,1019,0.056835295,19009,-1080
ZCTA5 48326,10939,667,10272,23737,35.8,14000,3902,3426,0.144331634,1978,21759
ZCTA5 48327,9373,528,8845,21207,39.7,18124,296,1439,0.067854954,1355,19852
ZCTA5 48328,11393,1452,9941,26095,41.9,20258,523,2448,0.093811075,3676,22419
ZCTA5 48329,9696,2429,7267,23387,45.4,20656,530,495,0.021165605,6745,16642
ZCTA5 48331,9152,201,8951,22000,48.2,14754,2691,3421,0.1555,564,21436
ZCTA5 48334,8028,1712,6316,19371,43.7,11877,2153,4191,0.216354344,4682,14689
ZCTA5 48335,11033,5865,5168,24224,36,11579,7439,3586,0.148035007,14424,9800
ZCTA5 48336,11723,858,10865,27256,41.1,19590,1721,4667,0.171228353,2500,24756
ZCTA5 48340,10690,3428,7262,26233,32.2,12120,1043,8379,0.319406854,9239,16994
ZCTA5 48341,7735,1050,6685,18921,36.9,5448,493,11118,0.587601078,3020,15901
ZCTA5 48342,6169,1790,4379,16419,30.5,4030,807,9819,0.598026676,4734,11685
ZCTA5 48346,9249,131,9118,23390,39.2,19573,353,1878,0.080290723,238,23152
ZCTA5 48348,8782,23,8759,24916,42.3,22136,596,398,0.015973672,53,24863
ZCTA5 48350,2781,1370,1411,7994,39.5,7493,31,72,0.009006755,4342,3652
ZCTA5 48353,2766,3511,-745,6922,45.1,6628,78,40,0.005778677,8942,-2020
ZCTA5 48356,3107,4759,-1652,8093,43.8,7881,21,63,0.007784505,12890,-4797
ZCTA5 48357,3226,5965,-2739,8643,47.1,8116,23,107,0.012379961,15373,-6730
ZCTA5 48359,4090,2560,1530,9941,39.2,8180,526,379,0.038124937,6788,3153
ZCTA5 48360,4677,2595,2082,12089,41.5,10470,731,184,0.015220448,7186,4903
ZCTA5 48362,5830,8,5822,14869,43.9,13550,250,328,0.022059318,28,14841
ZCTA5 48363,2283,10326,-8043,7417,38.1,6768,294,17,0.002292032,23870,-16453
ZCTA5 48367,1601,2284,-683,4399,47.4,4305,38,25,0.00568311,6418,-2019
ZCTA5 48370,534,1310,-776,1844,38.4,1820,20,4,0.002169197,3503,-1659
ZCTA5 48371,9477,656,8821,25826,40.5,24245,357,391,0.015139782,1761,24065
ZCTA5 48374,5661,5597,64,17952,38.6,12211,4316,662,0.036876114,14195,3757
ZCTA5 48375,9793,7242,2551,23468,40.8,14475,5904,1554,0.066217829,19887,3581
ZCTA5 48377,8835,809,8026,18942,38.4,10689,4192,2842,0.150036955,2142,16800
ZCTA5 48380,2767,7006,-4239,7695,48.2,7309,67,57,0.007407407,18395,-10700
ZCTA5 48381,5479,1621,3858,13464,42.2,12453,152,120,0.008912656,4093,9371
ZCTA5 48382,8450,784,7666,23674,42.6,20815,736,803,0.033919067,2061,21613
ZCTA5 48383,4620,1224,3396,12814,42.8,12089,69,197,0.01537381,3329,9485
ZCTA5 48386,7238,3974,3264,18394,44.6,17158,178,142,0.007719909,9967,8427
ZCTA5 48390,10426,2180,8246,23878,43.9,20808,1500,755,0.031619064,6289,17589
ZCTA5 48393,8736,2104,6632,19760,36.1,15448,991,2074,0.104959514,5784,13976
ZCTA5 48401,603,1259,-656,1326,51.8,1285,3,10,0.007541478,3111,-1785
ZCTA5 48410,55,490,-435,117,38.4,112,0,0,0,1457,-1340
ZCTA5 48411,28,3741,-3713,28,-,28,0,0,0,11273,-11245
ZCTA5 48412,2056,0,2056,5280,49.6,5085,9,25,0.004734848,593,4687
ZCTA5 48413,2883,1854,1029,7397,45.8,6839,75,28,0.003785318,4854,2543
ZCTA5 48414,1046,4175,-3129,2742,42.7,2509,3,0,0,10467,-7725
ZCTA5 48415,3468,1174,2294,9051,43.3,8764,1,109,0.012042868,3614,5437
ZCTA5 48416,1937,3679,-1742,5367,38.6,5141,6,8,0.001490591,10272,-4905
ZCTA5 48417,1112,719,393,2445,47.2,2115,0,8,0.003271984,1786,659
ZCTA5 48418,1556,113,1443,4230,44,4035,30,0,0,170,4060
ZCTA5 48419,971,191,780,2261,44.7,2148,4,2,0.000884564,347,1914
ZCTA5 48420,8784,1550,7234,21112,44.2,19617,134,483,0.022877984,3703,17409
ZCTA5 48421,2472,43,2429,6484,48.3,6211,1,1,0.000154226,107,6377
ZCTA5 48422,2517,14237,-11720,6069,45.6,5739,11,7,0.001153403,37262,-31193
ZCTA5 48423,14412,903,13509,33523,40.9,31208,77,705,0.021030337,1848,31675
ZCTA5 48426,374,536,-162,1324,28.7,1274,0,0,0,1435,-111
ZCTA5 48427,1162,4276,-3114,2832,45.8,2666,2,9,0.003177966,10389,-7557
ZCTA5 48428,2067,1729,338,5600,44.7,5405,34,0,0,4111,1489
ZCTA5 48429,3786,179,3607,8719,48,8521,26,6,0.000688152,347,8372
ZCTA5 48430,15207,812,14395,38731,42.4,36460,290,297,0.007668276,2182,36549
ZCTA5 48432,248,15012,-14764,528,48.3,510,0,1,0.001893939,45146,-44618
ZCTA5 48433,10141,9043,1098,25964,42.7,23467,157,1077,0.041480511,21235,4729
ZCTA5 48434,66,14977,-14911,121,62.5,120,1,0,0,38037,-37916
ZCTA5 48435,872,1028,-156,2550,37.9,2491,0,0,0,2508,42
ZCTA5 48436,1541,14961,-13420,4222,44,4037,19,16,0.003789673,42267,-38045
ZCTA5 48437,262,5231,-4969,501,32.7,446,0,0,0,14683,-14182
ZCTA5 48438,2544,449,2095,7009,43.9,6738,0,43,0.006134969,1173,5836
ZCTA5 48439,21012,2285,18727,52795,42.5,42507,1841,5718,0.108305711,5718,47077
ZCTA5 48440,75,1107,-1032,151,50.5,148,0,3,0.01986755,2946,-2795
ZCTA5 48441,1595,4163,-2568,4080,46.3,3910,31,33,0.008088235,9787,-5707
ZCTA5 48442,9076,972,8104,22034,43.4,20129,94,643,0.029182173,3059,18975
ZCTA5 48444,3701,1158,2543,9718,39.5,8537,13,7,0.000720313,2721,6997
ZCTA5 48445,501,949,-448,1130,50.3,1120,0,0,0,2766,-1636
ZCTA5 48446,12065,760,11305,30508,44.4,28372,84,970,0.031794939,2070,28438
ZCTA5 48449,1018,1722,-704,2747,35.5,2480,10,38,0.013833273,4653,-1906
ZCTA5 48450,2261,1104,1157,4294,57.5,4188,0,5,0.001164415,3007,1287
ZCTA5 48451,5493,604,4889,15429,42.8,14718,44,208,0.013481107,1736,13693
ZCTA5 48453,2012,3434,-1422,5066,38.1,4854,16,32,0.006316621,9058,-3992
ZCTA5 48454,462,864,-402,1114,44.4,1055,6,0,0,2306,-1192
ZCTA5 48455,3160,5567,-2407,8447,49.3,8008,96,18,0.002130934,15100,-6653
ZCTA5 48456,295,1811,-1516,698,46.8,679,0,0,0,4798,-4100
ZCTA5 48457,3234,1273,1961,8606,45.2,7912,20,289,0.033581222,3398,5208
ZCTA5 48458,7757,2191,5566,19089,39.1,12756,37,4899,0.25663995,5503,13586
ZCTA5 48460,1049,298,751,2615,37.3,2505,3,49,0.01873805,813,1802
ZCTA5 48461,3047,1423,1624,7967,41,7732,0,7,0.000878624,3429,4538
ZCTA5 48462,4873,2273,2600,12934,45.3,12164,162,92,0.007113035,5817,7117
ZCTA5 48463,1798,2258,-460,4616,45.5,4439,59,45,0.0097487,6575,-1959
ZCTA5 48464,836,988,-152,2019,53.6,1876,13,1,0.000495295,2442,-423
ZCTA5 48465,219,1410,-1191,556,42.4,524,0,0,0,3061,-2505
ZCTA5 48466,632,1538,-906,1471,51.5,1344,1,57,0.03874915,3790,-2319
ZCTA5 48467,1220,673,547,2230,60.1,2172,0,5,0.002242152,1955,275
ZCTA5 48468,530,1401,-871,1223,58.9,1189,1,0,0,3852,-2629
ZCTA5 48469,596,883,-287,1216,58.7,1155,3,0,0,2147,-931
ZCTA5 48470,278,123,155,624,48.4,594,2,12,0.019230769,274,350
ZCTA5 48471,2313,502,1811,5608,44.7,5228,42,57,0.010164051,1317,4291
ZCTA5 48472,597,0,597,1455,47.3,1415,7,9,0.006185567,0,1455
ZCTA5 48473,9652,743,8909,23111,45.6,21594,149,647,0.027995327,1983,21128
ZCTA5 48475,1015,1906,-891,2550,44.1,2536,0,0,0,5153,-2603
ZCTA5 48476,205,1170,-965,539,44.5,532,7,0,0,2845,-2306
ZCTA5 48502,55,1562,-1507,1257,26.8,735,34,421,0.334924423,4226,-2969
ZCTA5 48503,9609,367,9242,22717,38.6,8870,185,12448,0.547959678,1010,21707
ZCTA5 48504,10115,2173,7942,24738,34.5,6737,211,16449,0.66492845,5863,18875
ZCTA5 48505,7247,2124,5123,18618,34.1,2219,13,14894,0.799978515,5872,12746
ZCTA5 48506,9904,798,9106,25058,39.1,19271,42,2947,0.117607151,2321,22737
ZCTA5 48507,12357,862,11495,28841,37.3,18468,141,8232,0.285426996,2114,26727
ZCTA5 48509,3871,1360,2511,9445,44.5,8170,207,421,0.044573849,3776,5669
ZCTA5 48519,3245,380,2865,7596,42.1,6248,82,876,0.115323855,1162,6434
ZCTA5 48529,3791,1337,2454,8670,38.8,7369,0,892,0.102883506,3473,5197
ZCTA5 48532,8214,266,7948,20219,39.1,10661,253,7350,0.363519462,668,19551
ZCTA5 48601,13450,190,13260,32550,37.2,10114,0,20443,0.628049155,331,32219
ZCTA5 48602,11283,1156,10127,27911,36.3,16573,67,6901,0.247250188,4298,23613
ZCTA5 48603,12244,1210,11034,27603,43.5,21366,1424,3099,0.112270405,3278,24325
ZCTA5 48604,4283,1975,2308,12075,28.4,9956,128,1293,0.107080745,5781,6294
ZCTA5 48607,677,5915,-5238,1802,37.8,607,6,907,0.503329634,14559,-12757
ZCTA5 48609,5290,688,4602,12526,49.6,11827,232,56,0.004470701,2045,10481
ZCTA5 48610,1484,512,972,3138,52.9,3013,12,7,0.00223072,1772,1366
ZCTA5 48611,2692,58,2634,6205,43.8,6087,14,0,0,164,6041
ZCTA5 48612,3625,6171,-2546,8568,49.2,8236,23,32,0.003734827,18990,-10422
ZCTA5 48613,385,2646,-2261,864,45.5,834,0,0,0,7830,-6966
ZCTA5 48614,447,360,87,1082,48.8,1059,0,0,0,1055,27
ZCTA5 48615,1095,1596,-501,2857,39.8,2670,7,10,0.003500175,4169,-1312
ZCTA5 48616,3055,965,2090,7560,43,7062,58,68,0.008994709,2198,5362
ZCTA5 48617,3293,3549,-256,9573,38,9223,11,40,0.004178418,10015,-442
ZCTA5 48618,2095,6996,-4901,5078,46.9,4781,55,65,0.012800315,20565,-15487
ZCTA5 48619,255,729,-474,537,62.1,511,0,0,0,1635,-1098
ZCTA5 48620,56,1062,-1006,82,61.8,78,0,0,0,2803,-2721
ZCTA5 48621,398,104,294,944,59.4,906,1,9,0.009533898,202,742
ZCTA5 48622,2171,6945,-4774,5734,46.9,5455,3,78,0.013603069,19552,-13818
ZCTA5 48623,5119,7203,-2084,14751,41,13250,139,582,0.039454952,20081,-5330
ZCTA5 48624,6693,479,6214,16101,50.9,15567,94,51,0.003167505,1523,14578
ZCTA5 48625,5093,5347,-254,12887,51.4,12194,21,193,0.014976333,15674,-2787
ZCTA5 48626,2278,28,2250,5961,48.2,5774,36,9,0.001509814,75,5886
ZCTA5 48627,47,6244,-6197,112,60.6,112,0,0,0,15792,-15680
ZCTA5 48628,820,451,369,1941,50.3,1888,13,0,0,1306,635
ZCTA5 48629,3637,3117,520,7783,56.9,7588,25,10,0.001284852,9457,-1674
ZCTA5 48630,26,598,-572,52,66.5,52,0,0,0,1683,-1631
ZCTA5 48631,1826,1399,427,4053,51.9,3966,0,0,0,3928,125
ZCTA5 48632,2058,2970,-912,5008,50,4643,4,0,0,8661,-3653
ZCTA5 48633,101,1516,-1415,144,69.5,144,0,0,0,4264,-4120
ZCTA5 48634,1968,3147,-1179,4448,43,4416,0,0,0,8624,-4176
ZCTA5 48635,771,1765,-994,1632,58.4,1574,0,0,0,5356,-3724
ZCTA5 48636,350,6135,-5785,755,59.6,731,0,16,0.021192053,16666,-15911
ZCTA5 48637,1242,1202,40,3132,43.5,2787,0,11,0.003512133,2945,187
ZCTA5 48638,5938,3917,2021,12478,46.2,9808,179,2050,0.164289149,11126,1352
ZCTA5 48640,13108,140,12968,32389,38.6,30303,252,530,0.01636358,466,31923
ZCTA5 48642,13844,1491,12353,33734,41.1,29821,1529,679,0.020128061,4666,29068
ZCTA5 48647,1478,4798,-3320,4311,38.9,4112,22,21,0.00487126,11665,-7354
ZCTA5 48649,546,688,-142,1315,52.9,1278,2,5,0.003802281,1681,-366
ZCTA5 48650,2792,825,1967,6647,46.4,6412,0,14,0.002106213,2513,4134
ZCTA5 48651,1995,1155,840,4306,48,4056,25,49,0.011379471,3000,1306
ZCTA5 48652,769,11576,-10807,1983,43.8,1873,0,2,0.001008573,33697,-31714
ZCTA5 48653,4545,631,3914,9851,55.4,9037,19,27,0.002740838,1654,8197
ZCTA5 48654,1023,1977,-954,2369,55.6,2316,0,16,0.006753905,5277,-2908
ZCTA5 48655,2290,1413,877,5644,45.7,5317,11,189,0.033486889,3567,2077
ZCTA5 48656,1818,5134,-3316,3716,59.3,3563,28,1,0.000269107,13800,-10084
ZCTA5 48657,3086,2208,878,7576,45.9,7186,6,44,0.005807814,5369,2207
ZCTA5 48658,2006,465,1541,4883,45.8,4619,21,23,0.004710219,1186,3697
ZCTA5 48659,919,4572,-3653,2588,40.9,2492,0,5,0.001931994,12169,-9581
ZCTA5 48661,4417,3178,1239,10325,48.8,9782,158,56,0.005423729,8399,1926
ZCTA5 48662,555,5491,-4936,1365,47,1343,0,0,0,19437,-18072
ZCTA5 48701,541,623,-82,1210,43.3,1150,5,9,0.007438017,1379,-169
ZCTA5 48703,1434,810,624,2988,56.9,2844,2,16,0.005354752,2289,699
ZCTA5 48705,221,3072,-2851,376,63.3,347,0,0,0,8724,-8348
ZCTA5 48706,16908,685,16223,39225,43.8,36790,209,490,0.012492033,1570,37655
ZCTA5 48708,11366,374,10992,26163,41.7,23117,211,773,0.029545541,810,25353
ZCTA5 48710,0,3600,-3600,0,-,0,0,0,#DIV/0!,8848,-8848
ZCTA5 48720,419,895,-476,1033,44.6,979,33,0,0,2080,-1047
ZCTA5 48721,204,652,-448,449,56.9,424,15,0,0,1576,-1127
ZCTA5 48722,1310,4232,-2922,3131,49.5,2672,0,216,0.068987544,11228,-8097
ZCTA5 48723,4964,2558,2406,12898,43,12165,74,188,0.014575903,6530,6368
ZCTA5 48724,355,11793,-11438,1053,27.6,1053,0,0,0,29669,-28616
ZCTA5 48725,1059,10248,-9189,1972,60.1,1902,25,0,0,27476,-25504
ZCTA5 48726,2165,2793,-628,5760,42.9,5604,14,15,0.002604167,8001,-2241
ZCTA5 48727,366,2354,-1988,998,45.6,985,0,0,0,7450,-6452
ZCTA5 48728,157,2258,-2101,283,62.9,263,0,0,0,5857,-5574
ZCTA5 48729,579,16036,-15457,1412,39.8,1402,0,0,0,45359,-43947
ZCTA5 48730,2234,16120,-13886,4515,55,4227,24,68,0.015060908,44193,-39678
ZCTA5 48731,661,1170,-509,1560,45.7,1526,13,0,0,3519,-1959
ZCTA5 48732,5140,11176,-6036,11247,46.6,10330,37,185,0.016448831,33896,-22649
ZCTA5 48733,643,9704,-9061,1563,45.5,1471,0,22,0.014075496,26127,-24564
ZCTA5 48734,3214,7395,-4181,7276,47.6,6800,19,228,0.031335899,16810,-9534
ZCTA5 48735,438,0,438,1042,40.1,974,0,20,0.019193858,0,1042
ZCTA5 48737,589,1118,-529,1231,56.6,1207,9,0,0,3135,-1904
ZCTA5 48738,557,637,-80,1154,58.9,1118,0,18,0.01559792,1406,-252
ZCTA5 48739,1777,2691,-914,3727,61,3532,0,0,0,6938,-3211
ZCTA5 48740,1099,593,506,2473,56.8,2381,2,7,0.00283057,1149,1324
ZCTA5 48741,789,15260,-14471,1946,49.3,1880,3,13,0.00668037,36654,-34708
ZCTA5 48742,752,15551,-14799,1593,56.6,1514,2,2,0.001255493,42775,-41182
ZCTA5 48743,27,9729,-9702,54,47.1,54,0,0,0,26882,-26828
ZCTA5 48744,1802,7954,-6152,4162,49.8,4058,7,11,0.00264296,20539,-16377
ZCTA5 48745,554,895,-341,1248,53.1,1151,42,20,0.016025641,2461,-1213
ZCTA5 48746,3223,1301,1922,8148,45,7616,96,51,0.006259205,3256,4892
ZCTA5 48747,595,1062,-467,1555,44.1,1489,15,4,0.002572347,2371,-816
ZCTA5 48748,670,884,-214,1470,58.8,1409,25,2,0.001360544,2938,-1468
ZCTA5 48749,482,2087,-1605,1285,41.1,1235,0,22,0.017120623,6260,-4975
ZCTA5 48750,4305,644,3661,9114,50.1,8637,43,33,0.003620803,1668,7446
ZCTA5 48754,362,1061,-699,990,47.7,932,0,0,0,2409,-1419
ZCTA5 48755,1248,1748,-500,2743,52.5,2623,5,19,0.006926723,4727,-1984
ZCTA5 48756,1738,1760,-22,4135,49.2,3935,0,2,0.000483676,4781,-646
ZCTA5 48757,1586,7961,-6375,3740,47,3625,0,15,0.004010695,18972,-15232
ZCTA5 48759,1537,4027,-2490,3617,42.6,3488,3,38,0.010505944,10847,-7230
ZCTA5 48760,542,24,518,1304,48.1,1186,0,77,0.05904908,39,1265
ZCTA5 48761,427,439,-12,825,62.8,807,0,0,0,1250,-425
ZCTA5 48762,487,2962,-2475,1054,59.1,980,0,10,0.009487666,8738,-7684
ZCTA5 48763,1921,3464,-1543,4943,49.8,4621,37,81,0.01638681,8825,-3882
ZCTA5 48765,263,9132,-8869,620,56.3,603,1,1,0.001612903,27226,-26606
ZCTA5 48766,529,14491,-13962,1362,48.4,1293,0,0,0,34625,-33263
ZCTA5 48767,914,16018,-15104,2264,47.3,2159,2,0,0,39832,-37568
ZCTA5 48768,3634,12919,-9285,9131,41.8,8440,12,187,0.020479685,31093,-21962
ZCTA5 48770,633,11760,-11127,1625,49.3,1567,0,0,0,33171,-31546
ZCTA5 48801,5181,12132,-6951,13576,36.2,12748,176,293,0.021582204,37871,-24295
ZCTA5 48806,645,15419,-14774,1741,42.6,1684,6,7,0.004020678,40101,-38360
ZCTA5 48807,360,9528,-9168,873,45.3,855,0,3,0.003436426,26074,-25201
ZCTA5 48808,3004,6896,-3892,6566,44.4,6371,54,66,0.010051782,15377,-8811
ZCTA5 48809,4063,11307,-7244,11340,38,10650,39,20,0.001763668,27888,-16548
ZCTA5 48811,1255,10672,-9417,5600,40.2,4215,9,946,0.168928571,27113,-21513
ZCTA5 48813,7618,8732,-1114,20252,41.6,18751,47,277,0.013677661,21777,-1525
ZCTA5 48815,814,3782,-2968,2279,39.5,2166,51,0,0,8781,-6502
ZCTA5 48816,180,11778,-11598,348,57.9,348,0,0,0,31145,-30797
ZCTA5 48817,2395,11582,-9187,5733,43.1,5409,0,163,0.028431886,30155,-24422
ZCTA5 48818,983,8463,-7480,2504,41.3,2255,11,105,0.041932907,21502,-18998
ZCTA5 48819,909,78,831,2531,41.4,2370,10,0,0,210,2321
ZCTA5 48820,6671,530,6141,17828,42.7,16404,60,316,0.017724927,1222,16606
ZCTA5 48821,2421,287,2134,6025,46.8,5346,226,124,0.020580913,590,5435
ZCTA5 48822,911,1223,-312,2500,42.9,2238,0,122,0.0488,2987,-487
ZCTA5 48823,21619,1809,19810,51481,24.3,40020,5108,2855,0.055457353,4235,47246
ZCTA5 48824,0,820,-820,2024,19.1,1490,205,110,0.054347826,1928,96
ZCTA5 48825,0,1408,-1408,10994,19.4,8556,910,849,0.07722394,3376,7618
ZCTA5 48827,6033,242,5791,15653,41.5,14793,102,156,0.009966141,719,14934
ZCTA5 48829,1337,444,893,3549,39,3405,1,19,0.005353621,895,2654
ZCTA5 48831,1382,821,561,3316,44.6,3061,4,42,0.012665862,2460,856
ZCTA5 48832,543,1282,-739,1383,40.3,1309,0,0,0,2983,-1600
ZCTA5 48834,754,1068,-314,2104,39.5,1974,15,28,0.013307985,2612,-508
ZCTA5 48835,1069,379,690,2995,40,2878,8,15,0.005008347,1224,1771
ZCTA5 48836,5149,550,4599,14791,39.2,14376,40,5,0.000338043,1306,13485
ZCTA5 48837,8579,223,8356,20536,42.5,18905,72,350,0.017043241,496,20040
ZCTA5 48838,7197,34,7163,18674,39,17544,58,120,0.006426047,113,18561
ZCTA5 48840,6095,137,5958,12686,43.4,10764,493,427,0.033659152,301,12385
ZCTA5 48841,304,1043,-739,701,50.3,663,2,0,0,2344,-1643
ZCTA5 48842,9250,625,8625,21415,39.5,17049,891,1637,0.076441746,1302,20113
ZCTA5 48843,17798,2325,15473,46433,40.8,43651,479,361,0.007774643,5801,40632
ZCTA5 48845,290,455,-165,912,41,862,0,10,0.010964912,1111,-199
ZCTA5 48846,6745,1507,5238,20828,39.7,17130,51,2652,0.127328596,3439,17389
ZCTA5 48847,2205,49,2156,5578,39.4,5248,3,64,0.011473646,160,5418
ZCTA5 48848,2847,1620,1227,7641,40.9,7330,32,55,0.007198011,3692,3949
ZCTA5 48849,2096,211,1885,5762,38.2,5488,39,90,0.015619577,457,5305
ZCTA5 48850,1700,1242,458,4802,41.3,4566,12,47,0.009787589,3618,1184
ZCTA5 48851,922,310,612,2356,45.6,2136,6,27,0.011460102,758,1598
ZCTA5 48852,66,1018,-952,154,50.5,143,0,0,0,2847,-2693
ZCTA5 48853,254,736,-482,622,36.6,619,0,0,0,1567,-945
ZCTA5 48854,7413,306,7107,19565,40.1,17755,393,386,0.019729108,855,18710
ZCTA5 48855,5716,2180,3536,15944,39.6,15225,118,42,0.00263422,5978,9966
ZCTA5 48856,305,732,-427,833,44,637,0,0,0,1716,-883
ZCTA5 48857,1277,681,596,3482,43.2,3340,12,12,0.003446295,1616,1866
ZCTA5 48858,16860,3484,13376,43105,26.3,36197,930,1235,0.028650969,8274,34831
ZCTA5 48859,24,885,-861,2588,19.4,2206,77,195,0.075347759,2064,524
ZCTA5 48860,546,2055,-1509,1701,40.3,1630,8,1,0.000587889,7854,-6153
ZCTA5 48861,733,1328,-595,1802,47.1,1662,72,14,0.007769145,3252,-1450
ZCTA5 48862,2,3077,-3075,5,-,5,0,0,0,7528,-7523
ZCTA5 48864,8912,794,8118,23100,36.9,14626,5206,1419,0.061428571,1956,21144
ZCTA5 48865,654,290,364,2086,42.6,2020,3,13,0.006232023,642,1444
ZCTA5 48866,1729,1152,577,4416,41.1,4161,0,53,0.012001812,3118,1298
ZCTA5 48867,11425,478,10947,27163,43.2,25884,65,223,0.008209697,1376,25787
ZCTA5 48870,68,1413,-1345,214,26.6,213,0,0,0,3776,-3562
ZCTA5 48871,822,2613,-1791,2181,40.1,2155,0,0,0,6756,-4575
ZCTA5 48872,2518,5921,-3403,6308,42.1,6155,0,42,0.006658212,13872,-7564
ZCTA5 48873,433,2052,-1619,1473,33.4,1464,0,0,0,6204,-4731
ZCTA5 48874,72,983,-911,216,42.1,94,0,122,0.564814815,2234,-2018
ZCTA5 48875,4117,1631,2486,11228,38.4,10386,164,118,0.010509441,4294,6934
ZCTA5 48876,1745,31,1714,4555,32.9,4183,0,60,0.013172338,62,4493
ZCTA5 48877,860,244,616,2031,49.8,1978,4,2,0.000984737,637,1394
ZCTA5 48878,627,1194,-567,1491,44.4,1364,11,12,0.00804829,3335,-1844
ZCTA5 48879,6819,878,5941,18575,40.9,17656,42,170,0.009152086,1911,16664
ZCTA5 48880,2625,64,2561,10477,39.6,7922,50,1964,0.187458242,158,10319
ZCTA5 48881,2047,541,1506,5536,39.6,5305,3,15,0.002709538,1176,4360
ZCTA5 48883,2664,1427,1237,6908,42.9,6607,11,33,0.00477707,3372,3536
ZCTA5 48884,1647,2792,-1145,4862,43.6,4568,6,3,0.00061703,7408,-2546
ZCTA5 48885,425,521,-96,1149,46.8,1104,20,0,0,1426,-277
ZCTA5 48886,708,804,-96,1802,48.6,1729,0,0,0,1997,-195
ZCTA5 48888,2517,1795,722,6077,47.9,5939,0,44,0.007240415,4275,1802
ZCTA5 48889,618,846,-228,1398,47.9,1333,0,12,0.008583691,2109,-711
ZCTA5 48890,735,15612,-14877,1968,40.1,1912,0,2,0.00101626,37672,-35704
ZCTA5 48891,1036,13651,-12615,2973,34.3,2912,4,11,0.003699966,32553,-29580
ZCTA5 48892,1936,915,1021,4775,42.8,4525,3,0,0,2486,2289
ZCTA5 48893,2128,763,1365,5459,44.9,4865,28,1,0.000183184,1594,3865
ZCTA5 48894,746,2340,-1594,2176,34.4,2083,0,0,0,6125,-3949
ZCTA5 48895,4720,470,4250,11470,45.3,10893,55,28,0.002441151,1034,10436
ZCTA5 48896,89,332,-243,339,26.7,339,0,0,0,1019,-680
ZCTA5 48897,590,1895,-1305,1462,42.3,1425,1,0,0,4677,-3215
ZCTA5 48906,10638,10065,573,26627,35.2,18351,469,4114,0.154504826,22478,4149
ZCTA5 48910,15183,1687,13496,33551,33.4,22599,1748,5257,0.156686835,3727,29824
ZCTA5 48911,16400,172,16228,40586,33.6,22020,3101,11693,0.288104272,348,40238
ZCTA5 48912,8025,3292,4733,16683,33,10187,669,3979,0.238506264,8076,8607
ZCTA5 48915,4012,694,3318,9557,29.9,5322,307,2782,0.291095532,2042,7515
ZCTA5 48917,15362,1228,14134,32218,42.3,23555,1552,4532,0.140666708,2969,29249
ZCTA5 48933,1583,364,1219,2678,30.3,1267,53,968,0.361463779,866,1812
ZCTA5 49001,8956,41,8915,20741,31.3,14087,145,5039,0.242948749,58,20683
ZCTA5 49002,8281,313,7968,20139,37.2,17594,272,742,0.036843935,752,19387
ZCTA5 49004,7268,611,6657,17491,37.6,14527,349,1235,0.070607741,1337,16154
ZCTA5 49006,10340,3950,6390,25488,23,18225,963,3557,0.139555869,9319,16169
ZCTA5 49007,4384,6390,-2006,10813,27.2,4854,115,4608,0.426153704,14386,-3573
ZCTA5 49008,6614,101,6513,17034,30.7,13484,420,1996,0.11717741,202,16832
ZCTA5 49009,19129,456,18673,47210,37.5,37363,1894,3942,0.083499259,1245,45965
ZCTA5 49010,6681,371,6310,18170,37.8,16516,246,412,0.022674739,680,17490
ZCTA5 49011,941,512,429,2475,45,2326,0,34,0.013737374,1015,1460
ZCTA5 49012,1353,2896,-1543,3708,40.2,3542,20,50,0.013484358,7168,-3460
ZCTA5 49013,1799,159,1640,5339,37.6,3756,115,211,0.039520509,356,4983
ZCTA5 49014,8246,693,7553,21383,42.6,17491,459,1615,0.075527288,1590,19793
ZCTA5 49015,11590,756,10834,28877,38.2,22550,2129,1782,0.061710011,2113,26764
ZCTA5 49017,8605,776,7829,20316,44.8,15694,102,2359,0.116115377,1901,18415
ZCTA5 49021,2279,7910,-5631,6449,39.3,5991,11,205,0.031787874,19640,-13191
ZCTA5 49022,12857,252,12605,29914,37.3,12034,133,16104,0.538343251,501,29413
ZCTA5 49024,12427,4213,8214,30070,36.5,25196,1009,2101,0.069870303,9962,20108
ZCTA5 49026,849,3032,-2183,1985,40.7,1846,0,33,0.016624685,6805,-4820
ZCTA5 49027,83,347,-264,318,34.5,310,0,0,0,786,-468
ZCTA5 49028,2252,362,1890,5712,41.4,5348,5,37,0.006477591,822,4890
ZCTA5 49029,539,546,-7,1432,45.2,1391,0,4,0.002793296,1264,168
ZCTA5 49030,882,1595,-713,2608,34.1,2447,20,41,0.015720859,3700,-1092
ZCTA5 49031,3280,837,2443,8192,48.5,6192,131,966,0.117919922,1784,6408
ZCTA5 49032,1121,69,1052,3402,38.5,3284,0,72,0.021164021,138,3264
ZCTA5 49033,712,1949,-1237,1730,48.6,1615,18,68,0.039306358,4166,-2436
ZCTA5 49034,871,760,111,2252,43.1,2166,26,7,0.003108348,1747,505
ZCTA5 49036,9346,275,9071,25059,42.7,22544,244,879,0.035077218,891,24168
ZCTA5 49037,8798,974,7824,20647,35.2,12810,582,4940,0.239259941,2339,18308
ZCTA5 49038,3755,813,2942,8861,45.1,7823,53,153,0.017266674,1989,6872
ZCTA5 49040,1204,1735,-531,3230,42.3,3116,3,5,0.001547988,3792,-562
ZCTA5 49042,1892,187,1705,4596,46.8,4308,70,31,0.006744996,396,4200
ZCTA5 49043,893,790,103,2158,40.4,941,5,767,0.355421687,1612,546
ZCTA5 49045,2410,259,2151,5748,48.8,4892,46,116,0.020180932,600,5148
ZCTA5 49046,3021,289,2732,7379,49.5,6964,0,90,0.012196775,585,6794
ZCTA5 49047,6053,49,6004,14584,41.2,12490,70,1012,0.069391114,156,14428
ZCTA5 49048,9514,1731,7783,24168,34,16350,351,5097,0.210898709,3998,20170
ZCTA5 49050,499,1015,-516,1366,48.7,1247,4,13,0.009516837,2455,-1089
ZCTA5 49051,912,246,666,2763,35.5,2582,0,47,0.017010496,471,2292
ZCTA5 49052,339,629,-290,961,37.7,845,0,36,0.037460978,1617,-656
ZCTA5 49053,2790,6897,-4107,7585,40.7,6851,63,206,0.027158866,17011,-9426
ZCTA5 49055,2394,824,1570,5890,49.4,5571,21,24,0.004074703,1895,3995
ZCTA5 49056,1190,50,1140,3696,41.3,3255,25,9,0.002435065,74,3622
ZCTA5 49057,2101,857,1244,6072,33.8,4370,2,108,0.017786561,1868,4204
ZCTA5 49058,7361,822,6539,19166,40.6,18652,52,9,0.000469582,1610,17556
ZCTA5 49060,906,2159,-1253,2515,50.3,2463,5,7,0.0027833,4753,-2238
ZCTA5 49061,640,725,-85,1669,42.5,1653,4,9,0.005392451,1836,-167
ZCTA5 49063,40,1837,-1797,116,70.5,116,0,0,0,4383,-4267
ZCTA5 49064,1363,252,1111,3795,42.2,2963,16,222,0.058498024,543,3252
ZCTA5 49065,2862,8238,-5376,7339,40.8,6746,68,70,0.009538084,19991,-12652
ZCTA5 49066,256,1101,-845,689,48.1,642,0,3,0.004354136,6567,-5878
ZCTA5 49067,1609,106,1503,4074,50.3,3856,29,26,0.006381934,264,3810
ZCTA5 49068,6383,197,6186,15230,43.7,14605,101,53,0.003479974,433,14797
ZCTA5 49070,869,911,-42,2190,41.5,2117,5,10,0.00456621,2137,53
ZCTA5 49071,4145,129,4016,11522,38.4,10739,166,28,0.002430134,238,11284
ZCTA5 49072,1133,947,186,2783,43.5,2597,6,6,0.002155947,2458,325
ZCTA5 49073,1924,4920,-2996,4870,44.8,4701,4,0,0,11266,-6396
ZCTA5 49074,63,2874,-2811,219,74.5,177,0,32,0.146118721,6462,-6243
ZCTA5 49075,81,135,-54,186,25.6,153,0,0,0,295,-109
ZCTA5 49076,1397,280,1117,4286,33.3,3914,8,250,0.058329445,547,3739
ZCTA5 49078,3823,1351,2472,9831,41.2,8486,31,49,0.004984234,3343,6488
ZCTA5 49079,4869,122,4747,13056,38.1,11891,10,135,0.010340074,228,12828
ZCTA5 49080,6174,367,5807,15711,42.3,14860,69,194,0.012348036,847,14864
ZCTA5 49082,2359,574,1785,6035,40.8,5950,2,11,0.001822701,1473,4562
ZCTA5 49083,2950,242,2708,7700,39.5,7172,133,144,0.018701299,628,7072
ZCTA5 49084,12,327,-315,15,64.5,15,0,0,0,914,-899
ZCTA5 49085,10055,231,9824,23920,43.4,21164,984,576,0.024080268,538,23382
ZCTA5 49087,2232,417,1815,6002,45.1,5778,105,17,0.002832389,959,5043
ZCTA5 49088,1364,19,1345,3708,43.1,3491,150,20,0.005393743,61,3647
ZCTA5 49089,656,140,516,1931,45.3,1834,0,0,0,236,1695
ZCTA5 49090,5710,606,5104,13302,52.1,10867,215,951,0.071493009,1348,11954
ZCTA5 49091,7620,90,7530,19574,37.6,17046,21,220,0.011239399,224,19350
ZCTA5 49092,746,159,587,1941,43.1,1850,0,2,0.001030397,334,1607
ZCTA5 49093,7404,57,7347,18556,39.5,15928,232,982,0.052920888,135,18421
ZCTA5 49094,1408,441,967,3746,40.5,3398,9,4,0.001067806,924,2822
ZCTA5 49095,914,7584,-6670,2260,51.3,2024,22,103,0.045575221,17371,-15111
ZCTA5 49096,1133,326,807,2975,40,2758,11,0,0,784,2191
ZCTA5 49097,4641,118,4523,11337,41.5,10642,55,29,0.002557996,288,11049
ZCTA5 49098,2244,117,2127,5950,39.4,5227,70,261,0.043865546,253,5697
ZCTA5 49099,2446,389,2057,5920,44.2,5631,9,5,0.000844595,798,5122
ZCTA5 49101,1238,394,844,2818,46.5,2656,25,23,0.008161817,1032,1786
ZCTA5 49102,648,4052,-3404,1517,53.2,1322,7,64,0.04218853,9658,-8141
ZCTA5 49103,4166,237,3929,11099,37.6,7526,584,1348,0.121452383,525,10574
ZCTA5 49104,0,183,-183,682,20.2,396,79,124,0.181818182,387,295
ZCTA5 49106,2106,367,1739,5317,44,5029,68,33,0.006206507,806,4511
ZCTA5 49107,4187,2863,1324,10513,45.1,9572,25,252,0.023970322,7181,3332
ZCTA5 49111,1295,404,891,3521,45.6,3064,20,148,0.042033513,824,2697
ZCTA5 49112,4221,76,4145,10336,43,9505,114,70,0.006772446,132,10204
ZCTA5 49113,788,5027,-4239,1791,45,1680,9,13,0.007258515,12536,-10745
ZCTA5 49115,86,60,26,114,70.4,105,0,0,0,100,14
ZCTA5 49116,70,587,-517,136,65.9,122,0,9,0.066176471,1520,-1384
ZCTA5 49117,1741,2828,-1087,3412,57.2,3169,32,13,0.003810082,6438,-3026
ZCTA5 49119,55,12761,-12706,132,41.8,132,0,0,0,33563,-33431
ZCTA5 49120,14534,5610,8924,36667,42.6,31690,157,2587,0.070553904,12004,24663
ZCTA5 49125,957,228,729,2226,54.1,2085,0,19,0.00853549,522,1704
ZCTA5 49126,451,1732,-1281,1278,38.7,1133,0,29,0.022691706,4792,-3514
ZCTA5 49127,4426,58,4368,11129,42.8,10099,204,288,0.025878336,98,11031
ZCTA5 49128,1405,39,1366,3308,48.4,2797,7,2,0.000604595,65,3243
ZCTA5 49129,310,3228,-2918,556,60.1,519,0,21,0.037769784,7952,-7396
ZCTA5 49130,539,1842,-1303,1351,53.2,1222,68,0,0,5129,-3778
ZCTA5 49201,16480,1366,15114,48553,41.3,40609,478,4909,0.101106008,3402,45151
ZCTA5 49202,8433,232,8201,18092,37.7,14335,211,1835,0.101426045,761,17331
ZCTA5 49203,15379,96,15283,37745,39.1,29420,203,4994,0.132308915,237,37508
ZCTA5 49220,1056,65,991,2719,40.8,2646,0,0,0,166,2553
ZCTA5 49221,15432,440,14992,41291,39.2,36348,103,1690,0.040929016,1162,40129
ZCTA5 49224,4423,447,3976,13637,32.5,10177,55,2581,0.189264501,1227,12410
ZCTA5 49227,458,11,447,1148,45.5,1120,1,13,0.011324042,33,1115
ZCTA5 49228,2070,1628,442,5381,40,5089,2,55,0.010221148,3581,1800
ZCTA5 49229,1274,416,858,3366,45.2,3160,3,4,0.001188354,896,2470
ZCTA5 49230,4440,523,3917,10136,53.7,9530,84,207,0.020422257,1144,8992
ZCTA5 49232,944,172,772,2698,41,2623,0,2,0.00074129,348,2350
ZCTA5 49233,1182,45,1137,2799,49.5,2705,8,25,0.008931761,89,2710
ZCTA5 49234,1074,191,883,2743,51.8,2537,0,29,0.010572366,812,1931
ZCTA5 49235,817,696,121,2115,44.8,2051,14,0,0,1649,466
ZCTA5 49236,1914,179,1735,5068,43.3,4762,20,79,0.015588003,447,4621
ZCTA5 49237,1106,1197,-91,2987,42.2,2885,25,39,0.013056579,2730,257
ZCTA5 49238,683,298,385,2087,33.4,1954,0,17,0.008145664,613,1474
ZCTA5 49240,3594,838,2756,9325,46.2,8842,191,7,0.00075067,1899,7426
ZCTA5 49241,843,907,-64,2107,50.3,2056,0,11,0.005220693,1988,119
ZCTA5 49242,5589,319,5270,14590,38.7,13646,102,136,0.009321453,669,13921
ZCTA5 49245,1512,249,1263,4342,35.6,4186,7,4,0.000921234,744,3598
ZCTA5 49246,1347,641,706,3864,41.4,3802,0,52,0.013457557,1592,2272
ZCTA5 49247,2167,116,2051,5376,41.2,5087,3,4,0.000744048,272,5104
ZCTA5 49248,319,62,257,849,46.6,822,0,19,0.02237927,101,748
ZCTA5 49249,1397,75,1322,3538,48.9,3501,1,16,0.004522329,162,3376
ZCTA5 49250,2284,628,1656,6082,39.1,5751,39,84,0.013811246,1876,4206
ZCTA5 49251,2407,896,1511,6454,41.1,6165,10,55,0.008521847,3542,2912
ZCTA5 49252,1037,189,848,2475,43.8,2402,0,3,0.001212121,378,2097
ZCTA5 49253,1237,1297,-60,2761,55,2716,0,7,0.002535313,2944,-183
ZCTA5 49254,1795,508,1287,3659,44.4,3464,0,42,0.011478546,948,2711
ZCTA5 49255,634,3048,-2414,2091,31.6,1988,2,0,0,7434,-5343
ZCTA5 49256,1512,251,1261,3647,44,3476,7,4,0.001096792,579,3068
ZCTA5 49258,4,1078,-1074,4,-,4,0,0,0,2775,-2771
ZCTA5 49259,1117,87,1030,2646,45.4,2502,39,6,0.002267574,236,2410
ZCTA5 49261,77,84,-7,231,28.6,231,0,0,0,132,99
ZCTA5 49262,478,97,381,1199,46.6,1180,0,1,0.000834028,249,950
ZCTA5 49263,14,1830,-1816,45,47.5,45,0,0,0,4222,-4177
ZCTA5 49264,555,136,419,1708,41.1,1574,0,8,0.004683841,261,1447
ZCTA5 49265,2125,348,1777,5059,48.3,4705,18,82,0.016208737,813,4246
ZCTA5 49266,1264,238,1026,3040,54.4,2887,0,16,0.005263158,503,2537
ZCTA5 49267,1472,154,1318,3959,49.2,3802,61,39,0.009850972,352,3607
ZCTA5 49268,504,114,390,1236,40.7,1198,16,0,0,239,997
ZCTA5 49269,2081,3065,-984,6053,40.1,5877,21,102,0.016851148,7036,-983
ZCTA5 49270,2038,3172,-1134,5565,47.1,5356,0,58,0.010422282,9824,-4259
ZCTA5 49271,859,413,446,2219,39.5,2144,0,22,0.009914376,1077,1142
ZCTA5 49272,1001,2894,-1893,2583,40.9,2486,0,12,0.004645761,6402,-3819
ZCTA5 49274,1432,3887,-2455,3848,39.6,3774,14,19,0.00493763,7870,-4022
ZCTA5 49276,394,44,350,937,48.6,914,0,4,0.004268943,124,813
ZCTA5 49277,1184,1069,115,3165,42.5,2967,0,1,0.000315956,2454,711
ZCTA5 49279,379,1658,-1279,866,48.9,794,0,0,0,3965,-3099
ZCTA5 49282,30,386,-356,45,64.5,45,0,0,0,1843,-1798
ZCTA5 49283,1002,291,711,3847,29.6,3595,33,49,0.012737198,573,3274
ZCTA5 49284,1076,584,492,2779,42.6,2598,6,27,0.009715725,1304,1475
ZCTA5 49285,2477,62,2415,6020,49.2,5696,60,60,0.009966777,144,5876
ZCTA5 49286,5762,1452,4310,14555,40.5,13071,90,162,0.011130196,2964,11591
ZCTA5 49287,844,111,733,2028,54.6,1944,16,0,0,431,1597
ZCTA5 49288,539,529,10,1504,37.3,1475,0,0,0,1206,298
ZCTA5 49289,23,173,-150,37,39.5,31,0,0,0,414,-377
ZCTA5 49301,6941,73,6868,20296,41,18405,786,252,0.01241624,123,20173
ZCTA5 49302,3020,51,2969,9548,37,9245,79,4,0.000418936,89,9459
ZCTA5 49303,325,100,225,1035,31.5,916,0,19,0.018357488,159,876
ZCTA5 49304,1521,342,1179,4233,54.5,3244,17,623,0.147176943,861,3372
ZCTA5 49305,1063,204,859,2239,52.5,2147,16,6,0.002679768,433,1806
ZCTA5 49306,3939,239,3700,10398,41.5,9585,101,97,0.009328717,513,9885
ZCTA5 49307,7082,1039,6043,19243,26.2,16945,381,923,0.047965494,2153,17090
ZCTA5 49309,759,527,232,1624,54.4,1493,0,65,0.040024631,1211,413
ZCTA5 49310,996,113,883,2838,37.8,2730,0,18,0.006342495,237,2601
ZCTA5 49312,99,191,-92,222,48.8,213,0,9,0.040540541,402,-180
ZCTA5 49315,8738,295,8443,24542,40.2,22485,746,258,0.010512591,866,23676
ZCTA5 49316,8949,629,8320,25163,39.7,21347,901,664,0.026387951,1479,23684
ZCTA5 49318,484,2551,-2067,1284,44.8,1091,47,44,0.034267913,6506,-5222
ZCTA5 49319,6997,289,6708,17868,41.1,16546,51,59,0.003301992,849,17019
ZCTA5 49320,112,632,-520,265,27.7,233,0,21,0.079245283,1655,-1390
ZCTA5 49321,6731,259,6472,16383,39,13879,326,932,0.056888238,710,15673
ZCTA5 49322,422,388,34,1104,46.1,1029,0,23,0.020833333,867,237
ZCTA5 49323,3714,6338,-2624,10729,36.2,10489,63,0,0,16367,-5638
ZCTA5 49325,745,12742,-11997,2418,33.1,2359,0,4,0.00165426,29522,-27104
ZCTA5 49326,1452,0,1452,4219,40.2,4164,8,0,0,1952,2267
ZCTA5 49327,3131,0,3131,8939,39.6,7622,84,51,0.005705336,3611,5328
ZCTA5 49328,1559,11357,-9798,4180,41.5,3899,0,82,0.019617225,27746,-23566
ZCTA5 49329,3134,637,2497,8798,37,8378,10,126,0.014321437,1627,7171
ZCTA5 49330,1855,8731,-6876,5649,33.7,5381,10,38,0.006726854,21132,-15483
ZCTA5 49331,6600,3705,2895,17715,38.6,16563,47,300,0.016934801,8273,9442
ZCTA5 49332,1414,10163,-8749,3293,53.2,3127,0,22,0.006680838,28105,-24812
ZCTA5 49333,4835,1499,3336,12481,37.3,11592,137,42,0.003365115,3325,9156
ZCTA5 49335,12,309,-297,69,18.1,69,0,0,0,594,-525
ZCTA5 49336,1540,129,1411,4304,45,3970,18,74,0.017193309,359,3945
ZCTA5 49337,4768,656,4112,12265,45.4,11495,25,50,0.004076641,1756,10509
ZCTA5 49338,696,343,353,1505,43.5,1318,17,68,0.045182724,713,792
ZCTA5 49339,823,227,596,2292,43.5,2097,1,22,0.009598604,414,1878
ZCTA5 49340,998,15,983,2414,45.8,2232,9,13,0.005385253,29,2385
ZCTA5 49341,14091,152,13939,38606,39.3,35910,434,285,0.007382272,367,38239
ZCTA5 49342,547,1859,-1312,1338,44,1289,15,11,0.008221226,5545,-4207
ZCTA5 49343,2177,6605,-4428,5941,44.4,5679,0,14,0.002356506,16258,-10317
ZCTA5 49344,1455,91,1364,3796,47.1,3439,4,83,0.021865121,192,3604
ZCTA5 49345,4909,190,4719,13593,38.5,12714,170,56,0.004119768,454,13139
ZCTA5 49346,2020,26,1994,4793,54.1,4705,0,16,0.003338202,67,4726
ZCTA5 49347,563,142,421,1642,42.6,1559,0,0,0,319,1323
ZCTA5 49348,5163,418,4745,13390,37.3,12247,200,292,0.021807319,1092,12298
ZCTA5 49349,3026,541,2485,7816,45.4,7141,13,165,0.021110542,1445,6371
ZCTA5 49401,8022,2096,5926,27048,21.5,24739,485,515,0.019040225,5480,21568
ZCTA5 49402,681,404,277,1573,54.2,1438,13,28,0.017800381,862,711
ZCTA5 49403,934,2603,-1669,2652,39.4,2467,10,0,0,6481,-3829
ZCTA5 49404,3087,276,2811,8876,35.1,8145,13,32,0.003605228,589,8287
ZCTA5 49405,605,127,478,1704,40.3,1547,7,25,0.014671362,312,1392
ZCTA5 49406,386,111,275,702,57,671,1,0,0,245,457
ZCTA5 49408,3779,1273,2506,10381,43.8,8753,26,84,0.008091706,3646,6735
ZCTA5 49409,61,331,-270,122,40.6,98,0,0,0,857,-735
ZCTA5 49410,709,556,153,1825,43.2,1690,4,3,0.001643836,1367,458
ZCTA5 49411,720,74,646,1571,54.4,1529,0,9,0.005728835,228,1343
ZCTA5 49412,4454,830,3624,12112,39.2,11067,52,106,0.008751651,1997,10115
ZCTA5 49415,2643,995,1648,6750,45.5,6433,29,79,0.011703704,2473,4277
ZCTA5 49417,13079,654,12425,32785,40.8,31002,229,178,0.005429312,1788,30997
ZCTA5 49418,11774,278,11496,29243,38.1,25575,806,832,0.028451253,672,28571
ZCTA5 49419,3004,1025,1979,8962,37.5,8653,44,5,0.000557911,2870,6092
ZCTA5 49420,2319,48,2271,6226,43.2,5438,9,166,0.026662384,101,6125
ZCTA5 49421,2130,242,1888,5419,46.7,5136,6,15,0.002768038,581,4838
ZCTA5 49423,17196,100,17096,46040,35.3,36754,1077,2276,0.049435274,258,45782
ZCTA5 49424,18059,172,17887,48433,36.7,35580,2975,1124,0.023207317,422,48011
ZCTA5 49425,1319,174,1145,3760,41.1,3601,0,9,0.002393617,470,3290
ZCTA5 49426,13399,443,12956,40748,33.8,38011,1056,265,0.006503387,1263,39485
ZCTA5 49428,10250,604,9646,28119,38.2,26259,268,283,0.010064369,1424,26695
ZCTA5 49430,32,445,-413,52,62.3,52,0,0,0,924,-872
ZCTA5 49431,7392,1083,6309,17255,48.3,16019,125,263,0.015241959,2878,14377
ZCTA5 49434,12,366,-354,12,-,12,0,0,0,955,-943
ZCTA5 49435,1373,160,1213,3870,34.7,3688,9,0,0,304,3566
ZCTA5 49436,733,323,410,1628,56.3,1480,0,1,0.000614251,934,694
ZCTA5 49437,2566,629,1937,6533,43.5,6179,1,37,0.005663554,1430,5103
ZCTA5 49440,657,63,594,906,60.7,750,9,76,0.08388521,128,778
ZCTA5 49441,14690,23,14667,35939,40.2,29917,403,3167,0.088121539,59,35880
ZCTA5 49442,15716,20,15696,45240,35.9,30633,459,10388,0.229619805,52,45188
ZCTA5 49443,0,213,-213,59,62.4,36,0,23,0.389830508,471,-412
ZCTA5 49444,9628,59,9569,26591,35.6,16391,85,8467,0.318416005,138,26453
ZCTA5 49445,8712,467,8245,21884,45.1,19742,86,455,0.020791446,1276,20608
ZCTA5 49446,792,380,412,2279,44.7,2004,0,39,0.017112769,879,1400
ZCTA5 49448,1620,426,1194,4149,39.1,4064,20,17,0.004097373,1116,3033
ZCTA5 49449,1182,215,967,2788,57.6,2685,0,0,0,551,2237
ZCTA5 49450,983,996,-13,3111,29.5,2248,0,11,0.003535841,2685,426
ZCTA5 49451,2181,3681,-1500,6329,37.4,5847,11,52,0.008216148,9649,-3320
ZCTA5 49452,763,4569,-3806,2129,39,1985,2,0,0,11701,-9572
ZCTA5 49453,1256,1135,121,2813,52.1,2619,18,0,0,2864,-51
ZCTA5 49454,1770,76,1694,4659,39.9,4409,6,27,0.005795235,180,4479
ZCTA5 49455,1808,83,1725,5042,36.8,4436,1,65,0.01289171,216,4826
ZCTA5 49456,8775,381,8394,19911,47.2,18502,133,172,0.008638441,903,19008
ZCTA5 49457,3990,230,3760,10695,42.5,9899,100,103,0.009630669,498,10197
ZCTA5 49458,38,110,-72,102,45.3,99,3,0,0,296,-194
ZCTA5 49459,554,561,-7,1727,36.6,1538,0,16,0.009264621,1510,217
ZCTA5 49460,2949,336,2613,8359,38.1,7159,197,136,0.016269889,775,7584
ZCTA5 49461,3630,1324,2306,9463,44,8410,61,143,0.015111487,3728,5735
ZCTA5 49464,10380,7212,3168,29060,38.2,26008,1345,181,0.006228493,19536,9524
ZCTA5 49503,16301,2938,13363,37005,30.4,24171,777,5674,0.153330631,6822,30183
ZCTA5 49504,16544,0,16544,40516,32.8,32117,565,2935,0.072440517,0,40516
ZCTA5 49505,13575,154,13421,33210,34.2,24331,972,4817,0.145046673,368,32842
ZCTA5 49506,12462,2375,10087,33651,33.7,26552,720,3697,0.109863006,5230,28421
ZCTA5 49507,12726,581,12145,39203,29.6,15422,438,12709,0.324184374,1514,37689
ZCTA5 49508,15761,6271,9490,42688,34.5,22620,4411,11241,0.263329273,17364,25324
ZCTA5 49509,10415,144,10271,28688,33.2,17521,514,3529,0.123013107,313,28375
ZCTA5 49512,8530,181,8349,18245,33.8,12972,671,3493,0.191449712,522,17723
ZCTA5 49519,10935,250,10685,28487,32.6,20719,950,2121,0.074455015,573,27914
ZCTA5 49525,11868,729,11139,30306,39.7,26967,664,908,0.029961064,1659,28647
ZCTA5 49534,9323,165,9158,22764,38.6,20420,447,336,0.014760148,401,22363
ZCTA5 49544,4311,4705,-394,10259,36.5,8261,438,562,0.054781168,11700,-1441
ZCTA5 49546,13084,561,12523,34242,38.9,27764,2315,2846,0.083114304,1391,32851
ZCTA5 49548,12437,984,11453,35017,32.7,22523,2068,3366,0.096124739,3074,31943
ZCTA5 49601,8731,218,8513,22109,43,20755,103,236,0.010674386,541,21568
ZCTA5 49611,146,367,-221,389,35.5,389,0,0,0,934,-545
ZCTA5 49612,601,222,379,1286,51.7,1187,3,0,0,633,653
ZCTA5 49613,285,1151,-866,587,64,574,0,0,0,2696,-2109
ZCTA5 49614,1134,164,970,3095,49.9,2883,0,41,0.013247173,380,2715
ZCTA5 49615,1805,164,1641,3860,59.2,3678,19,14,0.003626943,365,3495
ZCTA5 49616,853,182,671,2221,51.4,2051,0,8,0.003601981,368,1853
ZCTA5 49617,1211,372,839,3084,52.3,2819,12,1,0.000324254,878,2206
ZCTA5 49618,363,509,-146,876,49.2,788,18,0,0,1164,-288
ZCTA5 49619,358,329,29,952,53.3,879,0,12,0.012605042,660,292
ZCTA5 49620,976,343,633,2827,36,2691,20,39,0.013795543,903,1924
ZCTA5 49621,1404,237,1167,3709,43.8,3629,4,0,0,571,3138
ZCTA5 49622,1035,108,927,2546,49.1,2454,4,1,0.000392773,254,2292
ZCTA5 49623,422,1751,-1329,1366,57.4,1284,0,18,0.01317716,4213,-2847
ZCTA5 49625,493,296,197,1189,50.6,1150,2,0,0,620,569
ZCTA5 49626,115,11818,-11703,254,64,233,4,0,0,31524,-31270
ZCTA5 49627,80,200,-120,156,68.1,156,0,0,0,493,-337
ZCTA5 49628,81,887,-806,295,32.9,227,0,0,0,2013,-1718
ZCTA5 49629,960,517,443,1922,59.4,1829,20,0,0,1210,712
ZCTA5 49630,682,422,260,1441,61.3,1367,2,4,0.00277585,955,486
ZCTA5 49631,2208,252,1956,5308,51.8,5041,48,66,0.012434062,578,4730
ZCTA5 49632,475,22,453,1014,52,1001,6,0,0,75,939
ZCTA5 49633,1470,604,866,3358,51.7,3111,24,42,0.012507445,1650,1708
ZCTA5 49634,40,247,-207,116,44.6,116,0,0,0,549,-433
ZCTA5 49635,1318,307,1011,3238,59.6,3003,0,52,0.016059296,792,2446
ZCTA5 49636,257,1144,-887,558,68.1,508,3,13,0.023297491,3651,-3093
ZCTA5 49637,1135,1167,-32,3503,38.8,3259,0,2,0.000570939,2790,713
ZCTA5 49638,339,1149,-810,886,46.1,817,0,18,0.020316027,2951,-2065
ZCTA5 49639,958,326,632,2429,44.4,2201,0,29,0.01193907,783,1646
ZCTA5 49640,549,531,18,1420,57.9,1382,0,0,0,1345,75
ZCTA5 49642,383,3403,-3020,928,53.9,642,0,254,0.273706897,8021,-7093
ZCTA5 49643,2817,173,2644,7336,41.7,7032,61,55,0.007497274,423,6913
ZCTA5 49644,801,921,-120,1998,58.2,1902,0,1,0.000500501,2473,-475
ZCTA5 49645,685,8400,-7715,1766,49.9,1682,3,28,0.01585504,20550,-18784
ZCTA5 49646,3455,681,2774,8465,42.9,7941,73,77,0.009096279,1647,6818
ZCTA5 49648,1150,4179,-3029,2500,57.1,2469,0,2,0.0008,11385,-8885
ZCTA5 49649,2273,1390,883,7167,37.1,6880,25,4,0.000558114,3448,3719
ZCTA5 49650,1268,2728,-1460,3478,38.8,3317,0,0,0,6877,-3399
ZCTA5 49651,3102,282,2820,7733,47,7248,24,34,0.004396741,656,7077
ZCTA5 49653,733,1156,-423,1763,55.5,1683,0,7,0.003970505,2707,-944
ZCTA5 49654,292,326,-34,721,60.7,672,0,11,0.015256588,722,-1
ZCTA5 49655,1168,43,1125,3427,39.1,3311,0,24,0.00700321,84,3343
ZCTA5 49656,625,4886,-4261,1755,51.2,1669,0,4,0.002279202,14335,-12580
ZCTA5 49657,1327,3145,-1818,3674,37.8,3467,0,18,0.004899292,8985,-5311
ZCTA5 49659,2826,245,2581,7167,44,6858,17,13,0.001813869,628,6539
ZCTA5 49660,5614,236,5378,14597,48.9,12641,77,701,0.048023566,498,14099
ZCTA5 49663,2157,1161,996,6075,36.4,5761,13,23,0.003786008,2864,3211
ZCTA5 49664,802,1729,-927,1902,53.1,1761,38,1,0.000525762,5018,-3116
ZCTA5 49665,1545,7,1538,3992,43.8,3872,0,5,0.001252505,21,3971
ZCTA5 49667,264,790,-526,651,40.1,629,0,0,0,1916,-1265
ZCTA5 49668,1299,297,1002,3314,40.4,3052,8,12,0.003621002,783,2531
ZCTA5 49670,825,452,373,1895,59.7,1781,0,0,0,1125,770
ZCTA5 49674,41,63,-22,91,73.6,91,0,0,0,144,-53
ZCTA5 49675,376,168,208,769,54.6,757,0,0,0,449,320
ZCTA5 49676,1410,516,894,3494,49.4,3222,2,21,0.006010303,1214,2280
ZCTA5 49677,2728,265,2463,7448,43.3,7104,9,94,0.012620838,525,6923
ZCTA5 49679,449,202,247,1343,38.2,1161,0,82,0.061057334,500,843
ZCTA5 49680,677,598,79,2091,35.6,1960,6,76,0.036346246,1635,456
ZCTA5 49682,1832,1036,796,4590,55.6,3693,58,47,0.010239651,2827,1763
ZCTA5 49683,812,439,373,2068,48.6,1941,12,4,0.001934236,1086,982
ZCTA5 49684,8985,78,8907,21388,45.9,19863,193,227,0.010613428,199,21189
ZCTA5 49685,8353,958,7395,20665,39.3,19355,114,150,0.00725865,2673,17992
ZCTA5 49686,11063,164,10899,24714,46.6,23573,66,150,0.006069434,413,24301
ZCTA5 49688,836,96,740,2321,42.7,2191,15,10,0.004308488,225,2096
ZCTA5 49689,612,733,-121,1481,47.8,1404,1,16,0.010803511,1991,-510
ZCTA5 49690,2517,317,2200,6645,46.1,6151,60,20,0.003009782,706,5939
ZCTA5 49696,3848,808,3040,10259,42.9,9632,108,149,0.014523833,2250,8009
ZCTA5 49701,358,1990,-1632,762,56.2,621,17,26,0.034120735,4555,-3793
ZCTA5 49705,322,506,-184,926,42.5,853,3,16,0.017278618,1230,-304
ZCTA5 49706,2081,1080,1001,4669,37,3733,11,7,0.00149925,2510,2159
ZCTA5 49707,9889,484,9405,22023,48,20801,117,170,0.007719203,1211,20812
ZCTA5 49709,1639,59,1580,3428,59.2,3282,2,5,0.001458576,129,3299
ZCTA5 49710,181,156,25,351,53.6,256,0,0,0,339,12
ZCTA5 49712,3738,21,3717,8176,49.2,7701,38,31,0.003791585,52,8124
ZCTA5 49713,920,251,669,2301,41.7,2158,0,5,0.002172968,630,1671
ZCTA5 49715,1334,289,1045,3457,42.1,1738,27,75,0.021695111,822,2635
ZCTA5 49716,328,416,-88,999,37,925,0,24,0.024024024,1035,-36
ZCTA5 49717,73,854,-781,129,63,129,0,0,0,2565,-2436
ZCTA5 49718,260,173,87,718,40.5,600,0,2,0.002785515,410,308
ZCTA5 49719,648,6165,-5517,1328,57.8,1258,32,0,0,16195,-14867
ZCTA5 49720,4160,137,4023,8921,51.3,8433,58,88,0.009864365,383,8538
ZCTA5 49721,5658,12897,-7239,13853,51.8,12775,56,117,0.008445824,31733,-17880
ZCTA5 49722,43,10530,-10487,99,76.2,99,0,0,0,23905,-23806
ZCTA5 49724,367,422,-55,1043,42.5,843,3,0,0,1060,-17
ZCTA5 49725,299,322,-23,624,60.5,498,5,0,0,861,-237
ZCTA5 49726,552,73,479,1011,61.3,977,2,0,0,133,878
ZCTA5 49727,2919,3173,-254,6880,46,6500,34,0,0,8284,-1404
ZCTA5 49728,148,193,-45,386,57,298,7,0,0,376,10
ZCTA5 49729,666,225,441,1521,49.3,1431,2,16,0.010519395,633,888
ZCTA5 49730,799,935,-136,2040,43.7,1907,3,6,0.002941176,2608,-568
ZCTA5 49733,730,168,562,1783,47.2,1697,15,0,0,333,1450
ZCTA5 49735,8583,374,8209,20402,44.2,19313,118,219,0.010734242,928,19474
ZCTA5 49736,219,2934,-2715,417,61.9,388,0,0,0,5315,-4898
ZCTA5 49738,4127,12781,-8654,9513,50.9,9036,98,39,0.004099653,30029,-20516
ZCTA5 49740,3220,5656,-2436,7422,54.8,6801,36,43,0.005793587,15013,-7591
ZCTA5 49743,349,7555,-7206,865,54.2,849,6,0,0,15373,-14508
ZCTA5 49744,339,6669,-6330,800,52.9,784,0,0,0,17542,-16742
ZCTA5 49745,471,4263,-3792,1065,49.8,757,0,0,0,12006,-10941
ZCTA5 49746,1545,14524,-12979,3361,56.3,3255,1,18,0.005355549,35930,-32569
ZCTA5 49747,872,5935,-5063,2107,50.1,2010,0,0,0,16976,-14869
ZCTA5 49748,71,14342,-14271,127,64,110,0,0,0,35686,-35559
ZCTA5 49749,2047,0,2047,4503,57.2,4169,7,17,0.003775261,0,4503
ZCTA5 49751,870,7355,-6485,2076,49.8,2024,13,0,0,20259,-18183
ZCTA5 49752,292,3371,-3079,687,41,528,0,0,0,8156,-7469
ZCTA5 49753,798,13282,-12484,1879,53,1857,0,2,0.001064396,31085,-29206
ZCTA5 49755,760,3486,-2726,1699,50.9,1525,35,5,0.002942908,10331,-8632
ZCTA5 49756,1809,2050,-241,3783,56.7,3576,0,10,0.002643405,4857,-1074
ZCTA5 49757,424,5885,-5461,1025,43,568,11,227,0.221463415,15658,-14633
ZCTA5 49759,708,3867,-3159,1365,62.1,1327,0,5,0.003663004,10268,-8903
ZCTA5 49760,357,13764,-13407,745,54.5,508,3,22,0.029530201,29617,-28872
ZCTA5 49762,297,150,147,597,63.9,458,6,0,0,297,300
ZCTA5 49764,79,1278,-1199,106,28.4,106,0,0,0,2729,-2623
ZCTA5 49765,1713,1302,411,4226,48.5,3928,7,31,0.007335542,3072,1154
ZCTA5 49766,901,681,220,2387,49.4,2339,22,15,0.006284039,1483,904
ZCTA5 49768,191,20,171,449,60.8,415,0,0,0,54,395
ZCTA5 49769,685,4118,-3433,1780,33.4,1445,0,0,0,9283,-7503
ZCTA5 49770,7305,208,7097,17450,45.2,16333,108,124,0.007106017,463,16987
ZCTA5 49774,924,157,767,2717,44.4,2120,11,345,0.126978285,414,2303
ZCTA5 49775,24,117,-93,51,68.5,51,0,0,0,209,-158
ZCTA5 49776,672,111,561,1566,51.1,1499,2,17,0.010855683,242,1324
ZCTA5 49777,867,202,665,1842,59.2,1749,26,0,0,413,1429
ZCTA5 49779,2086,209,1877,4651,54.7,4511,28,11,0.002365083,517,4134
ZCTA5 49780,584,2315,-1731,1603,39.9,1307,9,35,0.021834061,5733,-4130
ZCTA5 49781,1692,1539,153,3404,49.9,2011,47,116,0.034077556,3918,-514
ZCTA5 49782,301,176,125,616,63.5,594,0,0,0,468,148
ZCTA5 49783,7786,186,7600,19302,37.6,13656,206,243,0.012589369,407,18895
ZCTA5 49784,0,2370,-2370,1068,39.6,375,0,612,0.573033708,5834,-4766
ZCTA5 49788,879,159,720,4064,31.8,1855,45,423,0.104084646,408,3656
ZCTA5 49791,106,254,-148,274,57.7,263,0,0,0,604,-330
ZCTA5 49793,62,526,-464,123,65.3,121,0,0,0,1270,-1147
ZCTA5 49795,791,266,525,1871,47.6,1795,4,0,0,611,1260
ZCTA5 49796,171,324,-153,354,52.6,347,0,0,0,808,-454
ZCTA5 49799,917,1213,-296,2295,47.5,2120,17,0,0,2524,-229
ZCTA5 49801,5216,226,4990,11623,48.8,11146,63,118,0.010152284,471,11152
ZCTA5 49802,2635,358,2277,6075,41.3,5497,68,61,0.010041152,950,5125
ZCTA5 49805,211,294,-83,465,48,446,0,0,0,754,-289
ZCTA5 49806,238,60,178,642,57.6,473,3,7,0.010903427,163,479
ZCTA5 49807,1402,167,1235,3428,46.2,3167,11,9,0.002625438,413,3015
ZCTA5 49808,122,701,-579,268,49.6,247,0,2,0.007462687,1749,-1481
ZCTA5 49812,335,187,148,775,50.7,753,0,0,0,473,302
ZCTA5 49814,438,861,-423,1161,42,1096,0,0,0,2039,-878
ZCTA5 49815,132,1295,-1163,255,55.5,245,0,0,0,2947,-2692
ZCTA5 49816,280,81,199,805,52.8,692,30,3,0.003726708,169,636
ZCTA5 49817,262,2373,-2111,649,41.3,496,6,4,0.006163328,5642,-4993
ZCTA5 49818,470,307,163,1136,47.9,1131,0,0,0,776,360
ZCTA5 49820,106,96,10,206,56.2,181,0,16,0.077669903,250,-44
ZCTA5 49821,506,767,-261,1343,43.8,1277,2,28,0.020848846,1985,-642
ZCTA5 49822,83,22,61,210,44.4,202,0,0,0,67,143
ZCTA5 49825,94,635,-541,242,50.1,242,0,0,0,1663,-1421
ZCTA5 49826,52,640,-588,127,49.3,127,0,0,0,1482,-1355
ZCTA5 49827,427,116,311,1128,47.7,984,0,0,0,262,866
ZCTA5 49829,7573,356,7217,16880,46.4,15099,211,73,0.004324645,735,16145
ZCTA5 49831,262,1004,-742,602,46.7,589,0,0,0,2568,-1966
ZCTA5 49833,42,120,-78,76,70.8,76,0,0,0,228,-152
ZCTA5 49834,210,619,-409,479,48.3,477,0,0,0,1686,-1207
ZCTA5 49835,314,342,-28,661,60.2,530,1,5,0.007564297,748,-87
ZCTA5 49836,464,168,296,1043,54.1,940,0,1,0.000958773,393,650
ZCTA5 49837,3782,434,3348,9833,44.9,9394,0,15,0.001525475,1017,8816
ZCTA5 49838,204,306,-102,326,61.5,299,0,0,0,656,-330
ZCTA5 49839,161,401,-240,336,68.5,314,0,6,0.017857143,777,-441
ZCTA5 49840,306,405,-99,663,57.5,594,8,0,0,895,-232
ZCTA5 49841,2840,369,2471,7310,42.1,6534,42,61,0.008344733,833,6477
ZCTA5 49847,478,186,292,1187,49.9,1174,3,0,0,389,798
ZCTA5 49848,41,11914,-11873,83,62.5,83,0,0,0,28659,-28576
ZCTA5 49849,4892,446,4446,12190,40.9,11276,221,75,0.006152584,1035,11155
ZCTA5 49852,57,3070,-3013,135,43.3,135,0,0,0,7006,-6871
ZCTA5 49853,455,647,-192,901,61.5,847,0,0,0,1541,-640
ZCTA5 49854,2824,106,2718,6168,52.7,5298,19,25,0.004053178,222,5946
ZCTA5 49855,13278,261,13017,32999,35.4,30269,179,908,0.027515985,616,32383
ZCTA5 49858,5229,454,4775,12018,49.3,11465,25,44,0.003661175,1200,10818
ZCTA5 49861,224,166,58,507,56.7,485,0,11,0.021696252,443,64
ZCTA5 49862,1446,232,1214,4668,45.1,3656,11,619,0.13260497,592,4076
ZCTA5 49863,74,76,-2,179,44.9,179,0,0,0,137,42
ZCTA5 49864,26,41,-15,35,64.9,35,0,0,0,41,-6
ZCTA5 49866,3343,333,3010,8271,39.5,7842,13,14,0.001692661,753,7518
ZCTA5 49868,1703,313,1390,4692,41,3523,31,501,0.106777494,793,3899
ZCTA5 49870,1547,209,1338,3478,45.4,3318,0,12,0.003450259,462,3016
ZCTA5 49871,220,1464,-1244,619,46.8,590,0,0,0,3590,-2971
ZCTA5 49872,98,96,2,259,62.3,237,0,0,0,221,38
ZCTA5 49873,43,204,-161,88,56.7,87,0,0,0,508,-420
ZCTA5 49874,369,311,58,999,57.2,968,0,0,0,779,220
ZCTA5 49876,496,517,-21,1231,55.1,1231,0,0,0,1315,-84
ZCTA5 49877,4,126,-122,7,70.5,7,0,0,0,291,-284
ZCTA5 49878,1467,439,1028,3240,54,2989,3,0,0,930,2310
ZCTA5 49879,554,1575,-1021,1118,59.3,1100,4,0,0,3998,-2880
ZCTA5 49880,489,363,126,1089,51.2,999,6,1,0.000918274,813,276
ZCTA5 49881,138,1994,-1856,364,36.6,286,0,0,0,4619,-4255
ZCTA5 49883,61,236,-175,162,55.8,150,0,6,0.037037037,441,-279
ZCTA5 49884,222,255,-33,489,55.9,436,0,0,0,609,-120
ZCTA5 49885,673,411,262,1735,46.5,1625,17,29,0.016714697,955,780
ZCTA5 49886,226,409,-183,542,46.2,538,4,0,0,885,-343
ZCTA5 49887,1061,449,612,2754,47.8,2576,5,23,0.008351489,1027,1727
ZCTA5 49891,210,648,-438,689,49.8,668,0,0,0,1650,-961
ZCTA5 49892,829,233,596,1956,52.4,1906,7,3,0.001533742,624,1332
ZCTA5 49893,559,75,484,1216,54.8,1204,10,1,0.000822368,247,969
ZCTA5 49894,312,156,156,813,57,813,0,0,0,367,446
ZCTA5 49895,338,2535,-2197,852,58.8,669,0,2,0.002347418,5935,-5083
ZCTA5 49896,521,44,477,1617,38.9,1080,34,26,0.016079159,97,1520
ZCTA5 49901,145,763,-618,253,53.8,253,0,0,0,1620,-1367
ZCTA5 49902,104,144,-40,174,58.1,168,0,0,0,271,-97
ZCTA5 49903,114,416,-302,156,71.4,150,0,0,0,843,-687
ZCTA5 49905,760,323,437,2533,31.8,2433,0,5,0.001973944,730,1803
ZCTA5 49908,1006,153,853,3159,38.5,1729,24,577,0.182652738,318,2841
ZCTA5 49910,128,242,-114,232,66,232,0,0,0,576,-344
ZCTA5 49911,1181,252,929,2620,50.6,2512,15,28,0.010687023,513,2107
ZCTA5 49912,422,268,154,932,58.5,869,4,1,0.001072961,560,372
ZCTA5 49913,2968,1191,1777,7172,42.7,6786,93,47,0.006553263,2578,4594
ZCTA5 49915,223,250,-27,482,50.5,429,9,18,0.037344398,603,-121
ZCTA5 49916,1215,146,1069,3001,43.6,2858,28,11,0.003665445,275,2726
ZCTA5 49917,81,77,4,291,35.2,290,0,0,0,196,95
ZCTA5 49918,56,582,-526,121,61,121,0,0,0,1434,-1313
ZCTA5 49919,51,346,-295,86,71.3,77,0,0,0,812,-726
ZCTA5 49920,1828,87,1741,4155,56.2,3989,18,36,0.00866426,202,3953
ZCTA5 49921,117,155,-38,366,22.3,357,0,0,0,321,45
ZCTA5 49922,348,27,321,907,32.4,890,0,14,0.015435502,77,830
ZCTA5 49925,259,1107,-848,563,57,552,0,0,0,2188,-1625
ZCTA5 49927,166,452,-286,489,46.3,398,14,53,0.108384458,1050,-561
ZCTA5 49929,78,226,-148,188,47.1,184,0,0,0,439,-251
ZCTA5 49930,2662,195,2467,7413,31.4,6931,126,44,0.005935519,342,7071
ZCTA5 49931,3095,320,2775,9753,22.6,8308,753,234,0.023992618,685,9068
ZCTA5 49934,354,1128,-774,727,46.8,703,10,10,0.013755158,2939,-2212
ZCTA5 49935,2612,369,2243,6062,51.4,5751,16,34,0.00560871,991,5071
ZCTA5 49938,3704,91,3613,7737,49.4,7321,29,140,0.018094869,160,7577
ZCTA5 49942,91,1186,-1095,159,50.3,159,0,0,0,2647,-2488
ZCTA5 49945,1295,399,896,2978,45.2,2925,5,5,0.001678979,891,2087
ZCTA5 49946,1579,144,1435,3844,46.5,3132,28,37,0.00962539,283,3561
ZCTA5 49947,324,4512,-4188,1064,49.7,722,2,169,0.158834586,12824,-11760
ZCTA5 49948,229,426,-197,541,53.7,520,0,6,0.011090573,918,-377
ZCTA5 49950,527,120,407,1004,62.9,955,0,11,0.010956175,283,721
ZCTA5 49952,53,16,37,124,51.8,116,0,0,0,46,78
ZCTA5 49953,1097,101,996,2280,60.5,2194,20,17,0.00745614,256,2024
ZCTA5 49955,139,3872,-3733,481,27.2,459,5,12,0.024948025,9115,-8634
ZCTA5 49958,381,469,-88,849,54,806,0,0,0,1147,-298
ZCTA5 49959,186,426,-240,403,47.3,366,0,22,0.054590571,1056,-653
ZCTA5 49960,85,183,-98,223,57.1,220,0,0,0,510,-287
ZCTA5 49961,62,994,-932,155,59.9,153,0,0,0,2413,-2258
ZCTA5 49962,111,675,-564,217,67.2,202,0,0,0,1627,-1410
ZCTA5 49963,245,294,-49,563,39.3,554,0,2,0.003552398,707,-144
ZCTA5 49965,240,669,-429,504,61.7,487,0,0,0,1604,-1100
ZCTA5 49967,192,71,121,420,60,393,17,0,0,144,276
ZCTA5 49968,933,393,540,2156,47.3,2072,7,2,0.000927644,1005,1151
ZCTA5 49969,517,249,268,1044,60.7,762,2,9,0.00862069,692,352
ZCTA5 49970,140,178,-38,290,61.2,290,0,0,0,456,-166
ZCTA5 49971,205,156,49,471,56.6,457,11,0,0,377,94
ZCTA5 50001,230,141,89,653,38.9,562,0,20,0.030627871,345,308
ZCTA5 50002,589,15366,-14777,1529,42.9,1431,50,18,0.0117724,42067,-40538
ZCTA5 50003,3441,4546,-1105,9048,39.5,8418,71,68,0.007515473,10562,-1514
ZCTA5 50005,374,972,-598,967,43.9,758,186,0,0,2460,-1493
ZCTA5 50006,674,28,646,1642,42.7,1521,0,31,0.018879415,52,1590
ZCTA5 50007,203,623,-420,551,42.3,539,3,4,0.007259528,1651,-1100
ZCTA5 50008,317,1231,-914,778,41.7,733,0,0,0,3108,-2330
ZCTA5 50009,7688,653,7035,20580,37,18920,128,628,0.030515063,1817,18763
ZCTA5 50010,14020,477,13543,34036,29.1,27952,3506,1081,0.031760489,1232,32804
ZCTA5 50012,0,644,-644,2284,19.4,2216,15,0,0,1716,568
ZCTA5 50013,0,1339,-1339,3732,19.4,3450,62,59,0.015809218,3530,202
ZCTA5 50014,12611,579,12032,30801,23.1,23944,3650,1024,0.033245674,1538,29263
ZCTA5 50020,535,880,-345,1269,53.3,1254,0,0,0,2523,-1254
ZCTA5 50021,11411,785,10626,27550,35.6,24899,843,920,0.033393829,1733,25817
ZCTA5 50022,3789,446,3343,8677,43.1,8407,41,98,0.011294226,1164,7513
ZCTA5 50023,15555,155,15400,42550,32.3,39668,831,439,0.010317274,402,42148
ZCTA5 50025,1357,372,985,2986,46.3,2817,2,30,0.010046885,803,2183
ZCTA5 50026,201,738,-537,487,44.6,453,0,0,0,1818,-1331
ZCTA5 50027,157,806,-649,352,36,327,0,0,0,1924,-1572
ZCTA5 50028,668,1392,-724,1642,44.3,1625,2,0,0,3179,-1537
ZCTA5 50029,248,614,-366,544,42.8,506,0,17,0.03125,1758,-1214
ZCTA5 50031,16,264,-248,60,21,60,0,0,0,753,-693
ZCTA5 50032,238,1105,-867,645,35.4,645,0,0,0,2706,-2061
ZCTA5 50033,7,3352,-3345,16,64.5,16,0,0,0,8190,-8174
ZCTA5 50034,134,416,-282,408,43.7,394,0,0,0,942,-534
ZCTA5 50035,2987,807,2180,9144,33.1,8482,66,516,0.056430446,1919,7225
ZCTA5 50036,6521,1689,4832,16373,40.7,15545,61,159,0.00971111,4554,11819
ZCTA5 50038,90,263,-173,266,39,266,0,0,0,648,-382
ZCTA5 50039,182,1500,-1318,542,54.4,526,0,6,0.011070111,3927,-3385
ZCTA5 50040,66,48,18,123,49.5,123,0,0,0,101,22
ZCTA5 50041,47,254,-207,98,40.3,98,0,0,0,677,-579
ZCTA5 50042,88,182,-94,201,54.8,191,0,0,0,399,-198
ZCTA5 50044,400,315,85,1008,39.9,1004,0,0,0,708,300
ZCTA5 50046,729,1115,-386,1818,37.2,1786,2,8,0.00440044,2620,-802
ZCTA5 50047,2234,2401,-167,6447,34.9,6126,0,14,0.002171553,5808,639
ZCTA5 50048,339,560,-221,904,40.5,848,0,0,0,1394,-490
ZCTA5 50049,2651,3185,-534,6257,41.9,6064,29,24,0.003835704,7218,-961
ZCTA5 50050,283,5,278,678,41,635,15,5,0.007374631,15,663
ZCTA5 50051,136,1134,-998,288,57,246,15,0,0,2690,-2402
ZCTA5 50052,43,375,-332,99,38.9,97,0,0,0,976,-877
ZCTA5 50054,1120,309,811,3191,37.8,3086,8,41,0.012848637,818,2373
ZCTA5 50055,456,496,-40,1213,38.9,1144,2,18,0.014839242,1353,-140
ZCTA5 50056,484,1018,-534,1178,38.5,1156,6,0,0,2365,-1187
ZCTA5 50057,112,798,-686,283,39.3,283,0,0,0,1963,-1680
ZCTA5 50058,762,113,649,1790,40.7,1734,0,0,0,401,1389
ZCTA5 50060,1002,263,739,2581,40.8,2454,4,22,0.008523828,651,1930
ZCTA5 50061,793,69,724,2466,42,2240,170,7,0.002838605,215,2251
ZCTA5 50062,292,1591,-1299,733,35.3,716,0,0,0,3494,-2761
ZCTA5 50063,971,1104,-133,2548,38.1,2453,7,48,0.018838305,2728,-180
ZCTA5 50064,63,841,-778,114,62.5,112,0,0,0,2241,-2127
ZCTA5 50065,274,4254,-3980,584,51.3,553,6,0,0,11897,-11313
ZCTA5 50066,111,495,-384,239,30.7,212,0,0,0,1158,-919
ZCTA5 50067,113,176,-63,346,31,317,12,0,0,490,-144
ZCTA5 50068,115,645,-530,262,53.4,257,0,0,0,1693,-1431
ZCTA5 50069,409,12846,-12437,1070,36.2,1002,41,0,0,29410,-28340
ZCTA5 50070,484,8586,-8102,1113,46.8,941,62,3,0.002695418,19724,-18611
ZCTA5 50071,381,7797,-7416,967,42.2,952,0,0,0,20153,-19186
ZCTA5 50072,1059,3310,-2251,2849,44.9,2675,16,11,0.003861004,8570,-5721
ZCTA5 50073,497,4061,-3564,1092,55,1050,4,10,0.009157509,9514,-8422
ZCTA5 50074,143,749,-606,292,67.9,280,0,0,0,1852,-1560
ZCTA5 50075,310,975,-665,741,37.3,718,0,0,0,2376,-1635
ZCTA5 50076,648,45,603,1498,50.2,1472,0,0,0,122,1376
ZCTA5 50078,44,146,-102,100,53.8,98,0,0,0,375,-275
ZCTA5 50101,15,158,-143,50,18.5,50,0,0,0,276,-226
ZCTA5 50102,50,16,34,151,34.3,145,0,0,0,24,127
ZCTA5 50103,155,245,-90,380,37.3,380,0,0,0,553,-173
ZCTA5 50104,41,1235,-1194,74,61.5,74,0,0,0,2854,-2780
ZCTA5 50105,467,36,431,1106,43.7,986,9,6,0.005424955,69,1037
ZCTA5 50106,429,218,211,971,43.5,964,4,0,0,587,384
ZCTA5 50107,361,331,30,951,35.5,936,0,0,0,936,15
ZCTA5 50108,151,490,-339,409,44.9,409,0,0,0,1143,-734
ZCTA5 50109,1325,34,1291,3230,40.9,3129,0,0,0,68,3162
ZCTA5 50110,18,161,-143,36,59.5,36,0,0,0,305,-269
ZCTA5 50111,5945,1160,4785,15491,35.9,14611,294,215,0.013879027,2678,12813
ZCTA5 50112,4782,859,3923,11885,39.3,10841,408,216,0.018174169,1898,9987
ZCTA5 50115,1151,318,833,2653,42.5,2498,2,4,0.001507727,728,1925
ZCTA5 50116,70,935,-865,170,43.5,163,0,0,0,2075,-1905
ZCTA5 50117,61,79,-18,149,49.9,149,0,0,0,202,-53
ZCTA5 50118,321,308,13,846,35,759,34,0,0,685,161
ZCTA5 50119,139,272,-133,310,48.8,306,0,0,0,645,-335
ZCTA5 50120,179,186,-7,392,58.4,392,0,0,0,652,-260
ZCTA5 50122,575,112,463,1419,49,1411,0,0,0,293,1126
ZCTA5 50123,361,68,293,799,56.1,795,0,0,0,155,644
ZCTA5 50124,1604,100,1504,4600,36,4247,54,165,0.035869565,276,4324
ZCTA5 50125,7523,934,6589,20228,37.9,19086,275,139,0.006871663,2102,18126
ZCTA5 50126,2767,968,1799,6507,46,6242,16,42,0.006454587,2467,4040
ZCTA5 50127,0,1095,-1095,0,-,0,0,0,#DIV/0!,2579,-2579
ZCTA5 50128,156,626,-470,366,42.7,365,0,0,0,1585,-1219
ZCTA5 50129,2313,575,1738,5257,46.9,4973,16,20,0.003804451,1360,3897
ZCTA5 50130,575,636,-61,1592,35.3,1558,14,0,0,1593,-1
ZCTA5 50131,9352,521,8831,23577,37.6,18953,1513,2325,0.098613055,1192,22385
ZCTA5 50132,139,281,-142,367,39.7,353,5,1,0.002724796,699,-332
ZCTA5 50133,219,37,182,482,41.9,467,3,0,0,94,388
ZCTA5 50134,303,105,198,783,38.5,632,59,24,0.030651341,309,474
ZCTA5 50135,550,179,371,1474,40.6,1440,14,9,0.006105834,313,1161
ZCTA5 50136,175,18,157,450,49,429,0,0,0,44,406
ZCTA5 50137,36,3018,-2982,88,39.3,88,0,0,0,6387,-6299
ZCTA5 50138,5106,226,4880,11994,42.9,11487,66,97,0.008087377,517,11477
ZCTA5 50139,456,568,-112,978,52.8,920,0,8,0.008179959,1445,-467
ZCTA5 50140,1056,187,869,2945,29.3,2567,38,120,0.040747029,317,2628
ZCTA5 50141,185,329,-144,460,47,460,0,0,0,819,-359
ZCTA5 50142,358,301,57,786,50.3,761,0,6,0.007633588,761,25
ZCTA5 50143,230,345,-115,548,53.5,516,12,0,0,892,-344
ZCTA5 50144,1069,1294,-225,2594,36.8,2546,0,0,0,3167,-573
ZCTA5 50145,33,722,-689,55,64.1,48,0,0,0,1955,-1900
ZCTA5 50146,181,839,-658,424,48.7,418,0,0,0,1867,-1443
ZCTA5 50147,159,334,-175,298,53.1,271,0,0,0,730,-432
ZCTA5 50148,179,485,-306,364,43.8,332,0,0,0,1342,-978
ZCTA5 50149,353,834,-481,993,35,983,0,0,0,2116,-1123
ZCTA5 50150,377,123,254,1009,40.8,950,0,0,0,331,678
ZCTA5 50151,257,667,-410,634,45.7,632,0,0,0,1758,-1124
ZCTA5 50152,65,4975,-4910,165,52.8,161,0,0,0,12070,-11905
ZCTA5 50153,404,215,189,928,53.9,919,0,0,0,509,419
ZCTA5 50154,261,784,-523,602,32.4,593,0,0,0,1756,-1154
ZCTA5 50155,85,724,-639,175,56.6,172,0,0,0,1717,-1542
ZCTA5 50156,1986,223,1763,4903,46.2,4828,0,2,0.000407914,628,4275
ZCTA5 50157,289,163,126,679,34.9,546,0,0,0,323,356
ZCTA5 50158,11669,637,11032,31241,37.5,24019,1295,567,0.018149227,1658,29583
ZCTA5 50160,240,939,-699,529,39.1,513,0,0,0,2528,-1999
ZCTA5 50161,857,1640,-783,2178,39.8,2036,4,12,0.005509642,3998,-1820
ZCTA5 50162,526,2262,-1736,1339,31.6,1322,0,0,0,7369,-6030
ZCTA5 50163,320,89,231,741,40.7,719,0,0,0,210,531
ZCTA5 50164,256,757,-501,614,47.8,581,0,0,0,1737,-1123
ZCTA5 50165,16,347,-331,39,40.5,39,0,0,0,802,-763
ZCTA5 50166,673,263,410,1768,43.5,1743,0,0,0,647,1121
ZCTA5 50167,332,232,100,882,40.4,847,0,0,0,500,382
ZCTA5 50168,349,1097,-748,946,40.7,898,3,14,0.014799154,2765,-1819
ZCTA5 50169,931,48,883,3151,37.3,2915,0,120,0.038083148,119,3032
ZCTA5 50170,1241,330,911,3159,37,3115,19,5,0.001582779,790,2369
ZCTA5 50171,1163,467,696,2528,50.1,2403,8,11,0.004351266,1296,1232
ZCTA5 50173,329,1722,-1393,760,55.5,522,0,13,0.017105263,4881,-4121
ZCTA5 50174,444,483,-39,1372,32,1302,0,6,0.004373178,1172,200
ZCTA5 50201,3551,251,3300,8266,41.4,7481,34,46,0.005564965,473,7793
ZCTA5 50206,187,454,-267,470,40.4,460,0,0,0,1077,-607
ZCTA5 50207,972,265,707,2305,42.9,2283,0,0,0,552,1753
ZCTA5 50208,7752,199,7553,20424,42.2,18685,182,567,0.027761457,473,19951
ZCTA5 50210,584,220,364,1457,41.8,1428,0,0,0,536,921
ZCTA5 50211,5670,455,5215,14905,36.8,14281,60,210,0.014089232,1100,13805
ZCTA5 50212,1213,465,748,2979,40.1,2932,11,0,0,767,2212
ZCTA5 50213,2901,6248,-3347,7366,38.3,6720,0,3,0.000407277,17831,-10465
ZCTA5 50214,281,8422,-8141,787,37.1,704,35,0,0,21878,-21091
ZCTA5 50216,1152,3595,-2443,2833,51.1,2766,0,14,0.004941758,9509,-6676
ZCTA5 50217,222,10011,-9789,483,55.1,478,5,0,0,26107,-25624
ZCTA5 50218,138,2224,-2086,274,42,251,0,0,0,6401,-6127
ZCTA5 50219,4956,1270,3686,13465,38,12732,241,138,0.010248793,3066,10399
ZCTA5 50220,3557,134,3423,9103,40,7673,18,320,0.035153246,228,8875
ZCTA5 50222,167,2742,-2575,445,48.1,444,0,0,0,6069,-5624
ZCTA5 50223,141,206,-65,315,41.5,314,0,0,0,588,-273
ZCTA5 50225,1273,89,1184,3245,38.1,2954,58,73,0.022496148,256,2989
ZCTA5 50226,2362,386,1976,6566,37.1,6461,0,30,0.004568992,993,5573
ZCTA5 50227,27,464,-437,90,39.1,90,0,0,0,1142,-1052
ZCTA5 50228,932,381,551,2661,37,2647,0,2,0.000751597,1007,1654
ZCTA5 50229,369,669,-300,1094,44.5,1075,6,3,0.00274223,1598,-504
ZCTA5 50230,393,513,-120,979,49.6,930,6,0,0,1284,-305
ZCTA5 50231,73,1071,-998,135,57.9,133,0,0,0,3081,-2946
ZCTA5 50232,263,629,-366,604,41.1,600,0,0,0,1672,-1068
ZCTA5 50233,552,624,-72,1405,42.4,1384,0,11,0.007829181,1727,-322
ZCTA5 50234,187,83,104,469,50.3,462,0,0,0,230,239
ZCTA5 50235,122,314,-192,304,42.9,263,12,4,0.013157895,748,-444
ZCTA5 50236,783,25,758,1783,45,1733,0,0,0,60,1723
ZCTA5 50237,1352,513,839,3269,44.1,3163,0,3,0.000917712,1492,1777
ZCTA5 50238,515,1475,-960,1400,39.3,1388,0,0,0,3918,-2518
ZCTA5 50239,32,1689,-1657,79,42.1,79,0,0,0,4721,-4642
ZCTA5 50240,894,645,249,2310,45.3,2296,0,3,0.001298701,1495,815
ZCTA5 50241,55,1409,-1354,116,51.8,100,0,2,0.017241379,3440,-3324
ZCTA5 50242,194,2538,-2344,519,35.6,517,1,0,0,8425,-7906
ZCTA5 50243,129,5625,-5496,349,37,344,0,0,0,12867,-12518
ZCTA5 50244,781,567,214,1845,41.9,1719,11,8,0.004336043,1007,838
ZCTA5 50246,294,201,93,732,40.3,710,3,0,0,477,255
ZCTA5 50247,905,3064,-2159,2468,36.5,2205,73,33,0.013371151,7513,-5045
ZCTA5 50248,1759,368,1391,4072,40.4,3896,36,17,0.004174853,895,3177
ZCTA5 50249,524,41,483,1298,51.2,1245,0,33,0.025423729,74,1224
ZCTA5 50250,1018,527,491,2440,43.6,2364,13,0,0,1232,1208
ZCTA5 50251,550,87,463,1432,43.1,1400,3,0,0,189,1243
ZCTA5 50252,114,166,-52,230,56.6,218,0,9,0.039130435,417,-187
ZCTA5 50254,80,992,-912,324,34.8,298,0,0,0,2248,-1924
ZCTA5 50255,40,667,-627,71,60.1,71,0,0,0,1515,-1444
ZCTA5 50256,262,204,58,565,37.5,545,0,0,0,486,79
ZCTA5 50257,392,2159,-1767,1201,40.6,1173,0,8,0.006661116,4392,-3191
ZCTA5 50258,378,473,-95,949,55.5,940,1,0,0,1122,-173
ZCTA5 50261,1007,392,615,2935,41.9,2864,12,11,0.003747871,693,2242
ZCTA5 50262,116,319,-203,238,59.2,234,0,0,0,795,-557
ZCTA5 50263,9513,560,8953,24074,34.3,20640,1110,747,0.031029326,1354,22720
ZCTA5 50264,203,3993,-3790,527,35.4,453,0,0,0,8581,-8054
ZCTA5 50265,14380,78,14302,32540,38.8,27578,1466,1381,0.042440074,162,32378
ZCTA5 50266,16383,269,16114,35088,34,28721,2816,1230,0.03505472,577,34511
ZCTA5 50268,390,122,268,1045,39.2,989,0,17,0.016267943,419,626
ZCTA5 50269,62,180,-118,128,50,112,9,0,0,398,-270
ZCTA5 50271,250,5137,-4887,605,48.8,582,1,0,0,12166,-11561
ZCTA5 50272,54,251,-197,163,29.1,154,0,0,0,742,-579
ZCTA5 50273,3441,150,3291,8407,38.1,8165,0,130,0.015463304,366,8041
ZCTA5 50274,90,255,-165,146,59.8,146,0,0,0,563,-417
ZCTA5 50275,209,369,-160,488,53,460,2,0,0,957,-469
ZCTA5 50276,855,446,409,2402,40.5,2116,0,29,0.012073272,1087,1315
ZCTA5 50277,200,139,61,507,36.3,501,0,0,0,361,146
ZCTA5 50278,308,155,153,716,40,647,7,9,0.012569832,381,335
ZCTA5 50309,6141,3238,2903,9117,30.2,6061,536,1475,0.161785675,9614,-497
ZCTA5 50310,13007,728,12279,31820,35.7,21907,3704,4214,0.132432432,1813,30007
ZCTA5 50311,6386,53,6333,15979,29.7,11471,930,2134,0.133550285,166,15813
ZCTA5 50312,7767,1322,6445,15740,40.1,13197,924,661,0.041994917,2830,12910
ZCTA5 50313,6955,244,6711,18762,37.2,14508,669,1739,0.092687347,505,18257
ZCTA5 50314,3909,97,3812,10816,30.4,4535,1793,3229,0.298539201,175,10641
ZCTA5 50315,14956,262,14694,35698,37.3,28429,1391,2217,0.06210432,662,35036
ZCTA5 50316,5376,897,4479,15991,31.2,10176,1045,2256,0.141079357,1926,14065
ZCTA5 50317,14082,820,13262,36051,35.9,27741,1124,3162,0.087709079,1767,34284
ZCTA5 50319,0,46,-46,0,-,0,0,0,#DIV/0!,101,-101
ZCTA5 50320,8067,326,7741,23252,33.6,16603,3033,1611,0.069284363,696,22556
ZCTA5 50321,3377,587,2790,8561,32.6,6390,179,1323,0.154538021,1534,7027
ZCTA5 50322,12592,976,11616,31736,39.1,26679,1485,2190,0.069006806,2364,29372
ZCTA5 50323,5435,666,4769,16117,35.4,14573,743,236,0.014642924,1623,14494
ZCTA5 50324,2137,46,2091,5208,41.2,4365,306,252,0.048387097,130,5078
ZCTA5 50325,6959,502,6457,18323,37.8,15292,993,724,0.03951318,1144,17179
ZCTA5 50327,4503,407,4096,12303,39.8,10888,390,556,0.04519223,1003,11300
ZCTA5 50401,13410,253,13157,29024,42.3,26484,221,836,0.028803749,639,28385
ZCTA5 50420,146,318,-172,395,36.5,382,0,0,0,789,-394
ZCTA5 50421,1124,396,728,2774,44.9,2580,0,11,0.003965393,923,1851
ZCTA5 50423,1118,321,797,2429,47.9,2259,15,14,0.005763689,668,1761
ZCTA5 50424,714,13996,-13282,1622,54.2,1592,16,0,0,35173,-33551
ZCTA5 50426,46,14286,-14240,96,40.2,85,0,1,0.010416667,36673,-36577
ZCTA5 50427,77,1385,-1308,160,39.8,160,0,0,0,3743,-3583
ZCTA5 50428,4138,73,4065,9117,52.2,8566,295,25,0.00274213,230,8887
ZCTA5 50430,191,823,-632,371,45,364,0,0,0,1831,-1460
ZCTA5 50431,80,151,-71,200,39.8,179,0,0,0,302,-102
ZCTA5 50432,114,435,-321,265,31.5,254,0,5,0.018867925,1042,-777
ZCTA5 50433,81,732,-651,218,35.1,214,0,0,0,1861,-1643
ZCTA5 50434,259,180,79,412,57.3,412,0,0,0,498,-86
ZCTA5 50435,248,347,-99,646,42,577,0,0,0,788,-142
ZCTA5 50436,2196,762,1434,5742,35.9,5213,277,74,0.012887496,1990,3752
ZCTA5 50438,1673,433,1240,4077,45.5,3930,0,104,0.025508953,1162,2915
ZCTA5 50439,125,358,-233,318,38.8,314,0,0,0,828,-510
ZCTA5 50440,174,238,-64,373,39.5,373,0,0,0,657,-284
ZCTA5 50441,2182,387,1795,5284,45.6,5023,0,33,0.006245269,930,4354
ZCTA5 50444,136,3178,-3042,325,49.3,324,0,0,0,9319,-8994
ZCTA5 50446,215,780,-565,517,45.5,500,6,0,0,1616,-1099
ZCTA5 50447,526,189,337,1290,34.8,1218,5,0,0,387,903
ZCTA5 50448,336,2851,-2515,632,57.5,604,0,18,0.028481013,6746,-6114
ZCTA5 50449,352,221,131,865,33,851,0,4,0.004624277,528,337
ZCTA5 50450,1233,131,1102,2968,42,2845,6,8,0.002695418,322,2646
ZCTA5 50451,187,349,-162,399,42.3,376,1,0,0,972,-573
ZCTA5 50452,391,176,215,944,40.4,761,0,24,0.025423729,423,521
ZCTA5 50453,220,382,-162,580,53,545,0,4,0.006896552,1018,-438
ZCTA5 50454,40,187,-147,65,58.6,65,0,0,0,425,-360
ZCTA5 50455,142,1000,-858,405,35.9,405,0,0,0,2778,-2373
ZCTA5 50456,702,139,563,1762,40.7,1605,10,10,0.005675369,311,1451
ZCTA5 50457,152,193,-41,459,35.7,374,0,0,0,364,95
ZCTA5 50458,886,68,818,2349,41.4,2238,0,27,0.011494253,173,2176
ZCTA5 50459,1277,664,613,3156,42.6,3022,22,21,0.006653992,1758,1398
ZCTA5 50460,177,89,88,602,26.2,602,0,0,0,223,379
ZCTA5 50461,2304,388,1916,5166,46.3,5025,73,47,0.009097948,1167,3999
ZCTA5 50464,213,95,118,588,39.3,559,1,10,0.017006803,204,384
ZCTA5 50465,78,2113,-2035,183,39.8,183,0,0,0,5209,-5026
ZCTA5 50466,776,179,597,2108,34.1,2021,0,0,0,484,1624
ZCTA5 50467,49,386,-337,130,39.3,130,0,0,0,925,-795
ZCTA5 50468,575,288,287,1405,44.5,1359,2,8,0.00569395,665,740
ZCTA5 50469,590,700,-110,1479,41.2,1458,0,0,0,1774,-295
ZCTA5 50470,95,827,-732,223,39.9,211,4,0,0,2121,-1898
ZCTA5 50471,274,495,-221,711,37.7,691,6,0,0,1276,-565
ZCTA5 50472,1037,173,864,2431,44.5,2341,14,0,0,414,2017
ZCTA5 50473,104,249,-145,211,49.8,211,0,0,0,576,-365
ZCTA5 50475,523,209,314,1368,41.3,1241,0,0,0,437,931
ZCTA5 50476,304,233,71,721,38.3,716,2,2,0.002773925,513,208
ZCTA5 50477,95,3059,-2964,243,50.3,243,0,0,0,6961,-6718
ZCTA5 50478,414,337,77,709,60.2,707,0,0,0,838,-129
ZCTA5 50479,282,286,-4,697,30,661,2,0,0,765,-68
ZCTA5 50480,321,156,165,823,46.1,803,0,0,0,328,495
ZCTA5 50482,317,446,-129,748,52.3,730,0,0,0,1121,-373
ZCTA5 50483,288,591,-303,778,42,760,1,0,0,1570,-792
ZCTA5 50484,153,708,-555,363,42.9,341,0,0,0,1987,-1624
ZCTA5 50501,12008,544,11464,28533,38.1,24678,482,1539,0.053937546,1308,27225
ZCTA5 50510,413,29,384,981,49.7,934,0,4,0.004077472,79,902
ZCTA5 50511,3250,1020,2230,7137,48.1,6825,67,38,0.005324366,2356,4781
ZCTA5 50514,557,2633,-2076,1194,52.5,1183,0,6,0.005025126,6007,-4813
ZCTA5 50515,117,73,44,243,43.1,228,0,0,0,152,91
ZCTA5 50516,321,123,198,740,43.1,734,4,0,0,266,474
ZCTA5 50517,429,2580,-2151,940,44.5,896,4,17,0.018085106,7145,-6205
ZCTA5 50518,138,203,-65,370,27.9,367,0,0,0,451,-81
ZCTA5 50519,261,93,168,607,43.4,570,0,0,0,250,357
ZCTA5 50520,63,589,-526,144,54.1,119,0,6,0.041666667,1369,-1225
ZCTA5 50521,14,443,-429,14,-,10,0,0,0,981,-967
ZCTA5 50522,353,721,-368,998,34.9,947,2,0,0,1687,-689
ZCTA5 50523,222,115,107,566,36.7,529,0,0,0,253,313
ZCTA5 50524,232,383,-151,636,35.4,633,0,0,0,867,-231
ZCTA5 50525,1563,44,1519,3452,47.2,3149,15,2,0.000579374,197,3255
ZCTA5 50527,52,88,-36,127,59.3,127,0,0,0,148,-21
ZCTA5 50528,119,139,-20,306,30.8,279,0,0,0,337,-31
ZCTA5 50529,367,145,222,929,38.5,847,0,2,0.002152853,380,549
ZCTA5 50530,511,640,-129,1246,44.6,1228,0,0,0,1621,-375
ZCTA5 50531,103,581,-478,207,63.1,207,0,0,0,1597,-1390
ZCTA5 50532,336,205,131,845,42.1,772,0,3,0.003550296,446,399
ZCTA5 50533,1581,29,1552,4059,38,3540,0,0,0,74,3985
ZCTA5 50535,474,17729,-17255,1135,45.3,1058,0,63,0.055506608,43560,-42425
ZCTA5 50536,1868,5771,-3903,4410,44.1,4303,34,3,0.000680272,14569,-10159
ZCTA5 50538,226,5425,-5199,540,38.7,473,0,56,0.103703704,13560,-13020
ZCTA5 50539,186,159,27,427,45.4,413,0,6,0.014051522,430,-3
ZCTA5 50540,429,2236,-1807,1178,39.2,997,0,6,0.005093379,5490,-4312
ZCTA5 50541,402,642,-240,931,38.9,890,0,3,0.003222342,1445,-514
ZCTA5 50542,386,1183,-797,940,45.7,915,0,0,0,2950,-2010
ZCTA5 50543,548,417,131,1260,48.3,1151,9,58,0.046031746,996,264
ZCTA5 50544,215,510,-295,551,27.5,539,0,0,0,1309,-758
ZCTA5 50545,75,177,-102,173,56.5,172,0,0,0,456,-283
ZCTA5 50546,171,343,-172,305,53.3,305,0,0,0,808,-503
ZCTA5 50548,2490,2212,278,5612,42.5,5398,84,3,0.000534569,5535,77
ZCTA5 50551,20,552,-532,35,45.9,35,0,0,0,1518,-1483
ZCTA5 50552,29,681,-652,74,42.5,74,0,0,0,1791,-1717
ZCTA5 50554,771,1012,-241,1695,44.6,1648,7,14,0.008259587,2275,-580
ZCTA5 50556,84,121,-37,150,62.7,141,6,0,0,301,-151
ZCTA5 50557,376,921,-545,820,47,815,4,0,0,2537,-1717
ZCTA5 50558,228,802,-574,706,32.3,700,0,4,0.005665722,2385,-1679
ZCTA5 50559,136,212,-76,260,65.8,251,0,8,0.030769231,537,-277
ZCTA5 50560,231,120,111,512,46.7,484,0,0,0,249,263
ZCTA5 50561,221,570,-349,591,35.8,578,0,11,0.018612521,1394,-803
ZCTA5 50562,167,222,-55,353,57.6,334,0,9,0.025495751,613,-260
ZCTA5 50563,1148,1290,-142,2648,41.9,2558,11,8,0.003021148,3003,-355
ZCTA5 50565,159,330,-171,359,44.3,344,0,0,0,886,-527
ZCTA5 50566,185,363,-178,437,49,428,0,2,0.004576659,830,-393
ZCTA5 50567,106,3295,-3189,225,57.9,217,6,0,0,7973,-7748
ZCTA5 50568,539,3660,-3121,1579,34.6,1474,2,0,0,8622,-7043
ZCTA5 50569,348,348,0,710,53.9,676,0,1,0.001408451,824,-114
ZCTA5 50570,74,444,-370,205,43.5,203,0,0,0,1071,-866
ZCTA5 50571,146,42,104,253,53.6,232,0,0,0,72,181
ZCTA5 50573,25,1412,-1387,88,18.1,88,0,0,0,4011,-3923
ZCTA5 50574,986,645,341,2097,54.3,2002,33,3,0.001430615,1624,473
ZCTA5 50575,303,465,-162,694,57.8,668,0,0,0,1013,-319
ZCTA5 50576,129,151,-22,273,55.6,242,0,2,0.007326007,301,-28
ZCTA5 50577,183,495,-312,330,53.3,297,0,2,0.006060606,1538,-1208
ZCTA5 50578,243,163,80,577,41.3,563,0,2,0.003466205,364,213
ZCTA5 50579,1028,1001,27,2993,39.5,2798,16,92,0.03073839,2479,514
ZCTA5 50581,333,151,182,921,37.3,917,0,0,0,412,509
ZCTA5 50582,105,430,-325,220,47.5,220,0,0,0,1047,-827
ZCTA5 50583,1161,316,845,2399,48.1,2286,50,1,0.00041684,657,1742
ZCTA5 50585,489,5076,-4587,1210,42.8,1136,6,0,0,13816,-12606
ZCTA5 50586,116,780,-664,328,39.8,291,1,0,0,1822,-1494
ZCTA5 50588,4628,216,4412,13258,31.8,8347,1781,471,0.03552572,575,12683
ZCTA5 50590,377,139,238,933,36.4,789,0,0,0,403,530
ZCTA5 50591,168,372,-204,405,43.5,371,1,0,0,975,-570
ZCTA5 50592,53,2455,-2402,162,10.5,71,91,0,0,5784,-5622
ZCTA5 50593,17,277,-260,27,55.3,27,0,0,0,518,-491
ZCTA5 50594,133,588,-455,203,49.8,174,0,0,0,1456,-1253
ZCTA5 50595,3637,526,3111,9018,41.9,8063,378,191,0.021179862,1695,7323
ZCTA5 50597,446,484,-38,1229,37.1,1164,0,0,0,1265,-36
ZCTA5 50598,370,463,-93,935,35,922,0,0,0,958,-23
ZCTA5 50599,224,431,-207,456,48.7,413,0,19,0.041666667,1001,-545
ZCTA5 50601,1028,899,129,2521,41.9,2371,20,0,0,1977,544
ZCTA5 50602,662,372,290,1583,43.5,1565,0,3,0.001895136,754,829
ZCTA5 50603,171,511,-340,337,59.7,337,0,0,0,1094,-757
ZCTA5 50604,669,329,340,1550,42,1537,0,3,0.001935484,782,768
ZCTA5 50605,112,753,-641,247,59.5,247,0,0,0,1790,-1543
ZCTA5 50606,315,155,160,823,38.1,801,2,0,0,275,548
ZCTA5 50607,162,1090,-928,427,36.7,417,0,0,0,2584,-2157
ZCTA5 50608,28,353,-325,43,69.8,43,0,0,0,910,-867
ZCTA5 50609,160,590,-430,365,46,335,0,0,0,1569,-1204
ZCTA5 50611,172,1235,-1063,347,44,347,0,0,0,3419,-3072
ZCTA5 50612,156,163,-7,338,48.2,329,0,0,0,306,32
ZCTA5 50613,16415,63,16352,43708,28.7,40085,1828,553,0.012652146,169,43539
ZCTA5 50616,4306,403,3903,9692,44.3,8705,180,201,0.020738754,926,8766
ZCTA5 50619,825,44,781,2133,42.7,2004,11,10,0.004688233,83,2050
ZCTA5 50620,27,68,-41,53,41.4,53,0,0,0,158,-105
ZCTA5 50621,639,194,445,1558,51.2,1430,0,45,0.028883184,509,1049
ZCTA5 50622,1190,278,912,3120,37,3053,9,0,0,659,2461
ZCTA5 50623,66,438,-372,123,61.1,119,0,0,0,1027,-904
ZCTA5 50624,639,2531,-1892,1544,41.3,1475,15,16,0.010362694,6273,-4729
ZCTA5 50625,378,1552,-1174,941,42.5,866,0,1,0.001062699,3718,-2777
ZCTA5 50626,600,446,154,1619,40.8,1595,0,2,0.00123533,1178,441
ZCTA5 50627,1274,381,893,3285,41.8,2807,87,116,0.035312024,1006,2279
ZCTA5 50628,514,790,-276,1176,44.8,1176,0,0,0,1957,-781
ZCTA5 50629,873,2992,-2119,2855,31.8,2675,0,0,0,8595,-5740
ZCTA5 50630,690,824,-134,1532,44.8,1428,2,0,0,2383,-851
ZCTA5 50631,114,196,-82,238,38.3,238,0,0,0,433,-195
ZCTA5 50632,548,1393,-845,1312,48.1,1289,0,6,0.004573171,3051,-1739
ZCTA5 50633,218,440,-222,453,49.2,424,0,0,0,1059,-606
ZCTA5 50634,337,297,40,790,43.7,779,0,4,0.005063291,800,-10
ZCTA5 50635,570,1145,-575,1294,51.3,1273,10,0,0,2714,-1420
ZCTA5 50636,944,102,842,1985,57.9,1841,65,30,0.01511335,246,1739
ZCTA5 50638,1326,1612,-286,3444,39.3,3372,24,0,0,4332,-888
ZCTA5 50641,445,1227,-782,1020,49,935,4,7,0.006862745,2981,-1961
ZCTA5 50642,235,296,-61,553,43.3,549,0,0,0,832,-279
ZCTA5 50643,1091,566,525,3058,40.9,2943,6,33,0.010791367,1430,1628
ZCTA5 50644,3516,205,3311,8646,42.5,8319,0,111,0.012838307,512,8134
ZCTA5 50645,579,751,-172,1253,56.2,1237,1,14,0.011173184,1921,-668
ZCTA5 50647,814,68,746,2090,41.5,2031,0,13,0.006220096,186,1904
ZCTA5 50648,1418,94,1324,4004,35.3,3922,0,0,0,248,3756
ZCTA5 50649,4,75,-71,8,-,8,0,0,0,196,-188
ZCTA5 50650,313,283,30,846,29.9,786,3,3,0.003546099,644,202
ZCTA5 50651,1357,620,737,3532,37.7,3355,0,26,0.007361268,1583,1949
ZCTA5 50652,47,841,-794,112,54.7,112,0,0,0,2411,-2299
ZCTA5 50653,243,141,102,556,45.9,541,0,0,0,335,221
ZCTA5 50654,147,888,-741,405,43,400,0,0,0,2556,-2151
ZCTA5 50655,325,1021,-696,759,41.4,735,0,0,0,2669,-1910
ZCTA5 50657,40,305,-265,106,44.5,104,2,0,0,776,-670
ZCTA5 50658,1031,114,917,2433,43.1,2312,44,14,0.005754213,253,2180
ZCTA5 50659,2347,97,2250,5951,41.7,5831,0,49,0.00823391,143,5808
ZCTA5 50660,453,3279,-2826,1216,39.9,1162,4,4,0.003289474,7046,-5830
ZCTA5 50662,2840,287,2553,6685,45,6320,0,88,0.0131638,824,5861
ZCTA5 50664,83,232,-149,127,55.7,126,0,0,0,619,-492
ZCTA5 50665,1095,521,574,2748,43.9,2705,30,1,0.000363901,1405,1343
ZCTA5 50666,310,13622,-13312,724,48.7,706,0,0,0,32052,-31328
ZCTA5 50667,320,7740,-7420,806,45.3,797,0,0,0,18931,-18125
ZCTA5 50668,429,0,429,1137,41,1108,5,0,0,1735,-598
ZCTA5 50669,971,8516,-7545,2286,45.6,2270,0,0,0,22786,-20500
ZCTA5 50670,907,9123,-8216,2440,41,2391,7,25,0.010245902,21453,-19013
ZCTA5 50671,112,1956,-1844,208,41.3,203,0,0,0,5273,-5065
ZCTA5 50672,207,722,-515,469,48.8,447,0,4,0.008528785,1892,-1423
ZCTA5 50673,74,384,-310,215,41.1,209,0,0,0,993,-778
ZCTA5 50674,1519,204,1315,3663,45.3,3582,7,15,0.004095004,513,3150
ZCTA5 50675,909,1149,-240,2405,37.5,2100,0,0,0,2853,-448
ZCTA5 50676,902,300,602,2170,39.9,2070,11,0,0,724,1446
ZCTA5 50677,4636,487,4149,12497,36.8,11523,207,212,0.016964071,1009,11488
ZCTA5 50680,451,71,380,1060,47.2,1030,2,8,0.00754717,158,902
ZCTA5 50681,177,1663,-1486,422,48.1,398,11,11,0.026066351,3936,-3514
ZCTA5 50682,621,14895,-14274,1640,43.2,1626,0,4,0.002439024,37247,-35607
ZCTA5 50701,13026,264,12762,30194,38.2,24328,701,3463,0.114691661,596,29598
ZCTA5 50702,8642,730,7912,20270,36.6,15831,869,2382,0.117513567,1864,18406
ZCTA5 50703,7910,26,7884,19270,36.6,11428,126,5514,0.286144266,65,19205
ZCTA5 50707,3531,66,3465,7597,42.7,6306,14,577,0.075951033,138,7459
ZCTA5 50801,3782,201,3581,9135,39.4,8755,83,37,0.004050356,416,8719
ZCTA5 50830,649,2778,-2129,1775,40,1651,0,16,0.009014085,6475,-4700
ZCTA5 50831,10,44,-34,24,60,24,0,0,0,114,-90
ZCTA5 50833,855,167,688,2077,42.4,1998,0,1,0.000481464,355,1722
ZCTA5 50835,38,1999,-1961,70,45.6,70,0,0,0,6163,-6093
ZCTA5 50836,186,400,-214,356,50.9,355,0,0,0,947,-591
ZCTA5 50837,158,626,-468,370,41.5,370,0,0,0,1553,-1183
ZCTA5 50839,25,6467,-6442,51,65.9,51,0,0,0,14688,-14637
ZCTA5 50840,268,473,-205,594,53,591,0,0,0,1180,-586
ZCTA5 50841,1055,547,508,2447,45.5,2340,0,5,0.002043318,1215,1232
ZCTA5 50842,32,220,-188,62,64.5,59,2,0,0,531,-469
ZCTA5 50843,196,1013,-817,439,38.8,418,0,0,0,2549,-2110
ZCTA5 50845,271,475,-204,841,44.6,774,0,0,0,1221,-380
ZCTA5 50846,472,599,-127,1061,38.6,1033,7,0,0,1757,-696
ZCTA5 50847,36,326,-290,58,51.5,58,0,0,0,919,-861
ZCTA5 50848,95,218,-123,227,44,227,0,0,0,487,-260
ZCTA5 50849,1124,1336,-212,2404,47.5,2361,0,25,0.010399334,3841,-1437
ZCTA5 50851,826,865,-39,2187,40.5,1823,0,0,0,2646,-459
ZCTA5 50853,315,294,21,739,42.3,713,5,0,0,764,-25
ZCTA5 50854,953,348,605,2357,43,2237,6,4,0.001697073,871,1486
ZCTA5 50857,88,796,-708,165,60.2,164,0,0,0,1910,-1745
ZCTA5 50858,324,2422,-2098,756,53.1,731,0,0,0,6516,-5760
ZCTA5 50859,275,79,196,696,47.5,679,0,0,0,204,492
ZCTA5 50860,53,304,-251,119,58.1,119,0,0,0,595,-476
ZCTA5 50861,121,895,-774,280,49.7,280,0,0,0,2317,-2037
ZCTA5 50862,62,389,-327,192,45.2,189,0,0,0,1028,-836
ZCTA5 50863,72,1182,-1110,186,54,186,0,0,0,3138,-2952
ZCTA5 50864,838,1627,-789,1875,44.9,1730,0,0,0,4560,-2685
ZCTA5 51001,945,919,26,2254,41.3,2134,0,2,0.000887311,2140,114
ZCTA5 51002,1008,444,564,2799,35.8,2320,251,52,0.018578064,1338,1461
ZCTA5 51003,665,1236,-571,1732,37.9,1647,17,6,0.003464203,2940,-1208
ZCTA5 51004,450,547,-97,961,39.3,889,0,0,0,1437,-476
ZCTA5 51005,669,426,243,1481,51.7,1312,0,0,0,982,499
ZCTA5 51006,474,688,-214,1173,44.5,1163,4,0,0,1562,-389
ZCTA5 51007,231,17,214,557,48.9,549,0,0,0,47,510
ZCTA5 51008,68,3028,-2960,179,26.8,139,1,0,0,7731,-7552
ZCTA5 51009,63,503,-440,175,26.3,172,0,0,0,1673,-1498
ZCTA5 51010,205,643,-438,431,57.6,431,0,0,0,1794,-1363
ZCTA5 51011,28,3787,-3759,54,56.5,54,0,0,0,8858,-8804
ZCTA5 51012,2747,106,2641,6613,42.3,6251,48,44,0.006653561,326,6287
ZCTA5 51014,254,124,130,491,55.8,470,0,1,0.00203666,267,224
ZCTA5 51015,32,1105,-1073,69,62.1,69,0,0,0,2815,-2746
ZCTA5 51016,476,1436,-960,1268,39.6,1090,7,0,0,3622,-2354
ZCTA5 51018,252,131,121,602,39.1,567,0,0,0,284,318
ZCTA5 51019,224,1845,-1621,561,40.1,547,0,0,0,4446,-3885
ZCTA5 51020,228,343,-115,543,30.7,503,0,1,0.001841621,682,-139
ZCTA5 51022,319,938,-619,818,52.9,809,0,0,0,2021,-1203
ZCTA5 51023,1209,16589,-15380,3264,36.9,2586,0,3,0.000919118,39847,-36583
ZCTA5 51024,883,9608,-8725,2170,44.8,2109,3,7,0.003225806,22487,-20317
ZCTA5 51025,784,15715,-14931,1886,37.4,1723,2,96,0.050901379,38614,-36728
ZCTA5 51026,366,10369,-10003,900,56.3,876,0,0,0,24420,-23520
ZCTA5 51027,471,2383,-1912,1504,35.1,1466,0,0,0,7394,-5890
ZCTA5 51028,881,12222,-11341,2124,38.1,2005,4,49,0.02306968,29729,-27605
ZCTA5 51029,162,463,-301,310,58.2,306,0,0,0,1068,-758
ZCTA5 51030,624,2472,-1848,1640,46.5,1622,7,0,0,5978,-4338
ZCTA5 51031,5022,557,4465,12418,39.4,11437,49,360,0.028990176,1474,10944
ZCTA5 51033,205,92,113,432,52.3,377,0,0,0,184,248
ZCTA5 51034,731,394,337,1678,47.2,1637,0,0,0,769,909
ZCTA5 51035,712,349,363,1481,53.9,1313,0,118,0.079675895,818,663
ZCTA5 51036,287,2400,-2113,748,51.4,724,0,0,0,6576,-5828
ZCTA5 51037,111,569,-458,273,46.4,270,0,0,0,1441,-1168
ZCTA5 51038,679,162,517,1957,36.6,1830,20,12,0.006131834,340,1617
ZCTA5 51039,1090,171,919,2755,41.5,2634,18,31,0.011252269,518,2237
ZCTA5 51040,1459,3217,-1758,3450,38.6,3307,0,2,0.00057971,7641,-4191
ZCTA5 51041,2390,36,2354,6988,32.7,6654,6,80,0.011448197,91,6897
ZCTA5 51044,103,241,-138,232,71.3,229,0,0,0,556,-324
ZCTA5 51045,32,243,-211,85,33.2,85,0,0,0,603,-518
ZCTA5 51046,656,270,386,1448,48.6,1413,9,11,0.007596685,625,823
ZCTA5 51047,310,331,-21,741,47.5,714,0,2,0.002699055,1030,-289
ZCTA5 51048,185,673,-488,509,33.8,478,0,0,0,1580,-1071
ZCTA5 51049,271,616,-345,545,42.9,516,0,0,0,1683,-1138
ZCTA5 51050,1037,158,879,2872,41,2736,0,6,0.002089136,388,2484
ZCTA5 51051,26,5223,-5197,68,39.5,42,0,0,0,12679,-12611
ZCTA5 51052,471,0,471,1004,47.2,992,4,0,0,78,926
ZCTA5 51053,434,192,242,984,43.3,948,0,0,0,446,538
ZCTA5 51054,1924,357,1567,5416,36.4,5115,46,7,0.001292467,968,4448
ZCTA5 51055,526,776,-250,1482,38.1,1342,0,0,0,1760,-278
ZCTA5 51056,170,779,-609,349,59.9,349,0,0,0,2057,-1708
ZCTA5 51058,446,91,355,1058,44.7,971,1,0,0,155,903
ZCTA5 51060,290,281,9,526,52,526,0,0,0,639,-113
ZCTA5 51061,146,281,-135,309,43.1,299,0,0,0,549,-240
ZCTA5 51062,235,337,-102,389,61.2,383,0,0,0,1034,-645
ZCTA5 51063,450,702,-252,1110,52.4,976,0,16,0.014414414,1552,-442
ZCTA5 51101,338,498,-160,649,38.3,469,41,70,0.107858243,1287,-638
ZCTA5 51103,6448,42,6406,17176,34.9,11631,758,625,0.036387983,84,17092
ZCTA5 51104,8418,351,8067,23038,34.5,17996,1066,1252,0.054344995,816,22222
ZCTA5 51105,3886,211,3675,10902,30.2,6496,241,1139,0.104476243,449,10453
ZCTA5 51106,10762,6116,4646,27491,37.3,23507,356,933,0.03393838,14946,12545
ZCTA5 51108,2017,200,1817,5431,41.7,4771,26,60,0.011047689,456,4975
ZCTA5 51109,1422,223,1199,3453,36.5,3013,13,37,0.01071532,492,2961
ZCTA5 51111,30,160,-130,80,36.1,80,0,0,0,370,-290
ZCTA5 51201,2379,199,2180,6139,39.6,5416,62,132,0.021501873,701,5438
ZCTA5 51230,194,352,-158,530,46.8,526,0,0,0,944,-414
ZCTA5 51231,209,182,27,659,30.7,659,0,0,0,429,230
ZCTA5 51232,343,42,301,790,47.5,772,0,0,0,131,659
ZCTA5 51234,442,461,-19,1215,37.8,1125,16,2,0.001646091,1239,-24
ZCTA5 51235,367,1318,-951,1126,29.8,1089,0,0,0,3011,-1885
ZCTA5 51237,723,71,652,1727,49.3,1671,0,0,0,209,1518
ZCTA5 51238,519,183,336,1383,33.3,1358,0,0,0,442,941
ZCTA5 51239,1056,193,863,3198,34.4,2854,0,3,0.000938086,541,2657
ZCTA5 51240,696,12499,-11803,1837,32.8,1778,27,0,0,29837,-28000
ZCTA5 51241,787,222,565,2085,37.8,2012,15,7,0.003357314,559,1526
ZCTA5 51242,114,341,-227,306,38.9,284,0,0,0,814,-508
ZCTA5 51243,259,261,-2,659,37.9,594,4,3,0.004552352,597,62
ZCTA5 51244,62,776,-714,159,47.8,152,0,1,0.006289308,1999,-1840
ZCTA5 51245,463,78,385,1217,40.2,1135,19,48,0.039441249,160,1057
ZCTA5 51246,1275,1055,220,3883,36.7,3703,26,7,0.00180273,2874,1009
ZCTA5 51247,1800,606,1194,4898,38.8,4093,0,4,0.00081666,1499,3399
ZCTA5 51248,683,5241,-4558,1636,43,1598,2,15,0.009168704,13062,-11426
ZCTA5 51249,1408,239,1169,3344,42.9,3085,46,29,0.008672249,642,2702
ZCTA5 51250,3095,5177,-2082,9627,30.4,9137,121,50,0.005193726,12943,-3316
ZCTA5 51301,5418,370,5048,12326,40.9,11627,81,13,0.001054681,905,11421
ZCTA5 51331,580,1121,-541,1001,60.5,988,6,0,0,2532,-1531
ZCTA5 51333,171,158,13,418,49.4,389,0,0,0,429,-11
ZCTA5 51334,2823,852,1971,7038,42.1,6174,4,210,0.029838022,2257,4781
ZCTA5 51338,394,636,-242,906,41.4,885,6,0,0,1681,-775
ZCTA5 51340,44,4469,-4425,89,54.6,83,0,1,0.011235955,12095,-12006
ZCTA5 51341,17,151,-134,39,61.8,39,0,0,0,463,-424
ZCTA5 51342,563,1208,-645,1392,40.8,1175,0,120,0.086206897,2891,-1499
ZCTA5 51343,75,127,-52,263,29.9,252,0,0,0,325,-62
ZCTA5 51345,212,87,125,460,40.5,389,2,2,0.004347826,226,234
ZCTA5 51346,841,400,441,2124,40,1966,0,37,0.017419962,1036,1088
ZCTA5 51347,653,339,314,1587,41.7,1573,3,0,0,807,780
ZCTA5 51350,188,314,-126,417,42,416,0,0,0,797,-380
ZCTA5 51351,2038,1401,637,4823,44.9,4675,0,0,0,3588,1235
ZCTA5 51354,515,683,-168,1150,51.3,1052,14,6,0.005217391,1779,-629
ZCTA5 51355,461,1882,-1421,905,57.2,841,21,1,0.001104972,4314,-3409
ZCTA5 51357,314,990,-676,751,36.8,740,0,5,0.00665779,2382,-1631
ZCTA5 51358,562,23,539,1342,43.5,1237,7,0,0,54,1288
ZCTA5 51360,3991,344,3647,8271,50.1,7731,123,11,0.001329948,810,7461
ZCTA5 51363,69,586,-517,188,40.4,187,0,0,0,1701,-1513
ZCTA5 51364,315,61,254,775,40.6,747,0,4,0.00516129,151,624
ZCTA5 51365,159,44,115,462,38.2,416,0,16,0.034632035,120,342
ZCTA5 51366,137,421,-284,323,49.3,323,0,0,0,1203,-880
ZCTA5 51401,5285,326,4959,12275,43.4,11598,57,50,0.00407332,849,11426
ZCTA5 51430,407,13893,-13486,1399,22.9,1231,0,0,0,35022,-33623
ZCTA5 51431,211,1637,-1426,467,40.5,414,0,0,0,4337,-3870
ZCTA5 51432,13,172,-159,26,70,25,0,0,0,556,-530
ZCTA5 51433,215,377,-162,606,35.4,603,0,0,0,864,-258
ZCTA5 51436,378,338,40,866,34.6,866,0,0,0,829,37
ZCTA5 51439,350,2043,-1693,840,46.6,816,10,0,0,4940,-4100
ZCTA5 51440,106,276,-170,283,35.1,281,0,0,0,726,-443
ZCTA5 51441,145,11788,-11643,433,31.7,329,0,0,0,28613,-28180
ZCTA5 51442,3323,130,3193,9373,34.2,6489,359,551,0.058785874,279,9094
ZCTA5 51443,550,1304,-754,1329,46.8,1222,33,0,0,3713,-2384
ZCTA5 51444,143,252,-109,356,30.5,343,0,0,0,785,-429
ZCTA5 51445,1143,2999,-1856,2661,43.3,2626,0,1,0.000375799,7537,-4876
ZCTA5 51446,232,248,-16,554,46.5,551,0,0,0,607,-53
ZCTA5 51447,86,408,-322,222,58.8,221,0,0,0,942,-720
ZCTA5 51448,236,899,-663,607,53.5,597,0,2,0.003294893,2099,-1492
ZCTA5 51449,804,3387,-2583,1996,49.9,1925,8,2,0.001002004,8967,-6971
ZCTA5 51450,676,396,280,1536,54.6,1520,0,0,0,1316,220
ZCTA5 51451,38,185,-147,72,60.8,72,0,0,0,493,-421
ZCTA5 51452,76,368,-292,171,43.5,159,0,7,0.040935673,893,-722
ZCTA5 51453,231,165,66,503,49.8,472,4,0,0,477,26
ZCTA5 51454,472,2151,-1679,1373,37.5,1299,0,7,0.005098325,5340,-3967
ZCTA5 51455,1025,485,540,2259,41.7,2076,47,2,0.000885347,1334,925
ZCTA5 51458,496,760,-264,1194,47,1159,9,0,0,1963,-769
ZCTA5 51459,31,791,-760,81,27.8,76,0,0,0,2106,-2025
ZCTA5 51460,47,82,-35,99,37.7,98,0,0,0,183,-84
ZCTA5 51461,537,96,441,1256,37.5,1067,11,19,0.015127389,231,1025
ZCTA5 51462,429,159,270,987,43.8,943,0,0,0,361,626
ZCTA5 51463,226,12188,-11962,453,57.4,449,0,0,0,30635,-30182
ZCTA5 51465,288,133,155,844,39.8,757,0,2,0.002369668,346,498
ZCTA5 51466,438,368,70,1214,43.2,1202,0,0,0,851,363
ZCTA5 51467,237,87,150,531,53.8,508,0,0,0,177,354
ZCTA5 51501,14122,539,13583,35051,38.3,30919,386,614,0.017517332,1184,33867
ZCTA5 51503,14845,337,14508,37408,41.1,34799,185,675,0.018044269,836,36572
ZCTA5 51510,1357,2118,-761,3796,38,3074,37,14,0.003688093,5070,-1274
ZCTA5 51520,83,956,-873,225,57.6,207,0,11,0.048888889,2317,-2092
ZCTA5 51521,819,40,779,1741,41.8,1701,0,0,0,107,1634
ZCTA5 51523,156,1465,-1309,402,43,397,0,2,0.004975124,4431,-4029
ZCTA5 51525,479,566,-87,1082,43.4,1052,0,0,0,1472,-390
ZCTA5 51526,678,1601,-923,1749,48.1,1744,0,0,0,3951,-2202
ZCTA5 51527,231,635,-404,618,42,607,0,0,0,1130,-512
ZCTA5 51528,300,3960,-3660,681,47.1,609,0,0,0,10102,-9421
ZCTA5 51529,784,9502,-8718,1789,49.3,1769,3,10,0.005589715,23291,-21502
ZCTA5 51530,251,10806,-10555,529,57.1,512,0,4,0.007561437,27300,-26771
ZCTA5 51531,282,11090,-10808,706,47.9,674,0,0,0,27622,-26916
ZCTA5 51532,261,6203,-5942,699,34.5,697,0,0,0,13366,-12667
ZCTA5 51533,418,743,-325,964,50.3,949,3,0,0,1820,-856
ZCTA5 51534,3348,886,2462,9246,42,8873,32,14,0.001514168,2281,6965
ZCTA5 51535,726,83,643,1721,47.6,1625,0,0,0,160,1561
ZCTA5 51536,174,1254,-1080,389,50.5,374,0,0,0,3303,-2914
ZCTA5 51537,2865,7525,-4660,6738,43.3,6340,0,121,0.017957851,19749,-13011
ZCTA5 51540,121,741,-620,306,61.3,287,5,0,0,1896,-1590
ZCTA5 51541,137,878,-741,440,31.8,432,0,0,0,1816,-1376
ZCTA5 51542,374,3081,-2707,985,53,963,0,0,0,7866,-6881
ZCTA5 51543,181,890,-709,410,54.9,407,0,0,0,2121,-1711
ZCTA5 51544,285,7189,-6904,681,45.3,667,0,0,0,18478,-17797
ZCTA5 51545,123,1324,-1201,296,43.5,276,0,14,0.047297297,3321,-3025
ZCTA5 51546,1215,3223,-2008,3239,38.9,3119,0,5,0.001543686,8187,-4948
ZCTA5 51548,183,982,-799,503,40.1,499,0,0,0,2630,-2127
ZCTA5 51549,217,153,64,593,30.9,494,0,0,0,390,203
ZCTA5 51550,55,2051,-1996,123,52.8,118,0,0,0,5440,-5317
ZCTA5 51551,635,2867,-2232,1648,44.5,1617,0,3,0.001820388,7784,-6136
ZCTA5 51552,127,719,-592,271,55.6,271,0,0,0,1840,-1569
ZCTA5 51553,381,1462,-1081,1119,34.8,1086,14,0,0,3406,-2287
ZCTA5 51554,48,1748,-1700,168,50.5,168,0,0,0,4770,-4602
ZCTA5 51555,1899,7551,-5652,4697,43.1,4482,0,0,0,19041,-14344
ZCTA5 51556,194,439,-245,417,50,409,4,0,0,2341,-1924
ZCTA5 51557,379,6800,-6421,866,43.9,853,0,0,0,16930,-16064
ZCTA5 51558,234,8743,-8509,651,51.6,608,0,0,0,22119,-21468
ZCTA5 51559,720,7692,-6972,2037,37.2,1975,0,13,0.006381934,20889,-18852
ZCTA5 51560,760,20,740,2135,37,1845,8,2,0.000936768,78,2057
ZCTA5 51561,321,1899,-1578,1007,43.4,990,6,0,0,4616,-3609
ZCTA5 51562,188,1928,-1740,532,38.5,527,0,0,0,4776,-4244
ZCTA5 51563,276,775,-499,726,46.3,716,0,0,0,1945,-1219
ZCTA5 51564,199,888,-689,457,40.3,453,0,0,0,2353,-1896
ZCTA5 51565,249,915,-666,525,49.5,505,0,0,0,2400,-1875
ZCTA5 51566,2894,3648,-754,6707,42.9,6272,34,0,0,9098,-2391
ZCTA5 51570,419,1437,-1018,931,42.5,915,0,0,0,3917,-2986
ZCTA5 51571,210,1864,-1654,699,30.8,667,0,31,0.04434907,5006,-4307
ZCTA5 51572,221,3134,-2913,478,35.2,469,0,0,0,8401,-7923
ZCTA5 51573,391,2976,-2585,1097,47.1,1058,0,5,0.004557885,7197,-6100
ZCTA5 51575,590,918,-328,1485,46.2,1469,0,0,0,2495,-1010
ZCTA5 51576,698,8380,-7682,2036,36.1,1852,0,23,0.01129666,21428,-19392
ZCTA5 51577,459,529,-70,932,52.2,919,0,11,0.011802575,1147,-215
ZCTA5 51578,62,35,27,163,47.6,163,0,0,0,109,54
ZCTA5 51579,836,1294,-458,2304,35.4,2232,21,3,0.001302083,3237,-933
ZCTA5 51601,2343,873,1470,5451,42,5198,5,41,0.007521556,2291,3160
ZCTA5 51630,58,2623,-2565,178,48.7,177,0,0,0,6782,-6604
ZCTA5 51631,145,14764,-14619,333,47.1,328,0,0,0,35656,-35323
ZCTA5 51632,2504,606,1898,6890,41.8,6161,135,232,0.033671988,1742,5148
ZCTA5 51636,213,1426,-1213,482,54,482,0,0,0,3734,-3252
ZCTA5 51637,112,675,-563,247,44.5,242,0,0,0,1851,-1604
ZCTA5 51638,616,2201,-1585,1246,56.5,1182,0,0,0,5089,-3843
ZCTA5 51639,334,614,-280,737,44.3,711,0,0,0,1548,-811
ZCTA5 51640,660,858,-198,1599,43.3,1510,0,0,0,2258,-659
ZCTA5 51645,108,13012,-12904,266,51.1,258,0,0,0,34039,-33773
ZCTA5 51646,340,224,116,894,40,858,0,0,0,477,417
ZCTA5 51647,96,1753,-1657,180,43.2,180,0,0,0,4642,-4462
ZCTA5 51648,142,10099,-9957,268,56.3,238,0,0,0,24026,-23758
ZCTA5 51649,118,5849,-5731,379,48.2,345,0,22,0.058047493,14972,-14593
ZCTA5 51650,119,5129,-5010,263,48.2,250,0,0,0,12712,-12449
ZCTA5 51651,68,1342,-1274,135,54.7,134,0,0,0,3352,-3217
ZCTA5 51652,604,1126,-522,1496,46.1,1410,0,7,0.004679144,3445,-1949
ZCTA5 51653,521,788,-267,1423,48.1,1370,0,0,0,2084,-661
ZCTA5 51654,130,551,-421,397,33.4,370,0,2,0.005037783,1334,-937
ZCTA5 51656,16,2089,-2073,38,37.5,38,0,0,0,5432,-5394
ZCTA5 52001,18026,18009,17,43623,36.6,38158,606,2440,0.055933796,43462,161
ZCTA5 52002,6900,8170,-1270,17420,39.5,15912,500,245,0.014064294,20062,-2642
ZCTA5 52003,5423,4600,823,13855,40.7,13256,85,12,0.000866113,11109,2746
ZCTA5 52030,161,3033,-2872,398,39,398,0,0,0,7799,-7401
ZCTA5 52031,2041,191,1850,5007,46.4,4787,63,49,0.009786299,438,4569
ZCTA5 52032,580,6833,-6253,1437,38.9,1432,0,0,0,18080,-16643
ZCTA5 52033,1246,8394,-7148,3314,35.7,3105,8,4,0.001207001,21906,-18592
ZCTA5 52035,441,817,-376,1078,54.9,976,0,0,0,2099,-1021
ZCTA5 52036,64,8414,-8350,125,56.3,116,0,0,0,20472,-20347
ZCTA5 52037,368,663,-295,915,45.3,863,10,11,0.012021858,1954,-1039
ZCTA5 52038,187,7194,-7007,558,37.6,505,0,0,0,19197,-18639
ZCTA5 52039,325,11420,-11095,849,56.2,822,27,0,0,27516,-26667
ZCTA5 52040,2364,1935,429,5560,48.1,5159,20,113,0.020323741,5883,-323
ZCTA5 52041,737,4572,-3835,2163,33.9,2123,0,0,0,11914,-9751
ZCTA5 52042,614,1310,-696,1662,37.4,1641,0,0,0,3749,-2087
ZCTA5 52043,853,2104,-1251,1780,50.7,1710,0,4,0.002247191,5718,-3938
ZCTA5 52044,75,11310,-11235,265,49.1,265,0,0,0,29632,-29367
ZCTA5 52045,1050,1355,-305,2748,35.4,2739,3,6,0.002183406,3534,-786
ZCTA5 52046,937,7713,-6776,2624,37.5,2567,0,0,0,18275,-15651
ZCTA5 52047,270,893,-623,805,33.4,768,7,0,0,2584,-1779
ZCTA5 52048,131,6154,-6023,334,38.2,329,0,0,0,15863,-15529
ZCTA5 52049,501,2632,-2131,1106,43.3,1087,0,0,0,6920,-5814
ZCTA5 52050,199,1905,-1706,513,37.1,472,20,0,0,5503,-4990
ZCTA5 52052,1332,3916,-2584,2846,54.4,2841,0,0,0,9951,-7105
ZCTA5 52053,450,7187,-6737,1222,40.1,1167,0,0,0,19672,-18450
ZCTA5 52054,335,2338,-2003,906,46.8,884,0,0,0,6058,-5152
ZCTA5 52056,85,743,-658,223,42.4,220,1,0,0,1654,-1431
ZCTA5 52057,3315,2510,805,8006,44.7,7654,37,0,0,6179,1827
ZCTA5 52060,3415,2990,425,8018,42.6,7592,14,98,0.012222499,8123,-105
ZCTA5 52064,319,5923,-5604,865,37.9,847,0,0,0,14068,-13203
ZCTA5 52065,318,3211,-2893,819,40.5,807,0,5,0.006105006,7713,-6894
ZCTA5 52066,46,12450,-12404,99,54.5,99,0,0,0,34680,-34581
ZCTA5 52068,1672,707,965,4701,37.7,4396,11,71,0.01510317,1951,2750
ZCTA5 52069,604,1148,-544,1613,37.1,1593,0,0,0,3036,-1423
ZCTA5 52070,491,11808,-11317,1153,50.5,1131,7,0,0,30856,-29703
ZCTA5 52071,63,11908,-11845,116,60.7,116,0,0,0,31999,-31883
ZCTA5 52072,220,8501,-8281,961,56.8,894,0,11,0.01144641,22829,-21868
ZCTA5 52073,574,10296,-9722,1517,46.4,1468,0,6,0.003955175,27174,-25657
ZCTA5 52074,121,2770,-2649,356,37.6,349,0,0,0,6993,-6637
ZCTA5 52075,66,7082,-7016,153,53.3,153,0,0,0,16978,-16825
ZCTA5 52076,931,7216,-6285,2140,43.1,2109,5,1,0.00046729,19221,-17081
ZCTA5 52077,140,9626,-9486,296,51.3,278,18,0,0,24992,-24696
ZCTA5 52078,261,13246,-12985,649,43.9,636,0,0,0,32484,-31835
ZCTA5 52079,351,797,-446,753,41.2,753,0,0,0,2263,-1510
ZCTA5 52101,5088,13719,-8631,13120,40.7,12566,141,97,0.007393293,34190,-21070
ZCTA5 52132,708,1156,-448,1824,35.7,1824,0,0,0,2983,-1159
ZCTA5 52133,247,5526,-5279,605,57.2,523,0,82,0.13553719,15951,-15346
ZCTA5 52134,113,217,-104,309,26.3,302,6,0,0,415,-106
ZCTA5 52135,291,3041,-2750,636,53.3,615,21,0,0,8487,-7851
ZCTA5 52136,2299,813,1486,5765,44,5564,6,25,0.004336513,2157,3608
ZCTA5 52140,226,8390,-8164,446,52.6,436,0,0,0,21119,-20673
ZCTA5 52141,534,2773,-2239,1288,46.8,1266,0,11,0.008540373,8641,-7353
ZCTA5 52142,634,1107,-473,1665,32.2,1357,77,136,0.081681682,2711,-1046
ZCTA5 52144,454,2432,-1978,922,50.4,895,0,0,0,6370,-5448
ZCTA5 52146,396,2949,-2553,801,58.8,790,0,0,0,7261,-6460
ZCTA5 52147,410,3240,-2830,997,47.5,923,0,11,0.011033099,9327,-8330
ZCTA5 52151,848,1154,-306,1816,56.6,1767,5,16,0.008810573,2955,-1139
ZCTA5 52154,349,1511,-1162,837,37.2,837,0,0,0,4385,-3548
ZCTA5 52155,547,6937,-6390,1434,39.8,1363,2,0,0,18295,-16861
ZCTA5 52156,223,13892,-13669,674,32.4,651,0,0,0,34685,-34011
ZCTA5 52157,822,14307,-13485,1706,51.5,1681,5,0,0,34532,-32826
ZCTA5 52158,161,9406,-9245,289,55.3,270,1,0,0,25240,-24951
ZCTA5 52159,1047,6755,-5708,2342,43.5,2269,17,0,0,18984,-16642
ZCTA5 52160,399,1295,-896,957,51.3,957,0,0,0,2870,-1913
ZCTA5 52161,612,106,506,1399,40,1328,5,0,0,155,1244
ZCTA5 52162,1187,34,1153,3455,34.5,2818,55,252,0.072937771,86,3369
ZCTA5 52163,147,14472,-14325,356,35.2,346,8,0,0,23290,-22934
ZCTA5 52164,123,659,-536,287,41,285,0,0,0,1103,-816
ZCTA5 52165,449,13076,-12627,1065,37.3,1047,3,0,0,41529,-40464
ZCTA5 52166,55,3595,-3540,128,39.2,127,0,0,0,9522,-9394
ZCTA5 52168,201,9302,-9101,371,47.4,366,0,0,0,29046,-28675
ZCTA5 52169,156,16247,-16091,362,52.4,328,0,0,0,36050,-35688
ZCTA5 52170,254,12106,-11852,523,59.6,523,0,0,0,32518,-31995
ZCTA5 52171,409,18384,-17975,1021,44.1,998,1,0,0,45295,-44274
ZCTA5 52172,2605,9806,-7201,6168,41.6,5932,22,1,0.000162127,28052,-21884
ZCTA5 52175,1465,14998,-13533,3522,39,3403,18,28,0.007950028,35175,-31653
ZCTA5 52201,565,12934,-12369,1494,41.6,1298,0,18,0.012048193,31065,-29571
ZCTA5 52202,402,11315,-10913,1125,37.5,1068,0,13,0.011555556,25924,-24799
ZCTA5 52203,923,15862,-14939,2478,43.4,2281,0,29,0.011702986,34789,-32311
ZCTA5 52205,3093,18895,-15802,8427,44.7,7825,115,332,0.039397176,59066,-50639
ZCTA5 52206,966,12614,-11648,2778,38.5,2720,11,20,0.007199424,32231,-29453
ZCTA5 52207,139,11695,-11556,321,60.8,321,0,0,0,28979,-28658
ZCTA5 52208,1266,13977,-12711,3015,45.1,2866,3,0,0,40323,-37308
ZCTA5 52209,393,15881,-15488,1025,34.8,904,5,0,0,35504,-34479
ZCTA5 52210,276,11656,-11380,889,34.1,880,0,4,0.004499438,26286,-25397
ZCTA5 52211,1155,15347,-14192,2566,38.6,2550,0,2,0.000779423,37707,-35141
ZCTA5 52212,187,11248,-11061,379,63.4,379,0,0,0,26362,-25983
ZCTA5 52213,1537,12108,-10571,3955,41.7,3903,32,5,0.001264223,28411,-24456
ZCTA5 52214,1213,8126,-6913,3093,43.4,3028,21,0,0,22849,-19756
ZCTA5 52215,368,9534,-9166,962,35.3,889,0,0,0,24259,-23297
ZCTA5 52216,612,8166,-7554,1362,48,1358,0,0,0,19246,-17884
ZCTA5 52217,231,10614,-10383,552,42.8,542,0,0,0,22591,-22039
ZCTA5 52218,663,6352,-5689,1657,40.7,1646,1,10,0.006035003,14579,-12922
ZCTA5 52219,64,4789,-4725,160,47,142,0,0,0,15421,-15261
ZCTA5 52220,83,4581,-4498,158,43.5,151,7,0,0,9325,-9167
ZCTA5 52221,100,0,100,247,39.6,204,0,0,0,104,143
ZCTA5 52222,299,12741,-12442,686,54,662,1,0,0,31876,-31190
ZCTA5 52223,437,10720,-10283,1014,55.3,1006,0,3,0.00295858,27413,-26399
ZCTA5 52224,807,5454,-4647,2026,43.7,1920,76,12,0.005923001,16081,-14055
ZCTA5 52225,187,10319,-10132,428,64.4,422,5,0,0,25619,-25191
ZCTA5 52227,1086,10862,-9776,2881,38.9,2790,38,25,0.008677543,25555,-22674
ZCTA5 52228,1357,0,1357,3637,39,3412,12,0,0,0,3637
ZCTA5 52229,316,957,-641,893,38.4,830,1,0,0,2419,-1526
ZCTA5 52231,138,809,-671,373,39.2,361,1,1,0.002680965,1891,-1518
ZCTA5 52232,102,854,-752,323,28.1,280,0,0,0,2048,-1725
ZCTA5 52233,2913,173,2740,7024,34.8,5942,239,461,0.065632118,421,6603
ZCTA5 52235,353,506,-153,821,41,733,0,26,0.031668697,1137,-316
ZCTA5 52236,200,826,-626,457,56.9,457,0,0,0,2209,-1752
ZCTA5 52237,535,2055,-1520,1570,34.8,1535,0,21,0.013375796,5454,-3884
ZCTA5 52240,15159,569,14590,36370,26.9,28491,2038,2938,0.080780863,1501,34869
ZCTA5 52241,9259,18563,-9304,22226,32.6,15895,2158,2880,0.129577972,48932,-26706
ZCTA5 52242,36,947,-911,3836,19.1,3287,163,137,0.035714286,2251,1585
ZCTA5 52245,9329,829,8500,22179,31.5,19029,1111,551,0.02484332,1994,20185
ZCTA5 52246,9925,650,9275,22411,28.1,15039,2571,3083,0.137566374,1632,20779
ZCTA5 52247,1776,510,1266,4806,37.9,4572,31,0,0,1124,3682
ZCTA5 52248,675,2516,-1841,1499,47.5,1457,2,13,0.008672448,6617,-5118
ZCTA5 52249,367,1344,-977,906,45.4,863,0,8,0.008830022,3603,-2697
ZCTA5 52251,245,440,-195,721,35.4,702,0,0,0,1176,-455
ZCTA5 52252,30,2006,-1976,117,31,117,0,0,0,4653,-4536
ZCTA5 52253,1102,1462,-360,2816,45.3,2779,0,12,0.004261364,3665,-849
ZCTA5 52254,399,233,166,926,36.5,801,0,0,0,532,394
ZCTA5 52255,549,3684,-3135,1276,39.3,1237,0,0,0,10072,-8796
ZCTA5 52257,95,2266,-2171,210,57.8,210,0,0,0,5794,-5584
ZCTA5 52301,1582,756,826,3856,45.6,3726,13,8,0.002074689,2153,1703
ZCTA5 52302,17244,1763,15481,42386,39.8,39198,730,776,0.018307932,4602,37784
ZCTA5 52305,279,1532,-1253,842,33.6,800,0,0,0,4430,-3588
ZCTA5 52306,587,5185,-4598,1334,47.9,1327,0,0,0,13532,-12198
ZCTA5 52307,50,2882,-2832,119,29.6,119,0,0,0,6937,-6818
ZCTA5 52308,94,4840,-4746,162,58.7,155,1,0,0,11108,-10946
ZCTA5 52309,265,3303,-3038,542,58.6,529,13,0,0,8782,-8240
ZCTA5 52310,2628,295,2333,6184,43.6,5723,10,102,0.016494179,681,5503
ZCTA5 52312,35,7400,-7365,60,56,60,0,0,0,18731,-18671
ZCTA5 52313,136,65,71,344,50.2,319,0,0,0,154,190
ZCTA5 52314,1804,345,1459,5995,29.3,5696,92,48,0.008006672,797,5198
ZCTA5 52315,517,676,-159,1331,37.5,1281,0,18,0.013523666,1729,-398
ZCTA5 52316,586,295,291,1519,41.4,1465,0,0,0,762,757
ZCTA5 52317,8035,9663,-1628,21848,33.1,17987,906,1100,0.050347858,22703,-855
ZCTA5 52318,409,12217,-11808,1015,50.3,1015,0,0,0,31906,-30891
ZCTA5 52320,470,7143,-6673,1279,36.1,1160,9,0,0,18293,-17014
ZCTA5 52321,201,3927,-3726,488,49.4,462,0,22,0.045081967,10147,-9659
ZCTA5 52322,785,450,335,1966,32,1790,3,29,0.014750763,1352,614
ZCTA5 52323,380,3406,-3026,1121,47.5,1116,0,0,0,8267,-7146
ZCTA5 52324,702,246,456,2030,38.6,1896,45,8,0.003940887,659,1371
ZCTA5 52325,269,427,-158,529,48.2,522,0,0,0,1112,-583
ZCTA5 52326,287,3438,-3151,781,37.2,767,4,0,0,8469,-7688
ZCTA5 52327,1365,1129,236,3498,42.5,3473,0,0,0,2750,748
ZCTA5 52328,1014,206,808,2816,43.6,2636,119,0,0,481,2335
ZCTA5 52329,293,4426,-4133,733,55,730,0,2,0.002728513,10681,-9948
ZCTA5 52330,349,2292,-1943,892,34.9,883,2,0,0,6121,-5229
ZCTA5 52332,632,1391,-759,1695,48.3,1666,0,0,0,3538,-1843
ZCTA5 52333,2692,662,2030,7249,45.5,7035,11,14,0.001931301,1519,5730
ZCTA5 52334,82,10495,-10413,211,54.3,211,0,0,0,24071,-23860
ZCTA5 52335,277,4265,-3988,697,34.4,662,0,2,0.00286944,10529,-9832
ZCTA5 52336,1075,2002,-927,2576,46.2,2488,36,6,0.002329193,5147,-2571
ZCTA5 52337,333,6441,-6108,862,37.5,843,0,7,0.00812065,15225,-14363
ZCTA5 52338,1419,419,1000,3877,44.6,3543,131,45,0.011606913,1098,2779
ZCTA5 52339,1479,1036,443,4189,36.4,2656,10,75,0.017904034,2550,1639
ZCTA5 52340,1852,142,1710,4695,32.9,4028,102,65,0.013844515,327,4368
ZCTA5 52341,414,3709,-3295,1180,42.7,1139,0,12,0.010169492,9676,-8496
ZCTA5 52342,1195,1280,-85,2915,44.7,2581,4,39,0.013379074,3056,-141
ZCTA5 52344,33,1428,-1395,42,70.1,42,0,0,0,3820,-3778
ZCTA5 52345,507,5622,-5115,1489,31.8,1428,3,0,0,15437,-13948
ZCTA5 52346,371,886,-515,1018,31.8,980,27,0,0,2528,-1510
ZCTA5 52347,521,546,-25,1352,48.4,1310,0,14,0.01035503,1448,-96
ZCTA5 52348,31,2334,-2303,78,43.7,75,0,0,0,5953,-5875
ZCTA5 52349,3220,782,2438,7754,46.1,7437,23,29,0.003740005,1834,5920
ZCTA5 52351,519,246,273,1498,36.5,1401,1,11,0.007343124,717,781
ZCTA5 52352,746,4549,-3803,1933,39.6,1914,5,1,0.000517331,11099,-9166
ZCTA5 52353,3704,436,3268,9208,38.4,8117,76,125,0.013575152,998,8210
ZCTA5 52354,120,2483,-2363,268,58.2,268,0,0,0,5827,-5559
ZCTA5 52355,99,802,-703,238,47.2,216,0,0,0,2029,-1791
ZCTA5 52356,1114,938,176,2807,45.7,2729,0,0,0,2357,450
ZCTA5 52358,1529,491,1038,3926,40.3,3705,45,39,0.009933775,1292,2634
ZCTA5 52359,113,1609,-1496,294,40.5,261,0,0,0,3898,-3604
ZCTA5 52361,2027,8304,-6277,4686,40.4,4454,8,62,0.013230901,20129,-15443
ZCTA5 52362,360,13886,-13526,896,39.9,890,1,2,0.002232143,36112,-35216
ZCTA5 52401,1232,7645,-6413,2130,34.9,1586,49,431,0.202347418,19546,-17416
ZCTA5 52402,17967,1978,15989,42649,36,33548,2636,2859,0.067035569,5136,37513
ZCTA5 52403,10338,6390,3948,24789,41.2,21717,121,1894,0.076404857,16883,7906
ZCTA5 52404,17102,1036,16066,40474,33.8,32360,443,4770,0.117853437,2652,37822
ZCTA5 52405,11351,38,11313,26307,38.8,22341,505,2020,0.076785646,70,26237
ZCTA5 52411,2858,18,2840,8298,48.1,7601,183,174,0.020968908,37,8261
ZCTA5 52501,12170,13546,-1376,30470,38.6,25679,547,1210,0.039711191,27280,3190
ZCTA5 52530,373,20424,-20051,1025,41,1010,0,3,0.002926829,43142,-42117
ZCTA5 52531,2279,11362,-9083,5754,39.6,5451,86,3,0.000521376,23683,-17929
ZCTA5 52533,459,54,405,1075,42.9,1061,0,0,0,6251,-5176
ZCTA5 52534,203,18123,-17920,503,40.6,449,6,25,0.049701789,43555,-43052
ZCTA5 52535,372,9830,-9458,802,55,755,0,7,0.00872818,23506,-22704
ZCTA5 52536,388,6967,-6579,817,56.3,789,1,0,0,15735,-14918
ZCTA5 52537,2500,4557,-2057,6642,37.5,6327,11,0,0,12738,-6096
ZCTA5 52540,460,8161,-7701,1185,42.7,1139,0,0,0,18195,-17010
ZCTA5 52542,177,5632,-5455,401,39.4,401,0,0,0,11753,-11352
ZCTA5 52543,123,5474,-5351,397,33.9,397,0,0,0,12510,-12113
ZCTA5 52544,3150,12747,-9597,7685,45.6,7484,5,21,0.002732596,30151,-22466
ZCTA5 52548,38,2245,-2207,103,30.9,88,0,2,0.019417476,5740,-5637
ZCTA5 52549,205,0,205,691,33.9,678,0,0,0,15,676
ZCTA5 52550,288,407,-119,699,35.5,693,0,3,0.004291845,934,-235
ZCTA5 52551,217,25,192,597,43,586,0,0,0,50,547
ZCTA5 52552,367,543,-176,1105,38.2,1061,42,0,0,1405,-300
ZCTA5 52553,649,564,85,1678,47.6,1658,0,6,0.003575685,1419,259
ZCTA5 52554,500,2047,-1547,1092,51.6,1059,5,0,0,5377,-4285
ZCTA5 52555,84,761,-677,190,49.5,186,0,0,0,1856,-1666
ZCTA5 52556,5162,1870,3292,11862,42.5,9658,780,983,0.082869668,4671,7191
ZCTA5 52557,0,427,-427,432,27.7,220,97,71,0.164351852,927,-495
ZCTA5 52560,68,1617,-1549,164,58.5,164,0,0,0,3827,-3663
ZCTA5 52561,378,191,187,965,30.1,921,16,11,0.011398964,441,524
ZCTA5 52562,39,1257,-1218,62,69.5,62,0,0,0,3291,-3229
ZCTA5 52563,581,2414,-1833,1636,37.5,1620,0,0,0,6128,-4492
ZCTA5 52565,783,313,470,1870,50,1845,0,6,0.003208556,923,947
ZCTA5 52566,81,95,-14,250,39.6,250,0,0,0,217,33
ZCTA5 52567,246,4922,-4676,505,57.4,482,7,0,0,14681,-14176
ZCTA5 52568,40,1041,-1001,83,54.1,83,0,0,0,2715,-2632
ZCTA5 52569,300,3413,-3113,652,61.1,620,2,0,0,8423,-7771
ZCTA5 52570,349,176,173,1028,34.9,978,37,1,0.000972763,620,408
ZCTA5 52571,533,547,-14,1313,52.1,1276,30,4,0.003046458,1378,-65
ZCTA5 52572,418,125,293,1223,28.6,1070,0,0,0,265,958
ZCTA5 52573,81,5994,-5913,259,36.2,259,0,0,0,14992,-14733
ZCTA5 52574,226,1403,-1177,539,48.8,496,0,0,0,3138,-2599
ZCTA5 52576,171,530,-359,466,55.8,464,0,0,0,1294,-828
ZCTA5 52577,5738,8481,-2743,14551,36.6,13487,253,338,0.023228644,20159,-5608
ZCTA5 52580,303,9207,-8904,799,46.4,755,0,4,0.005006258,22361,-21562
ZCTA5 52581,127,1010,-883,281,47.6,253,0,0,0,2814,-2533
ZCTA5 52583,140,204,-64,364,45.9,327,0,0,0,387,-23
ZCTA5 52584,193,393,-200,900,19.6,896,0,0,0,1009,-109
ZCTA5 52585,327,760,-433,813,40.9,783,0,0,0,2082,-1269
ZCTA5 52586,249,507,-258,564,58.3,562,0,0,0,1149,-585
ZCTA5 52588,6,3197,-3191,26,82.2,26,0,0,0,7758,-7732
ZCTA5 52590,453,444,9,1325,31.3,1279,0,0,0,1555,-230
ZCTA5 52591,1200,58,1142,2753,43.9,2698,1,16,0.005811842,174,2579
ZCTA5 52593,76,1049,-973,177,49.5,177,0,0,0,2695,-2518
ZCTA5 52594,169,476,-307,579,35.7,566,0,0,0,1241,-662
ZCTA5 52595,184,104,80,492,28.2,404,2,4,0.008130081,280,212
ZCTA5 52601,12501,947,11554,27804,43.4,24188,324,1987,0.071464537,2354,25450
ZCTA5 52619,303,1160,-857,660,54.5,660,0,0,0,4135,-3475
ZCTA5 52620,322,2018,-1696,895,39.8,837,8,9,0.010055866,4536,-3641
ZCTA5 52621,289,129,160,835,31.8,815,4,0,0,320,515
ZCTA5 52623,768,619,149,2011,41.8,1977,17,6,0.00298359,2691,-680
ZCTA5 52624,248,382,-134,601,44.9,596,0,0,0,1120,-519
ZCTA5 52625,892,104,788,2355,40.1,2307,0,28,0.011889597,227,2128
ZCTA5 52626,507,1147,-640,1239,44.9,1235,0,0,0,2860,-1621
ZCTA5 52627,5173,392,4781,12471,41.9,11582,4,488,0.039130783,954,11517
ZCTA5 52630,147,917,-770,302,54.5,299,0,0,0,2283,-1981
ZCTA5 52631,22,1776,-1754,63,36.5,61,0,0,0,4287,-4224
ZCTA5 52632,5178,43,5135,12162,40.8,10979,114,424,0.034862687,87,12075
ZCTA5 52635,367,3367,-3000,827,38.4,686,102,0,0,8311,-7484
ZCTA5 52637,1121,2695,-1574,2900,38.5,2780,20,26,0.008965517,6117,-3217
ZCTA5 52638,204,2303,-2099,528,41.7,513,2,0,0,5435,-4907
ZCTA5 52639,697,971,-274,1732,51.3,1500,105,68,0.03926097,2484,-752
ZCTA5 52640,539,1428,-889,1466,42.9,1443,0,0,0,3208,-1742
ZCTA5 52641,4524,141,4383,12388,40.2,10628,470,464,0.037455602,336,12052
ZCTA5 52644,143,2829,-2686,373,48.8,373,0,0,0,7002,-6629
ZCTA5 52645,1427,2255,-828,3926,37.3,3815,43,22,0.005603668,5356,-1430
ZCTA5 52646,138,1262,-1124,320,55.9,313,0,0,0,3280,-2960
ZCTA5 52647,70,5367,-5297,167,35.3,144,0,21,0.125748503,13268,-13101
ZCTA5 52649,320,1413,-1093,903,41.9,882,8,0,0,3285,-2382
ZCTA5 52650,296,318,-22,683,35.8,654,0,0,0,834,-151
ZCTA5 52651,198,4634,-4436,515,46,503,0,0,0,13761,-13246
ZCTA5 52652,35,1449,-1414,75,47.9,75,0,0,0,3531,-3456
ZCTA5 52653,1264,4332,-3068,3202,46.9,2820,0,25,0.00780762,10308,-7106
ZCTA5 52654,606,952,-346,1805,40,1711,0,0,0,2472,-667
ZCTA5 52655,1754,155,1599,4279,42.1,3767,64,315,0.073615331,464,3815
ZCTA5 52656,999,3472,-2473,2252,50.9,2217,21,0,0,8032,-5780
ZCTA5 52657,28,2451,-2423,57,32.7,57,0,0,0,6474,-6417
ZCTA5 52658,408,390,18,1015,51.5,968,0,0,0,1002,13
ZCTA5 52659,544,929,-385,1311,43.8,1291,0,0,0,2382,-1071
ZCTA5 52660,143,1190,-1047,301,49.7,301,0,0,0,2987,-2686
ZCTA5 52701,45,303,-258,122,33,122,0,0,0,709,-587
ZCTA5 52720,351,498,-147,868,32.6,841,0,14,0.016129032,1488,-620
ZCTA5 52721,354,941,-587,972,41.6,904,49,0,0,2367,-1395
ZCTA5 52722,15923,7,15916,40097,39.2,34587,2489,825,0.020575105,15,40082
ZCTA5 52726,2223,2501,-278,5189,48.2,5055,0,64,0.012333783,6504,-1315
ZCTA5 52727,115,1269,-1154,287,42.2,287,0,0,0,3303,-3016
ZCTA5 52728,410,941,-531,862,43.4,760,10,3,0.003480278,2505,-1643
ZCTA5 52729,335,1203,-868,901,49.2,795,84,0,0,3435,-2534
ZCTA5 52730,2304,11707,-9403,5152,44.4,5003,0,0,0,30424,-25272
ZCTA5 52731,304,6266,-5962,697,50.9,679,0,7,0.010043042,16442,-15745
ZCTA5 52732,10863,2960,7903,26077,42.6,23212,148,1272,0.048778617,7450,18627
ZCTA5 52737,104,2453,-2349,251,52.8,142,5,0,0,6675,-6424
ZCTA5 52738,1238,7786,-6548,3482,35.3,2353,377,52,0.014933946,21920,-18438
ZCTA5 52739,284,1339,-1055,760,39.3,512,43,3,0.003947368,3882,-3122
ZCTA5 52742,2887,1953,934,7621,40,7503,69,6,0.000787298,4595,3026
ZCTA5 52745,205,2579,-2374,389,52.5,370,0,12,0.030848329,7010,-6621
ZCTA5 52746,421,737,-316,1138,44.5,1124,0,1,0.000878735,2013,-875
ZCTA5 52747,802,383,419,1941,42.9,1850,31,20,0.010303967,984,957
ZCTA5 52748,3477,869,2608,9567,36.6,8464,149,217,0.022682137,2248,7319
ZCTA5 52749,391,737,-346,1232,30.3,1182,0,0,0,1860,-628
ZCTA5 52750,159,1102,-943,477,40,448,0,0,0,2877,-2400
ZCTA5 52751,411,415,-4,1022,35.9,972,23,0,0,839,183
ZCTA5 52752,178,167,11,394,40,384,3,0,0,304,90
ZCTA5 52753,2122,589,1533,6019,36.3,5694,112,41,0.006811763,1129,4890
ZCTA5 52754,566,1834,-1268,1400,47.7,1372,0,1,0.000714286,4812,-3412
ZCTA5 52755,788,1364,-576,2167,40.6,2128,4,0,0,3713,-1546
ZCTA5 52756,691,2004,-1313,2000,41.3,1900,0,0,0,5373,-3373
ZCTA5 52757,100,987,-887,229,46.4,199,2,0,0,2349,-2120
ZCTA5 52758,122,1036,-914,322,33,317,0,0,0,2279,-1957
ZCTA5 52759,49,1215,-1166,92,50.1,92,0,0,0,3294,-3202
ZCTA5 52760,229,2623,-2394,467,38.6,447,0,0,0,5352,-4885
ZCTA5 52761,11699,15327,-3628,30515,38.3,25867,172,874,0.028641652,40335,-9820
ZCTA5 52765,163,278,-115,324,58,312,3,0,0,1052,-728
ZCTA5 52766,347,77,270,753,48.4,667,28,13,0.017264276,144,609
ZCTA5 52767,94,1293,-1199,305,47.5,300,0,5,0.016393443,3102,-2797
ZCTA5 52768,533,92,441,1418,45.4,1280,0,0,0,234,1184
ZCTA5 52769,220,1695,-1475,580,38.3,565,2,0,0,3929,-3349
ZCTA5 52771,33,294,-261,55,58.3,55,0,0,0,565,-510
ZCTA5 52772,2174,1337,837,5453,43.3,5329,0,41,0.007518797,3725,1728
ZCTA5 52773,1082,17,1065,2895,37.1,2645,0,83,0.028670121,48,2847
ZCTA5 52774,57,715,-658,141,41.8,131,0,0,0,1756,-1615
ZCTA5 52776,1680,1250,430,5038,34.2,4109,26,180,0.035728464,3146,1892
ZCTA5 52777,516,9799,-9283,1337,36.4,1268,0,4,0.002991773,25194,-23857
ZCTA5 52778,1704,897,807,3799,46.9,3641,8,0,0,3099,700
ZCTA5 52801,854,2754,-1900,1381,32,914,46,254,0.183924692,6356,-4975
ZCTA5 52802,3996,489,3507,10130,41.2,8545,168,562,0.055478776,1131,8999
ZCTA5 52803,8993,464,8529,21877,36.4,17289,278,2544,0.116286511,867,21010
ZCTA5 52804,11092,1295,9797,27497,38.1,20640,783,3174,0.115430774,3237,24260
ZCTA5 52806,11222,3459,7763,27814,39,22337,548,3125,0.112353491,8727,19087
ZCTA5 52807,6643,938,5705,15329,38.6,12484,390,1476,0.096288081,2521,12808
ZCTA5 53001,855,6900,-6045,1904,49.3,1866,4,0,0,14870,-12966
ZCTA5 53002,918,619,299,2247,38.9,1820,24,2,0.000890076,1207,1040
ZCTA5 53003,53,328,-275,138,59.1,138,0,0,0,1057,-919
ZCTA5 53004,1470,1519,-49,3611,47.6,3376,33,4,0.001107726,3494,117
ZCTA5 53005,8191,3205,4986,21585,42.8,17871,2361,187,0.008663424,7294,14291
ZCTA5 53006,771,2391,-1620,1844,45.9,1801,18,0,0,5545,-3701
ZCTA5 53007,835,2009,-1174,1808,45.1,1559,103,114,0.063053097,6160,-4352
ZCTA5 53010,3016,775,2241,7571,48.2,7127,14,35,0.004622903,1661,5910
ZCTA5 53011,887,2526,-1639,2134,48.4,2072,0,6,0.002811621,6134,-4000
ZCTA5 53012,7802,564,7238,18929,45.8,17851,247,98,0.005177241,1369,17560
ZCTA5 53013,1351,82,1269,3499,45,3141,69,32,0.00914547,198,3301
ZCTA5 53014,3366,1245,2121,8030,43.9,7781,0,52,0.006475716,2842,5188
ZCTA5 53015,1106,3405,-2299,3041,37.6,2750,65,16,0.005261427,8944,-5903
ZCTA5 53016,155,2952,-2797,378,43,332,20,0,0,7503,-7125
ZCTA5 53017,1856,7360,-5504,5041,44.3,4890,22,22,0.004364213,16979,-11938
ZCTA5 53018,3057,915,2142,7624,45.6,6618,142,319,0.041841553,2580,5044
ZCTA5 53019,724,1400,-676,1692,45.9,1636,15,0,0,3586,-1894
ZCTA5 53020,1561,1237,324,3811,49.6,3776,0,0,0,3268,543
ZCTA5 53021,1715,1514,201,4399,38.3,3961,4,92,0.020913844,4311,88
ZCTA5 53022,7823,1236,6587,19949,40.6,17290,1234,569,0.028522733,2791,17158
ZCTA5 53023,513,488,25,1267,41.9,1220,11,0,0,971,296
ZCTA5 53024,8070,1316,6754,18619,40,17432,248,151,0.008109995,2827,15792
ZCTA5 53027,9640,1007,8633,23423,41.3,21511,176,303,0.012936003,2908,20515
ZCTA5 53029,8013,2225,5788,21126,44.8,19829,365,97,0.004591499,5448,15678
ZCTA5 53031,31,769,-738,85,30.8,36,0,0,0,1654,-1569
ZCTA5 53032,2196,692,1504,4983,42.3,4799,0,88,0.017660044,1671,3312
ZCTA5 53033,2422,802,1620,5973,52.3,5691,107,7,0.00117194,2070,3903
ZCTA5 53034,630,65,565,1681,46.8,1566,12,6,0.003569304,174,1507
ZCTA5 53035,909,2354,-1445,2429,45.6,2309,77,0,0,6375,-3946
ZCTA5 53036,1135,621,514,3301,37,3269,0,0,0,1188,2113
ZCTA5 53037,3777,406,3371,9487,46,9136,13,114,0.012016444,764,8723
ZCTA5 53038,1605,131,1474,4189,38.4,3844,88,44,0.0105037,228,3961
ZCTA5 53039,1692,557,1135,4991,46,4674,2,140,0.028050491,1127,3864
ZCTA5 53040,3265,652,2613,8155,42.8,7879,40,65,0.00797057,1596,6559
ZCTA5 53042,2728,112,2616,6615,42.1,6287,5,0,0,248,6367
ZCTA5 53044,856,2554,-1698,2218,42.9,2016,98,0,0,6035,-3817
ZCTA5 53045,9623,2857,6766,22892,46.2,18771,2757,289,0.012624498,7567,15325
ZCTA5 53046,619,17372,-16753,1292,43.1,1225,51,0,0,39927,-38635
ZCTA5 53047,62,607,-545,142,65.5,140,0,0,0,1575,-1433
ZCTA5 53048,1459,1078,381,3435,40.3,3300,8,44,0.012809316,2632,803
ZCTA5 53049,967,1595,-628,2437,37.4,2388,0,0,0,4230,-1793
ZCTA5 53050,2911,1798,1113,7129,43.5,6935,2,1,0.000140272,4641,2488
ZCTA5 53051,15751,305,15446,38250,41.6,32941,1674,1640,0.042875817,816,37434
ZCTA5 53057,721,774,-53,1843,47.7,1811,0,11,0.00596853,1488,355
ZCTA5 53058,1316,8512,-7196,3312,50.6,3136,75,7,0.002113527,16964,-13652
ZCTA5 53059,708,6340,-5632,1906,46.7,1831,0,5,0.002623295,14789,-12883
ZCTA5 53061,2208,927,1281,4969,45.6,4640,56,12,0.002414973,2443,2526
ZCTA5 53063,653,365,288,1693,46.4,1638,3,17,0.010041347,716,977
ZCTA5 53065,874,892,-18,2335,48,2187,30,36,0.015417559,2249,86
ZCTA5 53066,14660,9427,5233,36416,45.1,34295,248,516,0.014169596,22572,13844
ZCTA5 53069,351,12513,-12162,689,58.9,535,0,68,0.098693759,29765,-29076
ZCTA5 53070,1906,12199,-10293,4901,46.2,4635,39,8,0.00163232,28393,-23492
ZCTA5 53072,11827,12400,-573,26384,45,23952,992,157,0.005950576,27707,-1323
ZCTA5 53073,6254,0,6254,16090,43.7,14650,173,820,0.050963331,1260,14830
ZCTA5 53074,5444,12508,-7064,13098,40,12113,216,211,0.01610933,33620,-20522
ZCTA5 53075,1377,13226,-11849,3281,46.2,3203,0,0,0,36151,-32870
ZCTA5 53076,1226,12490,-11264,3620,37.8,3454,70,38,0.010497238,30333,-26713
ZCTA5 53078,722,9919,-9197,1691,50.4,1691,0,0,0,24792,-23101
ZCTA5 53079,577,1051,-474,1355,51.9,1335,1,0,0,2730,-1375
ZCTA5 53080,2308,1389,919,5052,44.7,4592,81,139,0.027513856,3507,1545
ZCTA5 53081,18719,586,18133,43704,38.4,34637,4795,1368,0.031301483,1448,42256
ZCTA5 53083,8680,453,8227,21370,40.7,17640,1646,211,0.009873655,1086,20284
ZCTA5 53085,5078,5729,-651,11378,44.7,10733,182,45,0.003955001,13046,-1668
ZCTA5 53086,3816,812,3004,8904,45.7,8684,18,0,0,2250,6654
ZCTA5 53088,150,1956,-1806,283,34.5,256,3,0,0,5766,-5483
ZCTA5 53089,7416,776,6640,19621,40.2,17924,1261,37,0.001885735,1962,17659
ZCTA5 53090,8915,58,8857,21956,42.1,20605,113,232,0.010566588,138,21818
ZCTA5 53091,875,1327,-452,2088,45.9,1999,10,21,0.010057471,3358,-1270
ZCTA5 53092,8278,715,7563,20844,48.8,19231,469,323,0.015496066,1810,19034
ZCTA5 53093,731,33,698,1988,42.8,1876,9,0,0,90,1898
ZCTA5 53094,7214,406,6808,18341,39.7,17472,53,98,0.00534322,1010,17331
ZCTA5 53095,12046,435,11611,27608,43.7,25941,122,542,0.019631991,1269,26339
ZCTA5 53097,2232,1161,1071,7254,36.4,6040,527,178,0.024538186,3090,4164
ZCTA5 53098,4411,401,4010,11649,43.3,10244,22,297,0.025495751,1272,10377
ZCTA5 53099,5,876,-871,11,50.2,11,0,0,0,2274,-2263
ZCTA5 53103,1584,760,824,3695,52.2,3511,0,16,0.004330176,1776,1919
ZCTA5 53104,2192,766,1426,5781,46.4,5594,5,44,0.00761114,2067,3714
ZCTA5 53105,12090,1554,10536,29504,43.7,28084,422,121,0.004101139,4344,25160
ZCTA5 53108,1297,483,814,2822,49.7,2676,15,50,0.017717931,1249,1573
ZCTA5 53110,8663,590,8073,18197,44.4,15718,321,646,0.035500357,1139,17058
ZCTA5 53114,938,46,892,2405,44.9,2208,6,2,0.000831601,127,2278
ZCTA5 53115,6578,726,5852,16071,41.2,14260,134,283,0.017609358,1660,14411
ZCTA5 53118,3031,871,2160,7383,48.1,7083,116,33,0.004469728,2090,5293
ZCTA5 53119,2186,816,1370,5741,45.5,5389,4,34,0.005922313,2332,3409
ZCTA5 53120,4248,1144,3104,10645,44.6,10270,42,40,0.003757633,3347,7298
ZCTA5 53121,7554,1223,6331,18813,42.7,16849,32,121,0.006431723,3068,15745
ZCTA5 53122,2272,346,1926,6456,45,5898,189,134,0.020755886,949,5507
ZCTA5 53125,1267,460,807,2826,57.7,2693,57,0,0,1166,1660
ZCTA5 53126,2814,835,1979,7233,43.3,6673,19,57,0.007880547,2203,5030
ZCTA5 53127,41,1135,-1094,108,28.9,108,0,0,0,3130,-3022
ZCTA5 53128,3346,217,3129,9299,35.7,8003,29,1,0.000107538,543,8756
ZCTA5 53129,6126,1691,4435,14678,40.8,12320,1013,190,0.012944543,4541,10137
ZCTA5 53130,3043,11311,-8268,7715,39.2,7031,120,47,0.006092029,25891,-18176
ZCTA5 53132,13649,149,13500,36182,43.1,29453,2076,1886,0.052125366,368,35814
ZCTA5 53137,617,5094,-4477,1581,42.4,1547,10,5,0.003162555,11712,-10131
ZCTA5 53139,936,8466,-7530,2180,49.7,2052,7,5,0.002293578,19254,-17074
ZCTA5 53140,12685,516,12169,30261,35.4,22299,512,3551,0.117345759,1304,28957
ZCTA5 53142,12659,6446,6213,33350,38.8,26687,1082,1617,0.048485757,17126,16224
ZCTA5 53143,8590,2742,5848,22358,35,16074,202,2643,0.11821272,6387,15971
ZCTA5 53144,10021,3705,6316,26674,36.5,19425,863,3015,0.113031416,8377,18297
ZCTA5 53146,3197,45,3152,7804,50.7,7399,129,202,0.025884162,153,7651
ZCTA5 53147,7815,571,7244,17624,46.6,15888,134,70,0.003971857,1194,16430
ZCTA5 53149,7176,1033,6143,19318,43.8,17869,347,89,0.004607102,2716,16602
ZCTA5 53150,9916,170,9746,25860,43.6,24906,227,159,0.006148492,413,25447
ZCTA5 53151,14092,365,13727,32398,45.2,28805,1682,383,0.011821717,836,31562
ZCTA5 53153,974,337,637,2604,42.9,2567,9,0,0,734,1870
ZCTA5 53154,15262,1171,14091,36266,39.2,28884,2521,1326,0.036563172,2890,33376
ZCTA5 53156,1395,5403,-4008,3344,39.9,3205,0,3,0.000897129,13722,-10378
ZCTA5 53157,0,749,-749,0,-,0,0,0,#DIV/0!,1876,-1876
ZCTA5 53158,6544,956,5588,17397,43.2,15218,290,166,0.009541875,2136,15261
ZCTA5 53167,233,622,-389,474,37.4,474,0,0,0,1708,-1234
ZCTA5 53168,3566,1056,2510,9053,40.7,8602,21,23,0.002540594,2461,6592
ZCTA5 53170,865,1676,-811,2265,40.3,2159,0,18,0.00794702,3897,-1632
ZCTA5 53172,8612,594,8018,20785,41.1,18391,90,527,0.025354823,1660,19125
ZCTA5 53176,64,7728,-7664,222,50.1,222,0,0,0,18773,-18551
ZCTA5 53177,2677,1521,1156,8457,37.8,6824,129,905,0.107011943,4198,4259
ZCTA5 53178,1079,576,503,2643,48.5,2593,12,0,0,1394,1249
ZCTA5 53179,2610,11757,-9147,7088,40.5,6230,0,76,0.010722348,29014,-21926
ZCTA5 53181,3305,3689,-384,7628,47.6,7345,2,34,0.004457263,9279,-1651
ZCTA5 53182,3214,1929,1285,9603,42,8518,51,568,0.059148183,5028,4575
ZCTA5 53183,1073,131,942,3021,40.2,2961,0,0,0,281,2740
ZCTA5 53184,1533,964,569,4301,40.3,3667,21,17,0.003952569,2271,2030
ZCTA5 53185,7444,4336,3108,18550,46.5,17523,174,51,0.002749326,9436,9114
ZCTA5 53186,14733,418,14315,34163,36.7,29446,1192,830,0.02429529,1287,32876
ZCTA5 53188,14053,627,13426,34338,38.2,30576,847,1090,0.031743258,1533,32805
ZCTA5 53189,10199,378,9821,26315,41.9,23794,591,178,0.006764203,866,25449
ZCTA5 53190,6152,728,5424,19104,22.4,16656,301,513,0.026853015,1541,17563
ZCTA5 53191,1441,299,1142,3264,50.1,3061,10,0,0,684,2580
ZCTA5 53192,49,11552,-11503,49,-,49,0,0,0,26769,-26720
ZCTA5 53195,38,3540,-3502,80,57.7,75,0,0,0,7790,-7710
ZCTA5 53202,16138,820,15318,25081,31.8,19462,1472,2211,0.08815438,2190,22891
ZCTA5 53203,1208,1220,-12,1878,28.3,1520,53,227,0.120873269,2995,-1117
ZCTA5 53204,13058,8704,4354,37687,28.2,14172,703,3651,0.096876907,19801,17886
ZCTA5 53205,3351,547,2804,8337,31.1,519,505,6797,0.815281276,1329,7008
ZCTA5 53206,7966,501,7465,21847,31.5,430,131,20251,0.926946492,990,20857
ZCTA5 53207,16267,180,16087,35120,36.8,29479,455,1397,0.039777904,384,34736
ZCTA5 53208,11778,880,10898,28155,31.8,9787,3219,11847,0.420777837,1909,26246
ZCTA5 53209,19419,220,19199,46908,35.4,11370,941,31508,0.671697791,465,46443
ZCTA5 53210,9366,88,9278,25706,31.1,4790,557,18124,0.705049405,146,25560
ZCTA5 53211,15003,598,14405,34406,30.3,28547,1891,1343,0.039033889,1196,33210
ZCTA5 53212,13133,1734,11399,29142,31.7,10947,268,15032,0.515819093,4298,24844
ZCTA5 53213,12124,3544,8580,27727,36.1,23088,1111,1657,0.059761244,7177,20550
ZCTA5 53214,16166,336,15830,35358,37.7,26683,786,2791,0.07893546,628,34730
ZCTA5 53215,19435,120,19315,59400,30.7,26216,2352,3829,0.064461279,240,59160
ZCTA5 53216,12541,362,12179,31398,32.8,3335,821,25776,0.820944009,823,30575
ZCTA5 53217,11661,482,11179,30098,40.9,24560,1781,1763,0.058575321,1096,29002
ZCTA5 53218,14765,512,14253,43302,29.7,4433,3754,31751,0.733245578,1170,42132
ZCTA5 53219,14668,342,14326,33994,37.4,24557,1302,1703,0.050097076,791,33203
ZCTA5 53220,12100,681,11419,27366,41.1,20276,1316,1203,0.043959658,1446,25920
ZCTA5 53221,16483,1158,15325,39238,38.6,26783,3313,2230,0.056832662,2244,36994
ZCTA5 53222,10663,130,10533,24771,35.1,14046,423,7957,0.321222397,243,24528
ZCTA5 53223,12400,229,12171,29397,39.9,9058,2009,16196,0.550940572,504,28893
ZCTA5 53224,7468,1401,6067,20989,29,4831,1463,13161,0.627042737,3164,17825
ZCTA5 53225,10148,618,9530,26963,31.4,7547,1523,15119,0.560731373,1334,25629
ZCTA5 53226,7895,599,7296,18223,38.1,15156,1092,1008,0.055314712,1136,17087
ZCTA5 53227,10856,525,10331,24114,38,18400,1094,1577,0.065397694,1466,22648
ZCTA5 53228,6852,205,6647,14793,43.9,12438,609,368,0.024876631,466,14327
ZCTA5 53233,4416,407,4009,14627,22.1,7413,984,4766,0.325835783,853,13774
ZCTA5 53235,4759,571,4188,9254,48.6,8000,105,211,0.022800951,1296,7958
ZCTA5 53295,0,709,-709,135,53.3,97,0,27,0.2,1356,-1221
ZCTA5 53402,14218,2293,11925,34608,41,26786,578,3582,0.10350208,4702,29906
ZCTA5 53403,10409,296,10113,26579,36.8,14905,256,6960,0.261860868,626,25953
ZCTA5 53404,5231,2294,2937,13993,29.4,7687,21,4041,0.288787251,4431,9562
ZCTA5 53405,10942,615,10327,26987,36.9,19486,350,3791,0.140475044,1281,25706
ZCTA5 53406,11308,2366,8942,26116,44.2,21122,564,2599,0.099517537,4958,21158
ZCTA5 53501,104,618,-514,145,57.6,40,0,0,0,1341,-1196
ZCTA5 53502,941,468,473,2293,40.7,2228,5,18,0.007849978,887,1406
ZCTA5 53503,877,1133,-256,1999,40.2,1810,18,50,0.025012506,2434,-435
ZCTA5 53504,919,296,623,2241,46.4,2207,5,0,0,727,1514
ZCTA5 53505,171,277,-106,373,49.1,372,0,0,0,537,-164
ZCTA5 53506,440,8,432,1016,49.2,969,4,23,0.022637795,9,1007
ZCTA5 53507,836,903,-67,2305,37.9,2199,0,12,0.005206074,1863,442
ZCTA5 53508,2306,288,2018,5791,41.2,5503,27,24,0.004144362,616,5175
ZCTA5 53510,582,241,341,1449,39.1,1372,8,2,0.001380262,455,994
ZCTA5 53511,18283,55,18228,48714,36.9,33496,718,5725,0.117522683,97,48617
ZCTA5 53515,1061,602,459,2623,48.1,2519,29,2,0.000762486,1432,1191
ZCTA5 53516,965,2461,-1496,2235,44.7,2175,7,0,0,5085,-2850
ZCTA5 53517,752,19995,-19243,1908,42.8,1762,92,8,0.004192872,49395,-47487
ZCTA5 53518,647,6443,-5796,1493,39,1422,4,6,0.004018754,14469,-12976
ZCTA5 53520,2894,740,2154,6754,46,6513,23,0,0,1653,5101
ZCTA5 53521,1360,451,909,3403,42.7,3074,9,46,0.013517485,1240,2163
ZCTA5 53522,378,2019,-1641,928,44.5,888,0,0,0,5109,-4181
ZCTA5 53523,2080,912,1168,4971,48.1,4752,26,45,0.009052505,2045,2926
ZCTA5 53525,1620,1170,450,4049,45.5,3767,0,28,0.006915288,2919,1130
ZCTA5 53526,234,4379,-4145,562,39.3,533,0,4,0.007117438,10708,-10146
ZCTA5 53527,4245,1042,3203,10798,40.5,9558,463,52,0.004815707,2696,8102
ZCTA5 53528,2431,918,1513,6141,42.2,5792,15,9,0.001465559,2286,3855
ZCTA5 53529,902,1225,-323,2507,38.5,2193,12,21,0.008376546,3785,-1278
ZCTA5 53530,1823,444,1379,4666,40.3,4459,59,46,0.009858551,1048,3618
ZCTA5 53531,1657,931,726,4414,38.8,3940,20,219,0.049614862,2083,2331
ZCTA5 53532,5968,801,5167,16279,37.7,14247,441,210,0.012900055,1977,14302
ZCTA5 53533,3023,617,2406,7273,42.8,6855,93,0,0,1290,5983
ZCTA5 53534,4877,118,4759,12256,41.8,11447,24,20,0.001631854,262,11994
ZCTA5 53536,3795,504,3291,8936,40.9,8689,0,35,0.003916741,1327,7609
ZCTA5 53537,396,806,-410,954,34.4,908,0,9,0.009433962,1852,-898
ZCTA5 53538,7662,484,7178,18669,43.1,16792,50,187,0.010016605,984,17685
ZCTA5 53540,62,1055,-993,157,31.1,106,0,0,0,2511,-2354
ZCTA5 53541,364,1546,-1182,819,53.1,807,3,0,0,3864,-3045
ZCTA5 53543,715,779,-64,1726,43.8,1676,3,29,0.016801854,1917,-191
ZCTA5 53544,298,463,-165,781,48.3,759,11,0,0,1188,-407
ZCTA5 53545,10434,1598,8836,23571,42,21044,256,1199,0.050867592,4342,19229
ZCTA5 53546,12197,726,11471,29505,41.1,26183,623,264,0.008947636,1718,27787
ZCTA5 53548,8356,4971,3385,20314,40,18364,298,513,0.02525352,13930,6384
ZCTA5 53549,4469,80,4389,10169,47.2,9098,61,174,0.017110827,223,9946
ZCTA5 53550,435,589,-154,1260,41.7,1250,0,0,0,1514,-254
ZCTA5 53551,3496,977,2519,9217,39.3,8256,70,19,0.002061408,2561,6656
ZCTA5 53553,269,0,269,655,34.7,647,0,0,0,0,655
ZCTA5 53554,364,801,-437,951,41.2,923,0,2,0.002103049,2065,-1114
ZCTA5 53555,3833,3,3830,8784,46.8,8464,115,18,0.00204918,7,8777
ZCTA5 53556,1054,457,597,2296,48.1,2125,22,5,0.0021777,1125,1171
ZCTA5 53557,169,31,138,335,49.6,312,0,3,0.008955224,72,263
ZCTA5 53558,5135,1550,3585,12902,39.1,12030,216,118,0.009145869,4086,8816
ZCTA5 53559,2399,588,1811,6382,39.4,5646,234,163,0.025540583,1702,4680
ZCTA5 53560,1558,9395,-7837,3542,47.2,3370,19,4,0.001129305,23286,-19744
ZCTA5 53561,795,530,265,2020,43.6,1970,3,8,0.003960396,1395,625
ZCTA5 53562,12609,384,12225,28817,39.3,23532,2526,916,0.031786793,980,27837
ZCTA5 53563,4503,356,4147,11716,41.2,11028,22,24,0.002048481,1048,10668
ZCTA5 53565,1952,67,1885,4640,44.7,4438,11,95,0.020474138,164,4476
ZCTA5 53566,6578,693,5885,15122,43,14308,59,66,0.004364502,1688,13434
ZCTA5 53569,406,6806,-6400,1089,43.1,1067,13,4,0.003673095,17201,-16112
ZCTA5 53570,1184,149,1035,2634,48.2,2560,0,25,0.009491268,391,2243
ZCTA5 53571,14,948,-934,66,18.6,66,0,0,0,2204,-2138
ZCTA5 53572,3751,514,3237,10358,37.9,9685,64,98,0.009461286,1462,8896
ZCTA5 53573,1276,6423,-5147,3070,40.8,3033,3,13,0.004234528,16014,-12944
ZCTA5 53574,1484,1393,91,4066,42.4,3921,4,19,0.004672897,3283,783
ZCTA5 53575,6882,552,6330,18108,41.8,16275,423,684,0.03777336,1425,16683
ZCTA5 53576,948,3586,-2638,2291,40.2,2156,8,17,0.00742034,8505,-6214
ZCTA5 53577,515,1058,-543,1229,41.2,1199,12,8,0.006509357,2414,-1185
ZCTA5 53578,2700,1733,967,6414,40.4,5971,3,53,0.008263174,4705,1709
ZCTA5 53579,632,2858,-2226,1729,40.2,1579,15,16,0.009253904,7583,-5854
ZCTA5 53580,177,589,-412,453,40.2,449,0,0,0,1937,-1484
ZCTA5 53581,4195,15931,-11736,10158,46,9469,87,97,0.009549124,40259,-30101
ZCTA5 53582,420,17026,-16606,1170,44.5,1096,27,8,0.006837607,41550,-40380
ZCTA5 53583,2522,3083,-561,6145,44.4,5789,13,0,0,7005,-860
ZCTA5 53584,10,583,-573,10,-,10,0,0,0,1392,-1382
ZCTA5 53585,830,1492,-662,2226,37.8,1822,12,4,0.001796945,4265,-2039
ZCTA5 53586,823,524,299,2136,39.8,2034,5,1,0.000468165,1186,950
ZCTA5 53587,478,2714,-2236,1141,46.5,1073,0,24,0.021034181,7286,-6145
ZCTA5 53588,1694,1222,472,3844,50.1,3739,48,9,0.002341311,2903,941
ZCTA5 53589,8502,680,7822,19936,43.3,18688,101,140,0.007022472,1735,18201
ZCTA5 53590,17249,1896,15353,42872,38.1,35533,2197,2755,0.064261056,5108,37764
ZCTA5 53593,10826,2627,8199,26724,38.4,22996,1606,321,0.012011675,6326,20398
ZCTA5 53594,2353,12668,-10315,5054,44.2,4524,32,26,0.00514444,31369,-26315
ZCTA5 53597,7968,1888,6080,20542,40.9,18910,255,242,0.011780742,4937,15605
ZCTA5 53598,1493,337,1156,3727,43.4,3493,0,29,0.007781057,776,2951
ZCTA5 53599,55,1167,-1112,96,33.8,78,0,0,0,2855,-2759
ZCTA5 53703,18702,515,18187,37444,24.7,30720,3384,1438,0.038404017,1372,36072
ZCTA5 53704,21392,308,21084,47731,34.8,35025,2555,5358,0.112254091,814,46917
ZCTA5 53705,11791,1595,10196,24786,36.3,18033,3795,669,0.026991043,3960,20826
ZCTA5 53706,0,218,-218,3660,19,2769,639,77,0.021038251,493,3167
ZCTA5 53711,20921,1134,19787,48498,37,38483,2679,3180,0.065569714,3003,45495
ZCTA5 53713,10851,1730,9121,22940,30.9,13223,1503,3206,0.139755885,4549,18391
ZCTA5 53714,7756,828,6928,16599,40.3,13091,577,1755,0.105729261,2138,14461
ZCTA5 53715,5077,571,4506,15761,21.5,13258,1590,493,0.031279741,1565,14196
ZCTA5 53716,8286,1600,6686,18710,43.3,16610,559,536,0.028647782,4009,14701
ZCTA5 53717,6193,892,5301,13207,37.8,9451,2189,1041,0.078821837,2110,11097
ZCTA5 53718,7636,272,7364,16935,37.4,13536,1472,1112,0.065662828,673,16262
ZCTA5 53719,15036,1102,13934,32933,34,23045,3100,3125,0.094889624,2686,30247
ZCTA5 53726,2408,465,1943,5474,23.8,4510,486,96,0.01753745,1042,4432
ZCTA5 53792,0,496,-496,0,-,0,0,0,#DIV/0!,1132,-1132
ZCTA5 53801,428,423,5,1052,49.8,1032,0,10,0.009505703,1021,31
ZCTA5 53802,30,9319,-9289,131,36.7,131,0,0,0,25957,-25826
ZCTA5 53803,522,745,-223,1152,46.5,1074,0,16,0.013888889,1729,-577
ZCTA5 53804,503,2954,-2451,1320,40,1291,8,0,0,7563,-6243
ZCTA5 53805,2139,434,1705,5521,42,5146,0,305,0.055243615,875,4646
ZCTA5 53806,747,1303,-556,1561,56.5,1539,2,0,0,3380,-1819
ZCTA5 53807,1732,1832,-100,4409,41.9,4319,6,13,0.002948514,4675,-266
ZCTA5 53808,377,659,-282,974,44.9,938,0,0,0,1565,-591
ZCTA5 53809,1670,87,1583,4655,30.9,4593,10,0,0,209,4446
ZCTA5 53810,150,460,-310,369,44.5,363,6,0,0,1195,-826
ZCTA5 53811,1266,467,799,3228,44.2,3171,0,4,0.001239157,1167,2061
ZCTA5 53812,130,447,-317,354,32.8,354,0,0,0,1129,-775
ZCTA5 53813,2274,13,2261,6254,36.7,6053,36,27,0.004317237,13,6241
ZCTA5 53816,275,625,-350,895,34,874,1,13,0.01452514,1641,-746
ZCTA5 53817,127,1250,-1123,207,53.4,207,0,0,0,3208,-3001
ZCTA5 53818,5614,2084,3530,15997,24.1,14813,367,438,0.027380134,6029,9968
ZCTA5 53820,923,198,725,2304,45.7,2218,16,9,0.00390625,427,1877
ZCTA5 53821,3105,826,2279,7663,47.4,7121,29,248,0.032363304,2126,5537
ZCTA5 53825,192,1585,-1393,525,27.7,520,0,0,0,4289,-3764
ZCTA5 53826,578,419,159,1473,39.1,1412,0,19,0.012898846,1098,375
ZCTA5 53827,127,1264,-1137,327,50.8,323,0,0,0,3338,-3011
ZCTA5 53901,5942,3002,2940,14815,40.8,13249,77,526,0.035504556,6426,8389
ZCTA5 53910,1474,558,916,3455,49.2,3135,133,9,0.00260492,1482,1973
ZCTA5 53911,528,4884,-4356,1424,35.3,1320,52,14,0.009831461,11631,-10207
ZCTA5 53913,9376,1040,8336,21287,40.9,19341,63,240,0.011274487,2402,18885
ZCTA5 53916,10095,2244,7851,22929,42.6,20469,363,361,0.015744254,5520,17409
ZCTA5 53919,823,250,573,2182,42.7,1973,19,2,0.00091659,577,1605
ZCTA5 53920,216,1152,-936,438,60.1,381,0,0,0,2598,-2160
ZCTA5 53922,421,1047,-626,1028,49.4,1021,0,0,0,2139,-1111
ZCTA5 53923,817,1176,-359,2224,41.6,2127,2,13,0.005845324,2633,-409
ZCTA5 53924,580,305,275,1353,49.4,1295,9,8,0.005912786,687,666
ZCTA5 53925,3531,702,2829,8665,40,8053,239,162,0.018695903,1395,7270
ZCTA5 53926,621,1841,-1220,1767,27.6,1738,0,14,0.007923033,4695,-2928
ZCTA5 53928,43,865,-822,97,37.5,97,0,0,0,2047,-1950
ZCTA5 53929,1047,336,711,2602,45.5,2534,10,17,0.006533436,801,1801
ZCTA5 53930,526,98,428,1219,44.9,1113,1,12,0.009844135,151,1068
ZCTA5 53931,125,401,-276,353,29.7,290,0,0,0,887,-534
ZCTA5 53932,911,2125,-1214,2461,36.4,2177,28,70,0.028443722,5155,-2694
ZCTA5 53933,1295,1531,-236,4341,42.8,3213,39,700,0.161253167,2986,1355
ZCTA5 53934,2067,217,1850,4303,56.6,4048,7,43,0.009993028,450,3853
ZCTA5 53935,110,482,-372,294,37.2,291,0,0,0,939,-645
ZCTA5 53936,575,448,127,1313,55.9,1213,8,2,0.001523229,1170,143
ZCTA5 53937,370,1625,-1255,1124,35.2,1104,2,6,0.005338078,3752,-2628
ZCTA5 53939,126,609,-483,339,50.4,339,0,0,0,1329,-990
ZCTA5 53940,0,137,-137,0,-,0,0,0,#DIV/0!,288,-288
ZCTA5 53941,1123,2006,-883,3028,44.5,2906,13,6,0.001981506,4376,-1348
ZCTA5 53942,43,98,-55,126,44.4,124,0,0,0,251,-125
ZCTA5 53943,395,24,371,1245,35.5,1231,0,3,0.002409639,54,1191
ZCTA5 53944,935,5090,-4155,2355,43,2218,1,9,0.003821656,11234,-8879
ZCTA5 53946,1737,119,1618,4099,48.3,3816,0,66,0.016101488,229,3870
ZCTA5 53947,122,69,53,341,40.8,330,0,2,0.005865103,168,173
ZCTA5 53948,3259,245,3014,8320,46,7646,67,227,0.027283654,594,7726
ZCTA5 53949,2799,1088,1711,6364,51.8,6135,18,34,0.005342552,2368,3996
ZCTA5 53950,1943,2714,-771,5277,47.3,4680,35,314,0.059503506,6156,-879
ZCTA5 53951,930,896,34,2432,37.4,2248,3,13,0.005345395,2044,388
ZCTA5 53952,1260,128,1132,3987,44,3346,0,424,0.106345623,251,3736
ZCTA5 53953,90,1776,-1686,140,63.8,139,0,0,0,4275,-4135
ZCTA5 53954,2677,398,2279,6892,43.5,6571,51,27,0.003917586,1062,5830
ZCTA5 53955,2342,297,2045,5662,44.7,5381,3,88,0.015542211,800,4862
ZCTA5 53956,1228,617,611,3093,41.7,2958,1,12,0.003879728,1422,1671
ZCTA5 53959,5408,13,5395,14115,38.5,12957,24,65,0.00460503,26,14089
ZCTA5 53960,1383,728,655,3347,42.4,3276,0,6,0.00179265,1609,1738
ZCTA5 53961,397,854,-457,922,42.5,874,0,7,0.007592191,1727,-805
ZCTA5 53962,21,68,-47,24,61.5,24,0,0,0,204,-180
ZCTA5 53963,5141,142,4999,14172,38.6,13204,172,467,0.0329523,245,13927
ZCTA5 53964,1368,580,788,3467,41.3,3277,39,23,0.006633978,1581,1886
ZCTA5 53965,4727,242,4485,11201,47,10140,154,356,0.031782877,443,10758
ZCTA5 53968,864,146,718,2397,39.6,2251,5,1,0.000417188,298,2099
ZCTA5 53969,110,6759,-6649,318,56,308,0,0,0,15472,-15154
ZCTA5 54001,3187,763,2424,7934,46.8,7600,67,55,0.006932191,1692,6242
ZCTA5 54002,2495,1418,1077,6629,35.7,6401,36,86,0.012973299,3288,3341
ZCTA5 54003,420,1220,-800,1171,37.1,1110,0,2,0.001707942,2684,-1513
ZCTA5 54004,931,1242,-311,2280,44.2,2160,4,0,0,2653,-373
ZCTA5 54005,1154,1396,-242,3019,41.5,2805,5,0,0,3522,-503
ZCTA5 54006,333,514,-181,834,46.9,765,44,0,0,1039,-205
ZCTA5 54007,403,736,-333,963,49.1,918,3,0,0,1637,-674
ZCTA5 54009,931,13497,-12566,2655,37.7,2554,8,5,0.001883239,30384,-27729
ZCTA5 54011,2693,677,2016,6860,41.5,6591,12,43,0.006268222,1339,5521
ZCTA5 54013,1497,1266,231,3537,44.4,3318,44,6,0.001696353,3059,478
ZCTA5 54014,852,1531,-679,2179,46.4,2076,36,0,0,3422,-1243
ZCTA5 54015,1489,1762,-273,4016,36.5,3695,24,13,0.003237052,3619,397
ZCTA5 54016,12833,508,12325,33213,42.5,31398,448,129,0.003884021,1099,32114
ZCTA5 54017,7209,799,6410,19430,37.7,18184,75,213,0.010962429,1544,17886
ZCTA5 54020,3111,13188,-10077,7682,42.9,7394,8,34,0.004425931,38361,-30679
ZCTA5 54021,2847,9826,-6979,7195,41.4,6721,38,22,0.003057679,22504,-15309
ZCTA5 54022,8370,8489,-119,23511,31.9,21957,376,327,0.013908383,20723,2788
ZCTA5 54023,1696,906,790,4700,35.3,4378,118,41,0.008723404,2340,2360
ZCTA5 54024,2065,10548,-8483,4700,49.8,4619,5,16,0.003404255,25841,-21141
ZCTA5 54025,2739,7053,-4314,7130,40.9,6647,65,6,0.000841515,17412,-10282
ZCTA5 54026,906,13113,-12207,1962,52,1915,16,7,0.003567788,30958,-28996
ZCTA5 54027,421,15450,-15029,1020,47.9,989,5,3,0.002941176,41715,-40695
ZCTA5 54028,1013,513,500,2564,38.9,2467,8,3,0.001170047,1262,1302
ZCTA5 54082,565,579,-14,1468,45.8,1440,0,28,0.019073569,1527,-59
ZCTA5 54101,1116,3702,-2586,2957,42.1,2882,27,4,0.001352722,8892,-5935
ZCTA5 54102,421,241,180,747,62.7,728,0,1,0.001338688,531,216
ZCTA5 54103,215,154,61,536,59.4,536,0,0,0,407,129
ZCTA5 54104,570,3613,-3043,1095,65.2,1065,20,2,0.001826484,8984,-7889
ZCTA5 54106,2160,696,1464,5346,37.2,4951,12,0,0,1700,3646
ZCTA5 54107,1356,93,1263,3566,46.4,3463,11,0,0,235,3331
ZCTA5 54110,2157,423,1734,5762,39.2,5596,23,15,0.002603263,1115,4647
ZCTA5 54111,1007,84,923,2207,48.4,2128,0,0,0,207,2000
ZCTA5 54112,1145,33,1112,2767,41.4,2557,6,0,0,84,2683
ZCTA5 54113,1401,18019,-16618,3614,41.2,3416,0,1,0.000276702,42279,-38665
ZCTA5 54114,2675,7395,-4720,5843,54.1,5686,0,0,0,18825,-12982
ZCTA5 54115,18998,1549,17449,48107,37.4,42314,2158,465,0.009665953,3742,44365
ZCTA5 54119,248,1180,-932,787,51.1,738,17,8,0.010165184,2557,-1770
ZCTA5 54120,121,3092,-2971,240,58.9,240,0,0,0,8867,-8627
ZCTA5 54121,1490,862,628,3194,55.6,3078,0,21,0.006574828,1903,1291
ZCTA5 54123,78,2987,-2909,183,39.6,155,0,0,0,8297,-8114
ZCTA5 54124,1423,1490,-67,3340,46.2,2963,1,0,0,3422,-82
ZCTA5 54125,231,0,231,506,53.9,476,8,0,0,57,449
ZCTA5 54126,1541,1039,502,4179,41,3676,9,13,0.003110792,2450,1729
ZCTA5 54127,31,108,-77,72,31.9,72,0,0,0,262,-190
ZCTA5 54128,765,1361,-596,2106,44.9,1544,3,13,0.00617284,3258,-1152
ZCTA5 54129,1457,1267,190,3362,50.1,3196,3,16,0.004759072,3066,296
ZCTA5 54130,10828,10871,-43,27322,39.3,26638,20,2,7.32E-05,25646,1676
ZCTA5 54135,840,17405,-16565,2963,29.9,408,0,13,0.004387445,43223,-40260
ZCTA5 54136,2885,1251,1634,6893,40,6252,254,4,0.000580299,2706,4187
ZCTA5 54137,466,5622,-5156,1100,43.1,1077,6,0,0,14096,-12996
ZCTA5 54138,412,499,-87,871,58.8,859,0,0,0,1133,-262
ZCTA5 54139,1245,2956,-1711,3179,45.2,3049,0,14,0.004403901,7172,-3993
ZCTA5 54140,3732,395,3337,8522,35.3,7624,90,91,0.010678245,1001,7521
ZCTA5 54141,1058,557,501,2595,48.5,2392,0,64,0.024662813,1402,1193
ZCTA5 54143,6640,751,5889,14985,44.8,14294,30,204,0.013613614,2011,12974
ZCTA5 54149,590,216,374,1197,61.1,1186,0,0,0,522,675
ZCTA5 54150,316,1256,-940,1157,32.3,34,6,4,0.003457217,2920,-1763
ZCTA5 54151,1419,1298,121,3376,47.1,3270,0,24,0.007109005,3876,-500
ZCTA5 54152,96,4173,-4077,244,31,195,0,0,0,10738,-10494
ZCTA5 54153,3090,579,2511,7006,48.3,6513,38,41,0.005852127,1452,5554
ZCTA5 54154,2375,591,1784,5683,41,5429,49,8,0.001407707,1425,4258
ZCTA5 54155,2796,553,2243,7959,35.6,5163,224,29,0.003643674,1499,6460
ZCTA5 54156,686,69,617,1454,55.9,1408,11,1,0.000687758,132,1322
ZCTA5 54157,2481,6519,-4038,6002,39.4,5695,3,28,0.004665112,15655,-9653
ZCTA5 54159,568,2994,-2426,1345,52.6,1277,16,0,0,7188,-5843
ZCTA5 54160,107,1757,-1650,232,47.8,228,0,0,0,4664,-4432
ZCTA5 54161,1184,1436,-252,2652,50.2,2547,10,5,0.00188537,3192,-540
ZCTA5 54162,3410,0,3410,9501,36.3,8855,81,54,0.005683612,461,9040
ZCTA5 54165,3007,1872,1135,7973,39.8,6946,40,22,0.002759313,4310,3663
ZCTA5 54166,7006,1137,5869,16698,43,13851,115,153,0.009162774,2908,13790
ZCTA5 54169,1176,1230,-54,3173,43.7,3123,0,0,0,3514,-341
ZCTA5 54170,1505,1626,-121,3748,44,3549,5,0,0,4571,-823
ZCTA5 54171,1399,1465,-66,3852,38.5,3782,0,0,0,4024,-172
ZCTA5 54173,1408,1049,359,3728,44.1,3554,0,53,0.014216738,2585,1143
ZCTA5 54174,1408,5428,-4020,3089,53.4,2861,0,4,0.001294917,14754,-11665
ZCTA5 54175,600,3157,-2557,1165,65.5,1156,0,0,0,7996,-6831
ZCTA5 54177,1285,3299,-2014,2683,56.2,2587,16,0,0,9696,-7013
ZCTA5 54180,1191,694,497,3204,33.2,2890,48,31,0.009675406,2172,1032
ZCTA5 54201,2152,2742,-590,5347,47,5009,54,52,0.009725079,6623,-1276
ZCTA5 54202,844,9224,-8380,1631,56.5,1573,29,0,0,27693,-26062
ZCTA5 54204,773,11492,-10719,1840,50.4,1736,0,33,0.017934783,34369,-32529
ZCTA5 54205,780,305,475,2113,45.2,2037,10,9,0.004259347,851,1262
ZCTA5 54207,83,325,-242,179,46.5,175,1,0,0,840,-661
ZCTA5 54208,2270,724,1546,6193,41.4,5905,55,5,0.000807363,1866,4327
ZCTA5 54209,718,1132,-414,1492,61.2,1461,0,0,0,3473,-1981
ZCTA5 54210,361,10773,-10412,675,67.3,612,6,0,0,29787,-29112
ZCTA5 54211,154,10858,-10704,264,68.8,258,0,0,0,32031,-31767
ZCTA5 54212,368,8972,-8604,796,62.8,779,0,0,0,23283,-22487
ZCTA5 54213,578,173,405,1468,44.6,1379,0,0,0,440,1028
ZCTA5 54214,286,980,-694,466,59.5,443,18,0,0,2886,-2420
ZCTA5 54215,111,4,107,224,55.1,198,0,0,0,4,220
ZCTA5 54216,2584,527,2057,5977,47.1,5732,45,4,0.000669232,1294,4683
ZCTA5 54217,2824,763,2061,7688,40,7343,21,84,0.010926119,2118,5570
ZCTA5 54220,17278,1227,16051,40327,44.3,36153,1884,813,0.02016019,3284,37043
ZCTA5 54227,683,11207,-10524,1588,46.4,1539,9,0,0,29372,-27784
ZCTA5 54228,1194,17,1177,2895,47.9,2822,13,0,0,34,2861
ZCTA5 54229,2099,2112,-13,5143,42,4999,0,0,0,4862,281
ZCTA5 54230,1647,7192,-5545,4319,44.1,4056,33,2,0.00046307,20625,-16306
ZCTA5 54232,497,4511,-4014,870,52.7,858,0,0,0,12710,-11840
ZCTA5 54234,1062,3239,-2177,2124,59.7,2088,0,0,0,7899,-5775
ZCTA5 54235,8073,3081,4992,17952,50.5,16739,44,106,0.005904635,8821,9131
ZCTA5 54241,6503,1414,5089,14111,47.2,12986,147,152,0.010771738,3463,10648
ZCTA5 54245,867,15910,-15043,1972,46.5,1883,10,0,0,47414,-45442
ZCTA5 54246,451,3023,-2572,888,62.7,860,8,0,0,7636,-6748
ZCTA5 54247,981,1912,-931,2292,44.3,2230,5,0,0,5339,-3047
ZCTA5 54301,9660,1075,8585,21614,38.6,17938,357,778,0.035995188,2730,18884
ZCTA5 54302,12854,918,11936,31281,33,20579,1163,1498,0.047888495,2688,28593
ZCTA5 54303,12195,3911,8284,27634,34.9,21209,1076,1265,0.045776941,9706,17928
ZCTA5 54304,12486,767,11719,28057,39.1,21848,1106,872,0.031079588,1834,26223
ZCTA5 54307,0,339,-339,1343,35.3,467,0,786,0.585256888,982,361
ZCTA5 54311,14438,760,13678,37440,37.6,30996,2027,781,0.020860043,2355,35085
ZCTA5 54313,15137,1430,13707,39819,41.6,36129,589,485,0.012180115,3459,36360
ZCTA5 54401,13204,4924,8280,31304,39.7,25701,3776,192,0.006133401,13763,17541
ZCTA5 54403,10433,7905,2528,24774,42,21591,1589,115,0.004641963,24524,250
ZCTA5 54405,994,11380,-10386,2812,35.8,2265,2,172,0.06116643,28899,-26087
ZCTA5 54406,1632,3726,-2094,3890,45.6,3801,5,16,0.004113111,9147,-5257
ZCTA5 54407,532,385,147,1267,48,1253,6,0,0,1101,166
ZCTA5 54408,480,7782,-7302,1204,45.8,1131,37,4,0.003322259,18344,-17140
ZCTA5 54409,5594,9470,-3876,12997,45.1,12180,16,86,0.006616912,27374,-14377
ZCTA5 54410,826,1592,-766,2432,40.1,2365,1,5,0.002055921,5500,-3068
ZCTA5 54411,1902,2640,-738,5058,43,4993,3,8,0.001581653,7447,-2389
ZCTA5 54412,817,2209,-1392,2027,49.1,1969,1,0,0,5689,-3662
ZCTA5 54413,91,1446,-1355,192,52,178,0,0,0,4582,-4390
ZCTA5 54414,1277,1188,89,3359,44.1,3208,3,13,0.003870199,3116,243
ZCTA5 54416,651,786,-135,1563,44.9,837,3,2,0.001279591,2022,-459
ZCTA5 54417,8,8423,-8415,17,55.5,17,0,0,0,20308,-20291
ZCTA5 54418,346,8816,-8470,1005,44.9,918,0,27,0.026865672,21037,-20032
ZCTA5 54420,454,4684,-4230,1372,37.1,1251,9,0,0,12842,-11470
ZCTA5 54421,1237,2859,-1622,3834,36.2,3442,30,8,0.002086594,7674,-3840
ZCTA5 54422,441,995,-554,1437,22.3,1257,0,0,0,2392,-955
ZCTA5 54423,789,13382,-12593,2185,47.2,2157,4,0,0,34954,-32769
ZCTA5 54424,646,688,-42,1552,51.4,1436,4,14,0.009020619,1776,-224
ZCTA5 54425,723,176,547,1903,37.1,1867,0,0,0,439,1464
ZCTA5 54426,1672,159,1513,4215,42.4,4127,10,0,0,382,3833
ZCTA5 54427,461,586,-125,1105,45.5,1077,3,3,0.002714932,1554,-449
ZCTA5 54428,455,699,-244,965,58.6,955,8,0,0,2018,-1053
ZCTA5 54430,54,160,-106,126,47.5,110,0,0,0,424,-298
ZCTA5 54433,656,4033,-3377,1839,42.5,1821,0,0,0,11042,-9203
ZCTA5 54435,838,3620,-2782,2007,51.4,1923,3,26,0.012954659,5621,-3614
ZCTA5 54436,775,9196,-8421,2185,37.4,2130,9,1,0.000457666,16986,-14801
ZCTA5 54437,1145,4818,-3673,3016,35.3,2941,0,0,0,13526,-10510
ZCTA5 54440,1088,17261,-16173,2729,43,2608,25,6,0.002198608,43700,-40971
ZCTA5 54441,355,10759,-10404,898,38.8,877,3,1,0.001113586,27055,-26157
ZCTA5 54442,527,18044,-17517,1482,51.2,1217,2,97,0.065452092,54382,-52900
ZCTA5 54443,849,5490,-4641,2078,47.1,1974,30,23,0.011068335,15664,-13586
ZCTA5 54446,1118,6184,-5066,3322,31.2,3238,0,14,0.004214329,15368,-12046
ZCTA5 54447,201,12518,-12317,470,53.5,453,0,14,0.029787234,31356,-30886
ZCTA5 54448,1684,15590,-13906,4296,45.7,4181,45,5,0.001163873,37399,-33103
ZCTA5 54449,11462,0,11462,25954,44.2,24285,589,266,0.010248902,0,25954
ZCTA5 54450,156,16917,-16761,420,39.2,370,0,0,0,43423,-43003
ZCTA5 54451,4346,17312,-12966,10963,44.6,10600,45,7,0.000638511,38991,-28028
ZCTA5 54452,8030,1477,6553,18920,46.6,18253,114,71,0.003752643,2847,16073
ZCTA5 54454,525,3088,-2563,1351,41.7,1311,2,1,0.000740192,8811,-7460
ZCTA5 54455,7633,11254,-3621,19178,40.2,18054,231,84,0.004380019,24622,-5444
ZCTA5 54456,2455,16146,-13691,5710,45,5444,19,29,0.005078809,42476,-36766
ZCTA5 54457,3752,12269,-8517,8111,54.5,7432,126,47,0.0057946,27915,-19804
ZCTA5 54458,52,14717,-14665,115,32.5,115,0,0,0,39120,-39005
ZCTA5 54459,561,1714,-1153,1282,48.4,1220,0,25,0.01950078,4261,-2979
ZCTA5 54460,912,3561,-2649,2739,40.6,2624,9,15,0.005476451,8012,-5273
ZCTA5 54462,163,12545,-12382,379,52.5,365,0,0,0,30430,-30051
ZCTA5 54463,373,9130,-8757,680,60.2,667,0,0,0,26096,-25416
ZCTA5 54464,25,19060,-19035,88,28.6,88,0,0,0,49336,-49248
ZCTA5 54465,322,16053,-15731,629,64.3,625,2,0,0,42918,-42289
ZCTA5 54466,1120,10699,-9579,2704,48.9,2656,0,0,0,25266,-22562
ZCTA5 54467,6072,7120,-1048,14557,36.8,13312,379,137,0.00941128,16893,-2336
ZCTA5 54469,730,10929,-10199,1894,41.6,1689,10,4,0.002111932,28365,-26471
ZCTA5 54470,814,6645,-5831,2066,46,1954,30,0,0,19240,-17174
ZCTA5 54471,621,5481,-4860,1727,46,1630,44,22,0.012738854,16763,-15036
ZCTA5 54473,1012,69,943,2606,46.9,2570,0,0,0,153,2453
ZCTA5 54474,1928,0,1928,4441,40.4,4266,111,14,0.003152443,0,4441
ZCTA5 54475,580,3508,-2928,1425,51.8,1411,4,1,0.000701754,10412,-8987
ZCTA5 54476,7948,2883,5065,19451,37.7,16796,1529,382,0.019639093,7098,12353
ZCTA5 54479,1375,17161,-15786,3596,36.2,3486,13,5,0.001390434,46429,-42833
ZCTA5 54480,526,15060,-14534,1413,40.2,1413,0,0,0,46030,-44617
ZCTA5 54481,11491,9017,2474,27894,29.4,24862,1307,376,0.013479601,18350,9544
ZCTA5 54482,4049,6581,-2532,9516,44.7,8633,365,14,0.001471206,16069,-6553
ZCTA5 54484,2437,1351,1086,5630,43.3,5166,30,10,0.001776199,3433,2197
ZCTA5 54485,154,2851,-2697,313,62.5,313,0,0,0,8834,-8521
ZCTA5 54486,915,5911,-4996,2099,50.8,1911,72,0,0,18465,-16366
ZCTA5 54487,4191,679,3512,9914,50.9,9555,27,27,0.002723421,1454,8460
ZCTA5 54488,459,11801,-11342,1107,41.5,1030,2,9,0.008130081,32426,-31319
ZCTA5 54489,638,642,-4,1503,44.7,1412,1,0,0,1566,-63
ZCTA5 54490,374,8561,-8187,953,48.2,878,0,0,0,23526,-22573
ZCTA5 54491,724,559,165,1496,56.1,1344,0,7,0.004679144,1416,80
ZCTA5 54493,277,1465,-1188,621,49.8,608,2,0,0,4836,-4215
ZCTA5 54494,11688,8706,2982,27373,45.2,25388,513,95,0.003470573,23198,4175
ZCTA5 54495,3396,7035,-3639,7812,36.4,6771,404,95,0.012160778,19310,-11498
ZCTA5 54498,831,9720,-8889,2446,37,2328,2,12,0.004905969,25449,-23003
ZCTA5 54499,1161,1812,-651,2775,49.9,2543,0,26,0.009369369,5180,-2405
ZCTA5 54501,8551,1743,6808,21172,46.9,20184,67,118,0.005573399,4641,16531
ZCTA5 54511,577,1859,-1282,1505,48.2,1345,20,8,0.005315615,5402,-3897
ZCTA5 54512,583,1128,-545,1393,53.2,1366,0,0,0,3181,-1788
ZCTA5 54513,248,543,-295,431,59.1,427,0,0,0,1278,-847
ZCTA5 54514,945,1756,-811,2039,55.3,2002,2,0,0,4525,-2486
ZCTA5 54515,264,1248,-984,558,55,537,0,0,0,3271,-2713
ZCTA5 54517,89,3102,-3013,186,66.2,175,6,0,0,8623,-8437
ZCTA5 54519,559,775,-216,1196,56.5,1090,0,0,0,1937,-741
ZCTA5 54520,1497,12708,-11211,3793,42.1,2755,0,35,0.009227524,35709,-31916
ZCTA5 54521,3787,6801,-3014,8292,54.2,7806,25,44,0.005306319,17892,-9600
ZCTA5 54524,333,688,-355,688,52.6,666,0,0,0,1754,-1066
ZCTA5 54525,114,351,-237,264,35.8,227,0,0,0,903,-639
ZCTA5 54526,310,1196,-886,719,52.3,705,4,0,0,2888,-2169
ZCTA5 54527,410,651,-241,839,55.4,801,2,8,0.009535161,1591,-752
ZCTA5 54529,440,3162,-2722,1168,54.8,1111,22,2,0.001712329,8062,-6894
ZCTA5 54530,344,17949,-17605,712,55.9,696,1,0,0,44607,-43895
ZCTA5 54531,546,396,150,1292,56.7,1271,9,0,0,990,302
ZCTA5 54534,1163,387,776,2582,51.8,2445,27,6,0.00232378,983,1599
ZCTA5 54536,88,2136,-2048,172,47.9,171,0,0,0,6364,-6192
ZCTA5 54537,229,945,-716,593,50,584,2,0,0,2717,-2124
ZCTA5 54538,1376,852,524,2943,44.9,1122,14,7,0.002378525,2105,838
ZCTA5 54539,544,11403,-10859,1274,57.5,1194,5,17,0.013343799,24724,-23450
ZCTA5 54540,414,6763,-6349,840,60.6,761,0,0,0,15130,-14290
ZCTA5 54541,502,8654,-8152,1451,43.2,1221,32,3,0.00206754,21736,-20285
ZCTA5 54542,229,5996,-5767,544,52.3,433,0,0,0,16180,-15636
ZCTA5 54545,483,10513,-10030,900,62.9,853,0,0,0,29533,-28633
ZCTA5 54546,501,1511,-1010,1111,51.9,1052,6,0,0,3818,-2707
ZCTA5 54547,639,7629,-6990,1362,61,1334,4,2,0.001468429,18228,-16866
ZCTA5 54548,2472,2876,-404,5601,55.5,5101,29,40,0.007141582,8714,-3113
ZCTA5 54550,260,1259,-999,585,47.8,572,1,0,0,3377,-2792
ZCTA5 54552,2137,1017,1120,4246,52.5,4001,42,0,0,2722,1524
ZCTA5 54554,500,4008,-3508,1056,58.1,988,9,10,0.009469697,9789,-8733
ZCTA5 54555,2164,2206,-42,4759,51.1,4475,35,0,0,6220,-1461
ZCTA5 54556,542,1190,-648,1164,49.9,1113,2,13,0.011168385,3436,-2272
ZCTA5 54557,465,1972,-1507,999,65.5,949,0,7,0.007007007,5096,-4097
ZCTA5 54558,1108,2167,-1059,2137,57.2,1963,9,0,0,5678,-3541
ZCTA5 54559,378,908,-530,919,45.4,553,0,0,0,2593,-1674
ZCTA5 54560,319,6731,-6412,635,57.1,580,0,36,0.056692913,18764,-18129
ZCTA5 54561,32,1550,-1518,71,63.4,71,0,0,0,4569,-4498
ZCTA5 54562,812,6111,-5299,1763,61,1728,8,1,0.000567215,14544,-12781
ZCTA5 54563,316,214,102,811,40.7,773,9,2,0.002466091,598,213
ZCTA5 54564,181,408,-227,367,58.5,345,0,16,0.04359673,1053,-686
ZCTA5 54565,25,845,-820,48,62.3,47,0,0,0,2111,-2063
ZCTA5 54566,640,13046,-12406,1381,47.9,969,0,0,0,33481,-32100
ZCTA5 54568,2062,345,1717,4888,49.6,4742,0,0,0,846,4042
ZCTA5 54601,20886,6298,14588,51393,30.7,46720,1968,955,0.018582297,16761,34632
ZCTA5 54603,6672,10668,-3996,14198,38.3,12389,513,311,0.021904494,30281,-16083
ZCTA5 54610,687,2032,-1345,1561,53.7,1507,0,6,0.00384369,5330,-3769
ZCTA5 54611,461,4189,-3728,1291,34,1147,0,7,0.005422153,12327,-11036
ZCTA5 54612,2105,1372,733,5671,35.2,4454,0,9,0.001587022,4368,1303
ZCTA5 54613,855,5363,-4508,1851,55.9,1794,0,0,0,16325,-14474
ZCTA5 54614,1014,8885,-7871,2436,41.1,2328,60,6,0.002463054,26703,-24267
ZCTA5 54615,4234,14161,-9927,11024,43.4,8905,78,346,0.031386067,40784,-29760
ZCTA5 54616,971,885,86,2502,35.7,2364,0,7,0.002797762,2171,331
ZCTA5 54618,828,1285,-457,2314,37.7,2106,42,20,0.008643042,3187,-873
ZCTA5 54619,1288,942,346,3713,35.5,3320,0,31,0.008349044,1726,1987
ZCTA5 54621,471,521,-50,1394,32.5,1388,0,0,0,1341,53
ZCTA5 54622,857,2041,-1184,1966,49.4,1929,0,18,0.009155646,6447,-4481
ZCTA5 54623,831,4506,-3675,2075,45.2,2018,6,0,0,12439,-10364
ZCTA5 54624,691,2181,-1490,1496,55.3,1473,0,0,0,5568,-4072
ZCTA5 54625,220,1018,-798,305,66.7,304,1,0,0,2600,-2295
ZCTA5 54626,601,894,-293,1457,43.5,1414,13,4,0.002745367,2253,-796
ZCTA5 54627,855,5981,-5126,2009,48,1968,0,23,0.011448482,14389,-12380
ZCTA5 54628,424,1145,-721,955,59.6,930,0,0,0,2679,-1724
ZCTA5 54629,1081,959,122,2610,48.8,2514,0,24,0.009195402,2274,336
ZCTA5 54630,1630,1008,622,4126,42.3,3955,62,2,0.000484731,2875,1251
ZCTA5 54631,683,5253,-4570,1734,50.5,1579,36,25,0.014417532,15782,-14048
ZCTA5 54632,450,4691,-4241,1150,47.7,1105,2,6,0.005217391,7157,-6007
ZCTA5 54634,1515,290,1225,4238,38.7,4060,25,0,0,381,3857
ZCTA5 54635,650,9836,-9186,1707,49.6,1628,32,3,0.001757469,14489,-12782
ZCTA5 54636,6061,12116,-6055,16394,38.6,14558,971,207,0.012626571,27265,-10871
ZCTA5 54637,87,7281,-7194,176,44.5,169,2,0,0,15105,-14929
ZCTA5 54638,593,14988,-14395,1483,46,1417,15,6,0.004045853,32084,-30601
ZCTA5 54639,1023,14117,-13094,2457,39.5,2416,4,6,0.002442002,37364,-34907
ZCTA5 54642,789,15163,-14374,2267,35.2,2122,11,3,0.001323335,31401,-29134
ZCTA5 54643,0,4920,-4920,0,-,0,0,0,#DIV/0!,12698,-12698
ZCTA5 54644,496,8705,-8209,1353,43.2,1173,91,0,0,19712,-18359
ZCTA5 54645,47,8840,-8793,69,48.9,69,0,0,0,27739,-27670
ZCTA5 54646,1631,7892,-6261,4230,46.2,4004,14,28,0.006619385,21306,-17076
ZCTA5 54648,528,6271,-5743,1665,35.1,1410,2,0,0,13073,-11408
ZCTA5 54650,10663,9654,1009,24327,40.7,21692,1398,469,0.01927899,27104,-2777
ZCTA5 54651,450,1018,-568,1291,33.6,1209,7,6,0.00464756,2905,-1614
ZCTA5 54652,378,14767,-14389,1154,35,1135,2,8,0.006932409,29587,-28433
ZCTA5 54653,445,11099,-10654,1135,34.1,1096,0,12,0.010572687,24963,-23828
ZCTA5 54654,59,13394,-13335,140,55.3,140,0,0,0,29981,-29841
ZCTA5 54655,641,10853,-10212,1792,42,1717,13,12,0.006696429,26733,-24941
ZCTA5 54656,6863,8996,-2133,18115,39.6,16758,146,320,0.017664919,21343,-3228
ZCTA5 54657,128,11320,-11192,351,42.1,348,0,2,0.005698006,26914,-26563
ZCTA5 54658,1040,12003,-10963,2614,43.3,2467,4,16,0.006120888,28261,-25647
ZCTA5 54659,498,14864,-14366,1371,36.8,1355,0,0,0,35525,-34154
ZCTA5 54660,6767,3447,3320,16074,42.2,14546,82,421,0.026191365,10015,6059
ZCTA5 54661,1531,3944,-2413,3789,42.5,3668,22,3,0.000791766,9452,-5663
ZCTA5 54664,606,11307,-10701,1723,38.6,1669,9,1,0.000580383,25093,-23370
ZCTA5 54665,3488,9563,-6075,8554,43.3,7978,27,18,0.002104279,22282,-13728
ZCTA5 54666,1081,11751,-10670,2761,46.2,2580,6,36,0.013038754,29911,-27150
ZCTA5 54667,1845,10057,-8212,5058,40.1,4944,13,6,0.00118624,27224,-22166
ZCTA5 54669,3083,7998,-4915,8247,42.9,7547,239,16,0.001940099,22277,-14030
ZCTA5 54670,502,7774,-7272,1810,28.2,1666,27,18,0.009944751,18175,-16365
ZCTA5 54701,16576,12600,3976,41633,33.9,37879,1397,600,0.014411645,30321,11312
ZCTA5 54703,17729,13321,4408,43399,34.6,37515,2696,627,0.014447337,33953,9446
ZCTA5 54720,3549,10639,-7090,8507,37.5,7598,108,141,0.016574586,28227,-19720
ZCTA5 54721,520,6354,-5834,1475,43.4,1432,3,0,0,11954,-10479
ZCTA5 54722,1489,5434,-3945,4011,37.1,3926,3,0,0,12761,-8750
ZCTA5 54723,438,7958,-7520,1017,44.3,1005,4,0,0,18034,-17017
ZCTA5 54724,2807,7236,-4429,7483,37.3,7403,18,1,0.000133636,16654,-9171
ZCTA5 54725,1328,3457,-2129,3045,44.4,2955,8,0,0,8772,-5727
ZCTA5 54726,694,7498,-6804,1815,36.2,1788,0,6,0.003305785,17807,-15992
ZCTA5 54727,1903,5383,-3480,4625,43.7,4447,13,16,0.003459459,12970,-8345
ZCTA5 54728,2483,10936,-8453,5972,49.9,5774,33,34,0.005693235,33054,-27082
ZCTA5 54729,14209,4944,9265,33977,42.3,31921,428,487,0.014333225,14079,19898
ZCTA5 54730,1992,3315,-1323,5258,40.8,4881,145,17,0.003233169,9808,-4550
ZCTA5 54731,313,7660,-7347,717,54.2,688,0,0,0,19467,-18750
ZCTA5 54732,1168,8483,-7315,3041,38.4,2955,13,21,0.006905623,21183,-18142
ZCTA5 54733,483,10105,-9622,1318,45.9,1247,1,0,0,27786,-26468
ZCTA5 54734,287,8567,-8280,683,47.5,658,0,0,0,23918,-23235
ZCTA5 54736,1790,26,1764,4218,44.9,4040,23,9,0.002133713,59,4159
ZCTA5 54737,216,3032,-2816,622,37.9,618,0,0,0,7359,-6737
ZCTA5 54738,1259,0,1259,3547,38.7,3484,5,5,0.001409642,1960,1587
ZCTA5 54739,1920,45,1875,5358,36.7,4975,129,15,0.002799552,122,5236
ZCTA5 54740,800,105,695,1949,45.4,1866,0,0,0,156,1793
ZCTA5 54741,650,221,429,1850,33.7,1700,0,0,0,510,1340
ZCTA5 54742,1813,1677,136,5149,40.8,4985,10,17,0.003301612,3436,1713
ZCTA5 54745,907,269,638,2203,56.6,2191,2,0,0,505,1698
ZCTA5 54746,291,121,170,686,45.3,656,5,0,0,192,494
ZCTA5 54747,1036,64,972,2427,45.8,2208,0,54,0.022249691,136,2291
ZCTA5 54748,560,118,442,1256,49.7,1191,48,0,0,222,1034
ZCTA5 54749,577,324,253,1525,39,1220,3,63,0.041311475,610,915
ZCTA5 54750,409,117,292,1041,45.2,1023,0,2,0.00192123,235,806
ZCTA5 54751,9764,1262,8502,26145,30.4,24087,1052,251,0.009600306,2586,23559
ZCTA5 54754,656,122,534,1691,50,1416,0,4,0.002365464,228,1463
ZCTA5 54755,2912,3186,-274,7161,41.4,6949,12,59,0.008239073,6998,163
ZCTA5 54756,413,187,226,950,53.5,901,0,0,0,448,502
ZCTA5 54757,1430,349,1081,3544,42.8,3423,25,8,0.002257336,734,2810
ZCTA5 54758,1947,597,1350,4760,44,4633,45,6,0.001260504,1280,3480
ZCTA5 54759,605,1565,-960,1373,52.8,1317,0,15,0.010924982,3323,-1950
ZCTA5 54760,85,831,-746,186,63,186,0,0,0,1657,-1471
ZCTA5 54761,463,1353,-890,1238,34.2,1210,2,0,0,3561,-2323
ZCTA5 54762,525,569,-44,1296,47.9,1249,5,0,0,1148,148
ZCTA5 54763,478,1740,-1262,1125,44.4,1096,2,0,0,4130,-3005
ZCTA5 54766,725,489,236,1873,44.3,1789,0,15,0.008008542,1214,659
ZCTA5 54767,1387,169,1218,3369,43.2,3166,36,0,0,570,2799
ZCTA5 54768,1776,249,1527,6494,38.3,5559,48,474,0.072990453,630,5864
ZCTA5 54769,271,401,-130,585,56.2,575,2,5,0.008547009,1076,-491
ZCTA5 54770,790,141,649,2105,37.1,1958,13,2,0.000950119,357,1748
ZCTA5 54771,1514,119,1395,4467,35.2,4379,33,0,0,252,4215
ZCTA5 54772,416,1218,-802,1044,42.3,1036,0,0,0,2974,-1930
ZCTA5 54773,1329,2646,-1317,3519,39.9,3311,0,37,0.010514351,5942,-2423
ZCTA5 54801,2809,6952,-4143,6292,53.7,5809,56,104,0.016528926,17040,-10748
ZCTA5 54805,656,1365,-709,1593,44.3,1508,2,26,0.016321406,3237,-1644
ZCTA5 54806,4713,483,4230,11395,40.2,9381,99,123,0.010794208,1105,10290
ZCTA5 54810,1054,1146,-92,2678,43.8,2498,2,31,0.011575803,2368,310
ZCTA5 54812,2177,356,1821,6018,37,4841,72,586,0.097374543,834,5184
ZCTA5 54813,234,66,168,623,46.8,617,0,0,0,119,504
ZCTA5 54814,1298,396,902,2921,51.2,1501,34,81,0.027730229,926,1995
ZCTA5 54817,934,2787,-1853,2066,55.4,1975,8,0,0,5987,-3921
ZCTA5 54819,1039,632,407,2410,51.1,2282,7,3,0.001244813,1366,1044
ZCTA5 54820,383,1673,-1290,752,51.3,674,0,2,0.002659574,4633,-3881
ZCTA5 54821,680,2801,-2121,1377,59.9,1325,6,0,0,6219,-4842
ZCTA5 54822,1896,812,1084,4721,44.4,4380,41,90,0.019063758,1892,2829
ZCTA5 54824,999,658,341,2318,48.1,2217,5,11,0.00474547,1389,929
ZCTA5 54826,291,210,81,698,53.8,625,0,4,0.005730659,512,186
ZCTA5 54827,177,1435,-1258,333,53.7,319,0,0,0,3087,-2754
ZCTA5 54828,340,125,215,772,41.8,250,0,0,0,303,469
ZCTA5 54829,2255,8613,-6358,5573,45.5,5032,6,34,0.006100843,20590,-15017
ZCTA5 54830,1571,7903,-6332,3134,63.8,2912,8,12,0.003828973,17149,-14015
ZCTA5 54832,165,681,-516,376,53,375,0,0,0,1517,-1141
ZCTA5 54835,454,258,196,951,53.7,842,5,0,0,551,400
ZCTA5 54836,382,831,-449,1035,44.8,1015,0,0,0,1967,-932
ZCTA5 54837,1550,656,894,3718,51.3,3577,16,21,0.005648198,1511,2207
ZCTA5 54838,500,201,299,1117,61,1003,4,6,0.005371531,394,723
ZCTA5 54839,129,454,-325,304,48.3,273,0,0,0,1044,-740
ZCTA5 54840,1815,187,1628,4624,42.9,4326,13,36,0.007785467,359,4265
ZCTA5 54841,133,377,-244,272,42,256,0,0,0,953,-681
ZCTA5 54842,58,69,-11,190,36.9,190,0,0,0,161,29
ZCTA5 54843,5495,1481,4014,12610,48.8,9976,60,32,0.002537669,2981,9629
ZCTA5 54844,117,268,-151,237,62.5,232,0,5,0.021097046,590,-353
ZCTA5 54845,40,259,-219,122,37.5,96,0,0,0,555,-433
ZCTA5 54846,254,360,-106,603,47.5,556,0,0,0,790,-187
ZCTA5 54847,1162,21,1141,2360,54.6,2214,4,12,0.005084746,43,2317
ZCTA5 54848,2543,1582,961,5891,46.4,5601,35,77,0.013070786,4630,1261
ZCTA5 54849,811,1410,-599,1710,55.2,1636,0,2,0.001169591,2874,-1164
ZCTA5 54850,151,1027,-876,300,58.8,273,2,0,0,2459,-2159
ZCTA5 54853,1596,807,789,3805,50.1,3556,9,6,0.001576873,1828,1977
ZCTA5 54854,355,37,318,965,39.1,908,0,12,0.012435233,74,891
ZCTA5 54855,291,600,-309,1005,25.5,990,0,2,0.00199005,1177,-172
ZCTA5 54856,670,1425,-755,1635,52.1,1542,9,11,0.006727829,3846,-2211
ZCTA5 54857,7,63,-56,15,-,15,0,0,0,223,-208
ZCTA5 54858,723,262,461,1622,44.3,1473,0,13,0.008014797,565,1057
ZCTA5 54859,1010,187,823,2073,57,1945,22,6,0.002894356,469,1604
ZCTA5 54861,70,1052,-982,251,34.2,9,0,19,0.075697211,2494,-2243
ZCTA5 54862,149,33,116,294,57.5,285,1,0,0,74,220
ZCTA5 54864,554,96,458,1456,46.4,1281,5,38,0.026098901,181,1275
ZCTA5 54865,275,128,147,521,55.8,494,0,12,0.02303263,343,178
ZCTA5 54867,211,244,-33,579,30.3,394,1,0,0,454,125
ZCTA5 54868,6603,938,5665,15756,41.9,15241,106,44,0.002792587,1908,13848
ZCTA5 54870,756,4809,-4053,1733,54.7,1709,2,0,0,10053,-8320
ZCTA5 54871,1193,236,957,3236,42.7,3036,26,4,0.001236094,513,2723
ZCTA5 54872,1201,674,527,2855,51.6,2652,5,21,0.007355517,1655,1200
ZCTA5 54873,1417,587,830,3294,56.1,3144,26,26,0.007893139,1591,1703
ZCTA5 54874,1547,201,1346,3996,45.7,3727,6,16,0.004004004,525,3471
ZCTA5 54875,548,1297,-749,1282,52.4,1226,3,0,0,2243,-961
ZCTA5 54876,760,6974,-6214,1897,50.2,1406,1,7,0.003690037,17510,-15613
ZCTA5 54880,13163,5751,7412,30211,39.6,27597,526,501,0.016583364,14108,16103
ZCTA5 54888,563,5210,-4647,1293,55.5,1214,0,0,0,10398,-9105
ZCTA5 54889,1234,4355,-3121,2820,48.7,2710,21,0,0,9848,-7028
ZCTA5 54891,1477,4317,-2840,3315,49.2,2917,14,50,0.015082956,9686,-6371
ZCTA5 54893,1736,2477,-741,3922,53.7,3393,23,33,0.008414074,5861,-1939
ZCTA5 54895,378,3506,-3128,895,57.3,876,0,0,0,8673,-7778
ZCTA5 54896,732,10235,-9503,1395,62.2,1304,12,21,0.015053763,26499,-25104
ZCTA5 54901,13583,3383,10200,37640,31,32077,1373,2325,0.061769394,10975,26665
ZCTA5 54902,9800,13,9787,21670,39.4,19374,723,603,0.027826488,714,20956
ZCTA5 54904,9683,20439,-10756,22610,44.6,21316,883,67,0.002963291,51007,-28397
ZCTA5 54909,804,9207,-8403,1968,43.1,1867,4,17,0.008638211,22853,-20885
ZCTA5 54911,10268,9705,563,25623,36.3,21923,1619,614,0.023962846,26193,-570
ZCTA5 54913,9229,0,9229,23419,39.4,20979,1157,548,0.023399804,0,23419
ZCTA5 54914,13661,7495,6166,31359,37.1,25768,1918,927,0.029560892,18023,13336
ZCTA5 54915,17087,566,16521,43089,38.3,37436,2181,753,0.017475458,1445,41644
ZCTA5 54921,552,551,1,1382,41.9,1198,2,7,0.005065123,1517,-135
ZCTA5 54922,486,11775,-11289,1210,48.3,1091,0,1,0.000826446,28617,-27407
ZCTA5 54923,3641,1406,2235,8850,42.3,8345,60,30,0.003389831,3686,5164
ZCTA5 54926,71,438,-367,132,60.2,124,0,0,0,1035,-903
ZCTA5 54927,159,427,-268,359,50.2,333,3,0,0,1033,-674
ZCTA5 54928,168,2542,-2374,513,40.8,479,8,0,0,7027,-6514
ZCTA5 54929,3938,2030,1908,8951,45.1,8572,20,2,0.000223439,5009,3942
ZCTA5 54930,685,326,359,1843,40.7,1797,13,0,0,859,984
ZCTA5 54931,154,1731,-1577,417,37.3,417,0,0,0,4328,-3911
ZCTA5 54932,441,489,-48,1295,44.4,1046,31,0,0,1391,-96
ZCTA5 54933,134,437,-303,320,33.5,315,0,0,0,1178,-858
ZCTA5 54935,17641,290,17351,42454,37.8,37561,904,1356,0.031940453,739,41715
ZCTA5 54937,8396,1491,6905,21192,44.4,19266,279,266,0.012551906,3984,17208
ZCTA5 54940,1860,424,1436,4656,47.6,4364,157,0,0,1160,3496
ZCTA5 54941,1165,142,1023,2431,55.1,2367,0,27,0.011106541,304,2127
ZCTA5 54942,3947,817,3130,10707,38.6,9927,476,28,0.002615112,2243,8464
ZCTA5 54943,839,98,741,2118,51.4,2031,0,2,0.000944287,279,1839
ZCTA5 54944,3369,1348,2021,9001,44.2,8804,30,0,0,3542,5459
ZCTA5 54945,1536,354,1182,3415,46.8,3292,16,7,0.00204978,879,2536
ZCTA5 54946,0,736,-736,559,83.4,535,1,10,0.017889088,1833,-1274
ZCTA5 54947,989,851,138,2242,46.9,2179,4,0,0,2086,156
ZCTA5 54948,88,955,-867,186,50.7,182,0,0,0,2647,-2461
ZCTA5 54949,1530,370,1160,3438,45.3,3265,4,7,0.002036067,784,2654
ZCTA5 54950,1047,1227,-180,2447,47,2381,0,0,0,2976,-529
ZCTA5 54952,11961,2634,9327,27186,38.9,23311,936,412,0.015154859,6998,20188
ZCTA5 54956,19100,599,18501,46109,37.9,42401,595,944,0.020473226,1329,44780
ZCTA5 54960,1148,1330,-182,2476,59.2,2333,15,3,0.001211632,3310,-834
ZCTA5 54961,5677,3076,2601,14153,39.9,12937,210,114,0.008054829,7673,6480
ZCTA5 54962,426,732,-306,1080,43.2,1073,0,0,0,1692,-612
ZCTA5 54963,2996,41,2955,7351,40.8,7190,26,48,0.006529724,83,7268
ZCTA5 54964,354,660,-306,962,43.5,932,0,0,0,1485,-523
ZCTA5 54965,579,916,-337,1297,53.5,1270,0,9,0.00693909,2563,-1266
ZCTA5 54966,779,356,423,2058,40.2,1871,29,12,0.005830904,879,1179
ZCTA5 54967,202,612,-410,455,55.2,395,0,0,0,1396,-941
ZCTA5 54968,1235,940,295,2840,49.7,2660,0,53,0.018661972,2770,70
ZCTA5 54970,1318,741,577,3945,47.7,3264,16,380,0.096324461,1800,2145
ZCTA5 54971,4436,283,4153,10599,44,10116,47,56,0.005283517,741,9858
ZCTA5 54974,616,768,-152,1675,47,1638,0,10,0.005970149,2137,-462
ZCTA5 54977,614,1136,-522,1410,48.2,1363,3,6,0.004255319,3104,-1694
ZCTA5 54978,28,200,-172,86,54.6,67,0,0,0,497,-411
ZCTA5 54979,642,317,325,1463,48.6,1384,35,0,0,781,682
ZCTA5 54980,151,2075,-1924,234,65.9,234,0,0,0,5126,-4892
ZCTA5 54981,6885,1648,5237,14867,46.9,14107,190,241,0.016210399,4356,10511
ZCTA5 54982,2963,1015,1948,6941,50.3,6143,36,9,0.001296643,2340,4601
ZCTA5 54983,1767,329,1438,4378,45.9,4171,0,1,0.000228415,883,3495
ZCTA5 54984,1365,68,1297,3169,51,2932,8,38,0.011991164,164,3005
ZCTA5 54985,0,479,-479,270,37,195,5,65,0.240740741,1230,-960
ZCTA5 54986,2252,412,1840,5535,50.7,5359,61,5,0.000903342,1098,4437
ZCTA5 55001,1179,1191,-12,2960,50.9,2795,33,23,0.00777027,3287,-327
ZCTA5 55003,1014,1621,-607,3801,39,2829,43,616,0.162062615,4902,-1101
ZCTA5 55005,1580,111,1469,4496,37.4,4006,21,138,0.03069395,275,4221
ZCTA5 55006,1376,912,464,3537,38.4,3341,6,15,0.004240882,2186,1351
ZCTA5 55007,954,1736,-782,2316,48.4,2174,0,22,0.009499136,4202,-1886
ZCTA5 55008,6147,2931,3216,15321,40.5,14211,505,223,0.014555186,7477,7844
ZCTA5 55009,3277,68,3209,8060,43.6,7652,45,12,0.001488834,211,7849
ZCTA5 55011,3817,331,3486,10844,40.3,10015,455,13,0.00119882,1043,9801
ZCTA5 55012,683,1806,-1123,1923,49.2,1797,6,30,0.015600624,3975,-2052
ZCTA5 55013,2644,208,2436,6828,42.5,6317,135,2,0.000292912,459,6369
ZCTA5 55014,10394,593,9801,28711,41.3,25079,1047,932,0.032461426,1445,27266
ZCTA5 55016,12719,745,11974,38162,36.3,31472,2604,1924,0.050416645,2051,36111
ZCTA5 55017,300,13758,-13458,834,41.7,793,17,0,0,35855,-35021
ZCTA5 55018,381,405,-24,937,48.9,903,3,0,0,983,-46
ZCTA5 55019,751,527,224,2099,40.1,1978,53,4,0.001905669,1214,885
ZCTA5 55020,1373,1936,-563,4349,33.6,4162,61,0,0,4923,-574
ZCTA5 55021,11406,17460,-6054,30837,40.2,24076,435,3584,0.116224017,46348,-15511
ZCTA5 55024,12212,5828,6384,36504,35.2,32613,1004,807,0.022107166,14207,22297
ZCTA5 55025,9845,9312,533,25428,38.9,22402,801,613,0.024107283,21217,4211
ZCTA5 55026,160,659,-499,498,39.6,476,1,0,0,1637,-1139
ZCTA5 55027,981,531,450,2862,33.2,2672,7,0,0,1268,1594
ZCTA5 55029,26,3287,-3261,101,13.8,82,0,0,0,8788,-8687
ZCTA5 55030,486,1942,-1456,1346,38.2,1324,0,0,0,4420,-3074
ZCTA5 55031,651,326,325,1748,40.5,1663,9,21,0.01201373,688,1060
ZCTA5 55032,1283,396,887,3440,43.3,3265,27,30,0.00872093,1009,2431
ZCTA5 55033,11427,585,10842,29474,42.6,27444,164,278,0.009432042,1521,27953
ZCTA5 55036,23,413,-390,45,51.6,35,0,0,0,1030,-985
ZCTA5 55037,1890,47,1843,5025,46.2,4251,48,56,0.011144279,91,4934
ZCTA5 55038,8520,437,8083,23143,37.6,21207,857,332,0.01434559,1110,22033
ZCTA5 55040,5107,26,5081,14113,36.9,13574,44,49,0.003471976,57,14056
ZCTA5 55041,3301,229,3072,7516,50.3,7038,118,92,0.012240553,556,6960
ZCTA5 55042,4138,1030,3108,11935,40.4,10858,265,487,0.040804357,2829,9106
ZCTA5 55043,1532,210,1322,3562,50.6,3338,65,0,0,494,3068
ZCTA5 55044,20177,706,19471,59141,36.2,49879,3094,2606,0.044064186,1842,57299
ZCTA5 55045,2844,395,2449,7771,42.9,7295,188,0,0,997,6774
ZCTA5 55046,2042,486,1556,6056,30.9,5717,172,20,0.00330251,1138,4918
ZCTA5 55047,956,315,641,2293,56.3,2114,27,0,0,742,1551
ZCTA5 55049,918,5444,-4526,2617,34.4,2191,33,23,0.008788689,12344,-9727
ZCTA5 55051,3795,106,3689,9462,45.3,9007,58,17,0.00179666,255,9207
ZCTA5 55052,745,159,586,1885,42.7,1863,4,4,0.002122016,352,1533
ZCTA5 55053,343,222,121,1001,39.3,940,9,0,0,584,417
ZCTA5 55054,795,176,619,2442,33.6,2034,50,154,0.063063063,503,1939
ZCTA5 55055,1706,826,880,3951,41.9,3069,260,289,0.073146039,2060,1891
ZCTA5 55056,5229,610,4619,14084,40.4,13376,239,53,0.003763135,1571,12513
ZCTA5 55057,7818,371,7447,24999,32.3,21511,922,528,0.021120845,876,24123
ZCTA5 55060,12016,427,11589,29651,40.1,26724,109,1223,0.041246501,1035,28616
ZCTA5 55063,3799,272,3527,9459,45.5,8989,56,90,0.009514748,667,8792
ZCTA5 55065,470,192,278,1292,38.6,1265,4,0,0,440,852
ZCTA5 55066,8107,808,7299,18948,42.9,16946,42,400,0.021110407,2001,16947
ZCTA5 55068,11078,321,10757,31352,38.1,26877,1282,1122,0.035787191,799,30553
ZCTA5 55069,1918,46,1872,5659,40.1,4812,66,494,0.087294575,73,5586
ZCTA5 55070,2787,46,2741,8186,34.1,7572,41,129,0.015758612,130,8056
ZCTA5 55071,2298,1375,923,5739,40.8,4474,342,143,0.024917233,3628,2111
ZCTA5 55072,1341,651,690,4419,42.9,3564,53,383,0.086671193,1631,2788
ZCTA5 55073,1309,315,994,3824,44.4,3733,0,0,0,742,3082
ZCTA5 55074,851,403,448,2235,37.6,2094,4,0,0,1042,1193
ZCTA5 55075,8326,392,7934,20610,36.3,15847,509,802,0.038913149,981,19629
ZCTA5 55076,9258,1505,7753,21943,42.4,18423,719,744,0.033906029,3892,18051
ZCTA5 55077,5283,33,5250,13697,38.1,10335,634,908,0.066291889,81,13616
ZCTA5 55079,3239,1515,1724,8837,42.3,8013,141,44,0.004979065,3783,5054
ZCTA5 55080,1104,2455,-1351,3189,39.3,2995,6,30,0.009407338,5975,-2786
ZCTA5 55082,13914,182,13732,36233,43.9,32906,411,825,0.022769299,419,35814
ZCTA5 55084,686,1304,-618,1853,42.2,1780,0,8,0.004317323,3277,-1424
ZCTA5 55085,170,1102,-932,450,42.6,440,4,0,0,2718,-2268
ZCTA5 55087,166,1076,-910,458,42.5,408,0,0,0,2900,-2442
ZCTA5 55088,604,443,161,1770,47.1,1702,1,14,0.007909605,996,774
ZCTA5 55089,611,1690,-1079,1607,44.1,1290,29,11,0.006845053,4352,-2745
ZCTA5 55090,162,4365,-4203,384,41.4,375,0,9,0.0234375,12025,-11641
ZCTA5 55092,4178,812,3366,11195,43.4,10923,63,35,0.003126396,2142,9053
ZCTA5 55101,4662,7101,-2439,7606,35.4,5323,960,615,0.080857218,16693,-9087
ZCTA5 55102,10142,817,9325,18956,40,15661,427,1646,0.086832665,2043,16913
ZCTA5 55103,5246,81,5165,14187,32.7,5004,3345,4044,0.285049693,236,13951
ZCTA5 55104,18023,180,17843,44643,32,28956,3610,7603,0.170306655,474,44169
ZCTA5 55105,11104,202,10902,27396,34.2,24217,1139,697,0.02544167,518,26878
ZCTA5 55106,18707,2367,16340,59197,30.2,20055,22408,9353,0.157997872,5957,53240
ZCTA5 55107,5395,4413,982,14376,32.9,7745,977,2187,0.152128548,13620,756
ZCTA5 55108,6585,341,6244,15334,34.4,12094,1478,855,0.055758445,842,14492
ZCTA5 55109,12628,2193,10435,34575,35.1,20898,7132,3059,0.088474331,5458,29117
ZCTA5 55110,15822,1294,14528,38838,43.5,34771,1023,770,0.019825944,3124,35714
ZCTA5 55111,95,795,-700,95,64.3,87,0,8,0.084210526,1958,-1863
ZCTA5 55112,17360,85,17275,46403,36.4,34403,3092,4616,0.099476327,202,46201
ZCTA5 55113,18225,308,17917,41798,40.2,31369,3587,2936,0.070242595,741,41057
ZCTA5 55114,1751,125,1626,3124,32.8,2223,377,357,0.114276569,255,2869
ZCTA5 55115,3237,5133,-1896,8889,44.4,8172,173,236,0.026549668,13404,-4515
ZCTA5 55116,12167,1268,10899,26533,39.5,19486,1058,3814,0.143745524,2993,23540
ZCTA5 55117,16654,1652,15002,46743,32.1,22609,11632,8346,0.178550799,3892,42851
ZCTA5 55118,12466,962,11504,28774,42.5,23313,689,898,0.03120873,2165,26609
ZCTA5 55119,15958,2626,13332,44430,33.8,22630,7937,9406,0.211703804,5836,38594
ZCTA5 55120,2058,762,1296,5230,39.5,3962,235,48,0.00917782,1913,3317
ZCTA5 55121,3761,187,3574,8590,36.5,5579,763,1715,0.199650757,440,8150
ZCTA5 55122,13628,106,13522,32019,38.9,22728,2988,4283,0.133764327,219,31800
ZCTA5 55123,10191,177,10014,27555,39.6,22866,2780,831,0.030157866,417,27138
ZCTA5 55124,21128,533,20595,55237,37.5,40872,3295,5466,0.09895541,1224,54013
ZCTA5 55125,17239,232,17007,45329,38.7,36711,4067,2155,0.047541309,600,44729
ZCTA5 55126,11640,129,11511,27367,45.5,22348,2462,1179,0.043081083,389,26978
ZCTA5 55127,7488,159,7329,18406,46.1,15682,1167,443,0.024068239,448,17958
ZCTA5 55128,11641,459,11182,28766,41.6,19648,3106,3628,0.126121115,1129,27637
ZCTA5 55129,9981,412,9569,28685,36,21154,4764,1427,0.049747255,1027,27658
ZCTA5 55130,5897,275,5622,19606,28.9,5123,8277,4236,0.216056309,670,18936
ZCTA5 55150,58,238,-180,137,41.8,129,1,2,0.01459854,557,-420
ZCTA5 55155,0,232,-232,0,-,0,0,0,#DIV/0!,460,-460
ZCTA5 55301,4436,39,4397,12650,32.5,11063,180,848,0.067035573,63,12587
ZCTA5 55302,2854,187,2667,7150,44.1,6842,47,30,0.004195804,439,6711
ZCTA5 55303,19090,778,18312,51398,37.7,44513,1172,2984,0.058056734,2045,49353
ZCTA5 55304,16651,302,16349,48902,41.4,44151,1864,1059,0.021655556,797,48105
ZCTA5 55305,9979,1020,8959,21687,39.7,17237,2235,1384,0.063817033,2390,19297
ZCTA5 55306,6166,212,5954,16116,38.8,11883,845,1963,0.121804418,508,15608
ZCTA5 55307,1262,188,1074,3393,36.8,3235,4,34,0.010020631,499,2894
ZCTA5 55308,3198,442,2756,9642,35.8,9264,24,0,0,1012,8630
ZCTA5 55309,6920,483,6437,20148,35.8,18910,36,382,0.018959698,1079,19069
ZCTA5 55310,607,336,271,1375,49.9,1342,0,16,0.011636364,876,499
ZCTA5 55311,13888,216,13672,37908,40.8,31274,2660,2432,0.064155323,484,37424
ZCTA5 55312,530,26,504,1505,40.6,1381,0,47,0.031229236,49,1456
ZCTA5 55313,9246,145,9101,25118,39.6,23993,238,62,0.002468349,327,24791
ZCTA5 55314,421,459,-38,1033,51.9,904,0,6,0.005808325,995,38
ZCTA5 55315,2219,1990,229,6644,37.5,6039,202,53,0.007977122,4531,2113
ZCTA5 55316,8725,481,8244,23877,41,19817,756,2212,0.092641454,998,22879
ZCTA5 55317,8057,242,7815,21773,39.3,18775,1480,321,0.01474303,624,21149
ZCTA5 55318,10940,17,10923,28981,37.7,25198,901,441,0.015216866,44,28937
ZCTA5 55319,1903,48,1855,5402,39.5,5199,30,63,0.011662347,131,5271
ZCTA5 55320,1927,579,1348,5258,40.8,5064,42,11,0.00209205,1328,3930
ZCTA5 55321,1856,1209,647,5376,36.5,4988,17,40,0.007440476,2684,2692
ZCTA5 55322,1403,357,1046,3708,43.4,3392,50,139,0.037486516,806,2902
ZCTA5 55324,461,674,-213,1183,54.3,1124,2,0,0,1686,-503
ZCTA5 55325,1702,67,1635,4837,39.3,4605,15,0,0,143,4694
ZCTA5 55327,1825,177,1648,4706,47.8,4092,315,113,0.0240119,468,4238
ZCTA5 55328,3457,2631,826,9572,37.5,9219,20,0,0,6078,3494
ZCTA5 55329,731,283,448,1915,44,1873,2,9,0.004699739,777,1138
ZCTA5 55330,15212,157,15055,43549,36.7,39102,604,1369,0.031435854,417,43132
ZCTA5 55331,7382,1067,6315,19317,48,18139,304,93,0.004814412,2976,16341
ZCTA5 55332,765,81,684,1919,44.4,1514,31,0,0,183,1736
ZCTA5 55333,252,151,101,715,41.7,599,29,16,0.022377622,345,370
ZCTA5 55334,1089,169,920,2670,41.9,2178,35,11,0.00411985,365,2305
ZCTA5 55335,666,2414,-1748,1598,49.9,1483,6,15,0.009386733,6016,-4418
ZCTA5 55336,3088,135,2953,8273,40,7190,56,37,0.00447238,368,7905
ZCTA5 55337,18906,95,18811,47810,37.4,32123,3203,6978,0.14595273,267,47543
ZCTA5 55338,428,309,119,1106,40.2,1041,2,15,0.013562387,697,409
ZCTA5 55339,362,393,-31,959,48.5,930,3,0,0,894,65
ZCTA5 55340,3055,289,2766,9117,37.8,7471,1142,236,0.025885708,735,8382
ZCTA5 55341,1154,226,928,3479,36.4,3396,41,1,0.000287439,540,2939
ZCTA5 55342,723,669,54,1808,44.7,1619,6,5,0.002765487,1592,216
ZCTA5 55343,12711,1411,11300,26472,36.3,18176,1732,4659,0.17599728,3107,23365
ZCTA5 55344,6850,153,6697,15083,35.5,8873,2595,2154,0.142809786,477,14606
ZCTA5 55345,8680,166,8514,21528,44,18700,917,678,0.031493868,348,21180
ZCTA5 55346,6572,1205,5367,18132,41.4,14354,1288,1423,0.078480035,2996,15136
ZCTA5 55347,11604,441,11163,30833,42.3,24453,4220,651,0.021113742,1063,29770
ZCTA5 55349,1482,15,1467,3531,44.8,3364,8,10,0.002832059,31,3500
ZCTA5 55350,7833,705,7128,18683,41.6,17774,243,44,0.002355082,1703,16980
ZCTA5 55352,3435,504,2931,10210,36,9518,105,47,0.00460333,1393,8817
ZCTA5 55353,1193,504,689,3273,38,3248,0,10,0.003055301,1251,2022
ZCTA5 55354,990,512,478,2957,36.4,2743,5,10,0.003381806,1287,1670
ZCTA5 55355,3940,228,3712,9505,45.3,9149,2,5,0.000526039,502,9003
ZCTA5 55356,2171,150,2021,5969,44.8,5514,121,84,0.014072709,345,5624
ZCTA5 55357,1124,4958,-3834,3344,44.7,3269,19,21,0.006279904,14068,-10724
ZCTA5 55358,1939,9446,-7507,5238,39.9,4979,4,41,0.007827415,23060,-17822
ZCTA5 55359,2400,96,2304,6883,43.2,6466,38,165,0.023972105,223,6660
ZCTA5 55360,1102,977,125,3242,35.5,3045,31,24,0.007402838,2352,890
ZCTA5 55362,7250,967,6283,19601,34.9,17474,450,109,0.005560941,2261,17340
ZCTA5 55363,1876,7,1869,5465,34.9,4672,20,96,0.017566331,16,5449
ZCTA5 55364,6242,221,6021,14442,45.5,13397,193,147,0.010178646,448,13994
ZCTA5 55366,208,232,-24,489,40.1,446,0,0,0,567,-78
ZCTA5 55367,374,280,94,997,39.1,976,5,1,0.001003009,669,328
ZCTA5 55368,737,2077,-1340,1829,44.4,1783,3,6,0.003280481,4399,-2570
ZCTA5 55369,15340,237,15103,37592,39.5,31008,1654,2344,0.062353692,583,37009
ZCTA5 55370,217,242,-25,563,41.8,558,0,0,0,588,-25
ZCTA5 55371,6376,414,5962,17383,39.8,16297,183,31,0.001783352,981,16402
ZCTA5 55372,12052,1258,10794,33818,40.1,30784,1176,275,0.008131764,3110,30708
ZCTA5 55373,2093,348,1745,5460,40,5139,79,87,0.015934066,850,4610
ZCTA5 55374,5329,744,4585,16249,36.8,15163,170,183,0.011262232,1917,14332
ZCTA5 55375,1353,551,802,4355,34.3,4045,62,81,0.018599311,1277,3078
ZCTA5 55376,6078,120,5958,17992,34.3,16420,314,658,0.03657181,297,17695
ZCTA5 55378,11228,302,10926,31701,37,24335,2656,2737,0.08633797,719,30982
ZCTA5 55379,16637,139,16498,47662,35,33071,4925,3726,0.078175486,262,47400
ZCTA5 55381,786,101,685,1940,44.3,1835,3,23,0.01185567,214,1726
ZCTA5 55382,1395,452,943,3538,46.3,3462,32,4,0.001130582,969,2569
ZCTA5 55384,1232,701,531,1921,55.4,1630,46,137,0.071317022,1859,62
ZCTA5 55385,470,298,172,1277,40,1146,0,0,0,777,500
ZCTA5 55386,3143,162,2981,9391,38.8,8416,445,264,0.028112022,404,8987
ZCTA5 55387,5166,977,4189,14157,37.4,13437,0,238,0.016811471,2368,11789
ZCTA5 55388,2132,200,1932,6098,36.1,5903,0,5,0.000819941,423,5675
ZCTA5 55389,933,154,779,2561,38.5,2478,4,0,0,323,2238
ZCTA5 55390,1076,239,837,2973,39,2803,6,29,0.009754457,645,2328
ZCTA5 55391,6557,209,6348,15621,50.5,14436,632,106,0.006785737,574,15047
ZCTA5 55395,1125,418,707,2555,46.3,2465,7,11,0.004305284,920,1635
ZCTA5 55396,949,1698,-749,2175,42.2,1969,13,27,0.012413793,3976,-1801
ZCTA5 55397,1102,644,458,3221,35.9,2656,0,206,0.063955293,1618,1603
ZCTA5 55398,5868,569,5299,16845,36.6,15261,384,132,0.007836153,1532,15313
ZCTA5 55401,7317,188,7129,10957,35.3,8494,1182,587,0.053573058,515,10442
ZCTA5 55402,415,401,14,590,35.1,357,72,105,0.177966102,883,-293
ZCTA5 55403,11021,135,10886,16349,34.1,12344,631,2054,0.125634595,294,16055
ZCTA5 55404,12410,460,11950,28413,30.5,11404,1006,10163,0.357688382,1180,27233
ZCTA5 55405,8047,503,7544,16523,32.2,10703,787,3545,0.214549416,1248,15275
ZCTA5 55406,16397,409,15988,35997,38.8,25887,1038,5077,0.141039531,943,35054
ZCTA5 55407,14981,145,14836,38921,33.1,22002,745,7262,0.186583079,334,38587
ZCTA5 55408,15990,1126,14864,31613,30,20546,1009,5086,0.160883181,2535,29078
ZCTA5 55409,4821,238,4583,11262,36.1,8218,241,1015,0.090126088,545,10717
ZCTA5 55410,8389,6241,2148,20525,39.2,18587,616,318,0.015493301,15662,4863
ZCTA5 55411,9979,326,9653,31397,28.6,6813,3814,15488,0.493295538,860,30537
ZCTA5 55412,8907,314,8593,25497,34.5,9854,2916,8701,0.341255834,772,24725
ZCTA5 55413,6951,215,6736,14299,35.5,10288,529,1777,0.124274425,461,13838
ZCTA5 55414,12403,883,11520,31788,23,22812,4229,1758,0.055303888,2146,29642
ZCTA5 55415,2593,3282,-689,5722,32.2,3762,345,1063,0.185774205,7815,-2093
ZCTA5 55416,17390,712,16678,34181,35.1,28960,1222,1502,0.043942541,1728,32453
ZCTA5 55417,10820,2546,8274,25610,39.5,21653,435,1395,0.05447091,6894,18716
ZCTA5 55418,13878,344,13534,31136,37.5,23543,1024,2777,0.089189363,963,30173
ZCTA5 55419,11270,468,10802,29051,37.6,23944,438,3078,0.105951602,1167,27884
ZCTA5 55420,8917,1995,6922,23119,39.3,14020,1641,3431,0.148406073,4916,18203
ZCTA5 55421,12249,70,12179,30249,37.4,18151,1806,6417,0.212139244,200,30049
ZCTA5 55422,12332,153,12179,28953,39.6,21237,1036,4289,0.148136635,347,28606
ZCTA5 55423,15679,1262,14417,36986,37.3,23596,2025,4351,0.117639107,3114,33872
ZCTA5 55424,3735,1238,2497,10712,41.2,9627,384,9,0.000840179,2810,7902
ZCTA5 55425,4191,485,3706,11002,34.6,5187,829,2051,0.186420651,1379,9623
ZCTA5 55426,12014,228,11786,25711,36.7,20171,1699,1710,0.066508498,577,25134
ZCTA5 55427,10686,226,10460,25581,39.6,19570,1021,3040,0.1188382,590,24991
ZCTA5 55428,12983,577,12406,33035,37.3,18922,2097,8998,0.272377781,1581,31454
ZCTA5 55429,10251,2852,7399,29071,32.4,11130,4659,10066,0.346255719,6546,22525
ZCTA5 55430,7796,918,6878,23191,32.7,9000,3358,7061,0.304471562,2224,20967
ZCTA5 55431,8297,480,7817,19501,45.1,15430,1164,899,0.0461002,1154,18347
ZCTA5 55432,12667,32,12635,32529,35.8,21050,2281,5188,0.159488456,87,32442
ZCTA5 55433,13643,2048,11595,34240,38.9,27243,2036,2658,0.077628505,4535,29705
ZCTA5 55434,11832,248,11584,33096,36.8,23994,2976,3613,0.109167271,647,32449
ZCTA5 55435,7536,189,7347,13753,48.1,10581,1500,770,0.055987784,521,13232
ZCTA5 55436,6034,246,5788,14288,47.6,12995,560,165,0.011548152,623,13665
ZCTA5 55437,8536,466,8070,19051,47.8,15334,1066,1667,0.087501968,1116,17935
ZCTA5 55438,7293,37,7256,16763,44,13215,677,1085,0.064725884,69,16694
ZCTA5 55439,3476,141,3335,9407,44.9,8042,656,133,0.014138408,340,9067
ZCTA5 55441,7832,902,6930,18242,40.5,14056,831,1643,0.090066879,2032,16210
ZCTA5 55442,5534,337,5197,13349,46.4,11192,632,395,0.029590231,822,12527
ZCTA5 55443,11900,11420,480,33120,37.4,14441,6104,10458,0.31576087,32362,758
ZCTA5 55444,5448,11312,-5864,17627,34.7,6961,4381,4320,0.245078573,25975,-8348
ZCTA5 55445,4496,6268,-1772,13330,35.5,6138,3499,2331,0.174868717,16012,-2682
ZCTA5 55446,10088,1847,8241,27079,38,18361,5604,1185,0.043760848,4994,22085
ZCTA5 55447,8857,10812,-1955,21775,41.9,18176,1605,769,0.035315729,24161,-2386
ZCTA5 55448,10750,492,10258,29029,40.1,22858,1414,2954,0.101760309,1193,27836
ZCTA5 55449,10836,1985,8851,30859,37.3,24792,2328,1497,0.048510969,5276,25583
ZCTA5 55450,6,285,-279,6,-,6,0,0,0,706,-700
ZCTA5 55454,3520,867,2653,8739,23.7,2072,746,5354,0.61265591,2253,6486
ZCTA5 55455,0,39,-39,5749,19,4309,852,86,0.014959123,78,5671
ZCTA5 55601,77,491,-414,159,59.1,155,0,0,0,1285,-1126
ZCTA5 55602,175,708,-533,311,61,308,0,0,0,1696,-1385
ZCTA5 55603,193,570,-377,360,54.6,345,0,7,0.019444444,1439,-1079
ZCTA5 55604,1631,519,1112,3788,52.9,3553,0,2,0.000527983,1171,2617
ZCTA5 55605,271,566,-295,620,42,178,13,0,0,1522,-902
ZCTA5 55606,106,2967,-2861,150,63.5,128,0,0,0,7959,-7809
ZCTA5 55607,83,0,83,225,46.5,218,0,2,0.008888889,1627,-1402
ZCTA5 55609,85,238,-153,149,87.2,149,0,0,0,543,-394
ZCTA5 55612,233,474,-241,485,55.5,464,0,0,0,1296,-811
ZCTA5 55613,118,75,43,229,57.8,226,0,0,0,168,61
ZCTA5 55614,1112,682,430,2267,52.2,2099,18,0,0,1517,750
ZCTA5 55615,140,292,-152,302,45.5,219,29,0,0,691,-389
ZCTA5 55616,3310,45,3265,7365,44.9,7165,5,26,0.00353021,103,7262
ZCTA5 55702,190,2619,-2429,456,47.1,425,0,0,0,7336,-6880
ZCTA5 55703,348,660,-312,902,43.1,844,3,0,0,1882,-980
ZCTA5 55704,445,644,-199,1044,45.6,1015,0,2,0.001915709,1827,-783
ZCTA5 55705,1541,499,1042,3247,52.1,3143,0,2,0.000615953,1141,2106
ZCTA5 55706,837,2439,-1602,1646,56.4,1557,19,2,0.001215067,5447,-3801
ZCTA5 55707,1202,96,1106,3183,44.1,3066,10,6,0.001885014,191,2992
ZCTA5 55708,328,689,-361,635,46.4,622,0,0,0,1633,-998
ZCTA5 55709,1641,725,916,4360,46.6,4004,0,30,0.006880734,1707,2653
ZCTA5 55710,573,457,116,1292,49.8,1271,0,5,0.003869969,1105,187
ZCTA5 55711,203,962,-759,537,44,435,0,3,0.005586592,2387,-1850
ZCTA5 55712,271,1304,-1033,598,54.9,555,7,10,0.016722408,2722,-2124
ZCTA5 55713,474,434,40,1098,46.6,958,3,27,0.024590164,983,115
ZCTA5 55716,149,6302,-6153,292,42,261,0,0,0,14893,-14601
ZCTA5 55717,125,2812,-2687,291,48.8,288,2,0,0,7123,-6832
ZCTA5 55718,1168,328,840,3115,44.7,2933,23,18,0.005778491,806,2309
ZCTA5 55719,2368,274,2094,5710,52.2,5510,17,37,0.00647986,556,5154
ZCTA5 55720,7025,2178,4847,17565,37.6,14877,122,144,0.008198121,6120,11445
ZCTA5 55721,1358,3319,-1961,3709,39.5,3385,5,12,0.003235373,8601,-4892
ZCTA5 55722,368,600,-232,825,38.8,781,0,0,0,1349,-524
ZCTA5 55723,943,228,715,2009,55.5,1955,3,4,0.00199104,509,1500
ZCTA5 55724,379,133,246,711,60.2,685,0,0,0,285,426
ZCTA5 55725,54,366,-312,114,55,110,0,0,0,1036,-922
ZCTA5 55726,363,1193,-830,987,41.8,938,0,6,0.006079027,3331,-2344
ZCTA5 55731,2703,1518,1185,5292,58.2,5044,3,45,0.008503401,3899,1393
ZCTA5 55732,668,1667,-999,1406,51.7,1352,7,0,0,4015,-2609
ZCTA5 55733,2042,1007,1035,5328,44.6,5280,0,5,0.000938438,2327,3001
ZCTA5 55734,2756,2356,400,6424,40.4,6161,0,62,0.009651308,5635,789
ZCTA5 55735,694,35,659,1739,50.1,1627,6,5,0.002875216,107,1632
ZCTA5 55736,651,2021,-1370,1406,50.5,1376,0,4,0.00284495,5299,-3893
ZCTA5 55738,232,2432,-2200,578,49.3,559,0,0,0,6296,-5718
ZCTA5 55741,1430,1715,-285,3206,52,3122,4,0,0,4532,-1326
ZCTA5 55742,91,188,-97,187,54.9,180,0,0,0,522,-335
ZCTA5 55744,8114,58,8056,20129,45.4,18744,42,101,0.005017636,117,20012
ZCTA5 55746,7851,1112,6739,17047,44,15944,232,321,0.018830293,2897,14150
ZCTA5 55748,534,2902,-2368,1431,42.2,1340,1,2,0.001397624,9858,-8427
ZCTA5 55749,240,297,-57,483,51.5,472,0,0,0,794,-311
ZCTA5 55750,897,121,776,2210,42.6,2076,0,0,0,345,1865
ZCTA5 55751,636,6421,-5785,1436,51.8,1370,0,4,0.002785515,17459,-16023
ZCTA5 55752,178,3153,-2975,433,56.1,429,2,0,0,7964,-7531
ZCTA5 55753,504,6317,-5813,1161,45,991,0,9,0.007751938,16125,-14964
ZCTA5 55756,115,1032,-917,274,45.4,252,8,0,0,2394,-2120
ZCTA5 55757,287,577,-290,644,48.2,613,2,2,0.00310559,1497,-853
ZCTA5 55758,75,180,-105,180,35.7,131,0,26,0.144444444,412,-232
ZCTA5 55760,1234,410,824,2957,56.2,2641,11,12,0.004058167,1061,1896
ZCTA5 55763,282,420,-138,504,56.8,496,0,2,0.003968254,903,-399
ZCTA5 55764,221,3154,-2933,481,41.7,417,17,4,0.008316008,6674,-6193
ZCTA5 55765,368,43,325,797,51.5,768,0,18,0.022584693,99,698
ZCTA5 55767,1158,12504,-11346,4706,44.5,3514,46,577,0.122609435,29349,-24643
ZCTA5 55768,1219,2994,-1775,2687,50.7,2568,17,12,0.004465947,7581,-4894
ZCTA5 55769,1085,4324,-3239,2397,47.9,2086,25,8,0.003337505,9334,-6937
ZCTA5 55771,673,658,15,1658,48.7,1167,0,1,0.000603136,1608,50
ZCTA5 55772,62,63,-1,133,46.7,12,0,0,0,182,-49
ZCTA5 55775,594,1164,-570,1461,48.3,1365,0,10,0.006844627,2683,-1222
ZCTA5 55779,1460,17,1443,3957,41.5,3666,37,42,0.010614102,39,3918
ZCTA5 55780,85,566,-481,284,30.3,140,0,5,0.017605634,1440,-1156
ZCTA5 55781,294,1169,-875,774,56.7,762,1,1,0.00129199,2934,-2160
ZCTA5 55782,240,510,-270,488,45.5,464,3,0,0,1358,-870
ZCTA5 55783,946,1546,-600,2348,49.7,2173,34,41,0.01746167,3351,-1003
ZCTA5 55784,63,1080,-1017,121,59.1,118,0,0,0,2199,-2078
ZCTA5 55785,121,714,-593,288,56.6,263,0,0,0,1567,-1279
ZCTA5 55786,123,1394,-1271,234,56.1,224,0,0,0,3031,-2797
ZCTA5 55787,252,625,-373,624,55.5,610,0,5,0.008012821,1485,-861
ZCTA5 55790,863,543,320,1840,60.3,1435,11,0,0,1090,750
ZCTA5 55792,4791,175,4616,9907,44.3,9226,133,39,0.00393661,330,9577
ZCTA5 55793,271,805,-534,668,45.9,607,17,0,0,2149,-1481
ZCTA5 55795,656,455,201,1847,42.5,1707,5,65,0.035192204,985,862
ZCTA5 55796,65,991,-926,118,56.5,118,0,0,0,1937,-1819
ZCTA5 55797,563,334,229,1356,49,1283,0,0,0,838,518
ZCTA5 55798,223,746,-523,595,45.3,569,2,0,0,1889,-1294
ZCTA5 55802,1297,20,1277,2412,58.4,1910,42,180,0.074626866,50,2362
ZCTA5 55803,7446,148,7298,17772,43.8,16904,212,84,0.004726536,311,17461
ZCTA5 55804,6056,1282,4774,15691,40.8,14569,178,97,0.006181888,3227,12464
ZCTA5 55805,4837,1702,3135,10082,26,8492,167,320,0.031739734,4184,5898
ZCTA5 55806,4369,889,3480,9369,31.2,7694,58,592,0.063187106,2015,7354
ZCTA5 55807,4213,1273,2940,9099,39.9,8185,0,96,0.01055061,3032,6067
ZCTA5 55808,2520,974,1546,5690,40.4,5070,39,26,0.00456942,2362,3328
ZCTA5 55810,3343,2308,1035,7961,43.4,7367,103,74,0.009295315,5283,2678
ZCTA5 55811,10925,442,10483,28000,36.9,26031,483,455,0.01625,880,27120
ZCTA5 55812,3488,4596,-1108,11511,21.9,9740,359,502,0.04361046,10412,1099
ZCTA5 55814,0,3097,-3097,490,45.9,286,11,159,0.324489796,7075,-6585
ZCTA5 55901,22829,1539,21290,57080,34,44107,3518,5650,0.098983882,3559,53521
ZCTA5 55902,11354,1649,9705,26092,39.9,21117,2757,739,0.028322858,3453,22639
ZCTA5 55903,0,638,-638,0,-,0,0,0,#DIV/0!,1693,-1693
ZCTA5 55904,11465,1117,10348,28892,37.3,22396,1111,3812,0.131939637,2572,26320
ZCTA5 55905,0,2165,-2165,0,-,0,0,0,#DIV/0!,5255,-5255
ZCTA5 55906,7974,852,7122,19791,42.7,16364,1707,693,0.035015916,2130,17661
ZCTA5 55909,521,2866,-2345,1428,48,1370,3,0,0,6734,-5306
ZCTA5 55910,512,1418,-906,1190,48.9,1162,1,5,0.004201681,3283,-2093
ZCTA5 55912,11517,7153,4364,29393,37.7,22572,1946,1414,0.048106692,16367,13026
ZCTA5 55917,1376,942,434,3671,37.7,3355,4,0,0,2318,1353
ZCTA5 55918,392,737,-345,959,44.8,890,9,1,0.001042753,1827,-868
ZCTA5 55919,454,1362,-908,1018,55.5,955,18,6,0.00589391,3541,-2523
ZCTA5 55920,3095,1404,1691,8175,38.4,7419,209,65,0.00795107,3179,4996
ZCTA5 55921,1987,111,1876,4531,43.1,4378,0,111,0.024497903,299,4232
ZCTA5 55922,329,118,211,998,31.4,966,0,23,0.023046092,244,754
ZCTA5 55923,1742,127,1615,4384,40.5,4151,56,43,0.009808394,378,4006
ZCTA5 55924,468,132,336,1225,41.4,1134,0,0,0,305,920
ZCTA5 55925,418,1649,-1231,1172,38.4,1166,0,0,0,4029,-2857
ZCTA5 55926,282,313,-31,750,43.6,742,1,0,0,789,-39
ZCTA5 55927,1579,251,1328,4201,38.4,3699,91,4,0.000952154,713,3488
ZCTA5 55929,437,217,220,1229,38.5,1162,9,2,0.001627339,556,673
ZCTA5 55931,168,334,-166,385,50.7,360,3,0,0,775,-390
ZCTA5 55932,791,52,739,1994,38,1860,55,0,0,153,1841
ZCTA5 55933,91,318,-227,232,41.6,225,0,1,0.004310345,729,-497
ZCTA5 55934,1437,692,745,3525,40.8,3387,16,66,0.018723404,1454,2071
ZCTA5 55935,391,1667,-1276,915,41.4,875,4,1,0.001092896,3996,-3081
ZCTA5 55936,707,917,-210,1805,38.8,1741,20,0,0,1981,-176
ZCTA5 55939,774,136,638,1920,47.1,1876,0,13,0.006770833,313,1607
ZCTA5 55940,1099,483,616,2722,40.7,2591,30,27,0.009919177,1075,1647
ZCTA5 55941,485,577,-92,1123,36,1032,0,60,0.053428317,1453,-330
ZCTA5 55943,1194,210,984,2998,42.9,2878,6,16,0.005336891,454,2544
ZCTA5 55944,2867,7783,-4916,7885,35.4,7486,3,4,0.000507292,18541,-10656
ZCTA5 55945,607,791,-184,1384,48.2,1339,6,0,0,1887,-503
ZCTA5 55946,1355,14,1341,3447,43.2,3325,12,39,0.011314186,38,3409
ZCTA5 55947,3185,1264,1921,7496,46.1,6930,114,16,0.002134472,2946,4550
ZCTA5 55949,771,115,656,1946,40.9,1898,0,3,0.001541624,239,1707
ZCTA5 55950,53,2041,-1988,102,56.7,96,6,0,0,5444,-5342
ZCTA5 55951,576,247,329,1449,40.6,1367,2,0,0,574,875
ZCTA5 55952,900,152,748,2793,38,2360,93,24,0.008592911,434,2359
ZCTA5 55953,343,1006,-663,803,46.8,745,3,9,0.01120797,2828,-2025
ZCTA5 55954,524,317,207,1340,45,1328,2,0,0,793,547
ZCTA5 55955,942,1708,-766,2596,42.2,2405,0,29,0.011171032,4338,-1742
ZCTA5 55956,866,154,712,2062,45.3,2020,7,6,0.002909796,375,1687
ZCTA5 55957,298,955,-657,773,43.7,766,2,0,0,2234,-1461
ZCTA5 55959,867,190,677,2049,45.4,1885,61,7,0.003416301,467,1582
ZCTA5 55960,1188,123,1065,3218,44,3094,29,14,0.004350528,293,2925
ZCTA5 55961,183,993,-810,533,37.2,506,0,0,0,2438,-1905
ZCTA5 55962,324,400,-76,784,48.3,776,2,0,0,920,-136
ZCTA5 55963,2209,1132,1077,5915,37.4,5630,29,69,0.011665258,2786,3129
ZCTA5 55964,1743,15221,-13478,4494,36.6,4358,0,4,0.000890076,40604,-36110
ZCTA5 55965,978,54,924,2308,43.5,2248,9,7,0.003032929,155,2153
ZCTA5 55967,352,150,202,1087,38.3,1064,0,5,0.004599816,525,562
ZCTA5 55968,73,1470,-1397,140,59.4,118,22,0,0,3565,-3425
ZCTA5 55969,407,85,322,1061,45.1,987,19,0,0,177,884
ZCTA5 55970,397,517,-120,1024,42.3,992,20,5,0.004882813,1316,-292
ZCTA5 55971,1114,513,601,2794,44,2697,25,1,0.00035791,1310,1484
ZCTA5 55972,2013,768,1245,5330,38.2,4913,231,2,0.000375235,1687,3643
ZCTA5 55973,97,2259,-2162,232,42.3,222,8,0,0,5377,-5145
ZCTA5 55974,968,2609,-1641,2236,47.2,2175,8,0,0,6023,-3787
ZCTA5 55975,1779,115,1664,4595,40.4,4392,32,16,0.003482046,282,4313
ZCTA5 55976,3175,281,2894,8452,36.2,8089,38,5,0.000591576,753,7699
ZCTA5 55977,67,365,-298,182,40.3,182,0,0,0,811,-629
ZCTA5 55979,368,8,360,1116,31.2,1098,4,0,0,15,1101
ZCTA5 55981,1655,340,1315,3665,52.5,3585,13,0,0,804,2861
ZCTA5 55982,251,443,-192,547,42.2,453,5,0,0,1011,-464
ZCTA5 55983,699,473,226,1669,43.1,1487,24,109,0.065308568,1334,335
ZCTA5 55985,657,150,507,1758,38.4,1560,10,27,0.015358362,360,1398
ZCTA5 55987,14273,74,14199,34133,33.1,31522,832,463,0.013564586,147,33986
ZCTA5 55990,397,653,-256,977,42.1,893,0,0,0,1649,-672
ZCTA5 55991,603,418,185,1549,45.1,1465,0,0,0,1032,517
ZCTA5 55992,2334,784,1550,5593,40.8,5355,98,3,0.000536385,1747,3846
ZCTA5 56001,19459,716,18743,50206,28.5,43608,1562,3044,0.060630204,1518,48688
ZCTA5 56003,6307,252,6055,15471,37.5,13688,294,316,0.020425312,593,14878
ZCTA5 56007,9011,858,8153,21639,43.6,18366,770,328,0.015157817,2278,19361
ZCTA5 56009,577,162,415,1428,47.8,1393,3,0,0,336,1092
ZCTA5 56010,513,57,456,1152,44.6,1121,2,1,0.000868056,169,983
ZCTA5 56011,3425,221,3204,9488,38.7,8866,30,254,0.026770658,574,8914
ZCTA5 56013,2002,19,1983,4546,45,4179,10,38,0.008358997,42,4504
ZCTA5 56014,282,147,135,653,49.6,620,0,3,0.004594181,325,328
ZCTA5 56016,378,12857,-12479,893,40.4,729,107,5,0.005599104,33164,-32271
ZCTA5 56017,720,1908,-1188,1756,47.9,1732,8,3,0.001708428,4575,-2819
ZCTA5 56019,344,1156,-812,757,46.9,744,2,0,0,2495,-1738
ZCTA5 56020,39,180,-141,89,31.8,89,0,0,0,328,-239
ZCTA5 56021,449,170,279,1068,43.5,1062,0,0,0,292,776
ZCTA5 56022,40,710,-670,67,47.9,67,0,0,0,1542,-1475
ZCTA5 56023,222,122,100,528,46.5,485,0,0,0,268,260
ZCTA5 56024,1239,776,463,3503,32.8,3087,13,20,0.005709392,1983,1520
ZCTA5 56025,193,1751,-1558,504,36.8,504,0,0,0,4283,-3779
ZCTA5 56026,762,712,50,1872,43,1786,5,0,0,1729,143
ZCTA5 56027,294,1975,-1681,578,49.2,529,2,0,0,5119,-4541
ZCTA5 56028,464,70,394,1055,48.8,1038,6,0,0,182,873
ZCTA5 56029,270,210,60,582,51.7,571,1,0,0,454,128
ZCTA5 56030,7,141,-134,23,37.8,23,0,0,0,349,-326
ZCTA5 56031,5213,354,4859,11948,45.8,11269,54,48,0.004017409,849,11099
ZCTA5 56032,145,147,-2,343,37.4,301,0,0,0,345,-2
ZCTA5 56033,160,304,-144,402,39.4,390,0,4,0.009950249,721,-319
ZCTA5 56034,159,4576,-4417,357,50.9,340,0,0,0,9860,-9503
ZCTA5 56035,187,302,-115,400,51.9,388,0,3,0.0075,755,-355
ZCTA5 56036,756,245,511,1802,48.6,1745,10,0,0,596,1206
ZCTA5 56037,659,226,433,1570,45.5,1535,1,4,0.002547771,500,1070
ZCTA5 56039,359,619,-260,948,41.5,932,0,5,0.005274262,1468,-520
ZCTA5 56041,423,42,381,1056,42.2,1028,3,0,0,116,940
ZCTA5 56042,334,700,-366,797,39.6,747,6,3,0.003764115,1333,-536
ZCTA5 56043,175,85,90,451,44.8,424,0,0,0,180,271
ZCTA5 56044,774,0,774,2100,42.1,2024,4,44,0.020952381,0,2100
ZCTA5 56045,367,28,339,897,41.8,843,4,0,0,66,831
ZCTA5 56046,47,145,-98,146,28,146,0,0,0,319,-173
ZCTA5 56048,1676,385,1291,4304,37.7,4087,6,102,0.023698885,888,3416
ZCTA5 56050,525,257,268,1316,42.3,1232,2,46,0.034954407,466,850
ZCTA5 56051,297,90,207,729,41.9,703,0,0,0,168,561
ZCTA5 56052,252,256,-4,589,51.4,584,0,0,0,1077,-488
ZCTA5 56054,361,260,101,1032,38,1004,0,0,0,663,369
ZCTA5 56055,1600,82,1518,3910,41.4,3811,5,16,0.004092072,160,3750
ZCTA5 56056,33,174,-141,70,48,70,0,0,0,372,-302
ZCTA5 56057,1510,438,1072,4039,39.8,3687,6,0,0,1800,2239
ZCTA5 56058,2523,820,1703,5992,40,5379,16,99,0.016522029,2938,3054
ZCTA5 56060,168,1013,-845,482,36.3,358,9,0,0,2124,-1642
ZCTA5 56062,1190,359,831,3346,37.2,2596,48,41,0.012253437,1060,2286
ZCTA5 56063,1143,648,495,2877,44.3,2698,16,8,0.002780674,1451,1426
ZCTA5 56065,994,469,525,2684,37.2,2428,6,24,0.008941878,1193,1491
ZCTA5 56068,403,49,354,928,45.8,913,0,0,0,85,843
ZCTA5 56069,1897,117,1780,4795,39.6,4466,8,68,0.014181439,259,4536
ZCTA5 56071,4418,289,4129,13104,36.6,12550,153,5,0.000381563,741,12363
ZCTA5 56072,871,130,741,2149,45.2,2086,6,0,0,257,1892
ZCTA5 56073,7121,84,7037,17381,40.3,16501,139,172,0.009895863,156,17225
ZCTA5 56074,692,451,241,1895,34.6,1821,4,37,0.019525066,1005,890
ZCTA5 56075,73,22,51,153,44.8,148,0,0,0,45,108
ZCTA5 56078,192,70,122,530,34.6,522,1,3,0.005660377,153,377
ZCTA5 56080,280,5242,-4962,739,37.6,680,6,26,0.035182679,12520,-11781
ZCTA5 56081,2443,205,2238,6096,41.1,5085,11,4,0.000656168,509,5587
ZCTA5 56082,4683,36,4647,14176,35.2,12473,251,503,0.035482506,56,14120
ZCTA5 56083,352,419,-67,811,47.4,741,0,9,0.011097411,883,-72
ZCTA5 56085,2108,537,1571,5219,44.6,4911,1,0,0,1190,4029
ZCTA5 56087,1306,126,1180,3087,45.6,3024,6,22,0.00712666,280,2807
ZCTA5 56088,868,3422,-2554,2039,37.5,1977,5,0,0,9297,-7258
ZCTA5 56089,98,28,70,271,42.5,226,20,2,0.007380074,72,199
ZCTA5 56090,274,4019,-3745,638,42.9,631,0,0,0,10054,-9416
ZCTA5 56091,131,161,-30,277,47.2,265,4,0,0,381,-104
ZCTA5 56093,5001,380,4621,12740,39.8,11583,133,113,0.008869702,871,11869
ZCTA5 56096,1179,55,1124,2701,47.4,2548,25,12,0.004442799,119,2582
ZCTA5 56097,1551,435,1116,3634,46.9,3390,39,31,0.008530545,1136,2498
ZCTA5 56098,831,646,185,2005,43.6,1793,0,2,0.000997506,1536,469
ZCTA5 56101,2499,341,2158,6127,39.8,5206,95,150,0.024481802,799,5328
ZCTA5 56110,619,578,41,1623,39.1,1493,13,2,0.001232286,1429,194
ZCTA5 56111,193,60,133,387,51,340,0,0,0,138,249
ZCTA5 56113,96,31,65,243,38.1,243,0,0,0,75,168
ZCTA5 56114,150,452,-302,356,50.3,354,0,0,0,1075,-719
ZCTA5 56115,516,185,331,1305,36.9,1256,1,0,0,405,900
ZCTA5 56116,223,204,19,665,37.2,645,4,0,0,469,196
ZCTA5 56117,125,341,-216,376,38.7,276,0,0,0,764,-388
ZCTA5 56118,193,424,-231,494,44.6,477,2,15,0.030364372,933,-439
ZCTA5 56119,330,383,-53,1039,41.1,809,0,0,0,853,186
ZCTA5 56120,358,604,-246,961,48.3,797,91,0,0,1402,-441
ZCTA5 56121,309,7,302,578,50.2,540,0,0,0,13,565
ZCTA5 56122,218,395,-177,598,49.2,564,1,0,0,973,-375
ZCTA5 56123,177,257,-80,375,53.6,372,0,0,0,627,-252
ZCTA5 56125,31,290,-259,48,70.5,48,0,0,0,743,-695
ZCTA5 56127,212,1038,-826,498,42.9,475,0,21,0.042168675,2590,-2092
ZCTA5 56128,771,2249,-1478,2039,38.9,1922,38,0,0,5666,-3627
ZCTA5 56129,290,233,57,834,38.3,813,11,0,0,506,328
ZCTA5 56131,897,66,831,2210,44.9,1990,122,9,0.004072398,131,2079
ZCTA5 56132,231,327,-96,481,57.5,472,1,0,0,759,-278
ZCTA5 56134,172,379,-207,391,43.1,370,0,0,0,908,-517
ZCTA5 56136,614,185,429,1300,50.5,1244,0,26,0.02,382,918
ZCTA5 56137,430,164,266,1061,40.9,1008,2,0,0,386,675
ZCTA5 56138,405,164,241,1025,40,971,0,33,0.032195122,402,623
ZCTA5 56139,158,187,-29,447,34.9,398,23,0,0,453,-6
ZCTA5 56140,37,1100,-1063,68,66.5,53,12,0,0,2697,-2629
ZCTA5 56141,136,2095,-1959,312,41.6,298,0,0,0,5238,-4926
ZCTA5 56142,428,628,-200,964,44.5,927,4,3,0.003112033,1537,-573
ZCTA5 56143,2054,410,1644,4501,46.8,4100,146,14,0.00311042,959,3542
ZCTA5 56144,466,665,-199,1095,47.4,987,20,3,0.002739726,1766,-671
ZCTA5 56145,207,1378,-1171,429,49.9,412,0,0,0,3473,-3044
ZCTA5 56146,23,3690,-3667,70,31.5,70,0,0,0,10615,-10545
ZCTA5 56147,77,8731,-8654,191,39.5,151,0,0,0,24372,-24181
ZCTA5 56149,516,202,314,1145,44.9,1117,0,0,0,531,614
ZCTA5 56150,1146,392,754,2755,41.4,2638,3,9,0.003266788,973,1782
ZCTA5 56151,300,1693,-1393,707,50.1,686,0,2,0.002828854,4229,-3522
ZCTA5 56152,558,626,-68,1380,45.8,1310,23,0,0,1583,-203
ZCTA5 56153,77,333,-256,157,52.3,146,4,0,0,856,-699
ZCTA5 56155,223,337,-114,519,42.1,488,0,1,0.001926782,729,-210
ZCTA5 56156,2554,664,1890,6267,39.4,6003,42,0,0,1591,4676
ZCTA5 56157,288,540,-252,724,35.5,625,2,0,0,1462,-738
ZCTA5 56158,137,528,-391,334,49.2,292,10,7,0.020958084,1474,-1140
ZCTA5 56159,980,136,844,2619,41.7,2183,261,0,0,372,2247
ZCTA5 56160,102,1906,-1804,245,36.8,241,0,0,0,4682,-4437
ZCTA5 56161,144,190,-46,349,44.5,336,4,0,0,484,-135
ZCTA5 56162,101,1046,-945,237,41.5,237,0,0,0,2826,-2589
ZCTA5 56164,2453,506,1947,5632,41.2,5204,0,100,0.017755682,1377,4255
ZCTA5 56165,125,50,75,343,41.1,307,0,0,0,158,185
ZCTA5 56166,75,1294,-1219,209,51.5,208,1,0,0,3235,-3026
ZCTA5 56167,296,819,-523,659,52.5,632,1,0,0,1887,-1228
ZCTA5 56168,303,1259,-956,751,44.3,685,0,0,0,3514,-2763
ZCTA5 56169,281,319,-38,667,47.6,639,9,3,0.004497751,740,-73
ZCTA5 56170,250,2117,-1867,601,43.8,553,0,0,0,6607,-6006
ZCTA5 56171,738,1661,-923,1605,50.5,1543,9,0,0,5168,-3563
ZCTA5 56172,1295,326,969,3014,44.9,2941,0,1,0.000331785,765,2249
ZCTA5 56173,122,496,-374,256,36.2,249,0,0,0,1197,-941
ZCTA5 56174,152,278,-126,383,44.1,362,0,0,0,635,-252
ZCTA5 56175,1106,429,677,2991,40.1,2554,281,0,0,1137,1854
ZCTA5 56176,418,672,-254,1004,41.7,959,7,2,0.001992032,1813,-809
ZCTA5 56178,685,1235,-550,1790,40.7,1719,3,8,0.004469274,3049,-1259
ZCTA5 56180,443,143,300,1117,39.2,783,278,5,0.004476276,342,775
ZCTA5 56181,516,14,502,1259,40.7,1175,34,0,0,42,1217
ZCTA5 56183,597,3376,-2779,1325,46.3,1228,49,2,0.001509434,8609,-7284
ZCTA5 56185,214,589,-375,528,51.5,512,14,0,0,1391,-863
ZCTA5 56186,158,464,-306,391,36.7,347,0,30,0.076726343,1012,-621
ZCTA5 56187,5032,220,4812,15401,33.9,9450,1159,1183,0.076813194,567,14834
ZCTA5 56201,9184,119,9065,24502,36,18771,240,2423,0.098889887,276,24226
ZCTA5 56207,92,407,-315,220,60.2,220,0,0,0,1134,-914
ZCTA5 56208,968,2424,-1456,2054,50.3,1850,0,44,0.021421616,5751,-3697
ZCTA5 56209,913,84,829,2476,38,2278,7,7,0.002827141,254,2222
ZCTA5 56210,5,134,-129,18,30.5,18,0,0,0,269,-251
ZCTA5 56211,196,95,101,488,41.9,478,1,0,0,401,87
ZCTA5 56212,203,722,-519,531,45.5,485,0,0,0,1771,-1240
ZCTA5 56214,275,269,6,648,47.9,617,3,0,0,573,75
ZCTA5 56215,2035,361,1674,4652,44.3,4431,36,81,0.017411866,1034,3618
ZCTA5 56216,333,53,280,696,51,663,0,0,0,152,544
ZCTA5 56218,214,879,-665,469,55.1,421,1,0,0,2078,-1609
ZCTA5 56219,413,600,-187,1090,47.1,740,7,0,0,1448,-358
ZCTA5 56220,1151,33,1118,2655,46.5,2572,6,0,0,122,2533
ZCTA5 56221,321,619,-298,771,44.1,760,2,0,0,2287,-1516
ZCTA5 56222,842,364,478,2203,36.4,2033,0,9,0.004085338,994,1209
ZCTA5 56223,542,1663,-1121,1396,36.7,1282,15,0,0,5108,-3712
ZCTA5 56224,129,156,-27,326,38,317,0,0,0,375,-49
ZCTA5 56225,299,643,-344,661,50.9,644,11,0,0,1649,-988
ZCTA5 56226,92,167,-75,221,44.4,218,0,0,0,483,-262
ZCTA5 56227,112,510,-398,285,49.1,274,8,0,0,1354,-1069
ZCTA5 56228,383,4304,-3921,901,46.8,862,1,0,0,11905,-11004
ZCTA5 56229,753,640,113,1793,41.7,1710,7,1,0.000557724,1521,272
ZCTA5 56230,309,1161,-852,779,35.6,720,0,0,0,2821,-2042
ZCTA5 56231,144,298,-154,382,38.4,382,0,0,0,762,-380
ZCTA5 56232,896,359,537,2390,41.3,2233,14,29,0.012133891,777,1613
ZCTA5 56235,216,387,-171,518,45.1,508,1,0,0,855,-337
ZCTA5 56236,156,148,8,366,51.1,356,0,0,0,383,-17
ZCTA5 56237,247,429,-182,585,44.6,528,25,7,0.011965812,1188,-603
ZCTA5 56239,244,7116,-6872,643,41.5,521,3,12,0.018662519,18699,-18056
ZCTA5 56240,341,13471,-13130,876,46,846,0,2,0.002283105,34824,-33948
ZCTA5 56241,1597,11030,-9433,3700,40.8,3228,4,52,0.014054054,26806,-23106
ZCTA5 56243,688,9094,-8406,1860,37.7,1774,19,9,0.00483871,21220,-19360
ZCTA5 56244,582,16349,-15767,1666,34.2,1545,19,9,0.005402161,39873,-38207
ZCTA5 56245,222,3091,-2869,676,26.6,586,0,2,0.00295858,8129,-7453
ZCTA5 56248,350,6757,-6407,770,49.2,758,3,7,0.009090909,17090,-16320
ZCTA5 56249,129,4526,-4397,310,48.4,308,0,0,0,12736,-12426
ZCTA5 56251,363,0,363,854,46.4,847,0,4,0.004683841,43,811
ZCTA5 56252,492,0,492,1199,40,1113,1,8,0.006672227,665,534
ZCTA5 56253,414,10548,-10134,936,47.3,924,2,0,0,24701,-23765
ZCTA5 56255,174,764,-590,391,39.8,365,0,0,0,1837,-1446
ZCTA5 56256,1085,179,906,2257,55.2,2199,30,5,0.00221533,397,1860
ZCTA5 56257,216,37,179,548,49.1,535,0,0,0,67,481
ZCTA5 56258,5979,435,5544,15749,33.8,12687,948,804,0.05105086,982,14767
ZCTA5 56260,407,112,295,966,42.9,946,0,0,0,269,697
ZCTA5 56262,308,151,157,706,41.4,485,3,0,0,305,401
ZCTA5 56263,192,263,-71,452,40.4,424,9,0,0,777,-325
ZCTA5 56264,857,323,534,2110,42.6,1962,4,13,0.006161137,948,1162
ZCTA5 56265,3172,278,2894,7533,43.4,6616,108,128,0.016991902,855,6678
ZCTA5 56266,573,444,129,1485,41.1,1392,0,0,0,1221,264
ZCTA5 56267,2679,85,2594,6805,31.8,5725,195,172,0.025275533,202,6603
ZCTA5 56270,434,737,-303,1178,35.3,543,13,0,0,1801,-623
ZCTA5 56271,507,856,-349,1325,34.7,1117,0,0,0,2316,-991
ZCTA5 56273,1989,145,1844,5055,42.9,4873,25,29,0.005736894,308,4747
ZCTA5 56274,78,749,-671,232,39.2,225,0,0,0,1631,-1399
ZCTA5 56276,96,124,-28,197,48.2,185,12,0,0,292,-95
ZCTA5 56277,1257,77,1180,3191,39.3,2830,12,3,0.000940144,175,3016
ZCTA5 56278,1293,449,844,2756,48.2,2672,18,4,0.001451379,1310,1446
ZCTA5 56279,462,402,60,1197,37.5,1107,5,10,0.008354219,1027,170
ZCTA5 56280,218,32,186,482,50.4,462,0,0,0,106,376
ZCTA5 56281,228,262,-34,650,32.6,637,0,8,0.012307692,480,170
ZCTA5 56282,585,150,435,1458,38.6,1296,8,13,0.008916324,371,1087
ZCTA5 56283,2579,120,2459,6400,39.4,5778,21,5,0.00078125,325,6075
ZCTA5 56284,751,301,450,2145,38,1777,10,10,0.004662005,982,1163
ZCTA5 56285,453,106,347,1102,46.1,1063,3,0,0,289,813
ZCTA5 56287,32,269,-237,76,42.2,64,0,11,0.144736842,685,-609
ZCTA5 56288,1994,55,1939,4614,51.5,4383,0,24,0.00520156,132,4482
ZCTA5 56289,305,56,249,670,50.3,664,0,4,0.005970149,134,536
ZCTA5 56291,185,97,88,423,43.1,423,0,0,0,207,216
ZCTA5 56292,216,526,-310,632,36.9,579,0,47,0.074367089,1388,-756
ZCTA5 56293,478,445,33,1220,48.6,1146,29,17,0.013934426,997,223
ZCTA5 56294,53,45,8,99,58.5,93,0,0,0,161,-62
ZCTA5 56295,132,2161,-2029,312,41.8,262,32,0,0,4919,-4607
ZCTA5 56296,843,185,658,1806,47.4,1696,0,6,0.003322259,506,1300
ZCTA5 56297,322,53,269,827,42.7,780,0,5,0.006045949,101,726
ZCTA5 56301,12614,289,12325,35453,26.6,25401,1500,6066,0.171099766,1067,34386
ZCTA5 56303,10725,93,10632,24803,37.7,20478,415,2411,0.097205983,353,24450
ZCTA5 56304,6961,189,6772,16619,33,11411,679,2814,0.169324267,440,16179
ZCTA5 56307,1912,390,1522,5337,35.8,5035,72,137,0.025669852,1144,4193
ZCTA5 56308,11546,137,11409,25941,42.3,24858,143,69,0.002659882,247,25694
ZCTA5 56309,563,1744,-1181,1396,46.1,1371,6,0,0,5208,-3812
ZCTA5 56310,1991,222,1769,5383,39.5,5321,8,0,0,479,4904
ZCTA5 56311,307,95,212,738,52.8,674,0,0,0,231,507
ZCTA5 56312,940,101,839,2437,38.9,2346,3,0,0,245,2192
ZCTA5 56313,32,213,-181,83,38.3,83,0,0,0,628,-545
ZCTA5 56314,467,206,261,1355,42.2,1314,0,0,0,542,813
ZCTA5 56315,713,169,544,1872,40.4,1831,3,11,0.005876068,383,1489
ZCTA5 56316,583,285,298,1417,43.2,1323,4,3,0.002117149,645,772
ZCTA5 56318,432,117,315,1010,48,990,1,0,0,304,706
ZCTA5 56319,578,70,508,1301,46.6,1273,0,7,0.005380477,116,1185
ZCTA5 56320,3102,425,2677,8223,42.8,7886,5,4,0.00048644,1152,7071
ZCTA5 56321,0,1269,-1269,1631,19.9,1413,64,102,0.06253832,2683,-1052
ZCTA5 56323,230,451,-221,568,37.6,512,0,1,0.001760563,1254,-686
ZCTA5 56324,468,247,221,1138,45.6,1103,0,2,0.001757469,795,343
ZCTA5 56325,81,434,-353,193,50.1,192,0,1,0.005181347,1029,-836
ZCTA5 56326,728,7816,-7088,1802,42.1,1779,0,1,0.000554939,18109,-16307
ZCTA5 56327,345,447,-102,824,53.5,798,1,11,0.013349515,1502,-678
ZCTA5 56328,77,180,-103,163,57.7,147,1,0,0,441,-278
ZCTA5 56329,2703,478,2225,7771,35.9,7453,53,39,0.005018659,1134,6637
ZCTA5 56330,656,297,359,1712,40.3,1643,17,0,0,742,970
ZCTA5 56331,771,391,380,2265,34,2151,0,13,0.005739514,1006,1259
ZCTA5 56332,686,252,434,1622,42.6,1555,28,3,0.001849568,602,1020
ZCTA5 56334,2510,434,2076,5819,46.5,5568,32,48,0.00824884,1153,4666
ZCTA5 56335,90,168,-78,252,33.3,252,0,0,0,414,-162
ZCTA5 56336,647,92,555,1598,54.6,1567,0,0,0,275,1323
ZCTA5 56338,676,136,540,1632,47.6,1538,3,0,0,218,1414
ZCTA5 56339,400,147,253,1035,36,976,0,5,0.004830918,370,665
ZCTA5 56340,926,1345,-419,2281,39.9,2257,1,0,0,3488,-1207
ZCTA5 56342,1218,437,781,2570,54.7,2317,5,1,0.000389105,1094,1476
ZCTA5 56343,414,136,278,920,50.9,899,1,0,0,492,428
ZCTA5 56345,6274,268,6006,14991,42.4,14354,65,30,0.002001201,864,14127
ZCTA5 56347,2918,258,2660,8090,39.1,6707,108,64,0.007911001,621,7469
ZCTA5 56349,318,279,39,786,42.3,748,4,0,0,824,-38
ZCTA5 56350,200,331,-131,384,53.7,359,0,2,0.005208333,879,-495
ZCTA5 56352,2458,134,2324,5876,43.2,5545,28,30,0.005105514,278,5598
ZCTA5 56353,3619,44,3575,9472,38.8,8883,36,47,0.004961993,71,9401
ZCTA5 56354,591,383,208,1390,51.9,1383,0,0,0,1410,-20
ZCTA5 56355,214,125,89,638,33.5,635,0,0,0,351,287
ZCTA5 56356,97,82,15,278,35.3,275,0,0,0,183,95
ZCTA5 56357,386,215,171,1356,33.1,1323,6,2,0.001474926,511,845
ZCTA5 56358,1257,81,1176,3204,44,3048,21,13,0.004057428,153,3051
ZCTA5 56359,1338,525,813,3567,42.5,2283,8,38,0.01065321,1332,2235
ZCTA5 56360,1762,8,1754,3697,54.2,3626,3,14,0.003786854,20,3677
ZCTA5 56361,925,229,696,2594,38.3,2564,0,2,0.00077101,513,2081
ZCTA5 56362,2168,679,1489,5295,47.8,5042,35,70,0.013220019,1558,3737
ZCTA5 56363,85,6253,-6168,230,33.4,229,0,0,0,14889,-14659
ZCTA5 56364,2099,345,1754,5816,38.4,5610,13,24,0.004126547,827,4989
ZCTA5 56367,2598,479,2119,7089,39.3,6863,15,23,0.003244463,1115,5974
ZCTA5 56368,1646,547,1099,4149,46.1,4007,11,0,0,1885,2264
ZCTA5 56369,226,22,204,560,29.5,425,0,4,0.007142857,78,482
ZCTA5 56371,37,300,-263,109,32.8,103,0,0,0,719,-610
ZCTA5 56373,1179,50,1129,3114,38.3,3014,8,33,0.010597303,115,2999
ZCTA5 56374,3280,942,2338,9895,31.9,9085,132,398,0.040222335,2062,7833
ZCTA5 56375,337,390,-53,817,37.5,790,2,0,0,1007,-190
ZCTA5 56376,128,39,89,316,37.8,315,0,0,0,86,230
ZCTA5 56377,7870,276,7594,20592,34.5,18857,590,254,0.012334887,585,20007
ZCTA5 56378,3354,926,2428,8245,38.2,7591,52,25,0.003032141,2406,5839
ZCTA5 56379,6897,78,6819,17106,35.7,15744,178,182,0.010639542,178,16928
ZCTA5 56381,997,454,543,2310,48.5,2183,39,0,0,1208,1102
ZCTA5 56382,534,950,-416,1337,43.1,1326,3,0,0,2200,-863
ZCTA5 56384,134,306,-172,313,36.7,289,0,0,0,844,-531
ZCTA5 56385,445,76,369,909,45.6,869,0,0,0,162,747
ZCTA5 56386,308,228,80,693,53.2,591,4,0,0,532,161
ZCTA5 56387,3515,107,3408,7722,35.7,4647,267,2402,0.311059311,242,7480
ZCTA5 56389,36,286,-250,93,32.4,93,0,0,0,633,-540
ZCTA5 56401,12558,416,12142,30827,40.3,29126,175,259,0.008401726,951,29876
ZCTA5 56425,3447,26,3421,8547,43,8227,27,83,0.00971101,38,8509
ZCTA5 56431,3695,1194,2501,8834,56.9,8442,10,38,0.004301562,3510,5324
ZCTA5 56433,773,234,539,1562,54.6,1475,2,4,0.002560819,516,1046
ZCTA5 56434,71,670,-599,242,36.3,237,0,0,0,1483,-1241
ZCTA5 56435,1198,279,919,2814,51.3,2597,39,17,0.006041222,796,2018
ZCTA5 56437,464,354,110,1376,33.5,1307,0,12,0.00872093,850,526
ZCTA5 56438,1068,513,555,2736,42.8,2503,5,48,0.01754386,1184,1552
ZCTA5 56440,517,38,479,1366,43,1311,6,6,0.004392387,103,1263
ZCTA5 56441,1722,12705,-10983,3876,48.5,3638,0,22,0.005675955,30103,-26227
ZCTA5 56442,1376,47,1329,2751,59.8,2714,0,0,0,115,2636
ZCTA5 56443,626,32,594,1391,53.7,1355,1,0,0,47,1344
ZCTA5 56444,1341,87,1254,3221,51.7,3083,12,17,0.005277864,167,3054
ZCTA5 56446,640,125,515,1842,35.4,1696,3,2,0.001085776,329,1513
ZCTA5 56447,365,34,331,720,59.8,712,0,0,0,75,645
ZCTA5 56448,218,234,-16,430,62.7,426,0,0,0,687,-257
ZCTA5 56449,725,306,419,1976,40.1,1802,5,0,0,774,1202
ZCTA5 56450,492,57,435,1014,55.6,824,0,0,0,142,872
ZCTA5 56452,934,844,90,1848,62.2,1728,17,12,0.006493506,2376,-528
ZCTA5 56453,301,140,161,768,43.8,724,0,0,0,490,278
ZCTA5 56455,649,213,436,1653,38.7,1555,5,7,0.004234725,521,1132
ZCTA5 56458,148,241,-93,405,49.8,383,0,0,0,497,-92
ZCTA5 56461,1306,112,1194,3188,44.6,2840,21,3,0.000941029,222,2966
ZCTA5 56464,1672,216,1456,4821,38,4614,44,8,0.001659407,481,4340
ZCTA5 56465,889,615,274,2167,54.4,2092,0,37,0.017074296,1373,794
ZCTA5 56466,1306,595,711,2871,50.3,2717,1,8,0.002786486,1442,1429
ZCTA5 56467,1064,33,1031,2705,54,2549,9,51,0.018853974,65,2640
ZCTA5 56468,1776,148,1628,4220,53,4013,0,22,0.00521327,468,3752
ZCTA5 56469,486,313,173,1006,59.5,887,0,0,0,762,244
ZCTA5 56470,4384,698,3686,10595,48,9801,12,98,0.009249646,1671,8924
ZCTA5 56472,3379,796,2583,8424,41.6,8031,15,3,0.000356125,2080,6344
ZCTA5 56473,1307,230,1077,3238,47,3116,6,12,0.003705991,382,2856
ZCTA5 56474,1864,193,1671,4430,45.9,4108,47,29,0.006546275,453,3977
ZCTA5 56475,641,78,563,1671,42.4,1609,0,2,0.001196888,155,1516
ZCTA5 56477,1136,277,859,2811,41.3,2697,6,1,0.000355745,654,2157
ZCTA5 56479,1832,856,976,4760,47.5,4299,3,35,0.007352941,2136,2624
ZCTA5 56481,888,115,773,2406,36.3,2154,12,4,0.00166251,249,2157
ZCTA5 56482,2975,290,2685,7407,39,6885,4,88,0.011880653,622,6785
ZCTA5 56484,1359,41,1318,3202,53.1,2349,14,15,0.004684572,95,3107
ZCTA5 56501,7284,363,6921,17849,43.9,16384,161,103,0.005770631,826,17023
ZCTA5 56510,926,45,881,2336,42.6,2216,0,21,0.008989726,93,2243
ZCTA5 56511,798,128,670,1943,43.4,1829,6,12,0.006176016,297,1646
ZCTA5 56514,1414,162,1252,3895,34.9,3671,76,4,0.001026958,407,3488
ZCTA5 56515,1243,146,1097,2730,59.8,2619,8,10,0.003663004,386,2344
ZCTA5 56516,122,58,64,331,41.4,302,0,10,0.03021148,117,214
ZCTA5 56517,95,116,-21,273,46.9,269,0,0,0,283,-10
ZCTA5 56518,152,107,45,395,29.3,370,0,0,0,278,117
ZCTA5 56519,111,1348,-1237,277,44.5,229,3,2,0.007220217,3291,-3014
ZCTA5 56520,1713,41,1672,3947,42.7,3714,0,10,0.00253357,191,3756
ZCTA5 56521,311,301,10,772,43.8,530,0,0,0,770,2
ZCTA5 56522,175,412,-237,452,45.3,399,0,5,0.011061947,975,-523
ZCTA5 56523,156,79,77,432,38.3,409,6,0,0,303,129
ZCTA5 56524,296,62,234,697,57.3,645,0,2,0.00286944,140,557
ZCTA5 56525,32,42,-10,78,59.7,74,4,0,0,92,-14
ZCTA5 56527,314,180,134,946,33.9,919,1,0,0,468,478
ZCTA5 56528,750,75,675,1758,50.5,1713,3,2,0.001137656,165,1593
ZCTA5 56529,1847,238,1609,4585,40.1,4028,18,215,0.046892039,598,3987
ZCTA5 56531,788,136,652,1896,42.2,1822,0,9,0.004746835,532,1364
ZCTA5 56533,116,6739,-6623,299,47.9,289,1,0,0,16205,-15906
ZCTA5 56534,530,65,465,1321,49.8,1248,4,0,0,131,1190
ZCTA5 56535,516,98,418,1263,41.2,1161,13,0,0,205,1058
ZCTA5 56536,145,185,-40,324,52,310,11,0,0,442,-118
ZCTA5 56537,8610,521,8089,19449,44.7,18030,87,365,0.018767032,1189,18260
ZCTA5 56540,726,410,316,1909,40.5,1825,4,5,0.002619172,977,932
ZCTA5 56541,27,244,-217,58,50.6,58,0,0,0,535,-477
ZCTA5 56542,1042,99,943,2516,48,2325,9,6,0.002384738,224,2292
ZCTA5 56543,96,1191,-1095,256,40.4,256,0,0,0,2791,-2535
ZCTA5 56544,2120,885,1235,5573,40.4,4985,19,65,0.011663377,1864,3709
ZCTA5 56545,268,61,207,638,38.5,575,15,13,0.020376176,132,506
ZCTA5 56546,93,218,-125,212,42.5,193,0,0,0,607,-395
ZCTA5 56547,945,61,884,2939,34.5,2693,45,16,0.005444029,118,2821
ZCTA5 56548,304,102,202,729,40.4,610,0,25,0.034293553,202,527
ZCTA5 56549,1783,33,1750,4931,37.8,4775,15,36,0.00730075,85,4846
ZCTA5 56550,141,17,124,308,42.8,296,0,0,0,51,257
ZCTA5 56551,918,367,551,2131,51.7,1981,8,0,0,940,1191
ZCTA5 56552,202,221,-19,534,34.3,435,3,0,0,591,-57
ZCTA5 56553,122,77,45,202,61,202,0,0,0,229,-27
ZCTA5 56554,1096,364,732,2740,48.6,2537,30,0,0,1406,1334
ZCTA5 56556,448,794,-346,1227,35.2,1056,1,65,0.052974735,1981,-754
ZCTA5 56557,984,237,747,2834,36.3,1322,10,8,0.002822865,572,2262
ZCTA5 56560,17665,81,17584,43302,32.5,37532,811,2716,0.062722276,239,43063
ZCTA5 56562,0,1035,-1035,527,19.6,499,12,16,0.030360531,3205,-2678
ZCTA5 56563,0,295,-295,1644,19.6,1397,57,126,0.076642336,727,917
ZCTA5 56565,38,88,-50,125,20.8,103,0,22,0.176,387,-262
ZCTA5 56566,197,29,168,683,25.1,44,0,0,0,106,577
ZCTA5 56567,1297,73,1224,3264,40.6,3141,1,7,0.002144608,267,2997
ZCTA5 56568,56,414,-358,133,49.9,97,0,0,0,1052,-919
ZCTA5 56569,464,376,88,1243,36.6,563,8,3,0.002413516,1423,-180
ZCTA5 56570,465,506,-41,1143,52,1062,15,13,0.011373578,1140,3
ZCTA5 56571,785,291,494,1833,55.7,1695,18,0,0,622,1211
ZCTA5 56572,2165,116,2049,5832,43.8,4833,133,246,0.04218107,328,5504
ZCTA5 56573,2712,542,2170,6532,44.2,6011,2,55,0.008420086,2144,4388
ZCTA5 56574,115,16,99,271,53.2,253,0,0,0,19,252
ZCTA5 56575,272,525,-253,644,55.4,297,0,0,0,2224,-1580
ZCTA5 56576,383,39,344,865,57.2,850,0,0,0,78,787
ZCTA5 56578,293,53,240,770,48,690,0,5,0.006493506,93,677
ZCTA5 56579,393,303,90,1115,37.6,1074,0,6,0.005381166,1137,-22
ZCTA5 56580,474,439,35,1220,37.8,1165,3,0,0,1337,-117
ZCTA5 56581,130,1923,-1793,261,47.6,229,0,0,0,4356,-4095
ZCTA5 56583,67,31,36,170,42,167,0,0,0,44,126
ZCTA5 56584,558,102,456,1356,48.2,1264,14,16,0.01179941,271,1085
ZCTA5 56585,484,1619,-1135,1074,50,1013,2,3,0.002793296,3928,-2854
ZCTA5 56586,813,213,600,1882,50.4,1759,0,1,0.00053135,432,1450
ZCTA5 56587,568,86,482,1228,52.8,1213,2,0,0,464,764
ZCTA5 56588,185,82,103,420,58.3,403,0,0,0,267,153
ZCTA5 56589,692,353,339,1896,35.7,946,10,8,0.004219409,1126,770
ZCTA5 56590,157,1228,-1071,377,48.2,356,0,0,0,4287,-3910
ZCTA5 56591,216,375,-159,641,24.2,15,4,0,0,966,-325
ZCTA5 56592,157,20,137,472,41.3,455,7,0,0,34,438
ZCTA5 56594,183,138,45,451,42.4,421,7,0,0,350,101
ZCTA5 56601,13661,304,13357,34176,35.3,27893,298,502,0.01468867,657,33519
ZCTA5 56621,1666,194,1472,4475,41.2,3507,18,12,0.002681564,558,3917
ZCTA5 56623,1058,26,1032,2743,52.9,2535,3,2,0.000729129,101,2642
ZCTA5 56626,87,20,67,221,48.1,88,2,0,0,35,186
ZCTA5 56627,136,854,-718,222,62.3,206,0,0,0,1834,-1612
ZCTA5 56628,650,58,592,1580,58.6,1472,7,48,0.030379747,351,1229
ZCTA5 56629,74,99,-25,172,56.8,172,0,0,0,220,-48
ZCTA5 56630,851,143,708,2110,46.2,1875,0,2,0.000947867,343,1767
ZCTA5 56633,1556,524,1032,4895,29.2,1656,59,31,0.006332993,1894,3001
ZCTA5 56634,615,70,545,1775,37.4,1639,25,0,0,164,1611
ZCTA5 56636,1932,107,1825,5119,45.3,3898,3,30,0.00586052,264,4855
ZCTA5 56637,73,85,-12,161,50.1,149,0,0,0,188,-27
ZCTA5 56639,207,143,64,407,56.1,356,2,0,0,257,150
ZCTA5 56641,132,106,26,402,36.8,159,25,2,0.004975124,306,96
ZCTA5 56644,281,38,243,652,50,569,13,0,0,81,571
ZCTA5 56646,155,39,116,421,31.5,368,1,41,0.097387173,120,301
ZCTA5 56647,313,111,202,838,39.3,789,1,2,0.002386635,368,470
ZCTA5 56649,4189,293,3896,9066,47.2,8273,9,69,0.007610854,688,8378
ZCTA5 56650,424,110,314,989,49.4,815,0,7,0.007077856,287,702
ZCTA5 56651,191,96,95,574,41.8,478,0,41,0.071428571,328,246
ZCTA5 56652,186,27,159,474,42.7,462,0,0,0,65,409
ZCTA5 56653,560,42,518,1247,55.2,1201,1,0,0,129,1118
ZCTA5 56654,38,17612,-17574,87,56.3,79,8,0,0,43530,-43443
ZCTA5 56655,758,13546,-12788,1420,63.9,1216,6,0,0,32509,-31089
ZCTA5 56657,90,5305,-5215,177,68.3,176,0,0,0,14333,-14156
ZCTA5 56658,0,854,-854,0,-,0,0,0,#DIV/0!,2836,-2836
ZCTA5 56659,64,233,-169,172,42.9,122,0,0,0,1174,-1002
ZCTA5 56660,119,112,7,246,63.6,224,3,2,0.008130081,401,-155
ZCTA5 56661,402,3071,-2669,990,51.6,922,5,0,0,7453,-6463
ZCTA5 56662,249,2449,-2200,510,64.5,466,10,7,0.01372549,6357,-5847
ZCTA5 56663,84,2350,-2266,149,57.6,94,0,0,0,6546,-6397
ZCTA5 56666,210,262,-52,1169,18.3,16,4,0,0,586,583
ZCTA5 56667,305,123,182,838,35.9,770,0,0,0,333,505
ZCTA5 56668,95,82,13,177,57.8,175,0,0,0,287,-110
ZCTA5 56669,108,52,56,220,58.7,208,0,9,0.040909091,116,104
ZCTA5 56670,300,2597,-2297,1218,29.4,38,0,3,0.002463054,5981,-4763
ZCTA5 56671,831,1058,-227,3069,20.4,67,0,9,0.002932551,2155,914
ZCTA5 56672,892,789,103,1931,56.2,1615,25,0,0,1627,304
ZCTA5 56673,165,52,113,510,36,502,0,0,0,113,397
ZCTA5 56676,714,21,693,1686,44.1,1566,0,0,0,82,1604
ZCTA5 56678,615,591,24,1706,39.1,1548,23,2,0.001172333,1552,154
ZCTA5 56680,54,884,-830,104,56.5,94,0,0,0,2051,-1947
ZCTA5 56681,104,2304,-2200,263,57.3,180,0,0,0,5336,-5073
ZCTA5 56683,253,89,164,579,50.8,541,11,2,0.003454231,282,297
ZCTA5 56684,139,129,10,377,41.3,353,1,1,0.00265252,393,-16
ZCTA5 56685,62,371,-309,120,65,118,2,0,0,893,-773
ZCTA5 56686,337,433,-96,937,45.3,839,0,0,0,2044,-1107
ZCTA5 56688,64,1546,-1482,138,59.6,138,0,0,0,3563,-3425
ZCTA5 56701,5562,42,5520,12956,39.7,11971,149,180,0.013893177,113,12843
ZCTA5 56710,191,221,-30,448,42.7,392,0,0,0,888,-440
ZCTA5 56711,5,90,-85,5,-,5,0,0,0,280,-275
ZCTA5 56713,409,146,263,953,42.3,943,0,0,0,791,162
ZCTA5 56714,467,618,-151,1193,44.1,1154,5,10,0.00838223,1849,-656
ZCTA5 56715,137,450,-313,283,59.6,282,0,0,0,1158,-875
ZCTA5 56716,3791,205,3586,9118,40.2,7723,252,280,0.030708489,438,8680
ZCTA5 56720,8,149,-141,8,70.5,8,0,0,0,408,-400
ZCTA5 56721,4165,374,3791,10827,35.5,9408,64,371,0.034266186,1838,8989
ZCTA5 56722,145,123,22,365,45.3,349,1,3,0.008219178,184,181
ZCTA5 56723,313,76,237,874,39.1,814,0,18,0.020594966,178,696
ZCTA5 56724,51,1267,-1216,144,43.5,138,6,0,0,3353,-3209
ZCTA5 56725,346,1098,-752,914,37.4,854,18,15,0.016411379,5838,-4924
ZCTA5 56726,601,401,200,1661,40.1,1523,71,15,0.009030704,1751,-90
ZCTA5 56727,351,157,194,892,45.3,838,2,0,0,315,577
ZCTA5 56728,492,134,358,1209,50.6,1127,8,9,0.007444169,356,853
ZCTA5 56729,48,4,44,124,46.1,123,0,0,0,11,113
ZCTA5 56731,46,147,-101,112,44.5,112,0,0,0,327,-215
ZCTA5 56732,430,57,373,1038,48.3,1005,4,20,0.019267823,161,877
ZCTA5 56733,164,25,139,378,42.3,354,0,12,0.031746032,42,336
ZCTA5 56734,189,6671,-6482,608,50.2,564,0,13,0.021381579,14052,-13444
ZCTA5 56735,274,4098,-3824,703,45.8,687,0,1,0.001422475,9420,-8717
ZCTA5 56736,326,158,168,775,51.4,759,10,0,0,374,401
ZCTA5 56737,354,266,88,766,51,750,1,2,0.002610966,662,104
ZCTA5 56738,528,488,40,1411,40,1345,12,0,0,1160,251
ZCTA5 56742,311,73,238,882,36.7,825,0,2,0.002267574,186,696
ZCTA5 56744,198,16,182,530,33.4,471,4,6,0.011320755,31,499
ZCTA5 56748,252,913,-661,583,43,513,0,22,0.037735849,2335,-1752
ZCTA5 56750,1005,162,843,2322,45,2204,0,11,0.004737295,908,1414
ZCTA5 56751,2207,21,2186,5716,42.1,5326,24,127,0.022218334,559,5157
ZCTA5 56754,224,36,188,536,37,495,2,2,0.003731343,90,446
ZCTA5 56755,32,0,32,64,59.3,64,0,0,0,0,64
ZCTA5 56756,210,106,104,664,31.7,558,10,1,0.001506024,275,389
ZCTA5 56757,355,239,116,878,53.7,845,0,8,0.009111617,652,226
ZCTA5 56758,132,181,-49,298,53,297,1,0,0,422,-124
ZCTA5 56759,124,34,90,318,52.1,312,0,2,0.006289308,66,252
ZCTA5 56760,189,112,77,463,43.5,401,0,14,0.030237581,277,186
ZCTA5 56761,157,19,138,411,50.8,400,3,0,0,38,373
ZCTA5 56762,1023,198,825,2431,38.8,2265,7,7,0.002879473,385,2046
ZCTA5 56763,1874,871,1003,5203,41,4498,323,4,0.000768787,2337,2866
ZCTA5 57001,668,59,609,1583,52.4,1449,7,4,0.002526848,114,1469
ZCTA5 57002,611,108,503,1439,29.7,1310,9,0,0,267,1172
ZCTA5 57003,659,63,596,1911,34.5,1807,0,1,0.000523286,222,1689
ZCTA5 57004,1493,200,1293,3919,37.5,3803,15,0,0,377,3542
ZCTA5 57005,4410,116,4294,12192,36.9,11422,45,297,0.024360236,244,11948
ZCTA5 57006,9540,148,9392,22749,27.9,20141,981,406,0.017846938,377,22372
ZCTA5 57007,0,563,-563,2629,19.3,2422,43,43,0.016356029,1152,1477
ZCTA5 57010,280,64,216,510,46.9,446,0,0,0,192,318
ZCTA5 57012,469,238,231,1019,40,952,0,9,0.008832188,548,471
ZCTA5 57013,1751,158,1593,4429,43.8,4238,55,0,0,352,4077
ZCTA5 57014,690,304,386,1723,41.9,1630,0,0,0,726,997
ZCTA5 57015,285,183,102,783,42.6,764,0,6,0.007662835,448,335
ZCTA5 57016,326,93,233,758,48,673,0,0,0,153,605
ZCTA5 57017,493,124,369,1354,32.7,1238,0,10,0.007385524,284,1070
ZCTA5 57018,550,120,430,1503,36.1,1460,0,5,0.00332668,282,1221
ZCTA5 57020,605,399,206,1702,41.5,1675,0,0,0,840,862
ZCTA5 57021,159,662,-503,459,39.7,419,35,0,0,1632,-1173
ZCTA5 57022,2162,454,1708,5876,38.2,5679,0,0,0,1384,4492
ZCTA5 57024,218,83,135,521,47.1,442,0,0,0,146,375
ZCTA5 57025,1139,1010,129,2933,36.9,2912,0,0,0,2545,388
ZCTA5 57026,546,258,288,1583,30.9,1373,0,2,0.001263424,553,1030
ZCTA5 57027,64,1401,-1337,138,58.7,125,0,0,0,3996,-3858
ZCTA5 57028,1230,189,1041,3194,38.6,1996,125,43,0.013462743,494,2700
ZCTA5 57029,888,110,778,2521,41.9,2210,24,0,0,232,2289
ZCTA5 57030,1121,519,602,2845,43.7,2613,0,11,0.003866432,1248,1597
ZCTA5 57031,393,268,125,729,43.7,684,2,0,0,646,83
ZCTA5 57032,2982,615,2367,8227,31.3,7845,0,0,0,1484,6743
ZCTA5 57033,2169,1308,861,5906,36.4,5537,19,18,0.003047748,3105,2801
ZCTA5 57034,368,68,300,863,47.5,849,0,0,0,135,728
ZCTA5 57035,368,75,293,1076,33.1,972,6,0,0,193,883
ZCTA5 57036,261,55,206,702,43.3,633,0,0,0,129,573
ZCTA5 57037,405,452,-47,1040,31.6,1022,0,0,0,1218,-178
ZCTA5 57038,613,532,81,1603,39.2,1558,0,0,0,1345,258
ZCTA5 57039,1496,171,1325,3752,38.6,3451,0,77,0.020522388,429,3323
ZCTA5 57040,145,91,54,296,60.2,292,0,0,0,228,68
ZCTA5 57041,29,162,-133,75,62.2,75,0,0,0,372,-297
ZCTA5 57042,3213,187,3026,8186,40.2,7715,0,32,0.003909113,457,7729
ZCTA5 57043,568,27,541,1414,43.9,1372,2,0,0,47,1367
ZCTA5 57045,454,118,336,1129,45.4,1105,15,0,0,235,894
ZCTA5 57046,360,148,212,800,44.6,788,0,0,0,374,426
ZCTA5 57047,140,48,92,288,39.7,263,0,0,0,118,170
ZCTA5 57048,512,196,316,1286,42.6,1285,0,0,0,427,859
ZCTA5 57049,3248,3556,-308,7476,39.3,6402,233,64,0.008560728,7934,-458
ZCTA5 57050,136,3599,-3463,340,46,337,0,0,0,8926,-8586
ZCTA5 57051,133,0,133,222,54.4,209,0,0,0,324,-102
ZCTA5 57052,104,268,-164,255,51.8,240,0,0,0,699,-444
ZCTA5 57053,803,10709,-9906,2112,38.6,2042,0,34,0.016098485,26302,-24190
ZCTA5 57054,247,196,51,544,48.5,453,9,0,0,423,121
ZCTA5 57055,512,379,133,1252,49.7,1189,0,0,0,970,282
ZCTA5 57057,93,14091,-13998,271,32.4,268,0,0,0,30781,-30510
ZCTA5 57058,718,22812,-22094,2000,38.9,1882,0,5,0.0025,47442,-45442
ZCTA5 57059,542,11204,-10662,1218,42.7,1112,0,0,0,28513,-27295
ZCTA5 57061,64,0,64,163,24.7,160,0,0,0,1809,-1646
ZCTA5 57062,498,15752,-15254,2460,38.6,1746,11,76,0.030894309,35515,-33055
ZCTA5 57063,337,0,337,874,48,839,0,0,0,1795,-921
ZCTA5 57064,2351,7107,-4756,6995,31.3,6584,61,29,0.004145818,17720,-10725
ZCTA5 57065,165,647,-482,328,59.6,296,4,2,0.006097561,2270,-1942
ZCTA5 57066,662,0,662,1484,48.2,1416,0,35,0.023584906,300,1184
ZCTA5 57067,94,135,-41,257,41.5,240,0,3,0.011673152,297,-40
ZCTA5 57068,609,237,372,1670,46,1573,10,7,0.004191617,495,1175
ZCTA5 57069,4535,130,4405,12682,23.7,10852,417,271,0.021368869,313,12369
ZCTA5 57070,578,40,538,1296,48.8,1236,0,5,0.003858025,93,1203
ZCTA5 57071,1360,263,1097,3161,33.7,3096,27,3,0.000949067,594,2567
ZCTA5 57072,265,21,244,701,39.9,651,0,0,0,28,673
ZCTA5 57073,188,1023,-835,508,48.2,474,3,3,0.005905512,2235,-1727
ZCTA5 57075,461,159,302,1022,57.4,972,0,13,0.012720157,411,611
ZCTA5 57076,194,87,107,410,61.5,410,0,0,0,219,191
ZCTA5 57077,484,15,469,1285,37.8,1208,0,20,0.015564202,19,1266
ZCTA5 57078,8254,468,7786,20052,41,17726,45,325,0.01620786,920,19132
ZCTA5 57103,14095,251,13844,36574,35.5,27875,899,4437,0.121315689,481,36093
ZCTA5 57104,11731,342,11389,26117,34.8,18599,281,3063,0.117279933,840,25277
ZCTA5 57105,9568,83,9485,22916,35.8,20060,472,1018,0.04442311,172,22744
ZCTA5 57106,20037,292,19745,49337,33.3,42175,934,2075,0.042057685,675,48662
ZCTA5 57107,4183,237,3946,10402,34.3,8582,232,375,0.036050759,631,9771
ZCTA5 57108,12512,118,12394,30152,37.5,27966,743,643,0.021325285,280,29872
ZCTA5 57110,7639,188,7451,19327,35.5,15708,1085,1176,0.060847519,459,18868
ZCTA5 57117,0,2362,-2362,5,60.5,5,0,0,0,5402,-5397
ZCTA5 57197,0,89,-89,953,19.7,857,9,42,0.044071354,191,762
ZCTA5 57201,11005,23,10982,25930,39.1,24007,162,261,0.010065561,50,25880
ZCTA5 57212,838,596,242,2134,40.8,2110,0,0,0,1384,750
ZCTA5 57213,164,47,117,407,39.4,400,0,0,0,102,305
ZCTA5 57214,51,261,-210,137,45.5,131,0,0,0,696,-559
ZCTA5 57216,602,93,509,1328,54.7,1290,6,0,0,213,1115
ZCTA5 57217,111,1111,-1000,230,62.3,230,0,0,0,2581,-2351
ZCTA5 57218,147,121,26,338,30.5,332,0,0,0,298,40
ZCTA5 57219,208,839,-631,506,46.6,450,0,4,0.007905138,2110,-1604
ZCTA5 57220,349,229,120,860,44.9,838,0,0,0,472,388
ZCTA5 57221,313,326,-13,987,25.6,971,0,3,0.003039514,868,119
ZCTA5 57223,474,787,-313,1354,34.3,1304,7,0,0,1831,-477
ZCTA5 57224,76,107,-31,161,65.6,155,0,0,0,240,-79
ZCTA5 57225,731,187,544,1770,41.3,1705,4,7,0.003954802,384,1386
ZCTA5 57226,756,82,674,1815,43.8,1748,0,1,0.000550964,170,1645
ZCTA5 57227,110,458,-348,400,20.9,400,0,0,0,1092,-692
ZCTA5 57231,681,56,625,1800,44.3,1767,0,0,0,143,1657
ZCTA5 57232,161,189,-28,411,57.2,408,0,0,0,457,-46
ZCTA5 57233,70,114,-44,262,22.7,262,0,0,0,220,42
ZCTA5 57234,468,487,-19,1252,36.9,1192,5,0,0,1265,-13
ZCTA5 57235,321,66,255,881,43.8,836,3,0,0,158,723
ZCTA5 57236,55,888,-833,131,42,128,3,0,0,2018,-1887
ZCTA5 57237,282,326,-44,691,51.3,685,0,0,0,751,-60
ZCTA5 57238,184,160,24,415,33.3,415,0,0,0,400,15
ZCTA5 57239,148,98,50,336,59.4,336,0,0,0,199,137
ZCTA5 57241,327,457,-130,976,30.8,947,11,0,0,1186,-210
ZCTA5 57242,130,330,-200,453,29.5,450,0,3,0.006622517,819,-366
ZCTA5 57243,276,251,25,548,50.2,532,16,0,0,538,10
ZCTA5 57245,73,119,-46,178,42.8,163,0,0,0,233,-55
ZCTA5 57246,72,673,-601,138,60.8,138,0,0,0,1861,-1723
ZCTA5 57247,87,54,33,199,56,199,0,0,0,128,71
ZCTA5 57248,391,703,-312,1114,38.4,1095,0,9,0.008078995,1573,-459
ZCTA5 57249,385,4143,-3758,879,53.8,749,4,0,0,9744,-8865
ZCTA5 57251,45,26,19,185,21.1,82,67,17,0.091891892,79,106
ZCTA5 57252,1953,2015,-62,4945,42.6,4573,0,5,0.001011122,6549,-1604
ZCTA5 57255,155,105,50,390,40.5,266,3,0,0,231,159
ZCTA5 57256,66,1640,-1574,176,44,174,0,0,0,3518,-3342
ZCTA5 57257,220,99,121,672,33.5,182,0,0,0,212,460
ZCTA5 57258,55,26,29,138,50.8,132,0,2,0.014492754,37,101
ZCTA5 57259,255,564,-309,680,30.8,675,0,0,0,1341,-661
ZCTA5 57260,383,30,353,1093,40.5,933,0,0,0,52,1041
ZCTA5 57261,119,133,-14,266,55.3,259,0,0,0,355,-89
ZCTA5 57262,1831,1077,754,5495,33.5,2041,5,47,0.00855323,3163,2332
ZCTA5 57263,192,172,20,480,47.6,465,0,0,0,369,111
ZCTA5 57264,107,53,54,235,44.3,234,0,0,0,120,115
ZCTA5 57265,83,161,-78,181,34,180,1,0,0,317,-136
ZCTA5 57266,194,360,-166,583,30.4,436,0,2,0.003430532,1456,-873
ZCTA5 57268,220,39,181,471,46.9,432,0,0,0,97,374
ZCTA5 57269,77,17,60,163,55.6,161,0,0,0,25,138
ZCTA5 57270,268,1191,-923,755,34.4,310,0,0,0,2531,-1776
ZCTA5 57271,50,47,3,227,20.9,215,0,0,0,81,146
ZCTA5 57272,74,435,-361,210,38.1,206,0,0,0,898,-688
ZCTA5 57273,411,69,342,1128,41.3,538,3,0,0,153,975
ZCTA5 57274,1193,322,871,2744,43.2,2637,9,0,0,656,2088
ZCTA5 57276,462,315,147,1102,37.2,1096,0,0,0,744,358
ZCTA5 57278,261,214,47,1052,23.2,935,0,12,0.011406844,505,547
ZCTA5 57279,439,211,228,994,55.1,863,7,0,0,474,520
ZCTA5 57301,7917,29,7888,18643,39.2,17125,187,150,0.008045915,48,18595
ZCTA5 57311,529,18,511,1682,38.4,1589,0,0,0,57,1625
ZCTA5 57312,288,766,-478,721,43.6,614,0,0,0,1682,-961
ZCTA5 57313,455,139,316,1175,46.7,1077,0,42,0.035744681,390,785
ZCTA5 57314,253,111,142,668,37,655,0,0,0,263,405
ZCTA5 57315,464,33,431,1164,37.3,1121,0,0,0,33,1131
ZCTA5 57317,206,63,143,669,38.2,472,0,0,0,145,524
ZCTA5 57319,340,162,178,916,41.2,838,0,0,0,291,625
ZCTA5 57321,115,426,-311,431,35.8,429,0,2,0.004640371,1178,-747
ZCTA5 57322,114,684,-570,292,52.1,282,0,0,0,1643,-1351
ZCTA5 57323,101,1662,-1561,235,48.5,204,6,0,0,3827,-3592
ZCTA5 57324,166,513,-347,423,38,370,0,0,0,1414,-991
ZCTA5 57325,1157,375,782,3152,38.8,2187,21,60,0.019035533,1479,1673
ZCTA5 57328,435,59,376,1148,41,1129,0,0,0,111,1037
ZCTA5 57329,140,309,-169,334,43.7,316,0,0,0,665,-331
ZCTA5 57330,184,160,24,501,40.6,449,0,0,0,457,44
ZCTA5 57331,130,120,10,383,40,383,0,0,0,365,18
ZCTA5 57332,272,192,80,860,37.4,857,0,0,0,345,515
ZCTA5 57334,335,116,219,927,41.3,880,0,0,0,326,601
ZCTA5 57335,110,89,21,213,55.2,206,0,0,0,176,37
ZCTA5 57337,45,262,-217,96,35.7,87,0,0,0,529,-433
ZCTA5 57339,345,126,219,1419,25.2,57,0,0,0,325,1094
ZCTA5 57340,87,97,-10,208,39.7,207,0,0,0,194,14
ZCTA5 57341,49,7295,-7246,139,33.5,139,0,0,0,17089,-16950
ZCTA5 57342,130,0,130,311,49.1,295,0,0,0,401,-90
ZCTA5 57344,45,7,38,83,73,83,0,0,0,347,-264
ZCTA5 57345,475,552,-77,1158,44.2,1093,0,0,0,1098,60
ZCTA5 57346,28,53,-25,44,59.6,8,0,24,0.545454545,138,-94
ZCTA5 57348,282,229,53,784,46.2,751,0,0,0,428,356
ZCTA5 57349,580,168,412,1414,49,1325,14,0,0,372,1042
ZCTA5 57350,6316,123,6193,15785,34.9,11436,1458,177,0.011213177,317,15468
ZCTA5 57353,283,1260,-977,786,37.4,722,2,0,0,2914,-2128
ZCTA5 57354,16,115,-99,19,80.9,19,0,0,0,304,-285
ZCTA5 57355,533,40,493,1389,38.7,1361,1,1,0.000719942,75,1314
ZCTA5 57356,622,119,503,2365,31.3,915,5,8,0.003382664,252,2113
ZCTA5 57358,11,660,-649,14,65,14,0,0,0,1478,-1464
ZCTA5 57359,216,86,130,595,40.5,557,2,0,0,217,378
ZCTA5 57361,72,151,-79,211,44.2,10,0,0,0,309,-98
ZCTA5 57362,885,115,770,1835,51.5,1807,9,0,0,291,1544
ZCTA5 57363,424,54,370,1033,41.6,998,0,0,0,132,901
ZCTA5 57364,5,64,-59,5,-,5,0,0,0,120,-115
ZCTA5 57365,262,482,-220,554,57.8,541,0,0,0,1008,-454
ZCTA5 57366,1013,801,212,2482,38,2362,0,0,0,2053,429
ZCTA5 57367,106,310,-204,280,50,187,5,3,0.010714286,669,-389
ZCTA5 57368,419,75,344,1174,34.7,1059,3,21,0.017887564,169,1005
ZCTA5 57369,999,77,922,2506,40.6,2462,4,0,0,192,2314
ZCTA5 57370,271,117,154,771,34.9,581,0,0,0,327,444
ZCTA5 57371,75,245,-170,130,38.5,128,0,0,0,532,-402
ZCTA5 57373,188,110,78,403,54.2,395,0,6,0.014888337,204,199
ZCTA5 57374,129,119,10,310,49.3,302,0,0,0,224,86
ZCTA5 57375,255,55,200,571,42.8,543,0,0,0,121,450
ZCTA5 57376,403,139,264,871,48.3,849,0,0,0,268,603
ZCTA5 57379,35,100,-65,86,49.1,83,0,0,0,204,-118
ZCTA5 57380,959,18,941,3472,32.2,1657,29,0,0,41,3431
ZCTA5 57381,214,200,14,496,47.3,495,0,0,0,429,67
ZCTA5 57382,546,131,415,1115,56.6,1064,0,0,0,316,799
ZCTA5 57383,343,271,72,834,43.2,827,0,7,0.008393285,521,313
ZCTA5 57384,440,597,-157,1078,44.4,1073,0,0,0,1327,-249
ZCTA5 57385,535,138,397,1311,40.1,1268,7,0,0,263,1048
ZCTA5 57386,154,240,-86,335,37.7,328,0,0,0,483,-148
ZCTA5 57401,13755,277,13478,32474,36.2,27476,1317,930,0.028638295,562,31912
ZCTA5 57420,53,139,-86,140,44.5,140,0,0,0,277,-137
ZCTA5 57421,25,213,-188,96,33.2,96,0,0,0,482,-386
ZCTA5 57422,88,247,-159,175,54.8,169,0,0,0,599,-424
ZCTA5 57424,83,173,-90,215,32.6,213,0,0,0,427,-212
ZCTA5 57426,5,1172,-1167,25,5.8,25,0,0,0,2700,-2675
ZCTA5 57427,199,86,113,422,51.1,422,0,0,0,166,256
ZCTA5 57428,211,116,95,556,43.3,501,0,10,0.017985612,260,296
ZCTA5 57429,45,73,-28,72,56.8,72,0,0,0,176,-104
ZCTA5 57430,819,90,729,1867,43.4,1777,0,4,0.002142475,153,1714
ZCTA5 57432,153,104,49,320,51.6,320,0,0,0,265,55
ZCTA5 57433,202,131,71,386,55.5,384,0,0,0,339,47
ZCTA5 57434,200,118,82,546,35.6,546,0,0,0,253,293
ZCTA5 57435,121,418,-297,286,48.5,284,0,0,0,914,-628
ZCTA5 57436,213,120,93,531,45.3,508,0,0,0,267,264
ZCTA5 57437,600,43,557,1384,59.6,1312,6,30,0.021676301,75,1309
ZCTA5 57438,397,66,331,1131,45.6,1077,0,0,0,115,1016
ZCTA5 57439,28,219,-191,28,-,28,0,0,0,517,-489
ZCTA5 57440,152,136,16,533,28.2,529,0,0,0,254,279
ZCTA5 57441,210,129,81,514,48.3,509,0,0,0,305,209
ZCTA5 57442,899,182,717,2192,42.8,1801,45,4,0.001824818,501,1691
ZCTA5 57445,728,134,594,1811,35.8,1763,0,0,0,362,1449
ZCTA5 57446,268,545,-277,718,36.1,692,20,0,0,1276,-558
ZCTA5 57448,194,123,71,454,52.6,454,0,0,0,250,204
ZCTA5 57449,100,119,-19,258,37.6,226,0,32,0.124031008,258,0
ZCTA5 57450,204,12484,-12280,519,52.2,504,14,0,0,28215,-27696
ZCTA5 57451,837,10282,-9445,2416,38.9,2357,3,1,0.000413907,25798,-23382
ZCTA5 57452,105,9870,-9765,241,42.8,235,0,0,0,24821,-24580
ZCTA5 57454,272,0,272,806,40,750,0,0,0,0,806
ZCTA5 57455,50,134,-84,161,29.6,135,0,0,0,300,-139
ZCTA5 57456,221,296,-75,753,38.7,742,0,0,0,658,95
ZCTA5 57457,46,1606,-1560,84,52.9,84,0,0,0,3611,-3527
ZCTA5 57460,99,40,59,307,37.2,307,0,0,0,56,251
ZCTA5 57461,138,198,-60,351,41.3,320,0,0,0,900,-549
ZCTA5 57465,152,292,-140,434,44.5,432,0,0,0,621,-187
ZCTA5 57466,64,477,-413,161,36.9,161,0,0,0,1081,-920
ZCTA5 57467,122,168,-46,451,32.2,319,0,0,0,369,82
ZCTA5 57468,152,113,39,358,41.9,353,0,0,0,285,73
ZCTA5 57469,1290,438,852,3155,46.4,2889,0,105,0.033280507,930,2225
ZCTA5 57470,25,254,-229,59,40.5,56,0,0,0,577,-518
ZCTA5 57471,232,627,-395,529,43.8,495,1,0,0,2605,-2076
ZCTA5 57472,369,1009,-640,999,42.4,894,0,0,0,2286,-1287
ZCTA5 57473,80,171,-91,328,48.4,328,0,0,0,346,-18
ZCTA5 57474,63,124,-61,177,49.8,165,0,0,0,273,-96
ZCTA5 57475,53,286,-233,115,59.6,115,0,0,0,618,-503
ZCTA5 57476,157,1428,-1271,422,46.3,422,0,0,0,3526,-3104
ZCTA5 57477,50,54,-4,169,30.4,168,0,1,0.00591716,154,15
ZCTA5 57479,224,816,-592,591,37.3,576,0,0,0,1646,-1055
ZCTA5 57481,159,9332,-9173,427,41.1,407,0,0,0,22888,-22461
ZCTA5 57501,7233,277,6956,17169,39.3,14026,3,13,0.000757179,758,16411
ZCTA5 57520,88,77,11,139,62.1,139,0,0,0,148,-9
ZCTA5 57521,64,87,-23,242,36.1,176,0,0,0,177,65
ZCTA5 57522,232,452,-220,586,30.7,524,0,9,0.015358362,1080,-494
ZCTA5 57523,409,184,225,1022,48.6,926,0,0,0,360,662
ZCTA5 57528,361,805,-444,1018,34.1,844,3,0,0,2094,-1076
ZCTA5 57529,106,51,55,341,40.8,341,0,0,0,155,186
ZCTA5 57531,36,99,-63,74,55.5,74,0,0,0,184,-110
ZCTA5 57532,1249,50,1199,2968,41.7,2674,0,17,0.005727763,106,2862
ZCTA5 57533,682,160,522,1675,42.5,1530,0,50,0.029850746,405,1270
ZCTA5 57534,70,26,44,160,37.6,160,0,0,0,53,107
ZCTA5 57536,157,121,36,390,48.9,315,0,0,0,373,17
ZCTA5 57537,37,316,-279,127,49,127,0,0,0,724,-597
ZCTA5 57538,84,149,-65,245,43.8,221,0,0,0,373,-128
ZCTA5 57540,35,322,-287,162,53.1,156,0,0,0,849,-687
ZCTA5 57541,34,403,-369,149,59.3,103,0,0,0,835,-686
ZCTA5 57543,273,377,-104,858,39.8,436,8,0,0,917,-59
ZCTA5 57544,162,797,-635,446,32.3,392,0,0,0,1768,-1322
ZCTA5 57547,56,469,-413,134,59.5,124,0,0,0,1062,-928
ZCTA5 57548,343,159,184,1649,23.5,99,11,0,0,315,1334
ZCTA5 57551,731,94,637,2272,28.7,1087,34,5,0.002200704,224,2048
ZCTA5 57552,260,8808,-8548,677,40.2,659,0,0,0,21650,-20973
ZCTA5 57553,47,68,-21,134,40.2,129,0,0,0,221,-87
ZCTA5 57555,1068,567,501,3670,23.3,357,113,1,0.00027248,1131,2539
ZCTA5 57559,294,638,-344,685,47.4,508,0,12,0.017518248,1523,-838
ZCTA5 57560,175,1003,-828,588,34.6,209,0,0,0,2308,-1720
ZCTA5 57562,22,100,-78,116,49.1,116,0,0,0,192,-76
ZCTA5 57563,36,120,-84,161,27.3,7,0,0,0,265,-104
ZCTA5 57564,353,91,262,818,48.3,762,0,0,0,214,604
ZCTA5 57566,187,159,28,803,21,0,0,0,0,422,381
ZCTA5 57567,439,435,4,1079,58.4,1001,0,1,0.000926784,991,88
ZCTA5 57568,231,71,160,586,51.4,578,0,0,0,165,421
ZCTA5 57569,105,86,19,235,29.6,187,0,0,0,176,59
ZCTA5 57570,480,309,171,2397,23.5,190,0,0,0,741,1656
ZCTA5 57571,11,412,-401,15,74.4,6,0,0,0,1163,-1148
ZCTA5 57572,374,884,-510,1711,26.1,23,159,0,0,1821,-110
ZCTA5 57574,77,585,-508,137,57.2,71,0,0,0,1576,-1439
ZCTA5 57576,66,36,30,120,60.2,120,0,0,0,106,14
ZCTA5 57577,216,136,80,1243,25,76,3,10,0.008045052,334,909
ZCTA5 57579,359,85,274,1212,36.5,446,0,4,0.00330033,217,995
ZCTA5 57580,1628,107,1521,4200,45.4,3206,26,40,0.00952381,247,3953
ZCTA5 57584,28,522,-494,47,63.2,41,0,0,0,1197,-1150
ZCTA5 57585,70,490,-420,118,51.7,53,0,0,0,1080,-962
ZCTA5 57601,1646,170,1476,3656,40.4,2561,10,197,0.053884026,376,3280
ZCTA5 57620,259,187,72,568,45.4,539,0,0,0,419,149
ZCTA5 57621,51,204,-153,308,20.5,2,0,0,0,529,-221
ZCTA5 57622,83,422,-339,334,24.5,29,0,0,0,938,-604
ZCTA5 57623,254,244,10,870,35.6,293,0,0,0,573,297
ZCTA5 57625,1115,95,1020,3982,26.8,366,5,4,0.00100452,331,3651
ZCTA5 57626,291,151,140,769,51,574,0,0,0,430,339
ZCTA5 57630,22,164,-142,33,61.1,28,0,0,0,367,-334
ZCTA5 57631,189,12609,-12420,392,53.5,392,0,0,0,28946,-28554
ZCTA5 57632,297,0,297,765,38.4,755,0,0,0,0,765
ZCTA5 57633,177,7629,-7452,415,38.3,346,0,2,0.004819277,19206,-18791
ZCTA5 57634,34,1394,-1360,152,23.4,66,0,0,0,4923,-4771
ZCTA5 57636,28,0,28,95,15.8,42,0,0,0,383,-288
ZCTA5 57638,791,0,791,1803,51.9,1701,0,0,0,425,1378
ZCTA5 57639,73,229,-156,366,22.2,9,0,0,0,484,-118
ZCTA5 57640,54,83,-29,87,58.3,87,0,0,0,183,-96
ZCTA5 57641,121,57,64,301,39.6,272,0,0,0,141,160
ZCTA5 57642,525,15,510,1937,26.6,391,0,3,0.001548787,28,1909
ZCTA5 57644,144,62,82,261,56.1,261,0,0,0,131,130
ZCTA5 57645,65,414,-349,127,47.2,107,0,0,0,1153,-1026
ZCTA5 57646,97,285,-188,259,37.4,244,0,0,0,560,-301
ZCTA5 57648,180,498,-318,381,52.4,371,1,0,0,1354,-973
ZCTA5 57649,98,127,-29,291,35.5,265,26,0,0,306,-15
ZCTA5 57650,4,110,-106,14,51.3,14,0,0,0,270,-256
ZCTA5 57651,49,126,-77,127,31.1,127,0,0,0,277,-150
ZCTA5 57652,83,621,-538,383,26.8,16,0,0,0,1250,-867
ZCTA5 57656,312,126,186,827,37.1,433,3,5,0.006045949,300,527
ZCTA5 57657,55,148,-93,215,30.6,111,0,0,0,383,-168
ZCTA5 57658,87,127,-40,413,27,4,0,0,0,273,140
ZCTA5 57659,1,191,-190,3,-,3,0,0,0,447,-444
ZCTA5 57660,32,214,-182,92,32.7,76,0,0,0,425,-333
ZCTA5 57661,53,64,-11,263,21.6,3,0,0,0,129,134
ZCTA5 57701,18311,301,18010,45149,36.7,33722,426,741,0.016412324,764,44385
ZCTA5 57702,14615,283,14332,33678,46.9,29632,424,282,0.008373419,648,33030
ZCTA5 57703,6421,78,6343,16785,37.6,13711,365,147,0.008757819,139,16646
ZCTA5 57706,502,653,-151,2204,21.7,1585,90,298,0.135208711,1557,647
ZCTA5 57714,160,60,100,957,17.5,0,0,0,0,98,859
ZCTA5 57716,154,278,-124,574,47.1,209,0,0,0,677,-103
ZCTA5 57717,3281,105,3176,8184,39,7511,23,0,0,187,7997
ZCTA5 57718,3090,56,3034,7641,37.2,6939,105,36,0.004711425,117,7524
ZCTA5 57719,3974,121,3853,10731,31.2,8531,99,161,0.015003262,277,10454
ZCTA5 57720,297,234,63,644,47.5,592,0,0,0,987,-343
ZCTA5 57722,81,120,-39,143,61.1,141,0,0,0,266,-123
ZCTA5 57724,91,372,-281,236,48.9,182,0,0,0,912,-676
ZCTA5 57725,131,112,19,261,65.4,227,0,0,0,275,-14
ZCTA5 57730,2433,432,2001,5918,53.3,5394,16,65,0.01098344,1092,4826
ZCTA5 57732,1064,108,956,1869,57.2,1774,2,6,0.003210273,219,1650
ZCTA5 57735,589,1112,-523,1488,43.9,1324,5,5,0.003360215,3120,-1632
ZCTA5 57737,0,142,-142,0,-,0,0,0,#DIV/0!,314,-314
ZCTA5 57738,157,90,67,226,71,218,0,0,0,193,33
ZCTA5 57741,68,148,-80,145,60.5,128,0,17,0.117241379,256,-111
ZCTA5 57744,731,530,201,2135,44.7,1621,5,0,0,1428,707
ZCTA5 57745,713,299,414,1921,47,1637,18,0,0,562,1359
ZCTA5 57747,2687,66,2621,5563,58.3,4669,70,0,0,128,5435
ZCTA5 57748,83,352,-269,279,29.2,125,0,0,0,766,-487
ZCTA5 57750,49,136,-87,114,25.9,57,0,0,0,384,-270
ZCTA5 57751,357,117,240,963,52,894,21,0,0,258,705
ZCTA5 57752,424,71,353,2283,23,82,0,0,0,140,2143
ZCTA5 57754,1772,188,1584,3520,52.3,3400,14,0,0,498,3022
ZCTA5 57755,57,299,-242,139,29.1,122,0,0,0,787,-648
ZCTA5 57756,131,166,-35,564,34.3,0,0,0,0,373,191
ZCTA5 57758,48,176,-128,125,20.8,63,0,0,0,406,-281
ZCTA5 57759,56,990,-934,404,21.4,181,0,69,0.170792079,2464,-2060
ZCTA5 57760,365,396,-31,994,45.2,881,0,43,0.043259557,1121,-127
ZCTA5 57761,377,101,276,1587,30.6,1378,6,20,0.012602394,150,1437
ZCTA5 57762,205,534,-329,479,58.6,370,0,0,0,1021,-542
ZCTA5 57763,129,141,-12,367,42.9,324,0,0,0,318,49
ZCTA5 57764,469,664,-195,1907,28.6,30,0,0,0,1738,169
ZCTA5 57766,61,135,-74,169,54.7,169,0,0,0,252,-83
ZCTA5 57767,98,322,-224,175,53.9,175,0,0,0,648,-473
ZCTA5 57769,1520,35,1485,3933,42.9,3533,0,30,0.007627765,94,3839
ZCTA5 57770,1017,96,921,6008,27.8,196,0,0,0,176,5832
ZCTA5 57772,321,7975,-7654,1684,20.9,85,0,0,0,19271,-17587
ZCTA5 57773,100,112,-12,254,36.4,248,0,0,0,306,-52
ZCTA5 57775,93,239,-146,286,38.9,256,0,0,0,622,-336
ZCTA5 57776,0,29,-29,0,-,0,0,0,#DIV/0!,57,-57
ZCTA5 57779,137,166,-29,268,58.3,268,0,0,0,364,-96
ZCTA5 57780,37,90,-53,47,57.4,47,0,0,0,218,-171
ZCTA5 57782,13,192,-179,32,55.3,32,0,0,0,446,-414
ZCTA5 57783,7096,68,7028,16394,40.2,14974,96,150,0.009149689,167,16227
ZCTA5 57785,4067,154,3913,10161,41.9,9437,115,127,0.01249877,292,9869
ZCTA5 57787,206,114,92,659,40.9,591,0,0,0,317,342
ZCTA5 57788,174,479,-305,624,35.8,607,0,0,0,1165,-541
ZCTA5 57790,373,708,-335,1100,38.8,816,12,22,0.02,1454,-354
ZCTA5 57791,85,108,-23,204,51.7,197,0,0,0,339,-135
ZCTA5 57792,51,1269,-1218,172,54.1,172,0,0,0,3084,-2912
ZCTA5 57793,721,72,649,1976,48.9,1924,13,0,0,154,1822
ZCTA5 57794,54,692,-638,630,19.7,0,0,0,0,1525,-895
ZCTA5 57799,0,78,-78,626,19.6,528,14,29,0.046325879,280,346
ZCTA5 58001,113,419,-306,260,37.8,256,0,0,0,1107,-847
ZCTA5 58002,0,282,-282,0,-,0,0,0,#DIV/0!,633,-633
ZCTA5 58004,147,64,83,308,40.5,302,0,2,0.006493506,114,194
ZCTA5 58005,330,195,135,926,39.1,898,0,2,0.002159827,438,488
ZCTA5 58006,187,31,156,500,45.6,494,0,3,0.006,72,428
ZCTA5 58007,37,1067,-1030,81,55.2,81,0,0,0,3104,-3023
ZCTA5 58008,99,90,9,197,52.3,197,0,0,0,238,-41
ZCTA5 58009,9,64,-55,20,60,20,0,0,0,127,-107
ZCTA5 58011,181,611,-430,458,47.8,452,0,0,0,1645,-1187
ZCTA5 58012,1162,218,944,2750,33,2708,0,0,0,603,2147
ZCTA5 58013,68,226,-158,123,61.9,117,0,0,0,732,-609
ZCTA5 58015,90,251,-161,231,41.3,222,0,0,0,664,-433
ZCTA5 58016,122,1607,-1485,239,45.3,202,0,0,0,3945,-3706
ZCTA5 58017,138,20,118,284,54.4,238,0,0,0,28,256
ZCTA5 58018,146,334,-188,525,38.8,397,0,0,0,2087,-1562
ZCTA5 58021,178,222,-44,515,34.8,504,0,0,0,502,13
ZCTA5 58027,636,37,599,1379,56.8,1348,12,16,0.011602611,104,1275
ZCTA5 58029,17,102,-85,53,23.3,35,0,0,0,327,-274
ZCTA5 58030,263,274,-11,663,37.9,634,0,0,0,664,-1
ZCTA5 58031,144,187,-43,425,35.9,374,0,0,0,407,18
ZCTA5 58032,313,354,-41,683,51.6,650,0,0,0,867,-184
ZCTA5 58033,183,685,-502,557,39.6,523,9,0,0,1464,-907
ZCTA5 58035,96,65,31,226,56.4,226,0,0,0,400,-174
ZCTA5 58036,93,146,-53,297,36.6,261,36,0,0,329,-32
ZCTA5 58038,107,92,15,236,57.7,233,0,0,0,301,-65
ZCTA5 58040,517,1909,-1392,1105,33.3,992,7,84,0.0760181,5377,-4272
ZCTA5 58041,622,35,587,1674,37.5,1358,0,3,0.001792115,117,1557
ZCTA5 58042,497,512,-15,1314,35.9,1236,0,0,0,1273,41
ZCTA5 58043,69,700,-631,172,43,157,1,0,0,1881,-1709
ZCTA5 58045,910,287,623,2061,44,1853,12,0,0,604,1457
ZCTA5 58046,233,15,218,650,42.4,574,0,0,0,34,616
ZCTA5 58047,1618,827,791,4350,40.1,4141,0,75,0.017241379,1786,2564
ZCTA5 58048,173,760,-587,447,40.1,426,0,0,0,3206,-2759
ZCTA5 58049,138,4242,-4104,282,52.8,281,0,0,0,10911,-10629
ZCTA5 58051,600,176,424,1731,35.5,1681,0,2,0.001155402,458,1273
ZCTA5 58052,242,4961,-4719,556,46,548,0,0,0,11964,-11408
ZCTA5 58053,538,347,191,1197,47.5,1072,0,0,0,1521,-324
ZCTA5 58054,1270,60,1210,3118,40.7,2861,24,36,0.011545863,150,2968
ZCTA5 58056,65,124,-59,122,67.2,122,0,0,0,530,-408
ZCTA5 58057,88,131,-43,228,49.1,228,0,0,0,280,-52
ZCTA5 58058,45,27,18,110,39.7,110,0,0,0,53,57
ZCTA5 58059,502,232,270,1490,33.2,1368,0,13,0.008724832,617,873
ZCTA5 58060,505,28,477,1159,43,1124,0,0,0,85,1074
ZCTA5 58061,128,95,33,267,44.2,240,0,0,0,163,104
ZCTA5 58062,72,110,-38,168,63,156,0,0,0,236,-68
ZCTA5 58063,148,25,123,419,44.5,405,0,0,0,58,361
ZCTA5 58064,203,804,-601,522,37,496,0,0,0,2136,-1614
ZCTA5 58065,7,132,-125,9,72.8,9,0,0,0,226,-217
ZCTA5 58067,106,42,64,270,34,251,0,0,0,82,188
ZCTA5 58068,141,180,-39,362,40.8,352,0,0,0,811,-449
ZCTA5 58069,67,113,-46,132,53.8,132,0,0,0,311,-179
ZCTA5 58071,188,1467,-1279,398,47.2,386,0,0,0,3295,-2897
ZCTA5 58072,3521,215,3306,7897,42.4,7180,123,193,0.024439661,473,7424
ZCTA5 58074,21,354,-333,41,-,41,0,0,0,849,-808
ZCTA5 58075,3818,44,3774,9163,36.1,8369,29,95,0.010367783,74,9089
ZCTA5 58076,0,1722,-1722,312,19.3,275,5,19,0.060897436,4112,-3800
ZCTA5 58077,291,158,133,755,41.1,733,0,0,0,321,434
ZCTA5 58078,14978,65,14913,38448,34.2,33889,875,1058,0.027517686,152,38296
ZCTA5 58079,133,33,100,394,43,394,0,0,0,64,330
ZCTA5 58081,377,36,341,869,36.8,835,2,0,0,91,778
ZCTA5 58102,13823,42,13781,30980,29.5,27134,840,1164,0.037572628,116,30864
ZCTA5 58103,23452,1241,22211,50019,33.4,37317,2910,6595,0.131849897,3492,46527
ZCTA5 58104,19233,10,19223,44073,33.5,38863,1267,2215,0.050257527,15,44058
ZCTA5 58105,14,15,-1,2302,19.1,2110,47,56,0.024326672,49,2253
ZCTA5 58201,18957,73,18884,42977,32,36222,1144,2024,0.047094958,127,42850
ZCTA5 58202,193,307,-114,2655,19.4,2335,98,26,0.009792844,805,1850
ZCTA5 58203,7468,219,7249,15807,28.7,12747,786,590,0.037325236,503,15304
ZCTA5 58204,587,505,82,1960,22.9,1425,54,174,0.08877551,1058,902
ZCTA5 58205,0,115,-115,718,21.2,551,10,110,0.153203343,470,248
ZCTA5 58210,128,16269,-16141,274,50.5,274,0,0,0,39453,-39179
ZCTA5 58212,180,21116,-20936,398,51,382,0,0,0,47155,-46757
ZCTA5 58214,160,11376,-11216,378,49.1,366,0,0,0,29760,-29382
ZCTA5 58216,65,4380,-4315,205,47,192,0,11,0.053658537,12581,-12376
ZCTA5 58218,324,1524,-1200,804,40.9,787,0,0,0,4981,-4177
ZCTA5 58219,36,74,-38,64,70.7,64,0,0,0,247,-183
ZCTA5 58220,972,150,822,2174,44.4,2053,22,11,0.005059798,485,1689
ZCTA5 58222,102,242,-140,255,51.3,242,0,0,0,848,-593
ZCTA5 58223,59,35,24,100,64.6,100,0,0,0,126,-26
ZCTA5 58224,7,506,-499,11,75.9,11,0,0,0,1210,-1199
ZCTA5 58225,429,52,377,961,47.1,938,0,1,0.001040583,133,828
ZCTA5 58227,228,371,-143,566,38.6,530,7,11,0.019434629,994,-428
ZCTA5 58228,341,106,235,738,34.5,614,3,52,0.070460705,188,550
ZCTA5 58229,39,663,-624,67,62.8,67,0,0,0,1573,-1506
ZCTA5 58230,287,107,180,672,48.4,656,0,0,0,209,463
ZCTA5 58231,159,155,4,347,49.2,343,0,4,0.011527378,308,39
ZCTA5 58233,136,154,-18,268,50.5,261,0,0,0,434,-166
ZCTA5 58235,206,197,9,550,42.9,509,2,0,0,427,123
ZCTA5 58236,39,2063,-2024,46,82.3,46,0,0,0,4704,-4658
ZCTA5 58237,2204,146,2058,5104,43.8,4425,55,67,0.013126959,303,4801
ZCTA5 58238,33,7,26,88,42.3,88,0,0,0,13,75
ZCTA5 58239,12,174,-162,15,41.5,15,0,0,0,419,-404
ZCTA5 58240,498,38,460,1239,44.4,1143,1,7,0.005649718,103,1136
ZCTA5 58241,73,101,-28,233,21.2,197,0,0,0,290,-57
ZCTA5 58243,231,27,204,561,35.4,527,0,0,0,66,495
ZCTA5 58244,16,181,-165,40,43.5,36,4,0,0,379,-339
ZCTA5 58249,1003,335,668,2391,45.7,2209,0,2,0.00083647,692,1699
ZCTA5 58250,100,99,1,202,53.3,200,0,0,0,219,-17
ZCTA5 58251,820,66,754,1975,43.8,1768,4,8,0.004050633,133,1842
ZCTA5 58254,221,64,157,495,49.7,488,0,0,0,105,390
ZCTA5 58255,0,915,-915,0,-,0,0,0,#DIV/0!,1894,-1894
ZCTA5 58256,298,1072,-774,780,37.8,732,8,0,0,3370,-2590
ZCTA5 58257,791,30,761,2207,30.5,2068,0,46,0.020842773,68,2139
ZCTA5 58258,128,9,119,248,51.4,248,0,0,0,18,230
ZCTA5 58259,242,50,192,478,53.7,418,14,0,0,128,350
ZCTA5 58260,73,139,-66,219,53.8,213,0,0,0,321,-102
ZCTA5 58261,508,53,455,1295,39.9,1227,1,0,0,128,1167
ZCTA5 58262,24,231,-207,83,55.3,76,0,0,0,492,-409
ZCTA5 58265,176,290,-114,510,41.7,488,2,15,0.029411765,771,-261
ZCTA5 58266,55,661,-606,130,43.9,130,0,0,0,1364,-1234
ZCTA5 58267,511,3203,-2692,1341,43.1,1305,0,10,0.007457122,7467,-6126
ZCTA5 58269,109,100,9,199,60,179,0,0,0,243,-44
ZCTA5 58270,794,163,631,1993,45.1,1868,0,1,0.000501756,336,1657
ZCTA5 58271,238,10,228,590,43.1,513,4,0,0,25,565
ZCTA5 58272,104,4957,-4853,209,58.9,191,2,0,0,11433,-11224
ZCTA5 58273,82,73,9,169,64.5,167,0,0,0,197,-28
ZCTA5 58274,429,9,420,999,37.2,942,0,14,0.014014014,24,975
ZCTA5 58275,313,1054,-741,749,40.5,716,20,0,0,2605,-1856
ZCTA5 58276,210,43,167,460,52.9,438,0,0,0,90,370
ZCTA5 58277,75,46,29,168,55.1,168,0,0,0,127,41
ZCTA5 58278,787,467,320,2056,42.6,2012,2,0,0,1128,928
ZCTA5 58281,34,44,-10,76,68.6,76,0,0,0,82,-6
ZCTA5 58282,590,25,565,1244,48.7,1118,0,0,0,50,1194
ZCTA5 58301,4267,828,3439,10256,36.9,8332,164,73,0.007117785,2512,7744
ZCTA5 58310,0,390,-390,0,-,0,0,0,#DIV/0!,880,-880
ZCTA5 58311,29,124,-95,70,35.5,70,0,0,0,325,-255
ZCTA5 58313,34,1235,-1201,70,51.5,70,0,0,0,2852,-2782
ZCTA5 58316,1706,3518,-1812,6028,27,109,13,74,0.012276045,8332,-2304
ZCTA5 58317,81,71,10,196,53.4,194,0,0,0,157,39
ZCTA5 58318,1572,6,1566,4067,38.6,3586,32,22,0.005409393,22,4045
ZCTA5 58321,36,78,-42,98,53.5,98,0,0,0,187,-89
ZCTA5 58323,21,321,-300,86,20.1,86,0,0,0,757,-671
ZCTA5 58324,625,46,579,1456,42.9,1220,7,10,0.006868132,124,1332
ZCTA5 58325,21,69,-48,75,53.1,53,0,0,0,190,-115
ZCTA5 58327,108,23,85,291,39.1,251,2,2,0.006872852,45,246
ZCTA5 58329,801,142,659,2820,30.4,395,11,0,0,315,2505
ZCTA5 58330,256,151,105,496,65.8,427,3,0,0,302,194
ZCTA5 58331,84,397,-313,144,52.7,144,0,0,0,864,-720
ZCTA5 58332,122,59,63,241,55.2,228,0,9,0.037344398,141,100
ZCTA5 58335,247,378,-131,1387,16,14,0,0,0,899,488
ZCTA5 58338,47,14,33,108,50.4,108,0,0,0,85,23
ZCTA5 58339,5,6443,-6438,18,16.5,18,0,0,0,13858,-13840
ZCTA5 58341,1122,10328,-9206,2544,46.6,2476,11,0,0,26930,-24386
ZCTA5 58343,17,12580,-12563,32,70.3,32,0,0,0,30504,-30472
ZCTA5 58344,378,339,39,989,37.2,913,17,0,0,747,242
ZCTA5 58345,69,105,-36,185,50.3,185,0,0,0,172,13
ZCTA5 58346,215,747,-532,490,38.6,476,0,0,0,2019,-1529
ZCTA5 58348,334,501,-167,762,36.8,685,0,1,0.001312336,1063,-301
ZCTA5 58351,144,192,-48,316,53.3,278,0,0,0,449,-133
ZCTA5 58352,162,2265,-2103,419,39.7,392,4,0,0,7896,-7477
ZCTA5 58353,42,44,-2,100,36.8,100,0,0,0,121,-21
ZCTA5 58355,16,60,-44,49,34.5,49,0,0,0,174,-125
ZCTA5 58356,777,71,706,1698,43,1574,0,0,0,211,1487
ZCTA5 58357,174,780,-606,634,29.6,94,0,0,0,1736,-1102
ZCTA5 58361,116,1064,-948,282,52.9,258,0,11,0.039007092,2682,-2400
ZCTA5 58362,0,27,-27,0,-,0,0,0,#DIV/0!,59,-59
ZCTA5 58363,37,1394,-1357,79,64.2,79,0,0,0,3455,-3376
ZCTA5 58365,89,1584,-1495,143,57.3,134,0,0,0,4585,-4442
ZCTA5 58366,316,187,129,925,36.1,565,0,4,0.004324324,490,435
ZCTA5 58367,511,61,450,1677,31.7,564,3,1,0.000596303,154,1523
ZCTA5 58368,1454,268,1186,3428,44.7,3138,43,13,0.003792299,635,2793
ZCTA5 58369,329,291,38,985,43.5,357,0,7,0.007106599,769,216
ZCTA5 58370,305,687,-382,1252,25.5,111,0,2,0.001597444,1630,-378
ZCTA5 58372,39,57,-18,128,41,126,0,0,0,130,-2
ZCTA5 58374,304,35,269,684,48.8,435,0,0,0,67,617
ZCTA5 58377,136,788,-652,292,58.7,259,9,0,0,1708,-1416
ZCTA5 58379,54,302,-248,246,18.7,20,0,0,0,889,-643
ZCTA5 58380,173,84,89,428,50.8,428,0,0,0,261,167
ZCTA5 58381,139,226,-87,350,42.6,192,22,0,0,571,-221
ZCTA5 58382,70,80,-10,102,60.6,99,0,0,0,155,-53
ZCTA5 58384,168,161,7,323,59.1,314,0,0,0,681,-358
ZCTA5 58385,63,191,-128,229,36.9,219,10,0,0,514,-285
ZCTA5 58386,35,102,-67,71,59.1,71,0,0,0,196,-125
ZCTA5 58401,7758,237,7521,17501,40.9,16325,116,271,0.015484829,556,16945
ZCTA5 58402,0,177,-177,239,50.5,207,0,4,0.016736402,368,-129
ZCTA5 58405,0,87,-87,603,19.9,472,19,47,0.077943615,185,418
ZCTA5 58413,563,46,517,1041,58.8,999,16,0,0,129,912
ZCTA5 58415,68,4010,-3942,191,37.8,191,0,0,0,9319,-9128
ZCTA5 58416,170,87,83,381,55.1,374,0,0,0,165,216
ZCTA5 58418,194,8,186,356,54.9,354,0,0,0,11,345
ZCTA5 58420,92,78,14,291,37.7,270,0,1,0.003436426,166,125
ZCTA5 58421,1255,49,1206,2866,46.4,2710,2,9,0.003140265,92,2774
ZCTA5 58422,48,164,-116,93,49.3,84,0,0,0,414,-321
ZCTA5 58423,31,41,-10,50,75,45,0,0,0,67,-17
ZCTA5 58424,133,51,82,359,49.5,359,0,0,0,98,261
ZCTA5 58425,522,53,469,1326,51,1257,0,0,0,277,1049
ZCTA5 58426,74,237,-163,228,35.8,228,0,0,0,686,-458
ZCTA5 58428,102,61,41,215,40.6,187,0,5,0.023255814,144,71
ZCTA5 58429,132,95,37,275,40.3,273,0,0,0,315,-40
ZCTA5 58430,57,347,-290,139,46,139,0,0,0,841,-702
ZCTA5 58431,55,1490,-1435,111,61.8,111,0,0,0,3858,-3747
ZCTA5 58433,518,139,379,1171,50.3,1151,3,6,0.005123826,455,716
ZCTA5 58436,667,369,298,1698,41.7,1561,0,16,0.00942285,912,786
ZCTA5 58438,368,197,171,881,44.1,874,0,0,0,529,352
ZCTA5 58439,55,289,-234,108,59.4,108,0,0,0,754,-646
ZCTA5 58440,59,200,-141,159,34.2,156,0,0,0,374,-215
ZCTA5 58441,135,43,92,433,41.8,396,0,7,0.016166282,110,323
ZCTA5 58442,187,206,-19,462,49.9,438,0,1,0.002164502,575,-113
ZCTA5 58443,64,536,-472,176,40.5,176,0,0,0,1508,-1332
ZCTA5 58444,83,572,-489,164,53,155,0,0,0,1435,-1271
ZCTA5 58445,73,126,-53,270,19,269,0,0,0,258,12
ZCTA5 58448,148,4965,-4817,295,59.3,295,0,0,0,12630,-12335
ZCTA5 58451,41,433,-392,101,54.7,101,0,0,0,1223,-1122
ZCTA5 58452,13,991,-978,52,13.4,52,0,0,0,3630,-3578
ZCTA5 58454,166,616,-450,386,50.4,355,0,0,0,1779,-1393
ZCTA5 58455,114,984,-870,413,33.6,350,11,0,0,2214,-1801
ZCTA5 58456,260,247,13,694,34,634,0,0,0,677,17
ZCTA5 58458,421,67,354,1107,45.4,1034,0,14,0.012646793,208,899
ZCTA5 58460,69,796,-727,162,47.9,158,0,0,0,2682,-2520
ZCTA5 58461,184,224,-40,440,39.2,406,0,4,0.009090909,812,-372
ZCTA5 58463,291,83,208,577,56.8,536,0,0,0,183,394
ZCTA5 58464,101,57,44,241,41.2,207,0,0,0,129,112
ZCTA5 58466,211,52,159,480,58.2,358,0,0,0,81,399
ZCTA5 58467,237,164,73,790,32.1,759,1,15,0.018987342,326,464
ZCTA5 58472,150,97,53,405,41.2,397,0,0,0,208,197
ZCTA5 58474,1068,30,1038,2677,40.9,2613,25,0,0,48,2629
ZCTA5 58475,84,48,36,143,61.3,143,0,0,0,188,-45
ZCTA5 58476,200,1277,-1077,382,49.7,380,0,0,0,2947,-2565
ZCTA5 58477,61,192,-131,161,23.3,159,0,0,0,433,-272
ZCTA5 58478,68,80,-12,120,62.5,120,0,0,0,239,-119
ZCTA5 58479,69,68,1,147,58.9,147,0,0,0,153,-6
ZCTA5 58480,100,17,83,204,54.5,197,0,0,0,39,165
ZCTA5 58481,124,36,88,269,42.2,269,0,0,0,115,154
ZCTA5 58482,442,21,421,933,52.8,921,0,0,0,40,893
ZCTA5 58483,132,13530,-13398,345,46.9,311,4,1,0.002898551,29619,-29274
ZCTA5 58484,38,9347,-9309,103,37.4,103,0,0,0,24193,-24090
ZCTA5 58486,75,103,-28,158,51.2,158,0,0,0,244,-86
ZCTA5 58487,185,822,-637,568,35.5,458,0,6,0.01056338,2207,-1639
ZCTA5 58488,83,81,2,115,64.3,115,0,0,0,210,-95
ZCTA5 58490,105,1821,-1716,245,59.3,235,0,0,0,4810,-4565
ZCTA5 58492,199,2654,-2455,453,52,426,0,0,0,7208,-6755
ZCTA5 58494,140,0,140,399,35.6,371,1,0,0,10,389
ZCTA5 58495,502,246,256,1185,49.8,1113,2,16,0.01350211,615,570
ZCTA5 58496,99,475,-376,135,58.5,135,0,0,0,993,-858
ZCTA5 58497,81,32,49,159,44.4,159,0,0,0,71,88
ZCTA5 58501,11794,23,11771,28676,37.4,24518,170,1102,0.038429349,45,28631
ZCTA5 58503,14766,262,14504,36745,38.1,33568,437,389,0.010586474,612,36133
ZCTA5 58504,11443,1791,9652,29071,34.8,24576,111,758,0.026074094,3996,25075
ZCTA5 58505,0,614,-614,0,-,0,0,0,#DIV/0!,1661,-1661
ZCTA5 58520,101,107,-6,236,50.4,234,0,0,0,410,-174
ZCTA5 58521,287,214,73,679,55.4,630,0,0,0,510,169
ZCTA5 58523,1337,14508,-13171,3321,42.9,3179,27,0,0,33145,-29824
ZCTA5 58524,43,46,-3,98,54.9,98,0,0,0,125,-27
ZCTA5 58528,152,135,17,693,19.6,9,0,4,0.005772006,237,456
ZCTA5 58529,308,3871,-3563,755,45.4,716,7,0,0,8922,-8167
ZCTA5 58530,427,103,324,1211,40.8,1087,1,0,0,202,1009
ZCTA5 58531,180,7187,-7007,350,67.6,345,0,0,0,18973,-18623
ZCTA5 58532,143,12399,-12256,288,33.2,270,0,0,0,31027,-30739
ZCTA5 58533,449,825,-376,953,51.2,883,33,1,0.001049318,1880,-927
ZCTA5 58535,207,11857,-11650,423,53.9,402,0,0,0,27837,-27414
ZCTA5 58538,634,161,473,2443,25.2,76,0,1,0.000409333,262,2181
ZCTA5 58540,1186,200,986,2990,44.9,2315,1,40,0.013377926,427,2563
ZCTA5 58541,253,1807,-1554,645,47.9,627,0,0,0,5655,-5010
ZCTA5 58542,126,49,77,284,49.2,271,0,0,0,143,141
ZCTA5 58544,241,3350,-3109,541,47.8,520,0,5,0.009242144,7773,-7232
ZCTA5 58545,1460,108,1352,3385,44.5,3033,46,16,0.004726736,202,3183
ZCTA5 58549,95,149,-54,276,31.5,261,0,0,0,398,-122
ZCTA5 58552,746,1020,-274,1495,57.3,1459,10,0,0,2080,-585
ZCTA5 58554,11361,830,10531,28446,36.2,25189,279,400,0.014061731,1776,26670
ZCTA5 58558,340,75,265,987,44.1,932,7,0,0,204,783
ZCTA5 58559,116,34,82,244,51.8,234,0,6,0.024590164,65,179
ZCTA5 58560,89,71,18,248,45.1,219,0,0,0,169,79
ZCTA5 58561,453,190,263,1022,50.1,1016,1,0,0,458,564
ZCTA5 58562,149,73,76,350,54.7,342,0,0,0,133,217
ZCTA5 58563,793,179,614,1973,53.6,1879,1,0,0,359,1614
ZCTA5 58564,42,118,-76,52,62.8,51,0,0,0,286,-234
ZCTA5 58565,96,1651,-1555,171,61.6,171,0,0,0,4383,-4212
ZCTA5 58566,94,93,1,241,37.9,239,0,0,0,138,103
ZCTA5 58568,178,61,117,578,32.7,186,0,3,0.005190311,131,447
ZCTA5 58569,45,44,1,101,40.1,101,0,0,0,76,25
ZCTA5 58570,174,103,71,506,35.4,378,0,1,0.001976285,203,303
ZCTA5 58571,263,76,187,618,48.2,604,0,1,0.001618123,245,373
ZCTA5 58572,122,742,-620,289,61.7,256,1,0,0,1468,-1179
ZCTA5 58573,266,136,130,635,45.9,635,0,0,0,276,359
ZCTA5 58575,371,99,272,864,51.3,856,2,0,0,249,615
ZCTA5 58576,462,1341,-879,1005,46.7,963,4,3,0.002985075,3047,-2042
ZCTA5 58577,817,403,414,1942,36.6,1772,0,7,0.003604531,922,1020
ZCTA5 58579,487,123,364,1230,43.8,1161,0,0,0,224,1006
ZCTA5 58580,199,13,186,383,46.8,376,0,0,0,325,58
ZCTA5 58581,129,855,-726,235,55.5,233,0,0,0,2005,-1770
ZCTA5 58601,11644,1539,10105,28902,33.7,25538,365,684,0.023666182,3370,25532
ZCTA5 58620,64,141,-77,151,59.8,132,0,0,0,373,-222
ZCTA5 58621,555,186,369,1381,45.6,1240,0,0,0,350,1031
ZCTA5 58622,653,170,483,1663,35.9,1605,0,38,0.022850271,323,1340
ZCTA5 58623,764,13532,-12768,1996,39.5,1847,0,0,0,30658,-28662
ZCTA5 58625,110,8756,-8646,326,53,254,10,0,0,18876,-18550
ZCTA5 58626,179,6140,-5961,634,31.8,531,6,19,0.029968454,16907,-16273
ZCTA5 58627,63,2956,-2893,192,43.5,192,0,0,0,7747,-7555
ZCTA5 58630,235,7336,-7101,581,49.3,520,0,0,0,18357,-17776
ZCTA5 58631,468,502,-34,1025,51.6,994,0,0,0,1203,-178
ZCTA5 58632,81,941,-860,204,57.2,201,0,0,0,2087,-1883
ZCTA5 58634,162,586,-424,415,35.6,415,0,0,0,1309,-894
ZCTA5 58636,336,634,-298,1007,36.5,680,4,11,0.010923535,1758,-751
ZCTA5 58638,399,1004,-605,967,43,941,0,0,0,2464,-1497
ZCTA5 58639,797,235,562,1813,46.1,1680,51,38,0.020959735,474,1339
ZCTA5 58640,515,153,362,1284,46.6,1132,37,0,0,402,882
ZCTA5 58641,37,2313,-2276,92,51.9,92,0,0,0,5631,-5539
ZCTA5 58642,99,923,-824,259,46.8,251,0,0,0,2368,-2109
ZCTA5 58643,67,76,-9,144,40.1,135,0,0,0,119,25
ZCTA5 58644,7,226,-219,17,59.5,17,0,0,0,587,-570
ZCTA5 58645,89,441,-352,197,62,197,0,0,0,950,-753
ZCTA5 58646,464,2119,-1655,1086,42.7,1016,0,0,0,5494,-4408
ZCTA5 58647,456,762,-306,1190,37.8,1077,0,14,0.011764706,2146,-956
ZCTA5 58649,129,172,-43,302,53.9,299,0,0,0,358,-56
ZCTA5 58650,210,5741,-5531,473,41.4,472,0,0,0,12683,-12210
ZCTA5 58651,223,145,78,486,56.5,486,0,0,0,754,-268
ZCTA5 58652,476,39,437,1285,38.2,1178,17,0,0,86,1199
ZCTA5 58653,290,140,150,787,40.8,765,0,0,0,369,418
ZCTA5 58654,92,325,-233,256,54.3,245,0,2,0.0078125,904,-648
ZCTA5 58655,253,658,-405,647,44.9,554,0,0,0,1232,-585
ZCTA5 58656,152,567,-415,344,41.1,317,5,5,0.014534884,1337,-993
ZCTA5 58701,14218,2021,12197,33186,35,27829,713,1224,0.036883023,4976,28210
ZCTA5 58703,9229,60,9169,22189,32.1,18711,238,969,0.043670287,175,22014
ZCTA5 58704,1290,129,1161,4551,23.2,3192,46,593,0.130301033,324,4227
ZCTA5 58705,0,381,-381,824,21.1,663,10,65,0.078883495,910,-86
ZCTA5 58707,0,145,-145,449,19.7,315,7,65,0.144766147,298,151
ZCTA5 58710,256,329,-73,590,51.8,590,0,0,0,751,-161
ZCTA5 58711,81,171,-90,193,34,193,0,0,0,412,-219
ZCTA5 58712,40,679,-639,77,69.3,75,0,0,0,1336,-1259
ZCTA5 58713,32,1419,-1387,170,11.3,170,0,0,0,3031,-2861
ZCTA5 58716,123,4303,-4180,289,55,271,0,0,0,9756,-9467
ZCTA5 58718,424,54,370,1222,40.1,1175,1,3,0.002454992,66,1156
ZCTA5 58721,214,2687,-2473,449,45.3,428,12,0,0,7092,-6643
ZCTA5 58722,654,1320,-666,1784,30.5,1590,9,0,0,3590,-1806
ZCTA5 58723,78,351,-273,213,34.6,204,0,0,0,1037,-824
ZCTA5 58725,162,13,149,475,37.1,452,2,0,0,16,459
ZCTA5 58727,83,782,-699,143,63.6,139,0,0,0,1746,-1603
ZCTA5 58730,516,4230,-3714,1307,41.2,1142,0,68,0.052027544,10508,-9201
ZCTA5 58731,149,83,66,392,42.8,388,2,0,0,180,212
ZCTA5 58733,155,918,-763,387,40.5,379,5,0,0,2356,-1969
ZCTA5 58734,115,1479,-1364,259,51.4,251,0,0,0,3186,-2927
ZCTA5 58735,136,510,-374,518,26.7,491,3,0,0,1023,-505
ZCTA5 58736,238,1377,-1139,484,47.3,455,0,0,0,3599,-3115
ZCTA5 58737,55,19661,-19606,186,30.7,181,4,1,0.005376344,49374,-49188
ZCTA5 58740,262,207,55,730,31.8,701,4,0,0,579,151
ZCTA5 58741,291,3602,-3311,716,40.2,709,0,0,0,7832,-7116
ZCTA5 58744,67,5211,-5144,106,61.5,106,0,0,0,13357,-13251
ZCTA5 58746,638,230,408,1365,49,1309,0,2,0.001465201,467,898
ZCTA5 58748,58,93,-35,133,51.5,108,0,0,0,156,-23
ZCTA5 58750,148,179,-31,381,43.2,375,0,0,0,434,-53
ZCTA5 58752,147,32,115,362,39.5,337,15,0,0,59,303
ZCTA5 58755,98,1630,-1532,219,49.4,219,0,0,0,3922,-3703
ZCTA5 58756,92,316,-224,174,54.7,169,0,0,0,735,-561
ZCTA5 58757,305,416,-111,1082,25.9,127,2,1,0.000924214,1225,-143
ZCTA5 58758,117,681,-564,267,56.5,267,0,0,0,1742,-1475
ZCTA5 58759,247,922,-675,673,47.5,665,0,0,0,2156,-1483
ZCTA5 58760,108,4639,-4531,266,38.8,240,0,0,0,10030,-9764
ZCTA5 58761,316,528,-212,883,40.9,872,0,0,0,1334,-451
ZCTA5 58762,73,129,-56,177,50.8,168,0,0,0,466,-289
ZCTA5 58763,1372,120,1252,3948,34.4,1146,14,42,0.010638298,382,3566
ZCTA5 58765,155,45,110,375,48.6,352,0,4,0.010666667,59,316
ZCTA5 58768,118,105,13,263,40.6,241,0,0,0,288,-25
ZCTA5 58769,136,414,-278,244,48.2,243,0,0,0,907,-663
ZCTA5 58770,573,131,442,1718,29.9,749,16,33,0.019208382,271,1447
ZCTA5 58771,215,647,-432,537,38.8,532,5,0,0,1586,-1049
ZCTA5 58772,75,17,58,124,47.3,101,0,14,0.112903226,62,62
ZCTA5 58773,368,264,104,1043,40.5,962,6,0,0,599,444
ZCTA5 58775,66,1691,-1625,193,56.5,31,3,1,0.005181347,3339,-3146
ZCTA5 58776,154,214,-60,325,31.7,274,0,0,0,512,-187
ZCTA5 58778,64,5748,-5684,110,34.9,89,6,0,0,12911,-12801
ZCTA5 58779,123,8918,-8795,350,42.4,339,0,4,0.011428571,23925,-23575
ZCTA5 58781,206,19456,-19250,551,44.2,528,0,0,0,49650,-49099
ZCTA5 58782,202,12231,-12029,570,30.6,570,0,0,0,30490,-29920
ZCTA5 58783,182,13419,-13237,409,55.5,406,0,0,0,33837,-33428
ZCTA5 58784,985,8494,-7509,2688,34.1,2347,26,96,0.035714286,22379,-19691
ZCTA5 58785,584,16204,-15620,1509,37.7,1389,3,0,0,44209,-42700
ZCTA5 58787,61,3776,-3715,122,32.5,122,0,0,0,11142,-11020
ZCTA5 58788,435,8925,-8490,837,51.5,767,16,29,0.034647551,26975,-26138
ZCTA5 58789,140,16879,-16739,323,49.6,312,1,0,0,48834,-48511
ZCTA5 58790,601,9344,-8743,1600,36.2,1547,4,6,0.00375,27218,-25618
ZCTA5 58792,101,23722,-23621,212,47.3,212,0,0,0,60437,-60225
ZCTA5 58793,211,10053,-9842,560,57,554,2,0,0,28957,-28397
ZCTA5 58794,88,4401,-4313,244,22.6,244,0,0,0,10533,-10289
ZCTA5 58795,74,1962,-1888,147,56.6,125,0,0,0,5680,-5533
ZCTA5 58801,12965,2809,10156,33088,30.9,25945,453,1837,0.055518617,8213,24875
ZCTA5 58830,88,14504,-14416,273,42.8,273,0,0,0,38689,-38416
ZCTA5 58831,397,5003,-4606,1282,35,1064,2,108,0.08424337,13382,-12100
ZCTA5 58833,85,163,-78,229,43.1,226,0,1,0.004366812,567,-338
ZCTA5 58835,320,13259,-12939,992,37.6,889,28,2,0.002016129,35419,-34427
ZCTA5 58838,137,13818,-13681,312,45,270,3,0,0,37993,-37681
ZCTA5 58843,251,4706,-4455,852,39.8,740,0,8,0.009389671,13824,-12972
ZCTA5 58844,40,711,-671,81,29.1,81,0,0,0,1830,-1749
ZCTA5 58845,336,11601,-11265,671,54.7,647,0,0,0,29856,-29185
ZCTA5 58847,112,1872,-1760,320,33.1,239,0,51,0.159375,5471,-5151
ZCTA5 58849,529,3465,-2936,1137,44.3,1048,0,5,0.004397537,8942,-7805
ZCTA5 58852,834,3004,-2170,1807,47.1,1742,0,0,0,8745,-6938
ZCTA5 58853,197,802,-605,416,52.2,127,2,0,0,2669,-2253
ZCTA5 58854,3074,3865,-791,8505,29.1,7249,24,102,0.011992945,9995,-1490
ZCTA5 58856,31,7116,-7085,54,56,54,0,0,0,20777,-20723
ZCTA5 59001,645,11991,-11346,1341,54.4,1278,0,0,0,34916,-33575
ZCTA5 59002,59,13483,-13424,162,31.7,124,0,0,0,41695,-41533
ZCTA5 59003,501,10496,-9995,1128,42.7,464,12,14,0.012411348,29246,-28118
ZCTA5 59006,563,11887,-11324,1364,29.9,1096,0,0,0,32294,-30930
ZCTA5 59007,66,9088,-9022,171,44,158,0,0,0,24212,-24041
ZCTA5 59008,147,8426,-8279,385,48,373,0,0,0,23194,-22809
ZCTA5 59010,103,20601,-20498,183,60.3,174,0,0,0,55153,-54970
ZCTA5 59011,1165,12644,-11479,3093,44,2951,0,83,0.026834788,38159,-35066
ZCTA5 59012,32,9555,-9523,81,55.8,50,0,0,0,25674,-25593
ZCTA5 59013,69,14914,-14845,151,52.4,151,0,0,0,40092,-39941
ZCTA5 59014,663,5003,-4340,1692,44.4,1590,0,0,0,16341,-14649
ZCTA5 59015,147,15003,-14856,353,44.6,330,0,0,0,38120,-37767
ZCTA5 59016,254,13895,-13641,931,39.4,88,0,0,0,37266,-36335
ZCTA5 59018,265,3297,-3032,558,59.3,534,0,0,0,8129,-7571
ZCTA5 59019,1631,6149,-4518,4038,47.4,3820,11,8,0.001981179,15915,-11877
ZCTA5 59020,50,1727,-1677,87,39.3,87,0,0,0,3507,-3420
ZCTA5 59022,424,334,90,2115,25.2,94,0,0,0,980,1135
ZCTA5 59024,142,18067,-17925,334,43,319,1,0,0,59142,-58808
ZCTA5 59025,24,13827,-13803,39,42.6,35,0,0,0,38843,-38804
ZCTA5 59026,83,11121,-11038,147,54.4,141,0,0,0,33412,-33265
ZCTA5 59027,412,10438,-10026,859,58.8,822,9,0,0,26400,-25541
ZCTA5 59028,252,3433,-3181,529,58.6,497,0,1,0.001890359,10070,-9541
ZCTA5 59029,334,3445,-3111,795,41.5,776,0,0,0,9833,-9038
ZCTA5 59030,744,5918,-5174,1287,50.8,1060,0,20,0.015540016,15848,-14561
ZCTA5 59031,87,22748,-22661,535,20.5,16,0,0,0,71038,-70503
ZCTA5 59032,201,9291,-9090,411,56.8,407,0,0,0,27717,-27306
ZCTA5 59033,53,1170,-1117,142,36,116,3,0,0,13743,-13601
ZCTA5 59034,1665,16308,-14643,5257,34,2489,25,0,0,41672,-36415
ZCTA5 59035,118,14281,-14163,261,41.8,162,0,0,0,37543,-37282
ZCTA5 59036,592,9514,-8922,1528,47.3,1477,0,11,0.007198953,27202,-25674
ZCTA5 59037,862,6609,-5747,2288,39.6,2219,0,0,0,19064,-16776
ZCTA5 59038,274,2614,-2340,578,56.3,562,0,0,0,6941,-6363
ZCTA5 59039,13,3909,-3896,33,65.7,33,0,0,0,11082,-11049
ZCTA5 59041,829,11919,-11090,2092,48.4,2023,0,14,0.006692161,32047,-29955
ZCTA5 59043,645,10476,-9831,3313,20.9,89,0,8,0.00241473,31308,-27995
ZCTA5 59044,4883,12812,-7929,12438,42.4,11575,129,97,0.007798681,39705,-27267
ZCTA5 59046,209,11102,-10893,506,47.2,438,0,5,0.009881423,31689,-31183
ZCTA5 59047,5792,14094,-8302,12899,44,12264,45,44,0.003411117,41872,-28973
ZCTA5 59050,359,5974,-5615,1717,30.1,217,0,0,0,19105,-17388
ZCTA5 59052,63,7001,-6938,133,62.2,133,0,0,0,20351,-20218
ZCTA5 59053,159,13289,-13130,403,32.4,334,0,0,0,40313,-39910
ZCTA5 59054,141,9056,-8915,293,50.9,264,0,0,0,22591,-22298
ZCTA5 59055,34,202,-168,140,33.2,131,0,0,0,496,-356
ZCTA5 59057,330,11273,-10943,727,53.3,670,0,0,0,38414,-37687
ZCTA5 59058,15,131,-116,30,58.3,30,0,0,0,414,-384
ZCTA5 59059,90,1371,-1281,221,52.2,216,0,0,0,4532,-4311
ZCTA5 59061,150,95,55,234,68.4,226,5,0,0,287,-53
ZCTA5 59062,32,16258,-16226,80,50,80,0,0,0,46410,-46330
ZCTA5 59063,727,5968,-5241,1939,39.7,1898,0,0,0,15685,-13746
ZCTA5 59064,102,3386,-3284,221,48.1,221,0,0,0,10088,-9867
ZCTA5 59065,75,15591,-15516,139,58.6,132,0,0,0,51046,-50907
ZCTA5 59066,127,16610,-16483,540,31.1,97,0,0,0,48523,-47983
ZCTA5 59067,92,6288,-6196,279,31.3,242,0,0,0,19216,-18937
ZCTA5 59068,1678,16035,-14357,3173,56.5,2965,44,60,0.018909549,46123,-42950
ZCTA5 59069,282,68,214,671,53.2,591,2,0,0,183,488
ZCTA5 59070,399,6894,-6495,1156,51.1,1110,0,3,0.002595156,14194,-13038
ZCTA5 59071,45,6059,-6014,136,65.9,136,0,0,0,18037,-17901
ZCTA5 59072,1914,10944,-9030,4249,52.2,3962,0,0,0,38156,-33907
ZCTA5 59074,193,9918,-9725,426,58.8,383,0,4,0.009389671,29634,-29208
ZCTA5 59075,88,2603,-2515,266,44.5,99,0,0,0,7101,-6835
ZCTA5 59076,18,2146,-2128,39,32.8,39,0,0,0,6829,-6790
ZCTA5 59077,21,14241,-14220,50,48.3,44,0,0,0,38572,-38522
ZCTA5 59078,74,11304,-11230,129,58.9,129,0,0,0,34755,-34626
ZCTA5 59079,1407,4469,-3062,3242,47.9,2885,0,0,0,14198,-10956
ZCTA5 59081,45,39,6,102,57,102,0,0,0,236,-134
ZCTA5 59082,9,10455,-10446,20,43.3,20,0,0,0,25586,-25566
ZCTA5 59083,0,3818,-3818,0,-,0,0,0,#DIV/0!,10245,-10245
ZCTA5 59085,56,20,36,150,49.2,103,11,0,0,38,112
ZCTA5 59086,456,817,-361,908,59.2,879,8,0,0,2513,-1605
ZCTA5 59087,177,960,-783,379,51.4,353,26,0,0,2717,-2338
ZCTA5 59088,454,20514,-20060,1135,41.7,1135,0,0,0,51365,-50230
ZCTA5 59089,135,584,-449,469,33.5,132,0,0,0,1542,-1073
ZCTA5 59101,16739,1592,15147,40565,36.2,32503,200,624,0.015382719,4281,36284
ZCTA5 59102,20841,4663,16178,48325,40.1,43802,739,230,0.004759441,13008,35317
ZCTA5 59105,12962,7718,5244,33494,36.2,29880,136,127,0.003791724,24187,9307
ZCTA5 59106,7799,6381,1418,19812,40.8,18505,0,332,0.016757521,16684,3128
ZCTA5 59201,1683,3154,-1471,5411,31.8,1838,112,14,0.002587322,7928,-2517
ZCTA5 59211,50,9792,-9742,259,8.9,259,0,0,0,28894,-28635
ZCTA5 59212,129,838,-709,384,33.1,330,0,0,0,2153,-1769
ZCTA5 59213,226,7598,-7372,727,30.4,106,0,0,0,25266,-24539
ZCTA5 59214,27,2994,-2967,51,65.5,51,0,0,0,8136,-8085
ZCTA5 59215,460,1852,-1392,926,53.7,912,0,0,0,5189,-4263
ZCTA5 59217,70,6640,-6570,181,23.9,181,0,0,0,22194,-22013
ZCTA5 59218,374,1281,-907,954,45.3,884,0,5,0.00524109,4942,-3988
ZCTA5 59219,92,11872,-11780,310,38.8,267,0,0,0,33934,-33624
ZCTA5 59221,856,4108,-3252,2093,38.8,1963,4,12,0.005733397,10245,-8152
ZCTA5 59222,111,9063,-8952,200,53.5,187,0,0,0,24287,-24087
ZCTA5 59223,26,6000,-5974,52,57.3,52,0,0,0,12243,-12191
ZCTA5 59225,144,11897,-11753,668,30.2,196,1,0,0,30853,-30185
ZCTA5 59226,172,8002,-7830,658,25.5,465,0,2,0.003039514,25961,-25303
ZCTA5 59230,1866,4533,-2667,4570,44.6,4158,6,23,0.005032823,11782,-7212
ZCTA5 59231,143,7179,-7036,373,39.5,312,0,0,0,22230,-21857
ZCTA5 59240,8,8664,-8656,14,58.5,14,0,0,0,21907,-21893
ZCTA5 59241,190,538,-348,419,42,396,0,0,0,1428,-1009
ZCTA5 59242,26,10785,-10759,60,48.5,59,0,0,0,29288,-29228
ZCTA5 59243,117,880,-763,326,40.2,323,0,0,0,2753,-2427
ZCTA5 59244,14,10878,-10864,83,36.5,80,0,0,0,36063,-35980
ZCTA5 59247,166,9124,-8958,298,55.8,271,0,0,0,28778,-28480
ZCTA5 59248,355,15525,-15170,943,49.4,850,1,2,0.002120891,42243,-41300
ZCTA5 59250,78,12005,-11927,256,27.4,247,0,0,0,31078,-30822
ZCTA5 59252,30,3968,-3938,96,27.6,95,0,0,0,10521,-10425
ZCTA5 59253,34,5272,-5238,92,51,82,5,0,0,14036,-13944
ZCTA5 59254,790,5362,-4572,1800,50.9,1625,19,0,0,16445,-14645
ZCTA5 59255,804,15798,-14994,3401,25.2,551,0,3,0.000882094,39495,-36094
ZCTA5 59256,33,7599,-7566,61,43.7,61,0,0,0,20136,-20075
ZCTA5 59257,32,2038,-2006,79,46.9,79,0,0,0,4239,-4160
ZCTA5 59258,74,15402,-15328,149,49.2,138,0,0,0,42197,-42048
ZCTA5 59259,141,13259,-13118,295,51.3,277,1,0,0,32422,-32127
ZCTA5 59260,41,1608,-1567,87,43.4,87,0,0,0,4760,-4673
ZCTA5 59261,204,1480,-1276,509,53.6,487,0,0,0,2298,-1789
ZCTA5 59262,284,13707,-13423,578,39,578,0,0,0,32224,-31646
ZCTA5 59263,619,6563,-5944,1407,47.7,1308,11,0,0,17259,-15852
ZCTA5 59270,3486,3821,-335,8803,38.2,7885,5,0,0,11174,-2371
ZCTA5 59273,5,2879,-2874,14,34.5,14,0,0,0,7720,-7706
ZCTA5 59274,152,21021,-20869,376,32.7,354,0,0,0,63734,-63358
ZCTA5 59275,181,7637,-7456,471,53.2,458,1,0,0,19646,-19175
ZCTA5 59276,9,5972,-5963,19,62.2,19,0,0,0,17722,-17703
ZCTA5 59301,4702,8487,-3785,11552,42.8,10680,30,91,0.007877424,25876,-14324
ZCTA5 59311,74,628,-554,151,57,151,0,0,0,1902,-1751
ZCTA5 59312,3,2085,-2082,6,66,6,0,0,0,5590,-5584
ZCTA5 59313,956,14490,-13534,2387,33.9,2216,0,1,0.000418936,37164,-34777
ZCTA5 59314,36,3866,-3830,109,47.8,109,0,0,0,12573,-12464
ZCTA5 59315,32,18822,-18790,71,61.5,70,0,0,0,58499,-58428
ZCTA5 59316,13,5741,-5728,16,77.3,16,0,0,0,14203,-14187
ZCTA5 59317,446,3389,-2943,1065,41.3,1020,0,0,0,9209,-8144
ZCTA5 59318,41,6001,-5960,135,34.1,135,0,0,0,15823,-15688
ZCTA5 59319,10,7993,-7983,16,55.5,16,0,0,0,22923,-22907
ZCTA5 59322,29,1892,-1863,90,27.5,90,0,0,0,6516,-6426
ZCTA5 59323,913,1534,-621,2094,47.6,1594,44,0,0,4110,-2016
ZCTA5 59324,379,3272,-2893,813,53.4,765,0,0,0,8866,-8053
ZCTA5 59326,88,9833,-9745,387,17.8,366,15,0,0,30264,-29877
ZCTA5 59327,921,868,53,2331,43,1897,23,0,0,2306,25
ZCTA5 59330,3674,3291,383,8545,40.1,8121,4,89,0.010415448,9098,-553
ZCTA5 59332,80,8996,-8916,166,60.3,166,0,0,0,28230,-28064
ZCTA5 59333,7,3991,-3984,31,28.9,31,0,0,0,12502,-12471
ZCTA5 59336,92,5450,-5358,278,43.5,277,0,0,0,16186,-15908
ZCTA5 59337,284,7716,-7432,642,45.9,638,0,4,0.00623053,21001,-20359
ZCTA5 59338,88,6796,-6708,190,55.2,158,0,0,0,20756,-20566
ZCTA5 59339,52,6367,-6315,98,47.8,97,0,0,0,21925,-21827
ZCTA5 59343,22,5734,-5712,43,50.9,43,0,0,0,17656,-17613
ZCTA5 59344,213,18036,-17823,625,36.6,596,0,0,0,49078,-48453
ZCTA5 59345,33,6419,-6386,107,24.9,65,0,0,0,18840,-18733
ZCTA5 59347,149,95,54,403,38.8,394,0,0,0,221,182
ZCTA5 59349,391,11545,-11154,831,60.8,817,13,0,0,28817,-27986
ZCTA5 59351,93,7597,-7504,228,59,213,0,0,0,22869,-22641
ZCTA5 59353,434,16027,-15593,1045,48.1,1007,6,0,0,53772,-52727
ZCTA5 59354,7,12043,-12036,15,-,15,0,0,0,34787,-34772
ZCTA5 59401,6105,3372,2733,13339,37.8,11368,103,112,0.008396432,9508,3831
ZCTA5 59404,10913,7806,3107,29092,40,25636,429,213,0.0073216,20565,8527
ZCTA5 59405,13631,695,12936,33253,34.5,27723,220,901,0.0270953,1865,31388
ZCTA5 59410,284,9759,-9475,600,59.2,556,1,0,0,26012,-25412
ZCTA5 59411,164,11721,-11557,757,32.9,307,50,0,0,39471,-38714
ZCTA5 59412,606,4465,-3859,1468,40.5,1324,3,0,0,13645,-12177
ZCTA5 59414,342,8040,-7698,752,45.2,552,0,0,0,24284,-23532
ZCTA5 59416,174,3262,-3088,399,44.7,376,0,7,0.01754386,9186,-8787
ZCTA5 59417,2096,7584,-5488,8115,29.3,737,28,25,0.003080715,20443,-12328
ZCTA5 59418,32,11176,-11144,82,31.8,82,0,0,0,34064,-33982
ZCTA5 59419,44,9544,-9500,74,59,69,0,0,0,27976,-27902
ZCTA5 59420,79,21778,-21699,239,52.3,227,0,0,0,56614,-56375
ZCTA5 59421,885,5659,-4774,1945,58,1745,0,2,0.001028278,16291,-14346
ZCTA5 59422,1035,1785,-750,2769,43.3,2565,0,28,0.010111954,4346,-1577
ZCTA5 59424,17,5084,-5067,26,60.5,26,0,0,0,14355,-14329
ZCTA5 59425,1388,5060,-3672,3751,41.7,3547,1,5,0.001332978,13997,-10246
ZCTA5 59427,1585,8960,-7375,4542,40.1,2989,7,17,0.003742845,28954,-24412
ZCTA5 59430,230,575,-345,528,53.7,507,0,0,0,1511,-983
ZCTA5 59432,65,1936,-1871,184,50,127,0,0,0,4661,-4477
ZCTA5 59433,203,14934,-14731,473,42.3,443,0,0,0,38562,-38089
ZCTA5 59434,170,5550,-5380,462,39.9,270,1,0,0,14340,-13878
ZCTA5 59435,22,3874,-3852,31,63.5,31,0,0,0,9627,-9596
ZCTA5 59436,828,7147,-6319,2079,40.8,1967,0,12,0.005772006,17474,-15395
ZCTA5 59440,115,8577,-8462,233,57,224,0,0,0,22552,-22319
ZCTA5 59441,31,9083,-9052,105,34.8,96,0,0,0,26514,-26409
ZCTA5 59442,681,2342,-1661,1718,38.3,1670,3,0,0,6158,-4440
ZCTA5 59443,211,1768,-1557,527,41.4,476,0,0,0,5975,-5448
ZCTA5 59444,125,194,-69,338,44.7,332,0,0,0,569,-231
ZCTA5 59446,209,5267,-5058,592,46.4,584,0,0,0,13757,-13165
ZCTA5 59447,113,1918,-1805,313,37.1,313,0,0,0,5158,-4845
ZCTA5 59448,140,7338,-7198,598,29.4,28,2,4,0.006688963,22376,-21778
ZCTA5 59450,220,300,-80,624,49.1,612,1,0,0,730,-106
ZCTA5 59451,79,4078,-3999,206,29.9,203,0,0,0,9785,-9579
ZCTA5 59452,211,1078,-867,521,48.4,409,0,0,0,2773,-2252
ZCTA5 59453,137,15139,-15002,254,61.9,250,0,0,0,38120,-37866
ZCTA5 59454,64,5857,-5793,127,48.8,127,0,0,0,16712,-16585
ZCTA5 59456,43,243,-200,60,55.5,60,0,0,0,904,-844
ZCTA5 59457,4146,2153,1993,9067,42.6,8442,273,57,0.006286534,5045,4022
ZCTA5 59460,111,4830,-4719,146,69.5,146,0,0,0,12072,-11926
ZCTA5 59461,5,4454,-4449,10,61.5,10,0,0,0,10991,-10981
ZCTA5 59462,93,2352,-2259,207,56.1,184,0,0,0,7012,-6805
ZCTA5 59463,65,8742,-8677,108,64.6,102,0,0,0,26428,-26320
ZCTA5 59464,206,5732,-5526,523,40.8,479,0,0,0,19609,-19086
ZCTA5 59465,24,7515,-7491,44,59.5,41,0,0,0,22657,-22613
ZCTA5 59466,49,3415,-3366,103,51.3,103,0,0,0,11790,-11687
ZCTA5 59467,29,8128,-8099,70,38.6,59,0,0,0,22770,-22700
ZCTA5 59468,263,4924,-4661,622,40,577,0,0,0,16550,-15928
ZCTA5 59469,37,13232,-13195,113,35,112,0,0,0,37961,-37848
ZCTA5 59471,131,19529,-19398,324,54.4,269,0,12,0.037037037,70324,-70000
ZCTA5 59472,297,19213,-18916,826,37.4,791,0,0,0,57139,-56313
ZCTA5 59474,1306,10265,-8959,3438,42.8,2894,5,147,0.042757417,28849,-25411
ZCTA5 59477,121,568,-447,310,39.6,290,0,0,0,1534,-1224
ZCTA5 59479,345,404,-59,731,50.6,708,0,0,0,1025,-294
ZCTA5 59480,134,7018,-6884,320,55.4,289,0,0,0,18843,-18523
ZCTA5 59482,219,3927,-3708,956,21.2,938,2,0,0,10535,-9579
ZCTA5 59483,146,10873,-10727,345,53,344,0,0,0,27902,-27557
ZCTA5 59484,51,10845,-10794,105,62.6,84,0,0,0,28178,-28073
ZCTA5 59485,260,12395,-12135,687,48.8,660,0,0,0,32317,-31630
ZCTA5 59486,488,1438,-950,1202,45.1,949,11,0,0,3730,-2528
ZCTA5 59487,536,40,496,1354,40.7,1217,0,0,0,91,1263
ZCTA5 59489,196,1154,-958,308,66.5,298,0,0,0,2946,-2638
ZCTA5 59501,4972,5730,-758,12175,34.9,9928,74,70,0.005749487,17530,-5355
ZCTA5 59520,433,4240,-3807,1128,45.1,952,5,8,0.007092199,9690,-8562
ZCTA5 59521,1096,11774,-10678,3978,28.6,141,1,30,0.007541478,31192,-27214
ZCTA5 59522,479,5467,-4988,1280,39.9,1270,0,0,0,13602,-12322
ZCTA5 59523,941,11207,-10266,2115,45.7,1937,0,26,0.012293144,28031,-25916
ZCTA5 59524,252,270,-18,889,37.8,236,0,0,0,777,112
ZCTA5 59525,100,697,-597,260,41.5,260,0,0,0,1870,-1610
ZCTA5 59526,753,11392,-10639,2686,29.1,627,4,0,0,26695,-24009
ZCTA5 59527,271,4040,-3769,1303,30.8,49,0,30,0.023023791,10620,-9317
ZCTA5 59528,110,37,73,229,59.1,229,0,0,0,93,136
ZCTA5 59529,49,216,-167,128,53.5,128,0,0,0,766,-638
ZCTA5 59530,52,8811,-8759,155,47.5,110,0,0,0,26430,-26275
ZCTA5 59531,149,0,149,441,32,431,0,0,0,169,272
ZCTA5 59532,67,15322,-15255,119,62.3,119,0,0,0,43361,-43242
ZCTA5 59535,10,1127,-1117,38,35.5,38,0,0,0,3024,-2986
ZCTA5 59537,14,5818,-5804,31,56.6,21,0,0,0,16416,-16385
ZCTA5 59538,1174,11750,-10576,2936,44.2,2481,23,0,0,36003,-33067
ZCTA5 59540,188,8785,-8597,520,34.2,508,0,0,0,25335,-24815
ZCTA5 59542,111,4561,-4450,263,43.9,257,0,0,0,13054,-12791
ZCTA5 59544,79,6157,-6078,179,42.3,157,0,0,0,15824,-15645
ZCTA5 59545,33,4897,-4864,56,78.4,56,0,0,0,12855,-12799
ZCTA5 59546,95,234,-139,136,65.5,129,0,0,0,928,-792
ZCTA5 59547,28,529,-501,80,47.5,75,0,0,0,1397,-1317
ZCTA5 59601,14555,1484,13071,31640,40.5,29102,230,207,0.006542351,4669,26971
ZCTA5 59602,11079,1493,9586,28367,40.3,26198,136,70,0.002467656,4013,24354
ZCTA5 59623,0,296,-296,0,-,0,0,0,#DIV/0!,882,-882
ZCTA5 59625,0,4209,-4209,246,20.7,216,10,1,0.004065041,11796,-11550
ZCTA5 59631,152,4857,-4705,377,54.4,356,16,4,0.01061008,13465,-13088
ZCTA5 59632,786,691,95,2141,41.3,1913,0,0,0,1938,203
ZCTA5 59633,140,0,140,255,56.3,246,0,0,0,0,255
ZCTA5 59634,1856,4258,-2402,5323,44.9,4974,1,24,0.004508736,12853,-7530
ZCTA5 59635,3157,10360,-7203,7715,41.3,7426,46,51,0.006610499,24567,-16852
ZCTA5 59636,0,8097,-8097,48,22.5,43,0,5,0.104166667,22677,-22629
ZCTA5 59638,221,9129,-8908,531,47.9,501,0,0,0,23197,-22666
ZCTA5 59639,634,14729,-14095,1259,54.3,1154,0,0,0,36236,-34977
ZCTA5 59640,58,12265,-12207,100,61.8,100,0,0,0,41217,-41117
ZCTA5 59642,34,13543,-13509,34,55.9,34,0,0,0,40434,-40400
ZCTA5 59643,299,6475,-6176,566,50.9,566,0,0,0,22081,-21515
ZCTA5 59644,1916,13219,-11303,4700,46.2,4458,0,3,0.000638298,46677,-41977
ZCTA5 59645,627,6343,-5716,1534,58.2,1441,5,1,0.00065189,9791,-8257
ZCTA5 59647,165,637,-472,389,47.2,389,0,0,0,1322,-933
ZCTA5 59648,182,261,-79,374,59.6,355,0,0,0,623,-249
ZCTA5 59701,14565,289,14276,33671,40.5,31112,170,54,0.001603754,428,33243
ZCTA5 59710,126,12396,-12270,303,58.6,301,0,0,0,22887,-22584
ZCTA5 59711,4295,1466,2829,9371,48.6,8682,69,85,0.009070537,2399,6972
ZCTA5 59713,63,11051,-10988,190,28,189,0,0,0,24277,-24087
ZCTA5 59714,8928,25203,-16275,22684,36.2,21388,34,0,0,80313,-57629
ZCTA5 59715,14900,19103,-4203,38347,31.1,34442,874,326,0.008501317,63208,-24861
ZCTA5 59716,1009,22370,-21361,2597,37,2500,0,4,0.001540239,37898,-35301
ZCTA5 59718,16949,19018,-2069,41341,31.9,38244,470,153,0.003700926,29026,12315
ZCTA5 59720,148,13179,-13031,310,71,267,0,0,0,35584,-35274
ZCTA5 59721,173,26915,-26742,426,51.6,419,0,0,0,49201,-48775
ZCTA5 59722,1828,33432,-31604,5683,46.4,4967,118,96,0.016892486,67203,-61520
ZCTA5 59724,51,20099,-20048,90,47.5,90,0,0,0,41462,-41372
ZCTA5 59725,3306,21123,-17817,7805,39.2,7324,13,88,0.011274824,48994,-41189
ZCTA5 59727,115,28868,-28753,344,37.5,332,0,0,0,84882,-84538
ZCTA5 59728,136,35534,-35398,360,48.3,343,0,0,0,97389,-97029
ZCTA5 59729,1031,26922,-25891,2238,54.5,2122,89,2,0.000893655,66254,-64016
ZCTA5 59730,768,25646,-24878,1993,41,1841,14,0,0,74245,-72252
ZCTA5 59731,51,11871,-11820,143,40.1,143,0,0,0,34418,-34275
ZCTA5 59732,74,23608,-23534,276,37.4,241,0,0,0,54676,-54400
ZCTA5 59733,58,23478,-23420,229,27.3,215,0,0,0,85203,-84974
ZCTA5 59735,95,12306,-12211,263,54.1,263,0,0,0,39398,-39135
ZCTA5 59736,74,28702,-28628,158,57.8,144,1,0,0,78685,-78527
ZCTA5 59739,146,22096,-21950,316,48.9,281,0,0,0,52007,-51691
ZCTA5 59740,209,24652,-24443,414,61.3,414,0,0,0,74001,-73587
ZCTA5 59741,1980,30135,-28155,5314,41.4,5120,20,0,0,111893,-106579
ZCTA5 59743,84,20699,-20615,175,58,174,0,0,0,56909,-56734
ZCTA5 59745,43,11631,-11588,139,33.3,139,0,0,0,29126,-28987
ZCTA5 59746,62,23541,-23479,142,63.3,137,0,0,0,90911,-90769
ZCTA5 59747,65,4989,-4924,164,52.4,141,0,0,0,13757,-13593
ZCTA5 59748,110,25231,-25121,308,36.7,301,6,0,0,73251,-72943
ZCTA5 59749,762,11814,-11052,2059,53.8,1986,0,0,0,40068,-38009
ZCTA5 59750,108,18842,-18734,377,34.9,370,7,0,0,47110,-46733
ZCTA5 59751,68,19620,-19552,299,32.9,296,0,0,0,54733,-54434
ZCTA5 59752,1544,25448,-23904,3931,43.3,3774,66,0,0,90763,-86832
ZCTA5 59754,419,34071,-33652,1075,51.1,1025,3,0,0,65198,-64123
ZCTA5 59755,55,24432,-24377,148,63.7,139,0,0,0,71294,-71146
ZCTA5 59756,16,9000,-8984,301,47.8,269,0,0,0,18743,-18442
ZCTA5 59758,679,17680,-17001,1658,41.2,1297,32,0,0,49842,-48184
ZCTA5 59759,1631,16033,-14402,3680,55.5,3429,0,26,0.007065217,47133,-43453
ZCTA5 59760,116,15501,-15385,243,45.8,237,0,0,0,45977,-45734
ZCTA5 59761,157,10606,-10449,360,60.8,335,0,0,0,27745,-27385
ZCTA5 59762,125,34219,-34094,253,64.6,229,0,0,0,87237,-86984
ZCTA5 59801,14518,21129,-6611,30886,31.2,27029,441,246,0.007964774,44516,-13630
ZCTA5 59802,8808,19452,-10644,19790,35.5,17618,534,69,0.003486609,63645,-43855
ZCTA5 59803,6307,13193,-6886,17052,39.6,16048,286,71,0.004163734,42616,-25564
ZCTA5 59804,3128,13700,-10572,7802,44.4,7120,271,0,0,31374,-23572
ZCTA5 59808,8865,9896,-1031,21669,37.6,19153,440,38,0.001753657,14607,7062
ZCTA5 59812,0,10128,-10128,1480,19.3,1292,40,13,0.008783784,28179,-26699
ZCTA5 59820,804,11608,-10804,1950,47.4,1787,10,16,0.008205128,27455,-25505
ZCTA5 59821,963,36971,-36008,2770,39.6,1431,7,3,0.001083032,68280,-65510
ZCTA5 59823,736,12763,-12027,1855,42.3,1713,8,3,0.001617251,40153,-38298
ZCTA5 59824,576,20847,-20271,1371,49.5,941,6,4,0.002917578,41774,-40403
ZCTA5 59825,870,4722,-3852,2333,44,2125,28,14,0.006000857,7238,-4905
ZCTA5 59826,282,9138,-8856,568,65.5,496,0,0,0,23148,-22580
ZCTA5 59827,145,15445,-15300,256,70.4,256,0,0,0,42400,-42144
ZCTA5 59828,2293,4169,-1876,5691,48.1,5297,0,36,0.006325778,12538,-6847
ZCTA5 59829,1100,11424,-10324,2335,55.2,2185,46,1,0.000428266,29903,-27568
ZCTA5 59830,76,8691,-8615,154,51.8,154,0,0,0,22842,-22688
ZCTA5 59831,212,21404,-21192,593,38.6,342,0,0,0,83924,-83331
ZCTA5 59832,319,6955,-6636,867,45.6,830,0,5,0.005767013,19852,-18985
ZCTA5 59833,2211,10137,-7926,5480,48.8,4743,24,0,0,28355,-22875
ZCTA5 59834,837,13210,-12373,2220,36.4,2078,0,134,0.06036036,37050,-34830
ZCTA5 59837,143,152,-9,330,43.8,329,0,0,0,381,-51
ZCTA5 59840,6665,550,6115,14292,49.3,13472,68,0,0,1604,12688
ZCTA5 59841,192,290,-98,914,19.8,850,0,0,0,794,120
ZCTA5 59842,49,558,-509,102,56.2,102,0,0,0,1357,-1255
ZCTA5 59843,110,9816,-9706,267,30.5,244,0,0,0,28727,-28460
ZCTA5 59844,253,4261,-4008,664,57,648,0,0,0,10681,-10017
ZCTA5 59845,607,220,387,1323,50.7,1144,0,0,0,717,606
ZCTA5 59846,599,322,277,1139,62.5,1139,0,0,0,770,369
ZCTA5 59847,2626,226,2400,6287,34.1,5936,71,39,0.006203277,532,5755
ZCTA5 59848,45,49,-4,98,29,94,0,0,0,133,-35
ZCTA5 59851,60,624,-564,130,27.3,114,0,0,0,1549,-1419
ZCTA5 59853,385,947,-562,815,53.7,796,4,0,0,2529,-1714
ZCTA5 59854,94,734,-640,213,50.1,206,0,0,0,1791,-1578
ZCTA5 59855,205,22,183,489,32.5,202,0,14,0.028629857,46,443
ZCTA5 59856,64,848,-784,196,67.1,122,0,0,0,2402,-2206
ZCTA5 59858,647,288,359,1653,54.1,1542,14,0,0,667,986
ZCTA5 59859,1749,300,1449,3953,53.5,3699,3,8,0.002023779,731,3222
ZCTA5 59860,4539,313,4226,11464,46.3,8655,87,48,0.00418702,817,10647
ZCTA5 59863,98,221,-123,191,37.9,171,0,0,0,560,-369
ZCTA5 59864,2460,0,2460,6931,33.5,3460,52,19,0.002741307,0,6931
ZCTA5 59865,1291,103,1188,3997,37.7,2260,18,13,0.003252439,277,3720
ZCTA5 59866,466,118,348,978,47.8,939,0,9,0.009202454,257,721
ZCTA5 59867,21,366,-345,36,50,24,0,0,0,1154,-1118
ZCTA5 59868,974,1800,-826,1977,60,1858,67,0,0,4110,-2133
ZCTA5 59870,4695,849,3846,11377,47.7,10727,86,80,0.007031731,2212,9165
ZCTA5 59871,169,1222,-1053,375,61.9,375,0,0,0,3457,-3082
ZCTA5 59872,938,771,167,2197,55.8,2066,20,2,0.000910332,2121,76
ZCTA5 59873,1284,2433,-1149,2810,58.9,2668,3,0,0,6091,-3281
ZCTA5 59874,823,83,740,1898,56,1796,13,29,0.015279241,191,1707
ZCTA5 59875,1632,175,1457,3924,53.1,3391,7,34,0.008664628,365,3559
ZCTA5 59901,22127,625,21502,58212,40.2,53368,741,343,0.005892256,1713,56499
ZCTA5 59910,272,255,17,759,41.3,427,0,0,0,591,168
ZCTA5 59911,3676,4516,-840,8615,54.2,7729,23,39,0.004526988,11947,-3332
ZCTA5 59912,5843,348,5495,15648,40,14801,47,15,0.000958589,857,14791
ZCTA5 59913,280,294,-14,497,58.5,429,0,0,0,753,-256
ZCTA5 59914,153,1070,-917,342,63.1,266,7,0,0,2492,-2150
ZCTA5 59915,123,2328,-2205,306,29.8,77,0,0,0,6299,-5993
ZCTA5 59916,78,635,-557,148,65.6,148,0,0,0,1736,-1588
ZCTA5 59917,2027,2148,-121,5277,53.3,5037,8,0,0,5556,-279
ZCTA5 59918,228,872,-644,599,44.7,562,7,2,0.003338898,2153,-1554
ZCTA5 59919,308,355,-47,607,47.4,570,0,0,0,978,-371
ZCTA5 59920,577,385,192,1409,50,1260,36,0,0,1048,361
ZCTA5 59922,1040,295,745,2440,45.9,2376,3,0,0,779,1661
ZCTA5 59923,4411,274,4137,9139,54.2,8446,39,12,0.001313054,670,8469
ZCTA5 59925,572,669,-97,1692,48,1580,7,5,0.002955083,1718,-26
ZCTA5 59926,176,1998,-1822,355,50.4,347,0,0,0,5166,-4811
ZCTA5 59927,129,556,-427,291,47.2,249,0,0,0,1354,-1063
ZCTA5 59928,84,163,-79,181,62.7,162,0,0,0,337,-156
ZCTA5 59929,69,17,52,162,39.2,162,0,0,0,50,112
ZCTA5 59930,217,3187,-2970,409,71.8,391,0,0,0,7257,-6848
ZCTA5 59931,131,196,-65,311,60.4,211,3,0,0,442,-131
ZCTA5 59932,698,130,568,1376,64.4,1345,0,0,0,280,1096
ZCTA5 59933,7,575,-568,23,37.3,23,0,0,0,1275,-1252
ZCTA5 59934,299,840,-541,819,39.6,784,0,6,0.007326007,2011,-1192
ZCTA5 59935,1269,217,1052,3408,49.4,3103,13,0,0,520,2888
ZCTA5 59936,179,11387,-11208,485,53.5,458,0,26,0.053608247,34364,-33879
ZCTA5 59937,6114,2781,3333,14066,44.6,13381,0,3,0.00021328,8335,5731
ZCTA5 60002,9506,866,8640,24257,44,21489,752,332,0.013686771,2272,21985
ZCTA5 60004,20494,810,19684,52344,42.3,40984,5319,1492,0.028503744,2409,49935
ZCTA5 60005,12405,250,12155,29622,42.5,21782,2918,823,0.027783404,624,28998
ZCTA5 60007,12745,496,12249,33048,41.9,25743,3970,776,0.023480997,1215,31833
ZCTA5 60008,8731,297,8434,23191,38.7,15807,1678,811,0.034970463,707,22484
ZCTA5 60010,16999,2039,14960,47130,46.8,38208,6526,421,0.008932739,5077,42053
ZCTA5 60012,3929,427,3502,11712,43.4,10973,353,111,0.009477459,1293,10419
ZCTA5 60013,9470,1334,8136,26689,40.7,23996,401,81,0.003034958,3448,23241
ZCTA5 60014,17177,1074,16103,47612,40.4,42790,1313,524,0.011005629,3280,44332
ZCTA5 60015,10246,9200,1046,27671,43.6,24581,2109,263,0.009504535,23706,3965
ZCTA5 60016,24144,982,23162,62140,41.7,38055,13620,2858,0.045992919,2625,59515
ZCTA5 60018,9685,1967,7718,29161,40.2,19390,3167,375,0.012859641,4823,24338
ZCTA5 60020,4869,0,4869,10932,47.5,9396,111,332,0.030369557,0,10932
ZCTA5 60021,2007,785,1222,5205,41.8,4500,177,0,0,1990,3215
ZCTA5 60022,3106,880,2226,8536,46.4,8083,200,128,0.014995314,2375,6161
ZCTA5 60025,16088,521,15567,42196,44.9,31700,7706,508,0.012039056,1635,40561
ZCTA5 60026,5463,13238,-7775,14206,46.6,9961,3046,187,0.013163452,31482,-17276
ZCTA5 60029,178,2903,-2725,524,49.9,435,58,23,0.04389313,6626,-6102
ZCTA5 60030,13928,79,13849,35517,41.4,28501,1622,1987,0.05594504,249,35268
ZCTA5 60031,14258,479,13779,37818,40,26200,4867,2633,0.069622931,1361,36457
ZCTA5 60033,4783,347,4436,13658,33.6,11924,21,56,0.004100161,1043,12615
ZCTA5 60034,769,662,107,2274,39.7,2166,0,38,0.016710642,1376,898
ZCTA5 60035,12082,187,11895,30251,48.4,26896,899,165,0.005454365,466,29785
ZCTA5 60040,1974,32,1942,5204,36.1,3834,21,249,0.047847809,61,5143
ZCTA5 60041,3442,59,3383,8646,43.1,6917,211,251,0.029030766,129,8517
ZCTA5 60042,3184,1170,2014,8552,40.3,7709,254,20,0.002338634,2648,5904
ZCTA5 60043,755,699,56,2423,40.4,2162,60,0,0,1529,894
ZCTA5 60044,4236,1753,2483,10286,45.2,8477,868,67,0.006513708,4237,6049
ZCTA5 60045,7659,212,7447,21324,46.5,18126,1570,227,0.010645282,591,20733
ZCTA5 60046,12024,124,11900,35225,38.8,29269,1913,1005,0.028530873,308,34917
ZCTA5 60047,14588,699,13889,43606,42.4,36010,4993,384,0.008806128,1664,41942
ZCTA5 60048,10455,410,10045,29594,43.4,25553,2146,274,0.009258634,1018,28576
ZCTA5 60050,12805,1319,11486,31748,41,29259,313,221,0.006961068,3199,28549
ZCTA5 60051,8956,1698,7258,23388,43,21311,713,85,0.003634342,3967,19421
ZCTA5 60053,9456,28,9428,25004,46.2,14612,8386,227,0.009078547,99,24905
ZCTA5 60056,21788,59,21729,56912,40.6,39677,7783,1804,0.03169806,149,56763
ZCTA5 60060,13041,579,12462,37105,38.6,25747,3826,479,0.012909311,1470,35635
ZCTA5 60061,10486,2933,7553,27761,40.6,18058,6778,545,0.019631858,6721,21040
ZCTA5 60062,16453,810,15643,41920,49.4,32862,6374,1017,0.024260496,1971,39949
ZCTA5 60064,5611,1546,4065,15961,28.4,3829,514,5390,0.337698139,4095,11866
ZCTA5 60067,15301,1513,13788,39006,41.9,28198,6412,1039,0.026636928,3727,35279
ZCTA5 60068,15179,3585,11594,39531,45,34615,2388,476,0.012041183,11086,28445
ZCTA5 60069,3572,341,3231,8475,52.1,6560,1660,79,0.009321534,821,7654
ZCTA5 60070,6272,5803,469,15875,39.9,10200,1488,181,0.011401575,15032,843
ZCTA5 60071,1866,463,1403,3910,49.8,3631,0,36,0.009207161,1080,2830
ZCTA5 60072,338,5999,-5661,908,47.7,869,2,33,0.036343612,14393,-13485
ZCTA5 60073,19392,4102,15290,62719,33.7,41263,3516,3151,0.050239959,11534,51185
ZCTA5 60074,14463,6909,7554,37655,35.3,22741,3164,1988,0.052795114,19820,17835
ZCTA5 60075,13,1983,-1970,29,-,29,0,0,0,4202,-4173
ZCTA5 60076,11506,443,11063,33432,43.2,18977,8659,2986,0.089315626,1046,32386
ZCTA5 60077,10878,54,10824,29238,42.9,14902,8315,2389,0.081708735,64,29174
ZCTA5 60081,3199,618,2581,9246,44.3,8539,113,0,0,1443,7803
ZCTA5 60083,3366,32,3334,9156,43.7,5939,815,1052,0.114897335,88,9068
ZCTA5 60084,6348,3866,2482,16999,39,14183,913,130,0.007647509,10805,6194
ZCTA5 60085,24250,8354,15896,73053,33.2,25526,4073,13428,0.183811753,21477,51576
ZCTA5 60087,9425,1061,8364,27470,34.6,13404,1321,4150,0.151073899,2792,24678
ZCTA5 60088,1330,1519,-189,13251,20.8,8300,910,2467,0.186174628,3371,9880
ZCTA5 60089,15953,704,15249,42993,41.2,28943,10331,1398,0.032516921,1652,41341
ZCTA5 60090,15298,2198,13100,39034,39.1,22309,6894,880,0.022544448,6409,32625
ZCTA5 60091,10292,338,9954,27750,45.7,22982,3416,197,0.007099099,794,26956
ZCTA5 60093,7240,50,7190,20379,44.8,18357,677,13,0.000637912,103,20276
ZCTA5 60096,2745,8071,-5326,6721,51.3,6020,34,243,0.036155334,22912,-16191
ZCTA5 60097,4433,6601,-2168,11593,39.1,10058,106,69,0.005951868,19712,-8119
ZCTA5 60098,12451,10053,2398,33101,40.4,28151,540,566,0.017099181,24392,8709
ZCTA5 60099,11012,6854,4158,31514,33.7,16448,1149,7315,0.232119058,17936,13578
ZCTA5 60101,13402,13052,350,37765,37.9,23699,3224,1683,0.044565073,31072,6693
ZCTA5 60102,11971,11804,167,32438,42.6,27257,2092,789,0.024323324,29485,2953
ZCTA5 60103,14272,11215,3057,42318,40.7,29362,6946,1355,0.032019472,28475,13843
ZCTA5 60104,6056,9299,-3243,18785,37.7,1838,169,13370,0.711738089,23771,-4986
ZCTA5 60106,7593,82,7511,20694,36.2,13265,755,1116,0.053928675,82,20612
ZCTA5 60107,12854,6090,6764,39683,38.1,21977,5303,2205,0.055565355,14510,25173
ZCTA5 60108,9196,8522,674,23703,41.5,17725,3190,1096,0.046238873,23085,618
ZCTA5 60109,197,15596,-15399,521,44.6,495,0,4,0.007677543,38943,-38422
ZCTA5 60110,11722,600,11122,39335,32,18428,3068,2608,0.066302275,1356,37979
ZCTA5 60111,70,2254,-2184,105,57.2,105,0,0,0,5328,-5223
ZCTA5 60112,1661,551,1110,4515,30.4,3636,0,664,0.147065338,1479,3036
ZCTA5 60113,93,561,-468,311,33.4,239,0,0,0,1283,-972
ZCTA5 60115,16873,636,16237,42815,25.5,28987,1869,6354,0.148405933,1474,41341
ZCTA5 60118,6270,39,6231,15536,44.3,12920,572,411,0.026454686,105,15431
ZCTA5 60119,3962,1380,2582,10779,44.1,10488,5,51,0.004731422,3369,7410
ZCTA5 60120,15953,481,15472,51024,33,24241,2592,2086,0.040882722,1242,49782
ZCTA5 60123,17570,2220,15350,49140,38,27180,2099,3768,0.076678877,6112,43028
ZCTA5 60124,8744,2754,5990,24176,42.2,19992,1745,151,0.006245864,6714,17462
ZCTA5 60126,17332,455,16877,47822,40.9,40875,3130,621,0.012985655,1092,46730
ZCTA5 60129,104,118,-14,223,46.9,195,0,6,0.02690583,319,-96
ZCTA5 60130,6961,9898,-2937,14297,42.4,8065,730,3993,0.279289361,24251,-9954
ZCTA5 60131,5895,1066,4829,18409,38.2,10881,740,75,0.004074094,2583,15826
ZCTA5 60133,11220,145,11075,37545,34.2,18236,6171,2951,0.078599015,360,37185
ZCTA5 60134,10896,2387,8509,30514,39.1,27677,803,336,0.011011339,5363,25151
ZCTA5 60135,2703,4407,-1704,7069,41.2,6494,53,43,0.006082897,11284,-4215
ZCTA5 60136,2749,746,2003,8350,32.9,4926,634,18,0.002155689,2099,6251
ZCTA5 60137,14629,513,14116,38648,41.4,32213,2739,955,0.024710205,1051,37597
ZCTA5 60139,11429,109,11320,33520,35,15752,7558,3936,0.117422434,307,33213
ZCTA5 60140,7007,375,6632,20859,40.1,17595,907,998,0.047845055,879,19980
ZCTA5 60141,137,368,-231,298,70.4,134,7,122,0.409395973,1001,-703
ZCTA5 60142,12494,444,12050,29478,48.3,25775,1487,1273,0.043184748,1010,28468
ZCTA5 60143,4658,540,4118,11673,44.9,8858,1412,100,0.008566778,1411,10262
ZCTA5 60144,43,239,-196,97,49.8,97,0,0,0,570,-473
ZCTA5 60145,992,4710,-3718,2607,37.2,2407,0,38,0.014576141,10516,-7909
ZCTA5 60146,927,18777,-17850,2324,42.5,2130,0,0,0,44921,-42597
ZCTA5 60148,20198,2746,17452,53072,38.3,40197,6642,2381,0.044863582,7089,45983
ZCTA5 60150,674,595,79,1998,37.9,1647,21,56,0.028028028,1400,598
ZCTA5 60151,1530,1293,237,4068,45.9,3874,15,5,0.001229105,3405,663
ZCTA5 60152,4580,165,4415,12471,37.8,11861,0,203,0.016277764,400,12071
ZCTA5 60153,7875,1733,6142,23547,39.9,3530,215,14572,0.618847412,4506,19041
ZCTA5 60154,6829,53,6776,16837,49.3,10992,485,3711,0.220407436,106,16731
ZCTA5 60155,3089,1209,1880,8005,40.8,1196,214,5667,0.707932542,3074,4931
ZCTA5 60156,9912,125,9787,29024,35.9,24225,1808,743,0.025599504,309,28715
ZCTA5 60157,967,433,534,2553,52,2344,161,15,0.005875441,1124,1429
ZCTA5 60160,7949,951,6998,25417,33.9,11192,103,1071,0.042137152,2627,22790
ZCTA5 60162,2987,3520,-533,8286,41.6,2367,211,3722,0.449191407,7719,567
ZCTA5 60163,1913,594,1319,5307,41.1,2053,129,1390,0.261918221,1980,3327
ZCTA5 60164,7162,975,6187,21719,37.5,11830,673,591,0.027211198,2354,19365
ZCTA5 60165,1307,742,565,4611,33.5,1694,60,112,0.024289742,1698,2913
ZCTA5 60169,12161,4401,7760,34188,35.4,17065,8282,2262,0.066163566,10684,23504
ZCTA5 60171,3762,1651,2111,10571,35.4,7848,155,5,0.000472992,4111,6460
ZCTA5 60172,9289,70,9219,24407,41.9,20025,2053,340,0.01393043,132,24275
ZCTA5 60173,6534,202,6332,14016,34.2,5662,5844,937,0.066852169,524,13492
ZCTA5 60174,12490,76,12414,30382,42.7,25746,1329,1024,0.033704167,200,30182
ZCTA5 60175,8701,344,8357,26677,43.2,23255,1552,538,0.020167185,854,25823
ZCTA5 60176,4299,119,4180,11680,38.2,8270,908,196,0.016780822,301,11379
ZCTA5 60177,8111,86,8025,23859,39,17872,1941,1238,0.051888176,249,23610
ZCTA5 60178,8419,156,8263,21684,37,19811,241,714,0.032927504,348,21336
ZCTA5 60180,555,233,322,1596,29.9,1396,22,0,0,633,963
ZCTA5 60181,11261,452,10809,30488,36.4,22730,2213,1908,0.062581999,1131,29357
ZCTA5 60183,0,294,-294,0,-,0,0,0,#DIV/0!,727,-727
ZCTA5 60184,919,119,800,2543,50.7,1985,376,65,0.025560362,281,2262
ZCTA5 60185,10743,577,10166,34471,37.8,21703,2346,1203,0.034898901,1716,32755
ZCTA5 60187,10341,33,10308,30465,35.2,25646,1887,1079,0.035417692,95,30370
ZCTA5 60188,15018,31,14987,42290,40.1,26456,8291,2735,0.064672499,52,42238
ZCTA5 60189,11835,369,11466,30550,41.1,24893,1942,892,0.029198036,1029,29521
ZCTA5 60190,4406,1049,3357,11448,47.4,9771,654,148,0.012928022,2296,9152
ZCTA5 60191,5184,514,4670,14136,41,10367,790,345,0.024405772,1216,12920
ZCTA5 60192,5785,6,5779,16391,44.5,9896,4775,757,0.046183881,13,16378
ZCTA5 60193,16016,592,15424,40150,41.3,28073,5550,1394,0.034719801,1419,38731
ZCTA5 60194,8093,543,7550,20467,39.8,11585,5146,1945,0.095031026,1463,19004
ZCTA5 60195,2271,0,2271,4865,34.6,1727,2533,277,0.056937307,0,4865
ZCTA5 60201,16240,38,16202,43452,32.4,28892,4492,5697,0.131110191,79,43373
ZCTA5 60202,14016,118,13898,34793,40.3,20748,2558,6937,0.199379185,299,34494
ZCTA5 60203,1670,237,1433,4728,42.8,3563,391,581,0.122884941,638,4090
ZCTA5 60208,0,193,-193,209,20.3,139,44,8,0.038277512,500,-291
ZCTA5 60301,1842,251,1591,2890,35.3,1488,402,521,0.180276817,847,2043
ZCTA5 60302,14375,211,14164,33039,41.6,21791,1438,6436,0.194800085,600,32439
ZCTA5 60304,6576,115,6461,18171,38.1,11636,1119,3109,0.171096803,267,17904
ZCTA5 60305,4428,120,4308,11742,40.6,9880,558,472,0.040197581,371,11371
ZCTA5 60401,2895,3168,-273,7852,41.1,7083,71,116,0.014773306,7877,-25
ZCTA5 60402,22272,3401,18871,65326,36.2,28014,1941,5004,0.076600435,8873,56453
ZCTA5 60403,7597,151,7446,17095,39.4,12248,649,2521,0.14747002,321,16774
ZCTA5 60404,6944,380,6564,19651,42.2,15964,643,930,0.047325836,811,18840
ZCTA5 60406,8971,31,8940,25007,35.2,11914,163,7838,0.313432239,73,24934
ZCTA5 60407,600,1866,-1266,1623,38.5,1579,0,0,0,4654,-3031
ZCTA5 60408,2109,357,1752,5488,40.1,5192,0,5,0.000911079,932,4556
ZCTA5 60409,13895,9904,3991,36065,36.9,6063,79,27413,0.76009982,24281,11784
ZCTA5 60410,4511,506,4005,13949,37.5,13183,12,345,0.024732956,1385,12564
ZCTA5 60411,17999,4570,13429,53242,35,14822,121,27427,0.515138425,10851,42391
ZCTA5 60415,5415,4858,557,14413,35.7,10313,370,1152,0.079927843,11121,3292
ZCTA5 60416,3913,236,3677,9307,41.7,8877,33,98,0.010529709,484,8823
ZCTA5 60417,6133,117,6016,15607,49.5,9169,56,5240,0.33574678,279,15328
ZCTA5 60418,4686,1334,3352,10910,47.5,8921,325,909,0.083318057,3764,7146
ZCTA5 60419,7789,623,7166,21588,37.5,1081,40,19846,0.919307022,1776,19812
ZCTA5 60420,1811,2359,-548,4750,35.8,4417,0,22,0.004631579,5673,-923
ZCTA5 60421,1537,111,1426,3838,44.2,3584,27,30,0.007816571,261,3577
ZCTA5 60422,3721,8079,-4358,10531,42.8,3112,190,6795,0.645237869,20494,-9963
ZCTA5 60423,10904,349,10555,32480,42.6,27362,691,2264,0.069704433,791,31689
ZCTA5 60424,844,513,331,2256,42.2,2037,40,8,0.003546099,1236,1020
ZCTA5 60425,3073,693,2380,8680,44.8,2149,31,5970,0.687788018,1649,7031
ZCTA5 60426,8572,559,8013,23963,35.8,3954,387,15847,0.661311188,1532,22431
ZCTA5 60428,3492,50,3442,11316,33.2,1873,41,8408,0.743018735,100,11216
ZCTA5 60429,5228,804,4424,15018,34,1554,46,12751,0.849047809,1950,13068
ZCTA5 60430,7594,47,7547,20351,39.5,9187,255,9629,0.473146283,93,20258
ZCTA5 60431,8678,427,8251,26965,33.8,19231,395,3641,0.135026887,1052,25913
ZCTA5 60432,6278,886,5392,19927,32.7,8280,59,3751,0.188237065,2244,17683
ZCTA5 60433,5304,601,4703,16045,36.9,7437,49,4017,0.250358367,1529,14516
ZCTA5 60435,18683,179,18504,48131,36.9,29418,616,7399,0.153726289,499,47632
ZCTA5 60436,6356,559,5797,19013,33.8,9466,198,4795,0.252195866,1393,17620
ZCTA5 60437,34,14327,-14293,87,33.6,84,0,0,0,34806,-34719
ZCTA5 60438,11306,1594,9712,29390,40.5,11663,707,13136,0.446954747,3643,25747
ZCTA5 60439,8571,165,8406,24589,44.5,22789,557,265,0.010777177,367,24222
ZCTA5 60440,17175,643,16532,51310,37.7,23913,4526,10493,0.204502046,1650,49660
ZCTA5 60441,12122,385,11737,37688,37.9,30791,549,3401,0.090240925,804,36884
ZCTA5 60442,4336,294,4042,12758,35.7,11688,14,102,0.007994984,842,11916
ZCTA5 60443,8207,678,7529,21043,42.4,3469,514,15918,0.756451076,1569,19474
ZCTA5 60444,717,88,629,1943,37.3,1917,4,0,0,219,1724
ZCTA5 60445,5751,89,5662,14666,37.5,9883,302,1185,0.080799127,166,14500
ZCTA5 60446,12458,297,12161,41247,35.7,24625,2473,4514,0.109438262,632,40615
ZCTA5 60447,5138,62,5076,15544,34.4,13740,110,262,0.016855378,128,15416
ZCTA5 60448,8978,552,8426,25172,42.6,23761,321,325,0.012911171,1108,24064
ZCTA5 60449,3635,605,3030,9579,45.1,6110,120,2849,0.297421443,1608,7971
ZCTA5 60450,8456,1529,6927,20540,39.9,18597,202,64,0.003115871,3250,17290
ZCTA5 60451,12328,277,12051,36681,37.1,34497,293,163,0.004443717,644,36037
ZCTA5 60452,10163,51,10112,27247,41.4,20800,1730,1740,0.063860241,105,27142
ZCTA5 60453,22064,130,21934,58032,41.3,44559,1756,4392,0.075682382,295,57737
ZCTA5 60455,6061,43,6018,17332,36.8,13420,586,667,0.03848373,113,17219
ZCTA5 60456,1895,982,913,4324,39.9,3592,41,66,0.015263645,2361,1963
ZCTA5 60457,4984,418,4566,14034,36.9,12135,276,471,0.033561351,830,13204
ZCTA5 60458,5190,338,4852,15080,31.8,9104,610,3254,0.215782493,784,14296
ZCTA5 60459,9482,126,9356,29312,38.5,19649,882,813,0.027736081,358,28954
ZCTA5 60460,557,245,312,1318,41.1,1231,3,0,0,601,717
ZCTA5 60461,1908,27,1881,4988,45.9,842,92,3981,0.798115477,124,4864
ZCTA5 60462,16086,1488,14598,40950,43.4,34743,2133,1547,0.037777778,3275,37675
ZCTA5 60463,5159,66,5093,14039,49.5,12768,159,292,0.020799202,151,13888
ZCTA5 60464,3727,401,3326,9811,50.2,8275,450,199,0.020283355,1022,8789
ZCTA5 60465,7727,414,7313,18379,46.7,15909,465,1083,0.058925948,963,17416
ZCTA5 60466,8108,353,7755,21549,37.1,4756,88,14980,0.695159868,828,20721
ZCTA5 60467,9534,134,9400,25322,49.3,21901,1117,820,0.032382908,330,24992
ZCTA5 60468,2262,259,2003,5752,39.9,5494,5,36,0.006258693,598,5154
ZCTA5 60469,1642,435,1207,5732,30,3143,51,601,0.104849965,995,4737
ZCTA5 60470,162,314,-152,370,42.5,365,1,0,0,580,-210
ZCTA5 60471,5070,5794,-724,13255,41.6,898,56,11860,0.894756696,14065,-810
ZCTA5 60472,1475,397,1078,4863,32.6,494,22,4238,0.871478511,930,3933
ZCTA5 60473,7480,1523,5957,21939,41.1,2859,110,17633,0.80372852,3869,18070
ZCTA5 60474,308,230,78,702,42,693,0,0,0,558,144
ZCTA5 60475,4196,754,3442,10010,40.4,6987,72,1336,0.133466533,1761,8249
ZCTA5 60476,983,152,831,2299,43.9,1484,20,610,0.265332753,425,1874
ZCTA5 60477,15474,154,15320,37073,40.6,29349,1068,2748,0.074124026,400,36673
ZCTA5 60478,5729,258,5471,16758,40.8,1474,356,14686,0.876357561,650,16108
ZCTA5 60479,342,251,91,740,45.3,710,0,0,0,542,198
ZCTA5 60480,2141,8225,-6084,5341,48.1,4816,116,158,0.029582475,22051,-16710
ZCTA5 60481,4642,373,4269,11313,45.7,10570,48,67,0.00592239,976,10337
ZCTA5 60482,4543,196,4347,11157,41,9055,400,275,0.024648203,475,10682
ZCTA5 60484,2441,103,2338,6678,30.3,724,30,5611,0.840221623,215,6463
ZCTA5 60487,9099,4296,4803,26336,40.4,22863,1102,1098,0.041691981,11499,14837
ZCTA5 60490,6345,488,5857,22497,36.6,11480,5100,3252,0.144552607,1117,21380
ZCTA5 60491,7634,145,7489,22897,44.1,20663,471,172,0.007511901,361,22536
ZCTA5 60501,3635,417,3218,11772,34.6,6293,374,1015,0.086221543,1088,10684
ZCTA5 60502,8313,88,8225,23066,38.9,13922,5265,1930,0.083672939,264,22802
ZCTA5 60503,5501,1053,4448,16752,35.6,9184,3219,1878,0.112106017,2377,14375
ZCTA5 60504,13819,245,13574,39454,34.1,20706,7511,5274,0.133674659,754,38700
ZCTA5 60505,18434,64,18370,61702,33.2,27316,592,4457,0.072234287,125,61577
ZCTA5 60506,17374,257,17117,49801,35.5,29223,1373,6520,0.130921066,640,49161
ZCTA5 60510,10580,714,9866,28696,38.3,25348,438,643,0.022407304,1539,27157
ZCTA5 60511,666,96,570,1835,33.6,1764,7,0,0,180,1655
ZCTA5 60512,368,94,274,1089,47,597,0,492,0.451790634,312,777
ZCTA5 60513,7608,217,7391,19535,40.2,16124,243,728,0.037266445,564,18971
ZCTA5 60514,3756,274,3482,9722,41.1,8007,1301,31,0.003188644,680,9042
ZCTA5 60515,11854,93,11761,29144,43.7,25518,1550,802,0.027518529,257,28887
ZCTA5 60516,11822,65,11757,29163,42.7,25303,1419,1091,0.037410417,193,28970
ZCTA5 60517,12680,620,12060,33318,38.3,22078,4068,4048,0.121495888,1530,31788
ZCTA5 60518,1511,229,1282,3650,43.2,3187,17,88,0.024109589,559,3091
ZCTA5 60519,24,764,-740,40,67.2,40,0,0,0,1871,-1831
ZCTA5 60520,1146,425,721,2888,37.4,2690,39,16,0.005540166,1063,1825
ZCTA5 60521,6020,196,5824,18004,42.2,13572,2544,216,0.011997334,522,17482
ZCTA5 60523,4359,695,3664,10173,56.6,6643,2835,172,0.0169075,1598,8575
ZCTA5 60525,12230,529,11701,31681,44.3,26434,354,1141,0.036015277,1243,30438
ZCTA5 60526,5192,375,4817,13572,40.5,11611,309,683,0.050324197,851,12721
ZCTA5 60527,12056,512,11544,28589,49.3,21448,3458,1650,0.057714506,1310,27279
ZCTA5 60530,237,919,-682,791,40.8,702,0,20,0.02528445,2191,-1400
ZCTA5 60531,793,800,-7,2073,38.7,2020,0,0,0,2058,15
ZCTA5 60532,12698,291,12407,29144,37.9,21600,4394,1198,0.041106231,692,28452
ZCTA5 60534,3900,1123,2777,10647,37.9,7014,367,308,0.028928337,2995,7652
ZCTA5 60536,50,113,-63,122,31.2,121,0,0,0,250,-128
ZCTA5 60537,244,6841,-6597,653,40.6,641,0,9,0.013782542,17677,-17024
ZCTA5 60538,9528,4381,5147,29725,33.2,22605,296,1161,0.039058032,11273,18452
ZCTA5 60539,0,92,-92,212,34.6,163,0,36,0.169811321,194,18
ZCTA5 60540,15524,3048,12476,42911,41.1,33280,5856,1302,0.03034187,8925,33986
ZCTA5 60541,1115,390,725,3377,37.3,3221,4,70,0.020728457,1073,2304
ZCTA5 60542,7024,857,6167,18229,41.2,14288,693,1430,0.078446432,2170,16059
ZCTA5 60543,13874,1209,12665,39625,39.8,29579,1133,3140,0.079242902,3039,36586
ZCTA5 60544,10038,2245,7793,27606,40.2,20861,1039,2489,0.090161559,6472,21134
ZCTA5 60545,4720,1198,3522,13468,34.7,10597,133,444,0.032967033,3329,10139
ZCTA5 60546,6546,193,6353,16728,42.4,13368,279,714,0.042682927,613,16115
ZCTA5 60548,4430,977,3453,12149,38.6,11534,72,75,0.006173348,2292,9857
ZCTA5 60549,151,642,-491,594,34.4,473,0,0,0,1648,-1054
ZCTA5 60550,493,606,-113,1120,54,1056,2,13,0.011607143,1546,-426
ZCTA5 60551,1445,1154,291,5125,38.5,3911,0,1013,0.197658537,2880,2245
ZCTA5 60552,1547,1275,272,4286,38.8,4120,16,21,0.004899673,3023,1263
ZCTA5 60553,266,78,188,688,40.8,673,2,8,0.011627907,197,491
ZCTA5 60554,4398,1110,3288,12043,44.2,10119,562,721,0.059868803,2891,9152
ZCTA5 60555,5281,53,5228,13924,37.9,10783,770,790,0.05673657,117,13807
ZCTA5 60556,750,1703,-953,2297,36.5,2049,14,25,0.010883761,3910,-1613
ZCTA5 60557,84,45,39,260,57,260,0,0,0,115,145
ZCTA5 60558,4510,258,4252,13550,42.3,12817,154,148,0.010922509,747,12803
ZCTA5 60559,10091,242,9849,24706,39.9,17732,3382,1573,0.063668744,803,23903
ZCTA5 60560,8991,1788,7203,26499,35.3,21415,730,2379,0.089776973,4662,21837
ZCTA5 60561,9281,1406,7875,23444,44.8,17973,2974,780,0.033270773,3790,19654
ZCTA5 60563,15718,4197,11521,38704,36.3,25960,7689,2401,0.062034932,11954,26750
ZCTA5 60564,14950,7042,7908,46390,39,28428,12951,2274,0.049019185,17640,28750
ZCTA5 60565,13639,73,13566,39200,41.8,29262,6585,994,0.025357143,195,39005
ZCTA5 60585,7377,97,7280,24471,39,17133,3625,2066,0.084426464,260,24211
ZCTA5 60586,13980,18039,-4059,48227,32.5,36052,1578,5427,0.112530325,43442,4785
ZCTA5 60601,8787,1245,7542,14804,32.5,8683,3865,1034,0.069845988,3485,11319
ZCTA5 60602,581,257,324,1142,33.4,623,101,38,0.033274956,536,606
ZCTA5 60603,734,1079,-345,1275,33.7,756,397,71,0.055686275,2716,-1441
ZCTA5 60604,401,55,346,687,30.1,531,70,72,0.104803493,141,546
ZCTA5 60605,17467,181,17286,32077,34.1,20129,4942,4620,0.144028432,406,31671
ZCTA5 60606,2388,439,1949,3298,37.3,2045,1087,16,0.004851425,1215,2083
ZCTA5 60607,13169,566,12603,29990,30.1,16844,6724,3742,0.124774925,1467,28523
ZCTA5 60608,27804,264,27540,83689,33.4,31441,11599,14439,0.172531635,506,83183
ZCTA5 60609,22402,1658,20744,61861,34.9,21452,3938,14914,0.241088893,4632,57229
ZCTA5 60610,24654,427,24227,42422,32.8,30940,4019,5110,0.120456367,954,41468
ZCTA5 60611,22394,731,21663,34562,40.2,24162,7172,1077,0.031161391,1847,32715
ZCTA5 60612,13766,9070,4696,33908,33.9,9611,1578,18830,0.555326177,23716,10192
ZCTA5 60613,28334,498,27836,53282,33.3,41222,4651,3146,0.05904433,1319,51963
ZCTA5 60614,33922,556,33366,72119,30.9,59962,5165,2863,0.039698276,997,71122
ZCTA5 60615,21709,6555,15154,41767,35.3,12933,3524,22360,0.535350875,16790,24977
ZCTA5 60616,24622,12916,11706,53085,37.6,17968,19788,12502,0.235509089,31481,21604
ZCTA5 60617,30141,6204,23937,84193,36.6,22859,254,45084,0.535483948,15673,68520
ZCTA5 60618,36855,2435,34420,95078,35,62235,6151,2661,0.027987547,8558,86520
ZCTA5 60619,28030,4593,23437,63481,40.9,809,169,60318,0.950174068,11161,52320
ZCTA5 60620,25825,2473,23352,69357,39.3,1157,230,65720,0.947561169,5490,63867
ZCTA5 60621,10783,10402,381,26538,36.2,945,144,24709,0.931079961,25203,1335
ZCTA5 60622,24839,13281,11558,54650,32,41086,2794,3868,0.070777676,28477,26173
ZCTA5 60623,26225,9903,16322,77352,33.3,22889,288,22680,0.293205088,22926,54426
ZCTA5 60624,13204,2882,10322,36986,33.9,1859,137,32336,0.874276753,6078,30908
ZCTA5 60625,30888,40,30848,80028,35.3,46060,10277,3951,0.04937022,603,79425
ZCTA5 60626,23272,15340,7932,50295,35.3,26094,2753,12922,0.256924148,36618,13677
ZCTA5 60628,23198,13649,9549,64489,39.4,2467,87,59680,0.925429143,34964,29525
ZCTA5 60629,33175,4205,28970,107487,32.3,41928,736,19346,0.179984556,12327,95160
ZCTA5 60630,21358,68,21290,55591,40.7,36646,7239,1188,0.021370366,155,55436
ZCTA5 60631,12189,282,11907,30589,42.1,25605,1262,401,0.013109288,780,29809
ZCTA5 60632,26080,230,25850,87395,32.3,39558,6073,1249,0.014291435,607,86788
ZCTA5 60633,5127,793,4334,12674,37.9,6826,16,3311,0.261243491,1727,10947
ZCTA5 60634,27567,157,27410,77520,40.9,51440,4322,2372,0.030598555,483,77037
ZCTA5 60636,11391,537,10854,30412,40.7,1561,49,25321,0.832598974,1540,28872
ZCTA5 60637,21450,990,20460,49514,31.2,8031,2505,36606,0.739306055,2544,46970
ZCTA5 60638,20775,4031,16744,58959,38.4,38428,392,1665,0.028239963,9888,49071
ZCTA5 60639,26363,548,25815,89037,34.9,34865,1879,12769,0.143412289,1456,87581
ZCTA5 60640,36521,386,36135,67936,37.5,42298,7319,11640,0.17133773,991,66945
ZCTA5 60641,24917,212,24705,71003,37,40969,3530,1966,0.027688971,454,70549
ZCTA5 60642,10515,67,10448,21374,31.9,15076,1595,2067,0.096706279,226,21148
ZCTA5 60643,18075,798,17277,49796,43.2,11241,292,35640,0.715720138,1959,47837
ZCTA5 60644,17870,424,17446,47630,36.7,2670,332,40708,0.854671426,977,46653
ZCTA5 60645,16806,1074,15732,48585,36.2,24841,7328,7477,0.153895235,2721,45864
ZCTA5 60646,10946,292,10654,29326,41.5,23533,3267,213,0.007263179,597,28729
ZCTA5 60647,36880,645,36235,85564,32.6,58385,3658,5701,0.066628489,1729,83835
ZCTA5 60649,23349,195,23154,48973,37.4,1900,294,45585,0.930819023,593,48380
ZCTA5 60651,20564,1556,19008,64638,34.7,12721,233,35016,0.541724682,4354,60284
ZCTA5 60652,13479,1908,11571,43485,36.7,12092,455,18446,0.42419225,4833,38652
ZCTA5 60653,16925,641,16284,34519,36.6,2445,454,29777,0.86262638,1596,32923
ZCTA5 60654,14294,627,13667,21859,32.7,16071,2671,913,0.041767693,1573,20286
ZCTA5 60655,10730,511,10219,28751,40.5,24847,414,1589,0.055267643,1478,27273
ZCTA5 60656,12471,100,12371,28665,40.2,22047,3241,1085,0.037851038,229,28436
ZCTA5 60657,38263,717,37546,72113,31.2,59259,4833,2683,0.037205497,1942,70171
ZCTA5 60659,13838,1640,12198,43729,36.1,21319,11689,3786,0.086578701,4381,39348
ZCTA5 60660,21179,627,20552,44972,35.5,26248,6163,6438,0.143155741,1562,43410
ZCTA5 60661,6850,1003,5847,11073,32,6913,3177,283,0.025557663,2624,8449
ZCTA5 60706,9408,285,9123,24272,43.6,20296,1633,319,0.013142716,620,23652
ZCTA5 60707,15551,28,15523,41309,40.2,25945,1518,2860,0.069234307,55,41254
ZCTA5 60712,4766,45,4721,13358,46,8968,3406,188,0.014073963,81,13277
ZCTA5 60714,11744,1628,10116,31208,46.9,22117,5535,783,0.025089721,4246,26962
ZCTA5 60803,8925,1228,7697,22329,38.6,14292,404,4635,0.20757759,3033,19296
ZCTA5 60804,23915,539,23376,84905,32.9,24184,485,2728,0.032130028,1320,83585
ZCTA5 60805,7495,1777,5718,19884,40.2,12577,423,5010,0.251961376,4700,15184
ZCTA5 60827,9589,943,8646,26010,30.9,1196,3,23396,0.899500192,2428,23582
ZCTA5 60901,13338,582,12756,34453,37.5,20748,210,10226,0.296810147,1493,32960
ZCTA5 60910,225,1113,-888,534,45.8,490,1,8,0.014981273,2640,-2106
ZCTA5 60911,494,18180,-17686,1250,39.8,1214,0,0,0,53282,-52032
ZCTA5 60912,233,5337,-5104,539,42.1,508,1,15,0.027829314,14512,-13973
ZCTA5 60913,712,197,515,1596,58.2,1476,0,5,0.003132832,507,1089
ZCTA5 60914,9493,419,9074,28842,34.2,23705,608,2878,0.099785036,1115,27727
ZCTA5 60915,3943,365,3578,10084,36.6,8626,19,594,0.058905196,1109,8975
ZCTA5 60917,181,136,45,464,42.3,438,0,0,0,300,164
ZCTA5 60918,279,228,51,603,55.1,585,0,6,0.009950249,596,7
ZCTA5 60919,227,351,-124,528,41,518,0,0,0,991,-463
ZCTA5 60920,81,138,-57,185,55.7,178,0,0,0,433,-248
ZCTA5 60921,685,587,98,1586,43.6,1444,0,0,0,1834,-248
ZCTA5 60922,1008,304,704,2616,38,2402,4,45,0.017201835,706,1910
ZCTA5 60924,661,312,349,1512,43.7,1425,0,2,0.001322751,869,643
ZCTA5 60926,41,11465,-11424,81,57.2,77,0,0,0,31751,-31670
ZCTA5 60927,938,8209,-7271,2255,42.7,2200,10,0,0,18320,-16065
ZCTA5 60928,228,113,115,518,46,510,0,0,0,246,272
ZCTA5 60929,276,282,-6,663,38.2,603,0,0,0,866,-203
ZCTA5 60930,295,151,144,749,50.9,713,3,10,0.013351135,366,383
ZCTA5 60931,228,757,-529,702,38.3,641,0,0,0,2080,-1378
ZCTA5 60932,127,469,-342,379,15.1,379,0,0,0,1134,-755
ZCTA5 60933,131,145,-14,284,47.7,276,0,0,0,329,-45
ZCTA5 60934,94,182,-88,225,42.9,199,0,0,0,475,-250
ZCTA5 60935,426,966,-540,1312,33.2,1242,5,11,0.008384146,2742,-1430
ZCTA5 60936,1943,573,1370,4243,44.4,3845,32,62,0.014612303,1586,2657
ZCTA5 60938,726,13470,-12744,1816,41.9,1459,5,26,0.014317181,36026,-34210
ZCTA5 60939,0,12839,-12839,0,-,0,0,0,#DIV/0!,29893,-29893
ZCTA5 60940,1100,9047,-7947,3098,38.4,2914,0,2,0.000645578,22834,-19736
ZCTA5 60941,650,211,439,1695,41.4,1586,6,7,0.004129794,698,997
ZCTA5 60942,2298,49,2249,5797,39.3,5246,150,112,0.019320338,120,5677
ZCTA5 60945,94,15096,-15002,252,38.6,185,0,14,0.055555556,37593,-37341
ZCTA5 60946,192,938,-746,446,37,439,0,5,0.011210762,2134,-1688
ZCTA5 60948,644,2529,-1885,1591,47.5,1528,1,32,0.020113136,7571,-5980
ZCTA5 60949,201,232,-31,500,38,474,0,5,0.01,640,-140
ZCTA5 60950,4849,239,4610,12006,43.7,11424,7,263,0.021905714,531,11475
ZCTA5 60951,328,550,-222,854,34.7,808,3,0,0,1444,-590
ZCTA5 60952,226,1255,-1029,632,27.9,595,0,0,0,3233,-2601
ZCTA5 60953,937,884,53,2560,38.6,2497,0,6,0.00234375,2355,205
ZCTA5 60954,2233,333,1900,5623,43.6,4556,14,190,0.033789792,908,4715
ZCTA5 60955,580,155,425,1820,37,1149,1,53,0.029120879,475,1345
ZCTA5 60956,50,1989,-1939,117,50.5,107,2,0,0,5164,-5047
ZCTA5 60957,2204,438,1766,5720,41.6,5219,53,33,0.005769231,1246,4474
ZCTA5 60958,646,62,584,1410,51.5,341,0,971,0.688652482,227,1183
ZCTA5 60959,447,682,-235,915,54.6,840,0,13,0.01420765,1719,-804
ZCTA5 60960,317,217,100,908,33.3,885,0,0,0,579,329
ZCTA5 60961,297,158,139,748,49.5,717,15,0,0,335,413
ZCTA5 60962,221,104,117,637,30.8,593,0,3,0.004709576,235,402
ZCTA5 60963,491,4831,-4340,1345,39.9,1302,15,0,0,12810,-11465
ZCTA5 60964,1879,679,1200,4749,44.8,3731,21,563,0.118551274,1700,3049
ZCTA5 60966,649,55,594,1464,46.6,1396,0,17,0.011612022,194,1270
ZCTA5 60967,26,2851,-2825,55,-,55,0,0,0,7219,-7164
ZCTA5 60968,198,43,155,520,38,480,1,12,0.023076923,90,430
ZCTA5 60969,24,1167,-1143,71,24.5,61,0,0,0,3139,-3068
ZCTA5 60970,2870,447,2423,6370,51.3,6035,53,34,0.00533752,1225,5145
ZCTA5 60973,107,208,-101,330,29.1,309,0,0,0,445,-115
ZCTA5 60974,106,339,-233,286,41,263,0,5,0.017482517,692,-406
ZCTA5 61001,544,715,-171,1251,52.9,1224,4,3,0.002398082,1796,-545
ZCTA5 61006,611,611,0,1377,51,1282,9,20,0.014524328,1636,-259
ZCTA5 61007,142,5604,-5462,373,41,373,0,0,0,14184,-13811
ZCTA5 61008,12529,562,11967,34420,40.5,27942,372,580,0.016850668,1497,32923
ZCTA5 61010,2849,116,2733,7496,38.3,6728,113,31,0.004135539,252,7244
ZCTA5 61011,919,365,554,2597,49.7,2167,198,143,0.055063535,977,1620
ZCTA5 61012,850,2290,-1440,2680,32.6,2388,0,3,0.001119403,6196,-3516
ZCTA5 61013,291,2838,-2547,664,46.4,657,0,0,0,6816,-6152
ZCTA5 61014,494,268,226,1140,50.1,1091,25,0,0,741,399
ZCTA5 61015,328,296,32,1015,38.6,1014,0,0,0,842,173
ZCTA5 61016,2087,698,1389,4836,48,4293,137,131,0.027088503,1948,2888
ZCTA5 61018,416,585,-169,1076,43.5,1066,0,0,0,1348,-272
ZCTA5 61019,1275,1762,-487,3318,46.9,3306,9,0,0,4546,-1228
ZCTA5 61020,964,288,676,3167,30.7,3005,7,4,0.001263025,650,2517
ZCTA5 61021,8907,1987,6920,22680,43.1,19510,192,1734,0.076455026,4415,18265
ZCTA5 61024,990,387,603,2471,44.2,2411,13,14,0.005665722,1130,1341
ZCTA5 61025,1946,1523,423,4316,51.3,4109,26,42,0.009731233,4383,-67
ZCTA5 61027,48,1688,-1640,121,26.8,65,0,56,0.462809917,5424,-5303
ZCTA5 61028,865,544,321,1780,48.2,1748,3,10,0.005617978,1326,454
ZCTA5 61030,824,650,174,2328,35.9,2104,42,28,0.012027491,1516,812
ZCTA5 61031,639,762,-123,1737,41.7,1554,4,2,0.00115141,1831,-94
ZCTA5 61032,13052,261,12791,29231,45.6,22591,314,4041,0.138243645,680,28551
ZCTA5 61036,3377,324,3053,6978,56.8,6847,61,17,0.002436228,974,6004
ZCTA5 61037,55,9448,-9393,107,69.6,107,0,0,0,25959,-25852
ZCTA5 61038,417,1010,-593,1310,45.1,1310,0,0,0,2402,-1092
ZCTA5 61039,304,312,-8,834,36.2,830,3,0,0,853,-19
ZCTA5 61041,609,337,272,1437,37.7,1332,0,19,0.01322199,1018,419
ZCTA5 61042,192,320,-128,501,46.1,468,0,0,0,648,-147
ZCTA5 61043,50,191,-141,156,43.3,156,0,0,0,587,-431
ZCTA5 61044,76,405,-329,136,58.1,136,0,0,0,1137,-1001
ZCTA5 61046,1093,216,877,2652,50,2545,19,32,0.012066365,465,2187
ZCTA5 61047,664,492,172,1712,46.1,1685,3,8,0.004672897,1141,571
ZCTA5 61048,1678,43,1635,3952,47.9,3858,9,61,0.015435223,120,3832
ZCTA5 61049,216,798,-582,682,46.1,532,1,0,0,1845,-1163
ZCTA5 61050,102,9486,-9384,278,51.9,278,0,0,0,21873,-21595
ZCTA5 61051,605,97,508,1436,42.3,1376,0,5,0.003481894,222,1214
ZCTA5 61052,388,33,355,916,47.2,828,0,0,0,49,867
ZCTA5 61053,1132,485,647,2802,46,2675,28,25,0.008922198,1227,1575
ZCTA5 61054,1830,585,1245,3581,50.1,3496,0,42,0.011728567,1346,2235
ZCTA5 61057,26,5464,-5438,109,35,95,0,2,0.018348624,12734,-12625
ZCTA5 61059,80,96,-16,205,42.3,192,0,0,0,194,11
ZCTA5 61060,577,3033,-2456,1397,42.8,1387,1,0,0,8022,-6625
ZCTA5 61061,2986,2521,465,6930,52.1,6724,19,31,0.004473304,6287,643
ZCTA5 61062,718,62,656,2063,38.6,1931,0,43,0.020843432,154,1909
ZCTA5 61063,1633,1219,414,4151,41.6,3898,0,23,0.005540834,2717,1434
ZCTA5 61064,1793,837,956,4263,43.3,3986,22,102,0.023926812,2009,2254
ZCTA5 61065,3477,611,2866,10406,35.2,9087,58,833,0.080049971,1599,8807
ZCTA5 61067,359,13466,-13107,695,60.2,695,0,0,0,32292,-31597
ZCTA5 61068,5960,224,5736,14609,40.3,12436,28,269,0.018413307,581,14028
ZCTA5 61070,524,807,-283,1536,48.3,1495,6,0,0,1934,-398
ZCTA5 61071,5803,4523,1280,13840,41.3,12655,48,97,0.007008671,11113,2727
ZCTA5 61072,4184,134,4050,10825,43.8,10379,130,83,0.007667436,315,10510
ZCTA5 61073,7140,2504,4636,20685,38.4,18324,516,800,0.038675369,6758,13927
ZCTA5 61074,1966,241,1725,4304,50.3,3769,39,30,0.00697026,550,3754
ZCTA5 61075,421,1666,-1245,995,52.1,965,0,8,0.008040201,4015,-3020
ZCTA5 61077,0,156,-156,0,-,0,0,0,#DIV/0!,319,-319
ZCTA5 61078,484,1712,-1228,1364,39.4,1319,8,5,0.003665689,3687,-2323
ZCTA5 61079,80,383,-303,209,42.8,209,0,0,0,802,-593
ZCTA5 61080,4298,1563,2735,10668,34.2,9474,92,256,0.023997,4390,6278
ZCTA5 61081,8786,192,8594,21414,43.7,18592,244,427,0.019940226,477,20937
ZCTA5 61084,1106,304,802,3061,45.7,2893,2,86,0.028095394,726,2335
ZCTA5 61085,1374,398,976,3146,45.5,2981,15,45,0.014303878,944,2202
ZCTA5 61087,637,27,610,1544,48,1454,2,1,0.000647668,50,1494
ZCTA5 61088,2514,4069,-1555,6416,45.5,6193,18,61,0.009507481,9703,-3287
ZCTA5 61089,293,11895,-11602,661,43.1,651,1,3,0.004538578,33356,-32695
ZCTA5 61091,10,245,-235,19,-,19,0,0,0,513,-494
ZCTA5 61101,7719,341,7378,20394,35.7,10492,125,7789,0.381926057,1275,19119
ZCTA5 61102,6199,46,6153,16861,34.1,8176,144,5746,0.34078643,145,16716
ZCTA5 61103,10002,392,9610,23446,41.2,15044,200,5207,0.222084791,876,22570
ZCTA5 61104,8061,272,7789,19106,34.1,11045,599,4351,0.227729509,771,18335
ZCTA5 61107,12975,2000,10975,29363,43.4,22768,1447,3032,0.103259204,4905,24458
ZCTA5 61108,11956,5334,6622,29582,41.4,21023,1651,3454,0.116760192,14228,15354
ZCTA5 61109,10802,6697,4105,26834,36,19133,1234,3186,0.118729969,16232,10602
ZCTA5 61111,9744,278,9466,22903,38.5,18793,721,1314,0.057372397,668,22235
ZCTA5 61112,71,833,-762,111,85,95,0,8,0.072072072,1951,-1840
ZCTA5 61114,6474,17543,-11069,14999,47.9,11809,581,1631,0.108740583,43303,-28304
ZCTA5 61115,8518,978,7540,22480,39.1,19980,355,763,0.033941281,2376,20104
ZCTA5 61201,15443,238,15205,38025,35.5,25703,1718,7107,0.186903353,584,37441
ZCTA5 61230,379,231,148,890,37.9,849,0,10,0.011235955,577,313
ZCTA5 61231,2114,698,1416,5096,45.4,4895,32,69,0.013540031,1782,3314
ZCTA5 61232,621,660,-39,1431,46.5,1338,6,17,0.011879804,1552,-121
ZCTA5 61233,107,2610,-2503,244,46.7,244,0,0,0,10178,-9934
ZCTA5 61234,507,114,393,1172,41.5,1104,11,14,0.011945392,279,893
ZCTA5 61235,706,266,440,1661,41.8,1631,0,0,0,604,1057
ZCTA5 61236,31,5068,-5037,82,37.3,80,0,0,0,13238,-13156
ZCTA5 61237,0,258,-258,0,-,0,0,0,#DIV/0!,590,-590
ZCTA5 61238,1066,271,795,2825,41.2,2714,0,47,0.016637168,585,2240
ZCTA5 61239,522,4034,-3512,1154,39.6,985,0,85,0.073656846,8819,-7665
ZCTA5 61240,2464,339,2125,5977,48.5,5862,29,42,0.007026937,747,5230
ZCTA5 61241,2812,249,2563,6801,43.3,6138,11,53,0.007792972,669,6132
ZCTA5 61242,527,2306,-1779,1217,48.9,1164,13,20,0.016433854,5102,-3885
ZCTA5 61243,139,798,-659,299,58,295,0,0,0,2267,-1968
ZCTA5 61244,9173,3163,6010,23628,39.6,16378,531,3953,0.167301507,7806,15822
ZCTA5 61250,1161,403,758,2707,42.5,2666,5,0,0,1125,1582
ZCTA5 61251,179,23,156,438,42.1,424,0,0,0,69,369
ZCTA5 61252,2472,941,1531,5357,46.7,5192,15,31,0.005786821,2500,2857
ZCTA5 61254,4965,1449,3516,12018,45.1,11420,119,5,0.000416043,3263,8755
ZCTA5 61256,834,10,824,1911,38.1,1780,0,41,0.021454736,10,1901
ZCTA5 61257,331,412,-81,919,44.1,873,0,0,0,1213,-294
ZCTA5 61258,79,1582,-1503,221,42.6,217,0,0,0,3621,-3400
ZCTA5 61259,541,48,493,1375,50.8,1375,0,0,0,97,1278
ZCTA5 61260,307,104,203,704,43.2,676,0,0,0,180,524
ZCTA5 61261,347,42,305,740,51.5,708,1,5,0.006756757,99,641
ZCTA5 61262,295,139,156,759,47.7,749,0,0,0,489,270
ZCTA5 61263,313,1070,-757,891,34.6,842,0,9,0.01010101,2731,-1840
ZCTA5 61264,4655,115,4540,10127,46.9,9225,122,175,0.017280537,313,9814
ZCTA5 61265,18784,1271,17513,44150,39.7,34143,1042,3793,0.085911665,3098,41052
ZCTA5 61270,2733,120,2613,6991,42.8,6769,23,34,0.004863396,365,6626
ZCTA5 61272,486,642,-156,1299,39.8,1276,6,0,0,1620,-321
ZCTA5 61273,1154,80,1074,3170,38.2,3054,26,22,0.006940063,216,2954
ZCTA5 61274,99,599,-500,233,53.4,233,0,0,0,1477,-1244
ZCTA5 61275,1724,884,840,4330,46.4,3824,0,73,0.016859122,2247,2083
ZCTA5 61276,22,3118,-3096,72,26.4,72,0,0,0,7031,-6959
ZCTA5 61277,1164,192,972,3108,45.8,3057,3,17,0.005469755,405,2703
ZCTA5 61278,273,365,-92,662,46.5,601,18,1,0.001510574,961,-299
ZCTA5 61279,422,155,267,1034,41.9,1013,3,1,0.000967118,336,698
ZCTA5 61281,965,1140,-175,2395,50.8,2291,0,0,0,3053,-658
ZCTA5 61282,3978,134,3844,8263,43.2,6854,241,509,0.061599903,382,7881
ZCTA5 61283,498,471,27,1671,35.8,1658,0,12,0.007181329,952,719
ZCTA5 61284,881,4812,-3931,1800,63.1,1739,0,48,0.026666667,11183,-9383
ZCTA5 61285,693,1048,-355,2338,43.9,1923,0,371,0.158682635,2620,-282
ZCTA5 61301,4394,62,4332,10295,40.4,8343,151,173,0.016804274,122,10173
ZCTA5 61310,1536,2620,-1084,3569,48.7,3396,31,26,0.007284954,7205,-3636
ZCTA5 61311,138,2832,-2694,381,43.7,381,0,0,0,8327,-7946
ZCTA5 61312,174,3106,-2932,412,47.7,381,0,0,0,8627,-8215
ZCTA5 61313,109,3560,-3451,229,46.3,229,0,0,0,8819,-8590
ZCTA5 61314,352,5468,-5116,839,48.2,787,23,0,0,16734,-15895
ZCTA5 61315,87,3490,-3403,242,39.8,211,0,0,0,8693,-8451
ZCTA5 61316,106,7089,-6983,252,35.7,252,0,0,0,16899,-16647
ZCTA5 61317,218,398,-180,475,54.5,462,7,0,0,1053,-578
ZCTA5 61318,273,670,-397,752,37.1,712,2,0,0,1919,-1167
ZCTA5 61319,515,917,-402,1153,51.3,1110,0,0,0,2642,-1489
ZCTA5 61320,251,309,-58,639,40.9,582,0,1,0.001564945,762,-123
ZCTA5 61321,104,574,-470,340,31.3,311,0,0,0,1678,-1338
ZCTA5 61322,507,392,115,1461,38.3,1002,20,26,0.01779603,893,568
ZCTA5 61323,57,8026,-7969,122,56.5,115,0,0,0,20695,-20573
ZCTA5 61324,42,11007,-10965,80,67.6,80,0,0,0,27571,-27491
ZCTA5 61325,415,7402,-6987,1127,38.4,1052,2,5,0.004436557,17786,-16659
ZCTA5 61326,822,1410,-588,2097,43.8,1990,0,0,0,5586,-3489
ZCTA5 61327,549,12057,-11508,1496,42.9,1408,17,12,0.00802139,29221,-27725
ZCTA5 61328,45,2365,-2320,134,19,134,0,0,0,6315,-6181
ZCTA5 61329,513,2917,-2404,1285,40.2,1198,0,0,0,7352,-6067
ZCTA5 61330,465,2829,-2364,1209,46.8,1154,10,9,0.007444169,7114,-5905
ZCTA5 61331,0,2588,-2588,0,-,0,0,0,#DIV/0!,9842,-9842
ZCTA5 61332,68,14031,-13963,143,45.3,138,0,0,0,33038,-32895
ZCTA5 61333,115,4851,-4736,352,37.3,337,0,0,0,12670,-12318
ZCTA5 61334,264,1111,-847,655,39.9,624,0,0,0,2787,-2132
ZCTA5 61335,128,349,-221,374,42.9,355,0,0,0,788,-414
ZCTA5 61336,197,1940,-1743,408,50.2,398,0,0,0,4722,-4314
ZCTA5 61337,188,753,-565,544,33.5,519,0,0,0,2183,-1639
ZCTA5 61338,115,461,-346,219,49.8,218,0,0,0,1381,-1162
ZCTA5 61340,213,514,-301,476,44.6,476,0,0,0,1539,-1063
ZCTA5 61341,2952,2308,644,7507,42.9,7169,131,12,0.001598508,5870,1637
ZCTA5 61342,3412,452,2960,8564,41,7304,103,28,0.0032695,1161,7403
ZCTA5 61344,124,658,-534,269,44.1,264,0,5,0.018587361,1681,-1412
ZCTA5 61345,300,3669,-3369,710,49.7,679,3,3,0.004225352,10428,-9718
ZCTA5 61346,35,121,-86,62,61,62,0,0,0,322,-260
ZCTA5 61348,1917,6084,-4167,4456,41.7,4065,12,5,0.001122083,15318,-10862
ZCTA5 61349,416,210,206,986,43.4,942,3,11,0.011156187,584,402
ZCTA5 61350,10016,383,9633,24444,41.4,22190,262,967,0.03955981,790,23654
ZCTA5 61353,462,2082,-1620,1229,34.5,1224,0,1,0.00081367,5636,-4407
ZCTA5 61354,4577,337,4240,10407,48.4,9726,104,121,0.01162679,843,9564
ZCTA5 61356,4753,1352,3401,10896,47.8,10156,166,4,0.000367107,3430,7466
ZCTA5 61358,144,3441,-3297,298,49.6,272,0,0,0,9160,-8862
ZCTA5 61359,185,2758,-2573,400,47.1,305,19,0,0,7167,-6767
ZCTA5 61360,1321,78,1243,3466,40.8,3203,0,37,0.01067513,184,3282
ZCTA5 61361,498,687,-189,1390,39.6,1340,0,9,0.00647482,1744,-354
ZCTA5 61362,2484,2067,417,5933,42.5,4987,3,108,0.01820327,5268,665
ZCTA5 61363,135,1276,-1141,279,45.1,267,2,0,0,3508,-3229
ZCTA5 61364,8275,1567,6708,18152,42.5,16067,227,516,0.02842662,4252,13900
ZCTA5 61367,351,85,266,873,31,831,0,8,0.009163803,238,635
ZCTA5 61368,545,343,202,1294,42.6,1218,40,4,0.00309119,833,461
ZCTA5 61369,618,11472,-10854,1320,52.6,1177,0,6,0.004545455,31441,-30121
ZCTA5 61370,504,954,-450,1189,42.3,1113,6,5,0.004205214,2072,-883
ZCTA5 61371,42,561,-519,82,28,82,0,0,0,1343,-1261
ZCTA5 61372,77,94,-17,190,36.9,190,0,0,0,413,-223
ZCTA5 61373,759,2567,-1808,2079,44.8,1996,8,0,0,8337,-6258
ZCTA5 61374,33,1293,-1260,101,38.7,101,0,0,0,3712,-3611
ZCTA5 61375,465,423,42,1127,55.1,1079,0,0,0,1174,-47
ZCTA5 61376,813,2612,-1799,1768,47,1746,0,5,0.002828054,7329,-5561
ZCTA5 61377,663,20,643,1525,40,1443,0,4,0.002622951,61,1464
ZCTA5 61378,124,167,-43,308,38.3,302,1,0,0,491,-183
ZCTA5 61379,512,787,-275,1247,41.1,1201,4,2,0.001603849,2058,-811
ZCTA5 61401,13569,209,13360,30968,41.9,25375,492,2909,0.093935676,489,30479
ZCTA5 61402,0,185,-185,1931,39.3,553,0,1260,0.652511652,562,1369
ZCTA5 61410,1586,1627,-41,3898,38.8,3782,0,63,0.016162134,4434,-536
ZCTA5 61411,198,2674,-2476,327,54.2,308,0,18,0.055045872,6197,-5870
ZCTA5 61412,514,1126,-612,1215,45.2,1173,0,0,0,2888,-1673
ZCTA5 61413,415,134,281,1034,41.1,897,0,2,0.001934236,351,683
ZCTA5 61414,285,284,1,758,43.7,724,0,31,0.040897098,786,-28
ZCTA5 61415,801,1968,-1167,1789,46.9,1776,0,6,0.003353829,4902,-3113
ZCTA5 61416,131,4839,-4708,281,40,280,0,1,0.003558719,14576,-14295
ZCTA5 61417,115,621,-506,277,50.1,270,7,0,0,1788,-1511
ZCTA5 61418,282,129,153,660,47.2,634,0,0,0,207,453
ZCTA5 61419,51,6043,-5992,84,64,84,0,0,0,15810,-15726
ZCTA5 61420,406,13733,-13327,995,41.6,908,19,0,0,33552,-32557
ZCTA5 61421,575,7209,-6634,1533,40.9,1500,0,12,0.007827789,18275,-16742
ZCTA5 61422,1226,415,811,3035,42.6,2942,0,0,0,964,2071
ZCTA5 61423,296,876,-580,660,42.1,655,0,0,0,2155,-1495
ZCTA5 61424,17,208,-191,59,22.8,59,0,0,0,468,-409
ZCTA5 61425,173,180,-7,399,62.5,392,0,0,0,449,-50
ZCTA5 61426,17,282,-265,74,29.4,74,0,0,0,747,-673
ZCTA5 61427,797,128,669,1920,47.4,1854,0,18,0.009375,250,1670
ZCTA5 61428,418,878,-460,1104,48.1,1046,0,36,0.032608696,2298,-1194
ZCTA5 61430,291,1705,-1414,595,54.2,572,2,0,0,3902,-3307
ZCTA5 61431,124,77,47,262,55,262,0,0,0,143,119
ZCTA5 61432,267,471,-204,646,45.9,638,0,0,0,1215,-569
ZCTA5 61433,17,117,-100,47,48.2,47,0,0,0,320,-273
ZCTA5 61434,1206,983,223,2816,43,2701,29,4,0.001420455,2207,609
ZCTA5 61435,67,789,-722,193,25.9,193,0,0,0,1834,-1641
ZCTA5 61436,353,55,298,818,53.7,772,0,0,0,122,696
ZCTA5 61437,267,39,228,633,50.8,631,0,0,0,103,530
ZCTA5 61438,282,534,-252,726,40,716,0,2,0.002754821,1407,-681
ZCTA5 61439,97,350,-253,246,35,205,0,12,0.048780488,878,-632
ZCTA5 61440,303,678,-375,718,34.6,706,1,0,0,1625,-907
ZCTA5 61441,363,1395,-1032,870,44.4,838,0,0,0,3523,-2653
ZCTA5 61442,312,270,42,741,48.1,733,0,0,0,593,148
ZCTA5 61443,5603,43,5560,13760,42.7,11651,53,911,0.066206395,139,13621
ZCTA5 61447,481,176,305,1112,42.4,1098,0,0,0,397,715
ZCTA5 61448,1530,98,1432,4006,42.5,3901,11,11,0.002745881,176,3830
ZCTA5 61449,127,894,-767,189,60.6,184,0,0,0,2609,-2420
ZCTA5 61450,764,74,690,1743,46.9,1690,0,0,0,190,1553
ZCTA5 61451,69,214,-145,196,50.1,196,0,0,0,525,-329
ZCTA5 61452,88,705,-617,178,41,176,0,0,0,1967,-1789
ZCTA5 61453,240,115,125,586,33.9,502,0,59,0.100682594,425,161
ZCTA5 61454,186,1482,-1296,427,48.4,414,0,0,0,5444,-5017
ZCTA5 61455,7069,691,6378,17979,29,15117,675,1425,0.079259136,1563,16416
ZCTA5 61458,230,341,-111,515,57,504,0,0,0,838,-323
ZCTA5 61459,119,274,-155,320,47.8,316,0,0,0,629,-309
ZCTA5 61460,101,72,29,259,52.2,256,0,0,0,199,60
ZCTA5 61462,4352,315,4037,11035,37.7,9068,225,580,0.052560036,770,10265
ZCTA5 61465,535,31,504,1201,49.5,1129,8,0,0,162,1039
ZCTA5 61466,102,644,-542,282,40.3,282,0,0,0,1757,-1475
ZCTA5 61467,469,257,212,1320,36.2,1312,4,2,0.001515152,631,689
ZCTA5 61468,88,193,-105,193,34.4,142,0,0,0,409,-216
ZCTA5 61469,936,2410,-1474,2186,55,2078,0,7,0.003202196,6088,-3902
ZCTA5 61470,204,311,-107,552,45.6,486,10,7,0.012681159,880,-328
ZCTA5 61471,44,704,-660,133,36.2,131,0,0,0,1817,-1684
ZCTA5 61472,219,494,-275,428,59,392,1,6,0.014018692,1224,-796
ZCTA5 61473,520,163,357,1176,44.3,1072,20,14,0.011904762,387,789
ZCTA5 61474,114,122,-8,259,36.1,258,0,0,0,333,-74
ZCTA5 61475,90,129,-39,177,55.5,177,0,0,0,342,-165
ZCTA5 61476,201,221,-20,515,37.7,485,6,0,0,607,-92
ZCTA5 61477,201,459,-258,591,44.4,515,0,0,0,1095,-504
ZCTA5 61478,89,402,-313,303,24.3,303,0,0,0,862,-559
ZCTA5 61479,23,923,-900,53,76,53,0,0,0,2063,-2010
ZCTA5 61480,456,155,301,1281,37.8,1234,0,2,0.00156128,352,929
ZCTA5 61482,227,7966,-7739,542,36.7,525,1,2,0.003690037,18534,-17992
ZCTA5 61483,807,324,483,1950,48.6,1835,19,21,0.010769231,997,953
ZCTA5 61484,343,1679,-1336,704,54.1,695,6,2,0.002840909,4484,-3780
ZCTA5 61485,183,119,64,436,48.7,427,0,0,0,270,166
ZCTA5 61486,592,670,-78,1536,37.9,1397,0,0,0,1744,-208
ZCTA5 61488,534,1135,-601,1229,42,1175,3,13,0.010577705,2187,-958
ZCTA5 61489,329,809,-480,826,38.5,749,0,68,0.082324455,2134,-1308
ZCTA5 61490,496,156,340,1125,44,1099,0,17,0.015111111,390,735
ZCTA5 61491,938,1857,-919,2110,46.5,2042,31,18,0.008530806,4786,-2676
ZCTA5 61501,759,345,414,1641,38.4,1619,0,0,0,986,655
ZCTA5 61516,267,404,-137,713,34.1,703,0,10,0.014025245,1112,-399
ZCTA5 61517,1099,331,768,2995,43.9,2912,0,24,0.008013356,866,2129
ZCTA5 61519,93,694,-601,259,37.6,239,0,0,0,1915,-1656
ZCTA5 61520,6522,265,6257,16576,44.1,14680,17,1045,0.063042954,621,15955
ZCTA5 61523,4454,487,3967,10541,42.6,10022,34,51,0.004838251,1081,9460
ZCTA5 61524,147,742,-595,340,55,338,0,1,0.002941176,1739,-1399
ZCTA5 61525,3891,1370,2521,11542,34.9,7619,2812,471,0.040807486,3366,8176
ZCTA5 61526,339,394,-55,841,54.4,779,11,0,0,1025,-184
ZCTA5 61528,1094,290,804,3256,41.2,3088,167,1,0.000307125,541,2715
ZCTA5 61529,1134,369,765,3179,37.4,3098,41,0,0,1048,2131
ZCTA5 61530,2655,95,2560,6706,38.7,6184,15,118,0.017596183,192,6514
ZCTA5 61531,1321,203,1118,3100,37.2,3014,0,18,0.005806452,489,2611
ZCTA5 61532,204,148,56,485,32.8,469,0,0,0,435,50
ZCTA5 61533,821,3313,-2492,2299,35.5,2272,0,0,0,7073,-4774
ZCTA5 61534,684,544,140,1930,39.6,1927,2,0,0,1407,523
ZCTA5 61535,653,2979,-2326,2082,40.4,1930,78,0,0,7370,-5288
ZCTA5 61536,1324,972,352,3192,52.1,2924,74,100,0.031328321,2259,933
ZCTA5 61537,1189,632,557,2751,44.9,2666,10,0,0,1852,899
ZCTA5 61539,79,161,-82,165,45.3,156,0,0,0,438,-273
ZCTA5 61540,1028,321,707,2898,44.8,2775,19,72,0.02484472,1011,1887
ZCTA5 61541,53,168,-115,95,49.1,95,0,0,0,389,-294
ZCTA5 61542,1425,1261,164,3409,44.5,3320,25,6,0.001760047,3176,233
ZCTA5 61543,60,2380,-2320,114,46.5,114,0,0,0,5821,-5707
ZCTA5 61544,284,1121,-837,828,34.9,828,0,0,0,2959,-2131
ZCTA5 61545,313,5097,-4784,734,35.2,734,0,0,0,12152,-11418
ZCTA5 61546,1604,912,692,3720,47.1,3646,3,15,0.004032258,2432,1288
ZCTA5 61547,1427,211,1216,3898,42.5,3779,0,8,0.002052335,555,3343
ZCTA5 61548,4538,4572,-34,12227,41.6,11875,125,65,0.005316104,11488,739
ZCTA5 61550,7476,897,6579,18223,43,17361,255,210,0.011523898,2308,15915
ZCTA5 61552,111,113,-2,281,36.8,281,0,0,0,254,27
ZCTA5 61553,85,532,-447,260,31,255,2,0,0,1055,-795
ZCTA5 61554,17422,350,17072,41057,42.6,38568,163,994,0.024210244,903,40154
ZCTA5 61559,1386,386,1000,3838,45.6,3460,0,6,0.001563314,1134,2704
ZCTA5 61560,258,512,-254,512,63.8,486,22,0,0,1243,-731
ZCTA5 61561,908,381,527,2340,43,2309,0,4,0.001709402,1005,1335
ZCTA5 61562,61,935,-874,87,77.1,87,0,0,0,6195,-6108
ZCTA5 61563,234,1395,-1161,514,42.2,513,0,0,0,4036,-3522
ZCTA5 61564,381,876,-495,1056,38.3,1048,0,0,0,2462,-1406
ZCTA5 61565,609,135,474,1404,43.5,1366,3,0,0,294,1110
ZCTA5 61567,267,3436,-3169,460,55.2,451,0,0,0,9771,-9311
ZCTA5 61568,1636,480,1156,4460,39.5,4334,75,0,0,1481,2979
ZCTA5 61569,398,362,36,947,49.6,947,0,0,0,825,122
ZCTA5 61570,704,142,562,1733,42.3,1701,9,0,0,346,1387
ZCTA5 61571,9512,802,8710,24761,39,23332,399,287,0.011590808,1999,22762
ZCTA5 61572,445,443,2,1063,46.1,1035,5,5,0.004703669,1223,-160
ZCTA5 61602,495,111,384,752,39,566,26,89,0.118351064,301,451
ZCTA5 61603,6566,327,6239,15747,36.2,6901,85,6591,0.418555915,917,14830
ZCTA5 61604,11992,296,11696,28828,39,17734,466,8136,0.282225614,742,28086
ZCTA5 61605,5775,87,5688,14010,34.6,4595,71,7998,0.570877944,222,13788
ZCTA5 61606,2552,1040,1512,7697,23,5319,220,1596,0.207353514,2491,5206
ZCTA5 61607,4214,747,3467,10386,42.6,9935,45,110,0.01059118,1766,8620
ZCTA5 61610,2131,156,1975,4947,36,4746,0,66,0.013341419,340,4607
ZCTA5 61611,10006,722,9284,23925,42.8,22899,399,193,0.008066876,1852,22073
ZCTA5 61614,13133,66,13067,28583,38.5,20772,1784,4356,0.152398279,186,28397
ZCTA5 61615,10147,377,9770,22957,37.8,17166,1923,2380,0.103672083,898,22059
ZCTA5 61616,2873,130,2743,5940,40.4,5188,91,210,0.035353535,338,5602
ZCTA5 61625,0,124,-124,534,19.9,429,46,50,0.093632959,348,186
ZCTA5 61701,15810,20,15790,35347,35.5,27540,1185,4035,0.114153959,60,35287
ZCTA5 61704,15046,540,14506,36875,35.5,27459,5060,2691,0.072976271,1293,35582
ZCTA5 61705,4839,15240,-10401,13130,37.8,11294,488,794,0.060472201,35383,-22253
ZCTA5 61720,84,6128,-6044,255,32.1,207,0,0,0,17235,-16980
ZCTA5 61721,217,397,-180,551,53.7,482,3,0,0,905,-354
ZCTA5 61722,230,14317,-14087,659,39.2,593,0,39,0.059180577,33826,-33167
ZCTA5 61723,1071,595,476,2571,38.6,2498,0,0,0,1625,946
ZCTA5 61724,163,682,-519,436,45,425,0,0,0,1761,-1325
ZCTA5 61725,598,54,544,1682,38.2,1490,3,118,0.070154578,166,1516
ZCTA5 61726,1033,446,587,2850,36.3,2748,15,44,0.015438596,846,2004
ZCTA5 61727,4011,554,3457,9517,40.4,9061,4,164,0.017232321,1231,8286
ZCTA5 61728,456,1380,-924,1271,36.8,1241,0,0,0,3785,-2514
ZCTA5 61729,429,372,57,1223,33.3,1110,6,0,0,986,237
ZCTA5 61730,145,16,129,403,47.6,397,0,0,0,38,365
ZCTA5 61731,45,167,-122,164,29.6,164,0,0,0,350,-186
ZCTA5 61732,766,544,222,2016,39.6,1806,32,7,0.003472222,1408,608
ZCTA5 61733,354,695,-341,823,40,784,0,14,0.017010936,1572,-749
ZCTA5 61734,1019,58,961,2647,42.2,2567,10,10,0.003777862,156,2491
ZCTA5 61735,162,188,-26,424,38.5,411,0,0,0,520,-96
ZCTA5 61736,911,717,194,2490,36.1,2389,2,2,0.000803213,1822,668
ZCTA5 61737,184,404,-220,454,46.8,425,0,0,0,934,-480
ZCTA5 61738,1558,602,956,4454,37.7,4270,1,124,0.027840144,1569,2885
ZCTA5 61739,1935,376,1559,4665,44.5,4442,29,92,0.019721329,890,3775
ZCTA5 61740,580,775,-195,1393,48.6,1346,12,9,0.006460876,1787,-394
ZCTA5 61741,626,2315,-1689,1549,33.2,1440,0,18,0.0116204,6019,-4470
ZCTA5 61742,465,1121,-656,1247,40.5,1243,2,2,0.001603849,2806,-1559
ZCTA5 61743,64,406,-342,129,51.8,126,0,2,0.015503876,903,-774
ZCTA5 61744,658,165,493,1543,51.6,1463,2,34,0.022034997,488,1055
ZCTA5 61745,1643,578,1065,4729,38.8,4517,9,0,0,1582,3147
ZCTA5 61747,644,148,496,1590,47.8,1562,0,6,0.003773585,391,1199
ZCTA5 61748,959,166,793,2547,39.8,2515,11,0,0,438,2109
ZCTA5 61749,315,3114,-2799,555,60.9,542,0,10,0.018018018,7109,-6554
ZCTA5 61750,26,1551,-1525,102,14.8,53,0,1,0.009803922,3577,-3475
ZCTA5 61751,31,518,-487,57,58.3,57,0,0,0,1215,-1158
ZCTA5 61752,1737,2005,-268,4458,41.6,4386,0,0,0,5269,-811
ZCTA5 61753,1228,2179,-951,3102,41.7,3065,2,9,0.002901354,5874,-2772
ZCTA5 61754,414,3155,-2741,1113,40.3,1089,2,0,0,7517,-6404
ZCTA5 61755,1890,425,1465,4624,37.9,4567,0,0,0,1018,3606
ZCTA5 61756,913,6639,-5726,2575,37.9,1992,96,79,0.030679612,16584,-14009
ZCTA5 61759,564,212,352,1474,40.3,1427,0,1,0.000678426,492,982
ZCTA5 61760,984,655,329,2384,40.3,2355,6,4,0.001677852,1903,481
ZCTA5 61761,20141,219,19922,54251,25.3,43583,1995,6361,0.117251295,694,53557
ZCTA5 61764,5358,589,4769,13867,40.7,11919,177,1103,0.079541357,1379,12488
ZCTA5 61769,247,210,37,679,38.8,643,8,0,0,501,178
ZCTA5 61770,440,113,327,1098,43.4,1067,0,0,0,311,787
ZCTA5 61771,265,404,-139,815,37.5,789,4,0,0,987,-172
ZCTA5 61772,70,745,-675,208,49.3,176,0,0,0,2110,-1902
ZCTA5 61773,130,1372,-1242,290,46.4,287,0,0,0,3597,-3307
ZCTA5 61774,368,2013,-1645,914,37.4,882,0,0,0,5586,-4672
ZCTA5 61775,122,346,-224,251,55.6,251,0,0,0,738,-487
ZCTA5 61776,527,2834,-2307,1195,54.7,1155,0,19,0.015899582,7938,-6743
ZCTA5 61777,420,486,-66,938,40.7,928,0,0,0,1285,-347
ZCTA5 61778,225,0,225,488,48,488,0,0,0,0,488
ZCTA5 61801,10938,279,10659,28234,24.1,17240,5311,3871,0.137104201,659,27575
ZCTA5 61802,8709,326,8383,19671,38,13069,1364,3805,0.193431956,845,18826
ZCTA5 61810,97,3331,-3234,233,47.1,204,2,19,0.081545064,8312,-8079
ZCTA5 61811,278,443,-165,661,48,627,0,0,0,1076,-415
ZCTA5 61812,139,355,-216,357,51.5,348,0,0,0,876,-519
ZCTA5 61813,685,4838,-4153,1677,44.9,1632,0,33,0.019677996,13138,-11461
ZCTA5 61814,475,182,293,1247,38.7,1170,12,36,0.028869286,514,733
ZCTA5 61815,160,112,48,333,44.8,306,5,14,0.042042042,253,80
ZCTA5 61816,144,238,-94,400,42,392,0,7,0.0175,598,-198
ZCTA5 61817,1090,254,836,2440,44.4,2410,0,24,0.009836066,556,1884
ZCTA5 61818,675,250,425,1587,42.3,1555,0,0,0,553,1034
ZCTA5 61820,14582,494,14088,38553,22.4,23283,7315,5451,0.141389775,1251,37302
ZCTA5 61821,12401,107,12294,28986,34.9,18769,1488,6890,0.237700959,187,28799
ZCTA5 61822,11083,1480,9603,27473,38.3,17701,5033,3618,0.131692935,3777,23696
ZCTA5 61830,174,615,-441,495,37.6,427,0,0,0,1526,-1031
ZCTA5 61831,98,157,-59,168,60.9,168,0,0,0,400,-232
ZCTA5 61832,13589,2412,11177,33173,38.8,21993,416,9065,0.273264402,5346,27827
ZCTA5 61833,829,215,614,1836,49.7,1764,0,10,0.005446623,553,1283
ZCTA5 61834,2509,10426,-7917,8247,42.9,6818,4,1144,0.138717109,27100,-18853
ZCTA5 61839,219,261,-42,613,41.4,557,0,23,0.037520392,571,42
ZCTA5 61840,198,7636,-7438,528,60.5,528,0,0,0,22720,-22192
ZCTA5 61841,462,427,35,1161,39.4,1137,0,2,0.001722653,1029,132
ZCTA5 61842,1058,165,893,2506,50.2,2496,0,1,0.000399042,454,2052
ZCTA5 61843,815,1405,-590,2207,34.7,2083,5,0,0,3107,-900
ZCTA5 61844,354,636,-282,772,58.4,745,0,14,0.018134715,1533,-761
ZCTA5 61845,172,243,-71,389,60.2,389,0,0,0,512,-123
ZCTA5 61846,2128,169,1959,4896,42.5,4554,15,278,0.056781046,468,4428
ZCTA5 61847,490,570,-80,1227,45.7,1163,0,15,0.012224939,1409,-182
ZCTA5 61848,92,1254,-1162,251,41,243,0,2,0.007968127,3274,-3023
ZCTA5 61849,847,179,668,2084,42.4,2020,0,0,0,457,1627
ZCTA5 61850,150,84,66,406,47.5,394,1,0,0,211,195
ZCTA5 61851,152,235,-83,316,43.9,316,0,0,0,609,-293
ZCTA5 61852,76,588,-512,159,56.1,155,0,0,0,1493,-1334
ZCTA5 61853,4809,2537,2272,13921,37.1,13057,135,75,0.005387544,6214,7707
ZCTA5 61854,526,1043,-517,1228,49.5,1219,0,0,0,2684,-1456
ZCTA5 61855,44,2216,-2172,128,56.1,128,0,0,0,5491,-5363
ZCTA5 61856,3282,306,2976,8179,40.8,7874,1,51,0.006235481,751,7428
ZCTA5 61857,87,2053,-1966,159,52.6,155,0,0,0,5601,-5442
ZCTA5 61858,1078,796,282,2829,37.1,2770,12,13,0.004595263,2093,736
ZCTA5 61859,513,296,217,1374,41.3,1309,57,0,0,792,582
ZCTA5 61862,222,173,49,637,46.2,619,0,0,0,427,210
ZCTA5 61863,360,1681,-1321,866,41.7,841,0,0,0,4200,-3334
ZCTA5 61864,593,929,-336,1743,37.9,1728,0,0,0,2156,-413
ZCTA5 61865,537,846,-309,1505,35.5,1379,53,34,0.022591362,2011,-506
ZCTA5 61866,5477,634,4843,13631,35.4,8667,199,2500,0.183405473,1536,12095
ZCTA5 61870,487,1264,-777,1155,43.1,1109,0,11,0.00952381,3029,-1874
ZCTA5 61871,166,120,46,387,41.3,349,0,33,0.085271318,270,117
ZCTA5 61872,245,599,-354,536,60.6,485,35,2,0.003731343,983,-447
ZCTA5 61873,2090,16375,-14285,5833,39.4,5615,117,29,0.004971713,37820,-31987
ZCTA5 61874,3412,11965,-8553,8572,35.6,6582,1133,451,0.052613159,29593,-21021
ZCTA5 61875,306,18849,-18543,1000,27,950,0,0,0,39925,-38925
ZCTA5 61876,232,2981,-2749,660,37.8,652,2,0,0,7669,-7009
ZCTA5 61877,513,6470,-5957,1287,40.2,1251,3,8,0.006216006,15721,-14434
ZCTA5 61878,541,3910,-3369,1225,50.1,1144,4,18,0.014693878,9804,-8579
ZCTA5 61880,1688,8774,-7086,4454,36.6,4071,0,204,0.045801527,22613,-18159
ZCTA5 61882,255,352,-97,659,45.5,598,0,40,0.060698027,1006,-347
ZCTA5 61883,1799,1347,452,4412,37.6,4351,19,0,0,3359,1053
ZCTA5 61884,427,360,67,1046,51.9,984,2,0,0,1040,6
ZCTA5 61910,1437,710,727,4732,34.8,3976,4,100,0.021132713,1744,2988
ZCTA5 61911,1660,51,1609,4703,32.6,4583,4,10,0.002126302,121,4582
ZCTA5 61912,549,382,167,1214,46.1,1180,0,25,0.020593081,1024,190
ZCTA5 61913,586,95,491,1470,41.1,1429,6,0,0,231,1239
ZCTA5 61914,876,4578,-3702,1976,45.4,1950,0,0,0,11352,-9376
ZCTA5 61917,240,669,-429,534,52.9,531,0,0,0,1929,-1395
ZCTA5 61919,318,161,157,789,50.4,785,0,0,0,358,431
ZCTA5 61920,8423,556,7867,21341,29.3,18668,392,1424,0.06672602,1319,20022
ZCTA5 61924,906,326,580,2343,44,2265,20,14,0.005975245,784,1559
ZCTA5 61925,464,166,298,1254,40.8,1239,0,6,0.004784689,427,827
ZCTA5 61928,305,185,120,705,42.7,697,0,0,0,389,316
ZCTA5 61929,308,75,233,661,41.8,655,2,0,0,179,482
ZCTA5 61930,257,3261,-3004,695,38.9,691,0,2,0.002877698,7513,-6818
ZCTA5 61931,498,1245,-747,1433,35.7,1313,0,4,0.002791347,2745,-1312
ZCTA5 61932,230,717,-487,512,44.3,488,0,0,0,1782,-1270
ZCTA5 61933,457,764,-307,1155,44.6,1112,0,3,0.002597403,1773,-618
ZCTA5 61936,125,79,46,360,40.8,360,0,0,0,211,149
ZCTA5 61937,761,562,199,1716,41.9,1563,0,36,0.020979021,1337,379
ZCTA5 61938,9495,481,9014,20816,43,19721,136,402,0.019312068,1276,19540
ZCTA5 61940,139,44,95,299,49.8,299,0,0,0,118,181
ZCTA5 61941,63,644,-581,199,31.6,199,0,0,0,1426,-1227
ZCTA5 61942,446,226,220,969,61.1,937,0,9,0.009287926,495,474
ZCTA5 61943,730,3601,-2871,1525,53,1490,0,0,0,9023,-7498
ZCTA5 61944,5365,112,5253,11703,44.1,11338,44,74,0.006323165,227,11476
ZCTA5 61949,80,485,-405,152,55.3,140,8,0,0,1177,-1025
ZCTA5 61951,2947,287,2660,7871,40.5,7658,19,100,0.012704866,742,7129
ZCTA5 61953,2637,4086,-1449,6193,39.6,5888,84,11,0.001776199,9015,-2822
ZCTA5 61955,69,621,-552,219,32,214,0,0,0,1795,-1576
ZCTA5 61956,1258,2525,-1267,2936,44.9,2845,5,48,0.016348774,6608,-3672
ZCTA5 61957,714,37,677,1648,40.7,1632,3,0,0,103,1545
ZCTA5 62001,689,386,303,1606,55.1,1588,0,0,0,970,636
ZCTA5 62002,13431,71,13360,30913,41.5,22610,194,6284,0.203280173,131,30782
ZCTA5 62006,162,865,-703,553,36.9,543,0,0,0,1943,-1390
ZCTA5 62009,723,404,319,1820,38.9,1745,4,0,0,2544,-724
ZCTA5 62010,4619,282,4337,11264,41.3,10899,13,132,0.01171875,626,10638
ZCTA5 62011,105,948,-843,241,66.1,237,0,0,0,2451,-2210
ZCTA5 62012,2318,125,2193,6713,42,6434,0,9,0.001340682,305,6408
ZCTA5 62013,157,101,56,579,37.6,577,0,0,0,249,330
ZCTA5 62014,1404,44,1360,3986,37.7,3901,17,16,0.004014049,129,3857
ZCTA5 62015,202,337,-135,543,40.2,542,0,0,0,856,-313
ZCTA5 62016,1396,702,694,3549,41.8,3454,0,2,0.000563539,1606,1943
ZCTA5 62017,454,97,357,896,42.1,894,0,0,0,217,679
ZCTA5 62018,1102,1385,-283,2940,39,2701,0,96,0.032653061,3325,-385
ZCTA5 62019,155,2389,-2234,391,50.4,367,0,12,0.030690537,5611,-5220
ZCTA5 62021,362,213,149,733,59.5,733,0,0,0,481,252
ZCTA5 62022,360,51,309,1072,39.1,1072,0,0,0,133,939
ZCTA5 62023,37,151,-114,117,32.1,95,1,0,0,343,-226
ZCTA5 62024,4141,4120,21,9544,44.9,8918,8,350,0.036672255,10115,-571
ZCTA5 62025,12304,10157,2147,34663,34.6,30584,645,2145,0.061881545,24305,10358
ZCTA5 62026,0,732,-732,1175,19.2,952,25,175,0.14893617,1823,-648
ZCTA5 62027,210,220,-10,540,43.2,508,22,0,0,528,12
ZCTA5 62028,269,662,-393,1027,22,900,29,38,0.037000974,1715,-688
ZCTA5 62030,33,1140,-1107,123,51.5,111,12,0,0,2746,-2623
ZCTA5 62031,286,761,-475,778,46.9,743,0,0,0,1995,-1217
ZCTA5 62032,268,297,-29,661,48.2,562,5,0,0,640,21
ZCTA5 62033,1847,386,1461,4559,42,4413,13,13,0.002851503,1114,3445
ZCTA5 62034,6000,158,5842,14568,41.5,12960,273,595,0.040842943,341,14227
ZCTA5 62035,6792,464,6328,16046,50.6,14567,53,967,0.06026424,1139,14907
ZCTA5 62036,208,108,100,558,56.9,557,0,0,0,252,306
ZCTA5 62037,727,221,506,1694,53.5,1603,0,31,0.018299882,498,1196
ZCTA5 62040,16719,131,16588,40912,39.1,34051,342,3675,0.089826946,295,40617
ZCTA5 62044,735,44,691,2257,40.6,2217,0,0,0,113,2144
ZCTA5 62045,154,236,-82,543,57.9,521,0,0,0,573,-30
ZCTA5 62046,352,4577,-4225,884,34.5,877,0,0,0,11386,-10502
ZCTA5 62047,388,891,-503,1623,49.3,1540,0,22,0.013555145,2175,-552
ZCTA5 62048,775,279,496,1846,39.2,1727,0,0,0,803,1043
ZCTA5 62049,2640,1151,1489,8698,41.6,7466,0,977,0.112324672,2884,5814
ZCTA5 62050,115,282,-167,343,38.1,343,0,0,0,769,-426
ZCTA5 62051,358,151,207,735,56.8,729,0,3,0.004081633,480,255
ZCTA5 62052,4720,99,4621,12627,41.9,12150,62,22,0.001742298,237,12390
ZCTA5 62053,138,972,-834,410,37.7,390,2,1,0.002439024,2504,-2094
ZCTA5 62054,131,324,-193,361,47.9,325,5,3,0.008310249,852,-491
ZCTA5 62056,3841,1235,2606,8751,45.9,8452,38,122,0.013941264,3422,5329
ZCTA5 62058,351,256,95,807,43.7,704,0,0,0,596,211
ZCTA5 62059,181,107,74,627,29.7,9,0,603,0.961722488,247,380
ZCTA5 62060,1843,373,1470,3662,45.8,1354,10,2171,0.59284544,887,2775
ZCTA5 62061,633,367,266,1638,40.4,1581,23,0,0,1022,616
ZCTA5 62062,3510,831,2679,8336,50.2,7075,297,573,0.068738004,2094,6242
ZCTA5 62063,359,5240,-4881,723,54.5,720,0,0,0,12605,-11882
ZCTA5 62067,870,189,681,2109,49.2,2059,43,0,0,550,1559
ZCTA5 62069,1392,777,615,3210,48.1,3106,58,31,0.009657321,2012,1198
ZCTA5 62074,473,663,-190,1228,45.9,1209,0,0,0,1779,-551
ZCTA5 62075,1296,10345,-9049,3122,37.8,3072,33,3,0.000960922,27823,-24701
ZCTA5 62076,48,1935,-1887,73,66.1,73,0,0,0,4506,-4433
ZCTA5 62077,113,912,-799,246,54.3,244,0,0,0,2248,-2002
ZCTA5 62078,23,283,-260,84,46.5,84,0,0,0,800,-716
ZCTA5 62079,80,2873,-2793,297,36.8,297,0,0,0,7007,-6710
ZCTA5 62080,872,866,6,2569,41.5,2509,0,11,0.004281822,2362,207
ZCTA5 62081,96,207,-111,377,32.2,329,0,15,0.039787798,458,-81
ZCTA5 62082,973,1089,-116,2484,48.3,2295,12,107,0.043075684,2535,-51
ZCTA5 62083,97,433,-336,148,56.5,148,0,0,0,1198,-1050
ZCTA5 62084,694,1273,-579,1520,41.8,1442,10,40,0.026315789,3008,-1488
ZCTA5 62085,70,129,-59,176,54.5,165,5,0,0,392,-216
ZCTA5 62086,480,344,136,1249,46.2,1172,10,0,0,878,371
ZCTA5 62087,787,1108,-321,2121,34.1,1923,0,51,0.024045262,2315,-194
ZCTA5 62088,2759,3997,-1238,6310,44.8,6066,68,10,0.001584786,9589,-3279
ZCTA5 62089,307,382,-75,605,58.5,603,0,0,0,861,-256
ZCTA5 62090,443,1298,-855,1117,42.2,58,0,983,0.88003581,3643,-2526
ZCTA5 62091,143,163,-20,478,35.6,478,0,0,0,486,-8
ZCTA5 62092,1018,1307,-289,2586,43.8,2538,0,22,0.008507347,3415,-829
ZCTA5 62093,209,240,-31,550,40.3,548,0,0,0,671,-121
ZCTA5 62094,340,1116,-776,902,35.8,893,0,4,0.00443459,2880,-1978
ZCTA5 62095,4518,873,3645,10703,36.5,9675,2,499,0.046622442,2104,8599
ZCTA5 62097,1092,111,981,2907,45.6,2855,2,0,0,235,2672
ZCTA5 62098,10,124,-114,32,49.7,32,0,0,0,288,-256
ZCTA5 62201,2099,2543,-444,5237,34.6,1362,21,2957,0.564636242,6204,-967
ZCTA5 62203,2186,788,1398,6500,46.1,302,42,6064,0.932923077,1712,4788
ZCTA5 62204,2447,567,1880,6126,39.1,110,47,5724,0.934378061,1618,4508
ZCTA5 62205,2304,411,1893,5807,52.3,129,112,5534,0.952987773,972,4835
ZCTA5 62206,4431,443,3988,13433,32.3,4254,197,8465,0.63016452,965,12468
ZCTA5 62207,3083,812,2271,7345,34.4,116,24,7122,0.96963921,2009,5336
ZCTA5 62208,7148,1098,6050,16898,39.8,9193,196,5901,0.349212925,2793,14105
ZCTA5 62214,450,1145,-695,1141,38.8,1097,6,0,0,3036,-1895
ZCTA5 62215,782,182,600,2094,42.3,2010,14,0,0,510,1584
ZCTA5 62216,1046,277,769,2944,38.9,2859,9,6,0.002038043,753,2191
ZCTA5 62217,324,252,72,752,51.1,739,0,0,0,675,77
ZCTA5 62218,732,230,502,1944,43.2,1905,0,0,0,703,1241
ZCTA5 62219,398,5363,-4965,963,44.3,900,9,6,0.00623053,13224,-12261
ZCTA5 62220,7242,259,6983,18160,39.8,13116,127,3442,0.189537445,583,17577
ZCTA5 62221,11940,5259,6681,30512,37.5,18522,542,8552,0.280283167,12771,17741
ZCTA5 62223,7309,347,6962,16353,44.4,10737,120,4451,0.272182474,806,15547
ZCTA5 62225,1444,119,1325,5595,22.6,3780,103,1231,0.220017873,264,5331
ZCTA5 62226,12270,2129,10141,29504,40.4,18750,461,8194,0.277725054,5375,24129
ZCTA5 62230,2630,1182,1448,6416,39.1,6149,55,3,0.000467581,3220,3196
ZCTA5 62231,2647,110,2537,6608,39,6198,34,59,0.008928571,311,6297
ZCTA5 62232,2693,222,2471,7154,42.8,5724,0,654,0.091417389,645,6509
ZCTA5 62233,2519,339,2180,8911,42.4,6351,35,2158,0.242172596,951,7960
ZCTA5 62234,13690,463,13227,32637,39.6,26192,302,3817,0.116953151,1229,31408
ZCTA5 62236,5357,925,4432,14481,40.5,13967,112,6,0.000414336,2032,12449
ZCTA5 62237,1051,10819,-9768,2276,56.2,2196,7,21,0.009226714,26628,-24352
ZCTA5 62238,207,4740,-4533,536,37.8,496,0,2,0.003731343,11937,-11401
ZCTA5 62239,1814,22,1792,4038,45,3801,0,182,0.045071818,80,3958
ZCTA5 62240,602,28,574,2253,30.2,2199,0,46,0.020417221,84,2169
ZCTA5 62241,344,248,96,759,53.2,756,0,0,0,791,-32
ZCTA5 62242,597,553,44,1476,39,1474,0,0,0,1339,137
ZCTA5 62243,2267,45,2222,6026,45.3,5707,139,9,0.001493528,112,5914
ZCTA5 62244,363,6499,-6136,827,52.6,819,0,0,0,15527,-14700
ZCTA5 62245,738,105,633,1706,46,1671,0,2,0.001172333,269,1437
ZCTA5 62246,3453,289,3164,9926,40.1,8396,155,1143,0.115152126,689,9237
ZCTA5 62248,228,306,-78,554,34.6,529,0,2,0.003610108,732,-178
ZCTA5 62249,6898,464,6434,16671,41.5,15698,332,356,0.021354448,1022,15649
ZCTA5 62250,240,552,-312,692,32.6,663,0,0,0,1463,-771
ZCTA5 62253,294,93,201,744,45.3,740,0,0,0,161,583
ZCTA5 62254,2342,164,2178,6532,38.3,5471,19,903,0.138242498,441,6091
ZCTA5 62255,359,240,119,1092,37.3,1084,0,0,0,577,515
ZCTA5 62256,17,528,-511,52,38.3,52,0,0,0,1311,-1259
ZCTA5 62257,862,582,280,1963,48.6,1943,0,0,0,1365,598
ZCTA5 62258,3448,542,2906,10234,38,8895,129,302,0.029509478,1365,8869
ZCTA5 62260,2714,765,1949,6816,44.7,6733,0,2,0.000293427,1753,5063
ZCTA5 62261,33,411,-378,41,67.6,41,0,0,0,1404,-1363
ZCTA5 62262,745,369,376,1743,48.5,1614,58,41,0.023522662,887,856
ZCTA5 62263,2145,647,1498,5046,45.5,4940,56,25,0.004954419,2143,2903
ZCTA5 62264,1322,364,958,3487,39.9,3470,5,9,0.002581015,966,2521
ZCTA5 62265,1834,387,1447,4347,46.7,3743,24,235,0.054060271,996,3351
ZCTA5 62266,12,289,-277,12,-,12,0,0,0,733,-721
ZCTA5 62268,398,1521,-1123,974,45.8,946,6,0,0,5210,-4236
ZCTA5 62269,13217,238,12979,35619,37.8,26527,1344,4751,0.133383868,413,35206
ZCTA5 62271,808,211,597,1990,38.8,1888,29,30,0.015075377,503,1487
ZCTA5 62272,652,122,530,1889,31.1,1720,11,0,0,371,1518
ZCTA5 62273,111,689,-578,248,59.5,242,0,0,0,1922,-1674
ZCTA5 62274,2670,5944,-3274,8302,39.8,6557,71,1442,0.173693086,17741,-9439
ZCTA5 62275,1124,13694,-12570,3264,41.3,3192,51,0,0,36304,-33040
ZCTA5 62277,405,14091,-13686,951,45.1,935,0,0,0,37114,-36163
ZCTA5 62278,2559,3530,-971,6504,41.1,6292,137,2,0.000307503,10334,-3830
ZCTA5 62279,24,615,-591,68,32.9,68,0,0,0,1697,-1629
ZCTA5 62280,197,222,-25,541,40.9,541,0,0,0,483,58
ZCTA5 62281,1127,726,401,3206,34.1,3146,5,0,0,1883,1323
ZCTA5 62282,285,2828,-2543,649,42.3,646,0,0,0,8088,-7439
ZCTA5 62284,274,16604,-16330,740,33.7,739,0,0,0,41402,-40662
ZCTA5 62285,1728,1746,-18,4624,42.6,4466,0,98,0.021193772,4512,112
ZCTA5 62286,2412,7873,-5461,5363,42.1,4314,13,925,0.172478091,20781,-15418
ZCTA5 62288,1136,21245,-20109,2665,45.5,2538,0,47,0.017636023,56102,-53437
ZCTA5 62289,159,1923,-1764,332,43.3,323,0,0,0,4925,-4593
ZCTA5 62292,357,4484,-4127,979,36.3,812,0,111,0.113381001,13184,-12205
ZCTA5 62293,1735,16071,-14336,4298,39.4,4217,0,4,0.000930665,43886,-39588
ZCTA5 62294,5615,9903,-4288,14827,39.4,13843,145,239,0.016119242,26152,-11325
ZCTA5 62295,533,135,398,1563,39.9,1529,0,3,0.001919386,333,1230
ZCTA5 62297,173,19016,-18843,325,60.1,325,0,0,0,48529,-48204
ZCTA5 62298,6868,17109,-10241,17024,42.9,16528,206,67,0.00393562,41502,-24478
ZCTA5 62301,13630,6654,6976,31614,38.7,27621,235,2195,0.069431265,18035,13579
ZCTA5 62305,7651,364,7287,18922,46.1,18160,146,392,0.020716626,680,18242
ZCTA5 62311,388,1250,-862,799,46,761,0,0,0,3093,-2294
ZCTA5 62312,652,2422,-1770,1887,35.3,1852,5,6,0.00317965,6797,-4910
ZCTA5 62313,142,413,-271,323,46.5,318,0,3,0.009287926,1378,-1055
ZCTA5 62314,224,3048,-2824,592,36.9,475,0,0,0,8795,-8203
ZCTA5 62316,285,142,143,863,34,801,6,11,0.012746234,363,500
ZCTA5 62319,110,8723,-8613,220,58.8,220,0,0,0,19924,-19704
ZCTA5 62320,885,9460,-8575,2457,36.2,2405,4,0,0,22311,-19854
ZCTA5 62321,1672,4370,-2698,3721,49.1,3537,6,15,0.004031174,10645,-6924
ZCTA5 62323,82,0,82,190,50.3,187,0,0,0,0,190
ZCTA5 62324,564,0,564,1480,41.8,1476,0,0,0,0,1480
ZCTA5 62325,167,1274,-1107,479,36.4,473,0,0,0,3397,-2918
ZCTA5 62326,1009,6062,-5053,2441,39.8,2394,0,0,0,16098,-13657
ZCTA5 62330,670,5357,-4687,1468,50.1,1389,0,0,0,14604,-13136
ZCTA5 62334,80,5177,-5097,193,46.2,175,0,9,0.046632124,14345,-14152
ZCTA5 62336,35,8927,-8892,85,55.5,84,0,0,0,25501,-25416
ZCTA5 62338,481,37,444,1157,48.5,1157,0,0,0,89,1068
ZCTA5 62339,416,921,-505,1019,41,1000,0,0,0,2329,-1310
ZCTA5 62340,699,724,-25,1697,45.6,1643,3,0,0,1914,-217
ZCTA5 62341,1401,0,1401,3536,44.5,3404,23,43,0.012160633,61,3475
ZCTA5 62343,318,870,-552,821,36.2,665,0,0,0,2518,-1697
ZCTA5 62344,10,77,-67,19,66.8,19,0,0,0,191,-172
ZCTA5 62345,134,1912,-1778,329,40.2,323,1,0,0,5074,-4745
ZCTA5 62346,75,5255,-5180,155,49.6,154,0,0,0,14815,-14660
ZCTA5 62347,717,3120,-2403,1793,45.3,1791,0,0,0,7850,-6057
ZCTA5 62348,74,378,-304,208,44.3,201,1,0,0,1284,-1076
ZCTA5 62349,297,1160,-863,706,56,681,8,0,0,3360,-2654
ZCTA5 62351,750,128,622,1940,40.2,1898,0,28,0.01443299,331,1609
ZCTA5 62352,88,7171,-7083,262,32.6,253,0,0,0,15420,-15158
ZCTA5 62353,1369,4363,-2994,4993,36.3,3613,3,1174,0.235129181,11280,-6287
ZCTA5 62354,509,22,487,1362,49.8,1307,31,14,0.010279001,34,1328
ZCTA5 62355,264,5874,-5610,875,42.6,805,0,6,0.006857143,15015,-14140
ZCTA5 62356,193,6734,-6541,669,23.9,662,3,0,0,17919,-17250
ZCTA5 62357,137,433,-296,329,40.2,305,0,0,0,1044,-715
ZCTA5 62358,200,3651,-3451,617,44.8,617,0,0,0,8058,-7441
ZCTA5 62359,48,2140,-2092,155,42.4,155,0,0,0,5387,-5232
ZCTA5 62360,696,8544,-7848,2002,33.8,1957,26,0,0,21833,-19831
ZCTA5 62361,111,558,-447,353,40.1,353,0,0,0,1315,-962
ZCTA5 62362,164,1256,-1092,373,50.7,360,0,10,0.026809651,1989,-1616
ZCTA5 62363,2254,1056,1198,5268,45.7,5043,28,120,0.022779043,2154,3114
ZCTA5 62365,184,3459,-3275,454,48.6,428,0,0,0,6242,-5788
ZCTA5 62366,468,8968,-8500,1541,33.8,1527,0,0,0,19454,-17913
ZCTA5 62367,611,6572,-5961,1287,49.8,1255,0,19,0.014763015,17380,-16093
ZCTA5 62370,118,4615,-4497,320,55.1,310,7,0,0,11546,-11226
ZCTA5 62373,145,4414,-4269,279,54.8,279,0,0,0,12349,-12070
ZCTA5 62374,180,10832,-10652,274,50.8,274,0,0,0,21175,-20901
ZCTA5 62375,270,13224,-12954,507,52.2,500,0,0,0,27255,-26748
ZCTA5 62376,433,7635,-7202,992,43.9,929,0,0,0,16217,-15225
ZCTA5 62378,355,8638,-8283,822,39,755,0,0,0,21363,-20541
ZCTA5 62379,762,8735,-7973,1829,45.1,1788,0,4,0.002186987,20024,-18195
ZCTA5 62380,113,4976,-4863,424,31.3,422,2,0,0,13045,-12621
ZCTA5 62401,7933,15112,-7179,19258,39.6,18408,112,158,0.008204383,36400,-17142
ZCTA5 62410,484,8460,-7976,1499,36.3,1404,28,0,0,22192,-20693
ZCTA5 62411,1756,19172,-17416,4218,40.3,4204,0,0,0,43884,-39666
ZCTA5 62413,138,4433,-4295,251,58.3,221,0,0,0,9331,-9080
ZCTA5 62414,675,10901,-10226,1580,40.7,1567,0,5,0.003164557,26862,-25282
ZCTA5 62417,1046,14193,-13147,2672,42.5,2539,0,121,0.045284431,33856,-31184
ZCTA5 62418,813,3408,-2595,2146,35.8,2073,18,0,0,8890,-6744
ZCTA5 62419,91,10932,-10841,203,41.7,200,0,0,0,26736,-26533
ZCTA5 62420,1824,16153,-14329,4070,41.8,3869,0,67,0.016461916,38582,-34512
ZCTA5 62421,204,21850,-21646,496,52.8,478,3,0,0,48869,-48373
ZCTA5 62422,404,4286,-3882,994,41.4,960,4,12,0.012072435,10418,-9424
ZCTA5 62423,229,13789,-13560,654,37,654,0,0,0,32685,-32031
ZCTA5 62424,872,6266,-5394,2447,33.7,2386,33,0,0,14907,-12460
ZCTA5 62425,256,1895,-1639,665,43.7,654,0,0,0,4610,-3945
ZCTA5 62426,365,12145,-11780,722,55.3,702,13,0,0,29082,-28360
ZCTA5 62427,804,21047,-20243,2010,39.3,2003,0,0,0,52927,-50917
ZCTA5 62428,1160,12635,-11475,2944,40.1,2871,22,8,0.002717391,30832,-27888
ZCTA5 62431,351,6473,-6122,926,35.8,923,0,0,0,17281,-16355
ZCTA5 62432,242,5853,-5611,759,42.9,745,3,0,0,13817,-13058
ZCTA5 62433,507,3237,-2730,1114,44.4,1094,1,6,0.005385996,8616,-7502
ZCTA5 62434,153,5584,-5431,369,53.5,369,0,0,0,14173,-13804
ZCTA5 62436,291,8662,-8371,781,55.7,733,0,0,0,21943,-21162
ZCTA5 62438,65,18422,-18357,177,58.5,177,0,0,0,47430,-47253
ZCTA5 62439,2862,7862,-5000,7077,41.1,6502,24,174,0.024586689,20604,-13527
ZCTA5 62440,506,7885,-7379,1003,56.7,981,0,0,0,21118,-20115
ZCTA5 62441,2850,11384,-8534,6994,45.8,6758,58,17,0.002430655,22384,-15390
ZCTA5 62442,1057,139,918,2672,41.4,2613,14,0,0,426,2246
ZCTA5 62443,704,8013,-7309,1770,40.4,1654,12,15,0.008474576,20326,-18556
ZCTA5 62444,161,5236,-5075,397,52.1,397,0,0,0,9668,-9271
ZCTA5 62445,406,4442,-4036,1107,37.1,1086,0,1,0.000903342,8869,-7762
ZCTA5 62446,138,14017,-13879,393,38.2,382,0,2,0.005089059,30027,-29634
ZCTA5 62447,1201,3954,-2753,3199,42,3099,0,0,0,10994,-7795
ZCTA5 62448,2234,0,2234,5316,44.1,5185,11,13,0.002445448,0,5316
ZCTA5 62449,1359,19326,-17967,2904,50.9,2750,2,31,0.010674931,49478,-46574
ZCTA5 62450,5027,18888,-13861,12551,42.7,11872,108,88,0.007011394,45781,-33230
ZCTA5 62451,933,14390,-13457,2133,46.8,2096,4,0,0,39986,-37853
ZCTA5 62452,144,71,73,297,53.8,292,0,0,0,123,174
ZCTA5 62454,3860,510,3350,10548,40.2,9364,68,947,0.089780053,1233,9315
ZCTA5 62458,906,348,558,2484,45.9,2451,11,6,0.002415459,825,1659
ZCTA5 62459,109,2817,-2708,335,26.9,335,0,0,0,9480,-9145
ZCTA5 62460,448,475,-27,1036,44.8,994,0,0,0,1012,24
ZCTA5 62461,357,376,-19,716,52.8,716,0,0,0,984,-268
ZCTA5 62462,471,1294,-823,1230,33.9,1228,0,0,0,3712,-2482
ZCTA5 62463,463,1721,-1258,1065,45.6,1049,11,0,0,4424,-3359
ZCTA5 62464,48,618,-570,157,29.3,94,0,4,0.025477707,1606,-1449
ZCTA5 62465,325,210,115,780,43.4,766,0,0,0,491,289
ZCTA5 62466,1027,1054,-27,4509,38.8,3095,10,1207,0.267686849,2969,1540
ZCTA5 62467,1545,2261,-716,3948,38.9,3854,34,7,0.00177305,6471,-2523
ZCTA5 62468,1003,502,501,2491,44.6,2335,0,4,0.001605781,1523,968
ZCTA5 62469,121,313,-192,368,48.8,368,0,0,0,855,-487
ZCTA5 62471,3373,733,2640,10067,41.9,8982,3,899,0.089301679,1852,8215
ZCTA5 62473,483,340,143,1120,49.9,1102,0,7,0.00625,943,177
ZCTA5 62474,285,1947,-1662,635,51,616,5,0,0,4733,-4098
ZCTA5 62475,139,1879,-1740,395,31.6,395,0,0,0,4574,-4179
ZCTA5 62476,610,553,57,1484,46.1,1446,0,12,0.008086253,1281,203
ZCTA5 62477,282,1904,-1622,778,37.1,744,0,34,0.043701799,4484,-3706
ZCTA5 62478,120,1935,-1815,291,51.1,289,0,0,0,5893,-5602
ZCTA5 62479,294,745,-451,812,34.6,795,0,3,0.003694581,1712,-900
ZCTA5 62480,233,17106,-16873,552,49.7,526,0,0,0,47464,-46912
ZCTA5 62481,135,7635,-7500,298,52.8,217,0,11,0.036912752,20018,-19720
ZCTA5 62501,901,14693,-13792,2176,47.4,2092,0,1,0.000459559,42201,-40025
ZCTA5 62510,771,869,-98,1775,39.1,1710,0,9,0.005070423,2284,-509
ZCTA5 62512,252,12,240,609,37.5,596,0,4,0.006568144,17,592
ZCTA5 62513,652,240,412,1545,41.9,1443,8,4,0.002588997,530,1015
ZCTA5 62514,147,26973,-26826,365,34.6,365,0,0,0,71241,-70876
ZCTA5 62515,426,791,-365,1086,53.2,1042,5,0,0,2472,-1386
ZCTA5 62517,88,8577,-8489,272,28.4,270,0,0,0,23911,-23639
ZCTA5 62518,96,190,-94,149,67.2,149,0,0,0,434,-285
ZCTA5 62519,30,1424,-1394,54,32.1,54,0,0,0,5026,-4972
ZCTA5 62520,602,6110,-5508,1429,48.6,1342,0,61,0.042687194,15783,-14354
ZCTA5 62521,14020,778,13242,33785,42,25280,477,6289,0.186147699,1899,31886
ZCTA5 62522,5814,11746,-5932,14479,35.8,9827,132,3671,0.253539609,33903,-19424
ZCTA5 62523,265,258,7,1096,32.4,348,10,688,0.627737226,648,448
ZCTA5 62526,14349,30,14319,31039,43.8,22864,382,5867,0.189020265,82,30957
ZCTA5 62530,632,314,318,1366,37.1,1288,11,53,0.038799414,820,546
ZCTA5 62531,707,2376,-1669,1924,40.6,1878,0,26,0.013513514,6945,-5021
ZCTA5 62532,50,3908,-3858,101,61.4,101,0,0,0,9905,-9804
ZCTA5 62533,338,8365,-8027,773,38,754,0,0,0,21229,-20456
ZCTA5 62534,490,214,276,1157,47.6,1145,10,0,0,555,602
ZCTA5 62535,1356,79,1277,3674,41.5,3400,139,22,0.005988024,108,3566
ZCTA5 62536,314,221,93,720,57.5,689,7,0,0,483,237
ZCTA5 62537,101,9,92,261,33.5,261,0,0,0,17,244
ZCTA5 62538,169,261,-92,483,43.9,481,0,0,0,662,-179
ZCTA5 62539,522,1568,-1046,1273,40,1247,1,4,0.003142184,4734,-3461
ZCTA5 62540,587,455,132,1281,50.8,1253,0,0,0,991,290
ZCTA5 62541,24,602,-578,46,60.4,46,0,0,0,1419,-1373
ZCTA5 62543,226,289,-63,509,38.2,454,5,0,0,772,-263
ZCTA5 62544,615,20,595,1605,39.8,1531,0,17,0.0105919,39,1566
ZCTA5 62545,571,610,-39,1356,49.3,1279,0,2,0.001474926,1392,-36
ZCTA5 62546,596,398,198,1506,42.1,1403,4,0,0,998,508
ZCTA5 62547,338,199,139,924,39.1,873,2,0,0,464,460
ZCTA5 62548,973,1442,-469,2323,41.5,2219,0,0,0,3678,-1355
ZCTA5 62549,2296,327,1969,6535,38.7,6032,10,233,0.03565417,746,5789
ZCTA5 62550,1102,492,610,2933,39.3,2824,1,33,0.011251279,1143,1790
ZCTA5 62551,331,626,-295,929,37.2,767,0,0,0,1463,-534
ZCTA5 62553,144,80,64,318,52.3,298,0,0,0,142,176
ZCTA5 62554,682,96,586,2024,38.3,1652,89,54,0.026679842,291,1733
ZCTA5 62555,205,418,-213,613,46,610,0,0,0,1091,-478
ZCTA5 62556,131,192,-61,326,46.9,326,0,0,0,537,-211
ZCTA5 62557,2972,390,2582,7042,46.5,6839,104,0,0,1032,6010
ZCTA5 62558,1463,1628,-165,3430,46.5,3320,7,13,0.003790087,3985,-555
ZCTA5 62560,496,100,396,1299,38,1257,24,0,0,298,1001
ZCTA5 62561,2245,95,2150,5212,42.8,5132,21,18,0.003453569,199,5013
ZCTA5 62563,2255,1813,442,5985,45,5671,72,11,0.001837928,4651,1334
ZCTA5 62565,3196,172,3024,7528,47.4,7334,9,28,0.003719447,405,7123
ZCTA5 62567,395,2175,-1780,912,49.8,890,12,0,0,5752,-4840
ZCTA5 62568,6391,711,5680,16536,42.1,15617,168,520,0.031446541,1650,14886
ZCTA5 62570,246,239,7,811,26.4,811,0,0,0,645,166
ZCTA5 62571,620,45,575,1428,52,1386,0,0,0,65,1363
ZCTA5 62572,204,174,30,555,45.2,553,0,0,0,468,87
ZCTA5 62573,494,58,436,1465,37.7,1438,0,0,0,70,1395
ZCTA5 62601,114,1006,-892,335,32.5,329,0,0,0,2327,-1992
ZCTA5 62610,72,533,-461,163,47.1,163,0,0,0,1364,-1201
ZCTA5 62611,463,308,155,1343,35.3,1311,0,0,0,680,663
ZCTA5 62612,627,182,445,1491,44.7,1435,0,25,0.01676727,440,1051
ZCTA5 62613,1544,149,1395,4023,36.3,3811,29,98,0.02435993,312,3711
ZCTA5 62615,1977,213,1764,5514,35.9,5403,11,43,0.007798332,539,4975
ZCTA5 62617,268,8072,-7804,518,53.9,504,0,0,0,21293,-20775
ZCTA5 62618,2763,361,2402,7462,36.6,5711,76,412,0.05521308,897,6565
ZCTA5 62621,445,170,275,1143,45.6,1091,42,0,0,381,762
ZCTA5 62622,8,535,-527,50,34.3,23,8,0,0,1187,-1137
ZCTA5 62624,132,383,-251,321,51.1,314,0,5,0.015576324,960,-639
ZCTA5 62625,375,341,34,951,51.3,906,0,0,0,818,133
ZCTA5 62626,2913,86,2827,7810,43.4,7261,0,147,0.018822023,208,7602
ZCTA5 62627,441,295,146,1019,47.1,978,0,0,0,766,253
ZCTA5 62628,305,821,-516,767,42.9,737,0,0,0,1812,-1045
ZCTA5 62629,5650,139,5511,15214,35.6,14247,160,269,0.017681083,325,14889
ZCTA5 62630,254,88,166,665,46.7,652,0,0,0,181,484
ZCTA5 62631,127,88,39,254,52,247,0,0,0,326,-72
ZCTA5 62633,234,154,80,602,43.3,558,0,0,0,343,259
ZCTA5 62634,426,155,271,1038,40.7,993,0,1,0.000963391,418,620
ZCTA5 62635,295,392,-97,683,39.8,681,0,0,0,994,-311
ZCTA5 62638,528,487,41,1389,46.6,1385,3,0,0,1160,229
ZCTA5 62639,118,550,-432,266,43.7,262,0,0,0,1213,-947
ZCTA5 62640,1235,205,1030,3446,44,3364,0,0,0,619,2827
ZCTA5 62642,545,488,57,1276,44.1,1265,0,0,0,1185,91
ZCTA5 62643,278,990,-712,673,35.7,634,0,0,0,2763,-2090
ZCTA5 62644,2105,140,1965,4745,44.1,4542,12,35,0.007376185,305,4440
ZCTA5 62649,176,3228,-3052,415,46.8,408,0,0,0,7929,-7514
ZCTA5 62650,9923,1308,8615,24964,40.3,21517,192,2055,0.082318539,3128,21836
ZCTA5 62655,233,1298,-1065,592,40.7,575,0,0,0,3583,-2991
ZCTA5 62656,6828,101,6727,18380,39.6,15459,123,2021,0.109956474,240,18140
ZCTA5 62661,540,314,226,1481,32.9,1446,5,10,0.006752194,675,806
ZCTA5 62663,88,525,-437,205,52.1,205,0,0,0,1523,-1318
ZCTA5 62664,1277,138,1139,3011,46.9,2937,15,10,0.003321156,244,2767
ZCTA5 62665,572,529,43,1390,47.3,1321,0,0,0,1531,-141
ZCTA5 62666,176,222,-46,452,47.5,444,0,0,0,645,-193
ZCTA5 62667,247,1860,-1613,579,50.3,566,0,12,0.020725389,4005,-3426
ZCTA5 62668,492,46,446,1333,43,1275,0,25,0.018754689,152,1181
ZCTA5 62670,1048,111,937,2606,44,2556,7,36,0.013814275,276,2330
ZCTA5 62671,202,6985,-6783,485,42.6,445,0,0,0,16391,-15906
ZCTA5 62672,73,574,-501,153,57.6,153,0,0,0,1468,-1315
ZCTA5 62673,162,629,-467,346,54.5,346,0,0,0,1437,-1091
ZCTA5 62674,551,372,179,1427,46.8,1421,0,0,0,835,592
ZCTA5 62675,2582,280,2302,6033,45.8,5853,23,17,0.002817835,795,5238
ZCTA5 62677,844,1521,-677,2018,53.1,2002,1,0,0,3457,-1439
ZCTA5 62681,2095,169,1926,5683,47.9,5220,15,335,0.058947739,441,5242
ZCTA5 62682,279,428,-149,686,42.5,651,11,3,0.004373178,934,-248
ZCTA5 62684,2038,1136,902,5520,43.7,5124,2,266,0.048188406,2776,2744
ZCTA5 62685,692,5184,-4492,1844,47.3,1599,2,225,0.122017354,16944,-15100
ZCTA5 62688,329,583,-254,771,46,763,0,0,0,1503,-732
ZCTA5 62689,251,1553,-1302,549,32,530,11,0,0,4362,-3813
ZCTA5 62690,1565,414,1151,3791,41.6,3769,14,8,0.002110261,1178,2613
ZCTA5 62691,910,385,525,2247,44.5,2169,5,14,0.00623053,1066,1181
ZCTA5 62692,842,222,620,2057,42.2,1934,32,39,0.01895965,563,1494
ZCTA5 62693,659,398,261,1733,39.9,1671,8,22,0.012694749,1053,680
ZCTA5 62694,1197,1132,65,2995,45.3,2888,0,12,0.004006678,2595,400
ZCTA5 62695,198,10114,-9916,478,50,472,2,0,0,26864,-26386
ZCTA5 62701,515,4404,-3889,1048,37.5,615,63,261,0.249045802,11335,-10287
ZCTA5 62702,15167,586,14581,33303,38.9,24482,406,6352,0.190733568,1711,31592
ZCTA5 62703,12391,1660,10731,28768,37.9,16308,183,10382,0.360887097,4406,24362
ZCTA5 62704,18930,424,18506,40407,39.5,31350,1758,5675,0.140445962,1197,39210
ZCTA5 62706,0,251,-251,0,-,0,0,0,#DIV/0!,616,-616
ZCTA5 62707,3500,644,2856,7973,47.8,6992,96,204,0.025586354,1763,6210
ZCTA5 62711,7384,124,7260,17752,45.4,15012,1049,846,0.047656602,344,17408
ZCTA5 62712,4328,1297,3031,9955,46.5,8761,328,556,0.055851331,4017,5938
ZCTA5 62801,7711,540,7171,20243,42.7,17071,203,2061,0.101812972,1451,18792
ZCTA5 62803,420,341,79,1126,36.3,1073,23,15,0.013321492,709,417
ZCTA5 62806,1384,3217,-1833,3308,41,3196,20,0,0,8230,-4922
ZCTA5 62807,381,104,277,887,41.8,882,0,0,0,254,633
ZCTA5 62808,664,44,620,1783,39.2,1776,0,2,0.001121705,127,1656
ZCTA5 62809,134,4565,-4431,357,40.1,354,0,0,0,10854,-10497
ZCTA5 62810,387,782,-395,926,39,855,5,0,0,2105,-1179
ZCTA5 62811,130,78,52,325,33.8,317,0,0,0,203,122
ZCTA5 62812,4773,98,4675,11514,41.6,10947,0,95,0.008250825,265,11249
ZCTA5 62814,707,13711,-13004,1840,38,1734,0,0,0,34967,-33127
ZCTA5 62815,94,3655,-3561,228,48.7,218,0,0,0,9411,-9183
ZCTA5 62816,464,1425,-961,1059,50.8,998,0,0,0,3793,-2734
ZCTA5 62817,269,286,-17,542,62.1,473,0,0,0,718,-176
ZCTA5 62818,177,313,-136,407,48.9,376,0,0,0,773,-366
ZCTA5 62819,148,1252,-1104,309,44.4,303,0,0,0,3335,-3026
ZCTA5 62820,71,16,55,213,35.5,212,0,0,0,34,179
ZCTA5 62821,3089,221,2868,7117,45.8,6852,71,64,0.008992553,533,6584
ZCTA5 62822,1195,2212,-1017,2517,42.7,2346,12,2,0.000794597,5645,-3128
ZCTA5 62823,680,22,658,1854,41.5,1786,0,10,0.005393743,55,1799
ZCTA5 62824,675,36,639,1692,38.8,1655,0,9,0.005319149,114,1578
ZCTA5 62825,118,35,83,249,50.1,243,0,0,0,124,125
ZCTA5 62827,497,20,477,1175,48.1,1156,0,5,0.004255319,36,1139
ZCTA5 62828,480,4,476,1336,39.3,1336,0,0,0,4,1332
ZCTA5 62829,59,204,-145,159,28.6,159,0,0,0,560,-401
ZCTA5 62830,590,414,176,1263,47.2,1172,11,8,0.006334125,1014,249
ZCTA5 62831,197,12,185,378,59.6,374,0,4,0.010582011,12,366
ZCTA5 62832,3786,446,3340,8932,41.8,7991,53,353,0.039520824,1103,7829
ZCTA5 62833,143,9504,-9361,319,52.6,319,0,0,0,24504,-24185
ZCTA5 62835,504,55,449,1328,45.4,1306,0,6,0.004518072,111,1217
ZCTA5 62836,338,280,58,896,40.2,873,0,0,0,843,53
ZCTA5 62837,3779,89,3690,8453,45,8031,34,162,0.019164794,261,8192
ZCTA5 62838,697,2110,-1413,1953,37.5,1938,0,0,0,5244,-3291
ZCTA5 62839,2747,415,2332,6418,44.2,6008,15,17,0.0026488,1058,5360
ZCTA5 62841,50,265,-215,189,36.3,189,0,0,0,608,-419
ZCTA5 62842,297,627,-330,704,48.5,692,5,0,0,1597,-893
ZCTA5 62843,74,63,11,127,57.3,127,0,0,0,135,-8
ZCTA5 62844,856,1065,-209,2015,40.5,1926,6,21,0.010421836,2695,-680
ZCTA5 62846,299,43,256,2332,41.9,1647,0,513,0.219982847,71,2261
ZCTA5 62848,271,6654,-6383,618,45.8,547,0,47,0.07605178,16553,-15935
ZCTA5 62849,792,2527,-1735,2070,37.4,1985,9,0,0,6690,-4620
ZCTA5 62850,145,417,-272,639,17,636,0,0,0,1130,-491
ZCTA5 62851,91,170,-79,246,44,244,0,0,0,356,-110
ZCTA5 62852,61,85,-24,130,50.2,120,4,0,0,192,-62
ZCTA5 62853,347,93,254,1019,37.4,990,7,0,0,299,720
ZCTA5 62854,752,377,375,1571,45.7,1557,0,0,0,1071,500
ZCTA5 62856,140,353,-213,309,51.8,295,0,0,0,1019,-710
ZCTA5 62858,1183,9209,-8026,3057,40.4,2972,1,41,0.013411842,23370,-20313
ZCTA5 62859,2167,137,2030,5411,43.8,5173,0,17,0.003141748,383,5028
ZCTA5 62860,207,441,-234,380,56.2,372,0,0,0,1097,-717
ZCTA5 62861,56,1242,-1186,166,37.3,166,0,0,0,3136,-2970
ZCTA5 62862,132,515,-383,325,40.5,325,0,0,0,1296,-971
ZCTA5 62863,3992,71,3921,9305,45.4,8860,155,10,0.001074691,231,9074
ZCTA5 62864,9580,1740,7840,23111,40.6,19415,369,2438,0.105490892,4364,18747
ZCTA5 62865,870,12,858,1988,49.6,1988,0,0,0,30,1958
ZCTA5 62867,150,316,-166,406,40.5,387,0,0,0,905,-499
ZCTA5 62868,674,94,580,1648,38.5,1629,0,3,0.001820388,257,1391
ZCTA5 62869,916,461,455,2626,38,2543,0,9,0.003427266,1168,1458
ZCTA5 62870,877,2794,-1917,2168,46.9,2060,0,28,0.012915129,7044,-4876
ZCTA5 62871,241,135,106,700,36,627,0,0,0,278,422
ZCTA5 62872,416,2453,-2037,1182,41.8,1066,0,0,0,6766,-5584
ZCTA5 62874,192,612,-420,384,46.5,364,0,0,0,1514,-1130
ZCTA5 62875,489,165,324,1306,42.6,1264,4,0,0,486,820
ZCTA5 62876,68,5445,-5377,138,53,136,0,0,0,12868,-12730
ZCTA5 62877,186,2136,-1950,434,48.4,405,0,3,0.006912442,5671,-5237
ZCTA5 62878,154,635,-481,300,49.9,297,0,3,0.01,1591,-1291
ZCTA5 62879,14,15,-1,40,44,38,0,0,0,35,5
ZCTA5 62880,251,560,-309,641,47.6,637,0,0,0,1461,-820
ZCTA5 62881,4497,101,4396,10897,40.6,10265,45,274,0.025144535,267,10630
ZCTA5 62882,902,1667,-765,2322,41.3,2146,2,12,0.005167959,4011,-1689
ZCTA5 62883,238,545,-307,624,43.1,624,0,0,0,1386,-762
ZCTA5 62884,1110,112,998,2776,42.5,2657,63,0,0,308,2468
ZCTA5 62885,238,514,-276,550,41.3,484,0,29,0.052727273,1283,-733
ZCTA5 62886,113,5052,-4939,280,46.8,262,12,6,0.021428571,13000,-12720
ZCTA5 62887,84,36,48,227,33.9,221,0,0,0,116,111
ZCTA5 62888,787,615,172,1864,48.3,1840,0,0,0,1492,372
ZCTA5 62889,436,2526,-2090,1140,45.4,979,0,65,0.057017544,6208,-5068
ZCTA5 62890,967,195,772,2278,41.7,2212,0,5,0.002194908,502,1776
ZCTA5 62891,298,484,-186,684,40.9,654,0,8,0.011695906,1416,-732
ZCTA5 62892,93,320,-227,215,49.2,213,2,0,0,776,-561
ZCTA5 62893,351,1572,-1221,905,50.2,888,0,0,0,3795,-2890
ZCTA5 62894,352,431,-79,946,39.3,901,5,18,0.019027484,1012,-66
ZCTA5 62895,805,2040,-1235,1856,46.6,1833,0,0,0,5149,-3293
ZCTA5 62896,4722,115,4607,11033,43.8,10672,19,62,0.005619505,293,10740
ZCTA5 62897,181,788,-607,462,35,441,0,0,0,2121,-1659
ZCTA5 62898,810,1370,-560,2159,37.2,2006,20,13,0.006021306,4046,-1887
ZCTA5 62899,555,50,505,1707,28.7,1670,2,0,0,128,1579
ZCTA5 62901,10482,281,10201,23296,25.8,14697,1292,5952,0.255494505,676,22620
ZCTA5 62902,1834,27,1807,4232,43.7,3582,245,159,0.037570888,89,4143
ZCTA5 62903,1278,190,1088,2993,24.8,2098,179,336,0.112261945,480,2513
ZCTA5 62905,220,13753,-13533,561,49.7,528,8,0,0,34429,-33868
ZCTA5 62906,2996,0,2996,7332,47.6,7002,33,161,0.021958538,0,7332
ZCTA5 62907,659,481,178,1805,41.2,1788,0,2,0.001108033,1197,608
ZCTA5 62908,151,1605,-1454,395,50.7,381,0,0,0,3825,-3430
ZCTA5 62910,808,27,781,2174,42.3,1863,0,293,0.134774609,94,2080
ZCTA5 62912,569,3901,-3332,1566,35.3,1560,1,0,0,10064,-8498
ZCTA5 62914,681,317,364,1968,47.3,613,0,1283,0.651930894,831,1137
ZCTA5 62915,208,1071,-863,443,33.5,319,6,53,0.119638826,3084,-2641
ZCTA5 62916,307,565,-258,772,44.3,769,0,0,0,1521,-749
ZCTA5 62917,951,578,373,2564,39.7,2086,0,428,0.166926677,1429,1135
ZCTA5 62918,4384,178,4206,10729,36.6,9668,175,328,0.030571349,548,10181
ZCTA5 62919,290,293,-3,819,43.8,755,0,50,0.061050061,777,42
ZCTA5 62920,1213,368,845,3013,46.9,2591,8,0,0,1038,1975
ZCTA5 62921,127,743,-616,301,34.4,202,0,69,0.22923588,1827,-1526
ZCTA5 62922,1262,444,818,3298,43.9,3275,0,0,0,1245,2053
ZCTA5 62923,162,152,10,424,42.3,392,0,16,0.037735849,384,40
ZCTA5 62924,1137,158,979,2819,39.7,2672,9,38,0.013479957,383,2436
ZCTA5 62926,732,638,94,2053,40.3,1950,3,21,0.010228933,1594,459
ZCTA5 62927,149,448,-299,353,39.3,349,0,0,0,1081,-728
ZCTA5 62928,28,83,-55,49,40.3,48,0,0,0,200,-151
ZCTA5 62930,2567,353,2214,5566,48,5265,65,10,0.001796622,959,4607
ZCTA5 62931,602,2556,-1954,1365,58,1297,0,17,0.012454212,5985,-4620
ZCTA5 62932,502,1219,-717,1164,45.3,1014,0,6,0.005154639,3153,-1989
ZCTA5 62933,518,764,-246,1184,49.6,963,6,16,0.013513514,1910,-726
ZCTA5 62934,280,0,280,641,55.1,641,0,0,0,0,641
ZCTA5 62935,845,243,602,2225,39.7,2153,9,0,0,613,1612
ZCTA5 62938,1029,1140,-111,2807,52.6,2505,5,120,0.042750267,2534,273
ZCTA5 62939,1105,1109,-4,2715,50.3,2698,0,0,0,2159,556
ZCTA5 62940,243,725,-482,798,23.7,757,0,0,0,1717,-919
ZCTA5 62941,266,269,-3,702,47.7,633,4,10,0.014245014,623,79
ZCTA5 62942,255,1325,-1070,646,35.1,614,0,0,0,3167,-2521
ZCTA5 62943,133,10341,-10208,374,36.7,328,0,0,0,27259,-26885
ZCTA5 62946,5152,9230,-4078,12215,39.6,11353,86,210,0.017191977,25991,-13776
ZCTA5 62947,199,11340,-11141,373,67.4,368,5,0,0,30151,-29778
ZCTA5 62948,5468,1752,3716,12800,40.5,11307,295,398,0.03109375,4995,7805
ZCTA5 62949,377,170,207,847,42.8,757,9,20,0.023612751,395,452
ZCTA5 62950,67,385,-318,132,52.1,124,0,0,0,932,-800
ZCTA5 62951,2103,730,1373,5115,48.6,4971,0,8,0.001564027,1861,3254
ZCTA5 62952,1150,1453,-303,3189,39.8,2997,9,36,0.011288805,3663,-474
ZCTA5 62953,89,199,-110,282,26.4,260,0,13,0.046099291,471,-189
ZCTA5 62954,342,62,280,662,61.4,662,0,0,0,158,504
ZCTA5 62956,410,6407,-5997,1387,33.6,1323,0,14,0.010093727,16715,-15328
ZCTA5 62957,231,5633,-5402,599,43.6,573,0,17,0.028380634,16210,-15611
ZCTA5 62958,823,9457,-8634,2065,46.8,1909,49,53,0.02566586,24463,-22398
ZCTA5 62959,11667,2813,8854,27446,41.6,24222,374,1822,0.066384901,8190,19256
ZCTA5 62960,4239,360,3879,10673,46.4,9454,32,569,0.053312096,1013,9660
ZCTA5 62961,11,106,-95,31,37.5,31,0,0,0,363,-332
ZCTA5 62962,0,2574,-2574,0,-,0,0,0,#DIV/0!,6419,-6419
ZCTA5 62963,217,2530,-2313,746,40.5,439,7,293,0.392761394,6313,-5567
ZCTA5 62964,498,1682,-1184,1257,48,326,0,912,0.725536993,4480,-3223
ZCTA5 62965,10,8811,-8801,36,53.3,36,0,0,0,21631,-21595
ZCTA5 62966,6124,9020,-2896,14419,39.7,11518,88,1264,0.087662112,20945,-6526
ZCTA5 62967,108,2107,-1999,348,61.3,327,3,0,0,5256,-4908
ZCTA5 62969,101,1615,-1514,237,56.6,237,0,0,0,3841,-3604
ZCTA5 62970,217,14380,-14163,619,56.1,520,0,95,0.153473344,33467,-32848
ZCTA5 62972,425,5933,-5508,1190,39.6,1036,9,0,0,16756,-15566
ZCTA5 62974,635,5584,-4949,1624,43.3,1587,7,0,0,13680,-12056
ZCTA5 62975,80,2388,-2308,140,59.8,140,0,0,0,7079,-6939
ZCTA5 62976,117,4644,-4527,255,50.2,132,0,109,0.42745098,13017,-12762
ZCTA5 62977,281,1364,-1083,744,38.4,733,0,0,0,3516,-2772
ZCTA5 62979,469,2162,-1693,865,48.6,812,5,0,0,5713,-4848
ZCTA5 62982,400,7714,-7314,1111,46.8,1111,0,0,0,20467,-19356
ZCTA5 62983,723,6030,-5307,1531,49.1,1426,0,62,0.040496408,16457,-14926
ZCTA5 62984,637,7,630,1596,45.2,1569,0,0,0,94,1502
ZCTA5 62985,259,8,251,1011,46.1,998,4,0,0,19,992
ZCTA5 62987,545,2451,-1906,1464,42,1367,0,0,0,5707,-4243
ZCTA5 62988,420,13362,-12942,1360,46.1,847,1,456,0.335294118,36474,-35114
ZCTA5 62990,318,1171,-853,1228,31.3,1136,0,80,0.06514658,3347,-2119
ZCTA5 62992,234,328,-94,759,41.4,661,0,97,0.127799736,904,-145
ZCTA5 62994,254,89,165,720,30.7,663,0,0,0,227,493
ZCTA5 62995,1388,299,1089,6113,41.4,4768,25,1205,0.19712089,779,5334
ZCTA5 62996,154,3976,-3822,503,32.4,348,0,56,0.111332008,11611,-11108
ZCTA5 62997,217,3572,-3355,565,32.9,543,0,4,0.007079646,9368,-8803
ZCTA5 62998,88,746,-658,158,46.7,158,0,0,0,1791,-1633
ZCTA5 62999,621,3351,-2730,1579,41.4,1528,0,7,0.004433186,9669,-8090
ZCTA5 63005,7118,4622,2496,19294,45.5,14897,2669,155,0.008033586,12569,6725
ZCTA5 63010,13768,4672,9096,34776,40.6,32401,378,201,0.005779848,12070,22706
ZCTA5 63011,14309,8704,5605,37037,44,31479,2153,824,0.022248022,22728,14309
ZCTA5 63012,3861,4730,-869,11114,34.9,10437,43,36,0.003239158,14208,-3094
ZCTA5 63013,528,7427,-6899,1426,51.5,1409,0,0,0,20375,-18949
ZCTA5 63014,305,595,-290,650,49,607,0,37,0.056923077,1812,-1162
ZCTA5 63015,805,3534,-2729,1930,54.4,1872,0,9,0.004663212,8694,-6764
ZCTA5 63016,2865,8036,-5171,7083,44,6626,27,0,0,21121,-14038
ZCTA5 63017,17110,440,16670,42783,47.2,33064,5491,1620,0.037865507,1226,41557
ZCTA5 63019,1904,4204,-2300,4510,37.1,3895,6,208,0.046119734,10866,-6356
ZCTA5 63020,7781,29,7752,19777,44.1,18128,106,56,0.002831572,64,19713
ZCTA5 63021,22254,30,22224,56646,40.5,46368,4721,1274,0.022490555,64,56582
ZCTA5 63023,2035,10335,-8300,5172,43.4,5058,18,0,0,27401,-22229
ZCTA5 63025,6094,460,5634,17500,40.4,15961,383,77,0.0044,1187,16313
ZCTA5 63026,17026,562,16464,45061,40.8,40518,490,755,0.016755065,1482,43579
ZCTA5 63028,10679,1079,9600,27597,41.7,25385,461,384,0.013914556,2843,24754
ZCTA5 63030,80,0,80,260,31.3,246,0,14,0.053846154,339,-79
ZCTA5 63031,18634,0,18634,49903,37.7,26012,436,19639,0.393543474,0,49903
ZCTA5 63033,16702,2649,14053,41560,37.8,11425,493,27352,0.65813282,3698,37862
ZCTA5 63034,6592,3255,3337,18927,43.1,4656,286,12277,0.648650077,7712,11215
ZCTA5 63036,549,3900,-3351,1281,56.5,1143,0,0,0,8348,-7067
ZCTA5 63037,1246,4090,-2844,2804,48.9,2750,8,0,0,9279,-6475
ZCTA5 63038,2645,6203,-3558,7600,46.8,7092,262,100,0.013157895,14896,-7296
ZCTA5 63039,195,9158,-8963,613,32.3,613,0,0,0,15848,-15235
ZCTA5 63040,3188,4983,-1795,8589,40.5,7022,565,63,0.007334963,7949,640
ZCTA5 63041,122,4747,-4625,254,59.6,254,0,0,0,11719,-11465
ZCTA5 63042,8451,11979,-3528,18419,35.1,8833,613,7172,0.389380531,24451,-6032
ZCTA5 63043,9456,6891,2565,22767,37.7,15124,3459,2889,0.126894189,14445,8322
ZCTA5 63044,4290,5877,-1587,10600,42.2,7863,373,1522,0.143584906,13609,-3009
ZCTA5 63045,0,17309,-17309,0,-,0,0,0,#DIV/0!,41760,-41760
ZCTA5 63047,0,11042,-11042,0,-,0,0,0,#DIV/0!,27683,-27683
ZCTA5 63048,1411,233,1178,4066,37.7,3563,20,122,0.030004919,373,3693
ZCTA5 63049,6514,3317,3197,17331,41.8,15837,314,24,0.001384802,10082,7249
ZCTA5 63050,6238,3899,2339,17584,39.8,16460,58,125,0.007108735,11267,6317
ZCTA5 63051,4583,610,3973,12145,39.6,11218,57,0,0,1678,10467
ZCTA5 63052,10438,1956,8482,28452,37.9,26785,116,99,0.003479544,5985,22467
ZCTA5 63053,40,6317,-6277,80,55,80,0,0,0,16343,-16263
ZCTA5 63055,655,4867,-4212,1804,40.1,1742,0,0,0,12014,-10210
ZCTA5 63056,628,3741,-3113,1669,41.9,1585,0,0,0,9178,-7509
ZCTA5 63060,792,8343,-7551,1809,51.1,1601,0,7,0.003869541,21250,-19441
ZCTA5 63061,53,10087,-10034,165,44.7,155,0,0,0,22559,-22394
ZCTA5 63068,2048,5526,-3478,5695,36.4,5300,0,20,0.003511853,13228,-7533
ZCTA5 63069,5591,14414,-8823,13888,44,11920,85,763,0.054939516,34953,-21065
ZCTA5 63070,2995,7951,-4956,8030,37.8,7210,0,262,0.032627646,21832,-13802
ZCTA5 63071,493,982,-489,1286,43.9,1237,0,0,0,2156,-870
ZCTA5 63072,1229,4412,-3183,4208,39.2,4071,0,81,0.019249049,11737,-7529
ZCTA5 63073,542,9931,-9389,1711,46.6,1686,0,0,0,24727,-23016
ZCTA5 63074,6989,573,6416,16336,33.7,8238,305,5676,0.347453477,1816,14520
ZCTA5 63077,4698,2153,2545,11465,39.5,10778,31,59,0.005146097,5154,6311
ZCTA5 63079,105,692,-587,193,61.8,191,0,0,0,1467,-1274
ZCTA5 63080,5543,210,5333,13176,44.2,12454,18,2,0.000151791,751,12425
ZCTA5 63084,7385,145,7240,20173,36.9,18744,146,293,0.014524364,277,19896
ZCTA5 63087,323,1359,-1036,766,53.3,766,0,0,0,3083,-2317
ZCTA5 63088,4249,10321,-6072,8544,39.5,7342,288,610,0.071395131,24023,-15479
ZCTA5 63089,2073,9703,-7630,6112,38.7,5772,13,124,0.020287958,26126,-20014
ZCTA5 63090,8899,2213,6686,21928,41.6,20956,158,64,0.002918643,5045,16883
ZCTA5 63091,521,4321,-3800,1446,44,1374,0,0,0,9606,-8160
ZCTA5 63101,2133,8455,-6322,3186,32.3,1495,111,1432,0.449466416,22080,-18894
ZCTA5 63102,1277,1779,-502,2365,37,1114,107,908,0.383932347,4907,-2542
ZCTA5 63103,5051,5155,-104,9311,32.2,4146,766,3816,0.409837826,15807,-6496
ZCTA5 63104,9644,1834,7810,20253,35.6,10140,386,8554,0.422357182,5074,15179
ZCTA5 63105,6515,128,6387,18827,29.8,14240,2001,1370,0.072767833,361,18466
ZCTA5 63106,4008,313,3695,8924,32.4,609,0,8123,0.910242044,636,8288
ZCTA5 63107,3841,147,3694,9069,41.5,664,12,8266,0.91145661,327,8742
ZCTA5 63108,11016,15,11001,20291,33.8,11284,2119,6149,0.303040757,19,20272
ZCTA5 63109,14028,121,13907,26392,42.7,23983,465,986,0.037359806,358,26034
ZCTA5 63110,8737,150,8587,17202,34.6,11317,718,3884,0.225787699,410,16792
ZCTA5 63111,8659,0,8659,21643,34.1,9458,460,9971,0.46070323,0,21643
ZCTA5 63112,8859,446,8413,19102,34.2,4619,598,12681,0.663857188,1256,17846
ZCTA5 63113,4471,1048,3423,11141,49.2,743,15,10162,0.91212638,2636,8505
ZCTA5 63114,14870,38,14832,34720,37.9,19101,1042,10021,0.288623272,95,34625
ZCTA5 63115,6860,326,6534,16753,40.4,131,0,16263,0.970751507,659,16094
ZCTA5 63116,19618,78,19540,43565,36.2,26950,2419,10936,0.251027201,199,43366
ZCTA5 63117,4816,345,4471,9949,37.5,8326,534,770,0.077394713,832,9117
ZCTA5 63118,11522,1750,9772,26599,34.1,11493,690,12071,0.453814053,4309,22290
ZCTA5 63119,14777,157,14620,34781,39.9,28786,764,2619,0.075299733,337,34444
ZCTA5 63120,2506,287,2219,6878,32.5,108,36,6612,0.961325967,657,6221
ZCTA5 63121,10663,371,10292,23760,39.5,3027,141,20063,0.844402357,908,22852
ZCTA5 63122,16719,4173,12546,41336,42.2,36119,793,1870,0.045239017,13444,27892
ZCTA5 63123,22071,269,21802,49886,40.7,43805,1770,1577,0.031612076,669,49217
ZCTA5 63124,4790,192,4598,10733,49,8953,939,257,0.023944843,443,10290
ZCTA5 63125,13612,30,13582,33172,37.6,29175,839,1627,0.049047389,149,33023
ZCTA5 63126,6161,32,6129,15362,40.4,14282,192,245,0.015948444,239,15123
ZCTA5 63127,2220,169,2051,5255,48.8,5033,78,80,0.015223597,440,4815
ZCTA5 63128,13083,287,12796,30333,48.6,28614,438,344,0.011340784,748,29585
ZCTA5 63129,21243,366,20877,50986,44.7,47327,779,1037,0.020338917,789,50197
ZCTA5 63130,12804,147,12657,28661,37.9,15523,1937,9629,0.33596176,349,28312
ZCTA5 63131,6822,643,6179,18407,47.4,16522,1022,249,0.013527462,1695,16712
ZCTA5 63132,6313,284,6029,14505,39.7,7349,2052,4460,0.307480179,887,13618
ZCTA5 63133,2936,43,2893,6945,36,592,5,6206,0.893592513,136,6809
ZCTA5 63134,5066,307,4759,13882,30.3,2979,15,9629,0.693632041,777,13105
ZCTA5 63135,8247,467,7780,19724,35.3,4959,85,13489,0.68388765,1443,18281
ZCTA5 63136,18718,565,18153,44223,35.4,2687,162,39986,0.904190127,1509,42714
ZCTA5 63137,8410,119,8291,20377,40.4,3593,14,16319,0.800853904,258,20119
ZCTA5 63138,7197,432,6765,18250,31.2,2901,1,14627,0.801479452,980,17270
ZCTA5 63139,10570,475,10095,21447,35.7,16307,934,2998,0.13978645,1161,20286
ZCTA5 63140,122,189,-67,291,23.6,139,3,125,0.429553265,450,-159
ZCTA5 63141,9092,221,8871,21027,46.4,16353,2318,1441,0.068530936,488,20539
ZCTA5 63143,4803,99,4704,9267,34.5,6905,214,1215,0.131110392,187,9080
ZCTA5 63144,4555,993,3562,8930,36.4,7211,534,371,0.041545353,2693,6237
ZCTA5 63146,15092,143,14949,30995,40.8,20637,4451,4685,0.151153412,336,30659
ZCTA5 63147,3504,622,2882,8317,47,334,0,7661,0.921125406,1317,7000
ZCTA5 63155,0,110,-110,0,-,0,0,0,#DIV/0!,252,-252
ZCTA5 63301,20441,91,20350,51261,36.1,44236,1134,2560,0.049940501,204,51057
ZCTA5 63303,20679,153,20526,47772,40.9,39442,2125,3377,0.070689944,370,47402
ZCTA5 63304,15685,327,15358,42342,41.9,38369,863,1383,0.032662605,814,41528
ZCTA5 63330,50,643,-593,80,54.6,78,0,0,0,1631,-1551
ZCTA5 63332,577,1584,-1007,1630,41.8,1566,0,1,0.000613497,4189,-2559
ZCTA5 63333,312,240,72,821,46.7,798,5,0,0,499,322
ZCTA5 63334,2471,78,2393,7771,37.6,6628,49,942,0.12121992,169,7602
ZCTA5 63336,469,5776,-5307,1184,52.6,1110,0,48,0.040540541,15915,-14731
ZCTA5 63339,318,850,-532,924,41.1,901,1,3,0.003246753,2369,-1445
ZCTA5 63341,1364,731,633,3486,49.3,3361,0,8,0.002294894,1475,2011
ZCTA5 63343,1672,225,1447,4692,35.2,4456,2,71,0.01513214,566,4126
ZCTA5 63344,676,649,27,1799,41.4,1744,0,11,0.006114508,1540,259
ZCTA5 63345,261,355,-94,728,34.6,613,0,103,0.141483516,900,-172
ZCTA5 63347,903,134,769,2679,44.2,2629,0,39,0.014557671,316,2363
ZCTA5 63348,3766,158,3608,10578,42.8,10036,2,213,0.020136132,403,10175
ZCTA5 63349,666,1369,-703,1862,51.2,1772,6,61,0.032760473,3530,-1668
ZCTA5 63350,233,381,-148,598,39,593,3,0,0,1153,-555
ZCTA5 63351,666,133,533,1699,52.3,1614,0,16,0.009417304,339,1360
ZCTA5 63352,575,474,101,1258,55.8,1228,0,17,0.013513514,1163,95
ZCTA5 63353,1933,935,998,4910,38,4257,15,180,0.036659878,2071,2839
ZCTA5 63357,2052,230,1822,6583,37,6299,164,57,0.008658666,587,5996
ZCTA5 63359,557,398,159,1385,44.3,1359,0,2,0.001444043,1053,332
ZCTA5 63361,1932,3066,-1134,4578,40,4192,8,127,0.027741372,7951,-3373
ZCTA5 63362,3057,270,2787,8576,30.7,8001,0,241,0.028101679,586,7990
ZCTA5 63363,616,374,242,1573,40.5,1442,0,19,0.01207883,862,711
ZCTA5 63365,33,761,-728,79,62.2,67,0,0,0,1970,-1891
ZCTA5 63366,19650,808,18842,51995,39.5,45743,1509,1638,0.031503029,2236,49759
ZCTA5 63367,9831,803,9028,26767,39.3,23928,413,1392,0.052004334,1909,24858
ZCTA5 63368,16470,631,15839,45246,37.7,38269,2419,1948,0.04305353,1637,43609
ZCTA5 63369,886,177,709,2342,36.2,2278,12,49,0.020922289,462,1880
ZCTA5 63373,255,402,-147,701,45.3,665,0,5,0.007132668,986,-285
ZCTA5 63376,28824,47,28777,75016,39.8,66850,1473,3412,0.04548363,106,74910
ZCTA5 63377,1184,200,984,3220,47.6,3124,0,68,0.021118012,515,2705
ZCTA5 63379,9754,172,9582,26575,37.1,24409,72,803,0.030216369,413,26162
ZCTA5 63380,268,38,230,776,31.8,640,13,32,0.041237113,94,682
ZCTA5 63381,208,4636,-4428,727,35.2,713,0,0,0,12554,-11827
ZCTA5 63382,1177,4814,-3637,4174,36.8,3473,29,437,0.104695736,12395,-8221
ZCTA5 63383,5765,3983,1782,14886,42.2,13855,73,138,0.009270455,10964,3922
ZCTA5 63384,793,5181,-4388,1969,44,1797,0,18,0.009141696,13559,-11590
ZCTA5 63385,16258,9145,7113,47110,36.7,41959,870,2644,0.056123965,23377,23733
ZCTA5 63386,169,5249,-5080,459,37.5,453,0,2,0.004357298,14592,-14133
ZCTA5 63387,49,4425,-4376,122,34,120,0,0,0,12093,-11971
ZCTA5 63388,395,205,190,766,58.2,677,0,89,0.11618799,522,244
ZCTA5 63389,2346,218,2128,6401,38.4,6036,73,4,0.000624902,704,5697
ZCTA5 63390,4056,210,3846,10876,41.6,9330,0,434,0.039904377,506,10370
ZCTA5 63401,8690,703,7987,21480,39,19470,110,1140,0.053072626,1706,19774
ZCTA5 63430,206,235,-29,689,35.3,651,22,0,0,563,126
ZCTA5 63431,110,2237,-2127,319,47.3,254,0,58,0.181818182,5883,-5564
ZCTA5 63432,187,206,-19,472,50.8,472,0,0,0,449,23
ZCTA5 63433,0,358,-358,0,-,0,0,0,#DIV/0!,867,-867
ZCTA5 63434,252,274,-22,702,35.7,644,10,0,0,596,106
ZCTA5 63435,1424,1992,-568,3979,41.8,3613,4,109,0.027393818,5015,-1036
ZCTA5 63436,586,194,392,1368,46.7,1357,1,8,0.005847953,557,811
ZCTA5 63437,582,129,453,1639,38.2,1539,3,61,0.037217816,382,1257
ZCTA5 63438,121,263,-142,261,43.2,261,0,0,0,583,-322
ZCTA5 63439,85,172,-87,121,55.2,115,0,0,0,477,-356
ZCTA5 63440,366,110,256,938,44.9,885,25,6,0.006396588,251,687
ZCTA5 63441,462,1174,-712,1181,39.1,1174,4,2,0.00169348,3144,-1963
ZCTA5 63443,193,249,-56,303,57.8,299,0,0,0,625,-322
ZCTA5 63445,1268,375,893,3615,46.6,3435,50,0,0,939,2676
ZCTA5 63446,138,518,-380,283,61.6,282,0,1,0.003533569,1471,-1188
ZCTA5 63447,358,1266,-908,1268,37.7,1182,0,57,0.044952681,3338,-2070
ZCTA5 63448,545,91,454,1444,47.3,1227,12,172,0.119113573,198,1246
ZCTA5 63450,87,180,-93,186,60.6,175,0,0,0,428,-242
ZCTA5 63451,121,161,-40,255,33.6,255,0,0,0,375,-120
ZCTA5 63452,455,659,-204,1605,32.3,1587,0,12,0.007476636,2097,-492
ZCTA5 63453,115,275,-160,276,44.9,272,4,0,0,685,-409
ZCTA5 63454,350,257,93,1158,36.3,1104,11,0,0,643,515
ZCTA5 63456,1909,268,1641,4901,41.2,4475,38,169,0.034482759,672,4229
ZCTA5 63457,101,163,-62,379,33.4,370,0,8,0.021108179,470,-91
ZCTA5 63458,32,288,-256,61,34.5,51,2,1,0.016393443,735,-674
ZCTA5 63459,1502,21,1481,4161,43.5,3920,6,118,0.028358568,56,4105
ZCTA5 63460,89,90,-1,309,57.8,309,0,0,0,124,185
ZCTA5 63461,2211,106,2105,5312,40.6,4857,50,140,0.026355422,266,5046
ZCTA5 63462,594,191,403,1556,37.8,1386,7,0,0,500,1056
ZCTA5 63463,296,1278,-982,800,35.8,793,4,0,0,3368,-2568
ZCTA5 63465,149,359,-210,478,34.5,477,0,0,0,995,-517
ZCTA5 63466,23,198,-175,30,54,30,0,0,0,524,-494
ZCTA5 63467,19,452,-433,84,31.4,84,0,0,0,1002,-918
ZCTA5 63468,909,182,727,2459,43.8,2348,0,78,0.031720211,449,2010
ZCTA5 63469,413,157,256,957,50.8,938,0,12,0.012539185,357,600
ZCTA5 63471,271,558,-287,936,37,921,0,0,0,1382,-446
ZCTA5 63472,203,385,-182,565,44.8,561,0,4,0.007079646,987,-422
ZCTA5 63473,104,800,-696,321,38.4,307,14,0,0,2055,-1734
ZCTA5 63474,164,50,114,435,42.2,435,0,0,0,85,350
ZCTA5 63501,7382,931,6451,20943,26.1,18732,578,988,0.047175667,2343,18600
ZCTA5 63530,366,177,189,1337,36.6,1251,35,10,0.007479432,427,910
ZCTA5 63531,116,98,18,381,36,325,2,0,0,296,85
ZCTA5 63532,491,279,212,1143,53.5,1135,0,6,0.005249344,744,399
ZCTA5 63533,269,66,203,862,34.7,861,0,0,0,167,695
ZCTA5 63534,334,150,184,858,52,852,2,3,0.003496503,292,566
ZCTA5 63535,21,3352,-3331,27,75.4,27,0,0,0,7865,-7838
ZCTA5 63536,333,100,233,1081,28.7,1078,0,0,0,245,836
ZCTA5 63537,606,249,357,2176,39,2080,2,12,0.005514706,643,1533
ZCTA5 63538,69,235,-166,207,60.9,195,0,10,0.048309179,562,-355
ZCTA5 63539,100,5574,-5474,272,39.3,272,0,0,0,14661,-14389
ZCTA5 63540,64,1668,-1604,307,8.9,307,0,0,0,4509,-4202
ZCTA5 63541,172,178,-6,545,41,441,0,0,0,415,130
ZCTA5 63543,64,240,-176,167,27.9,164,0,0,0,620,-453
ZCTA5 63544,333,850,-517,962,52.1,891,5,8,0.008316008,2048,-1086
ZCTA5 63545,341,806,-465,871,46.4,796,0,0,0,2182,-1311
ZCTA5 63546,505,189,316,1625,47.8,1597,0,1,0.000615385,453,1172
ZCTA5 63547,190,243,-53,432,60,420,7,5,0.011574074,690,-258
ZCTA5 63548,286,2930,-2644,872,40.1,859,0,2,0.002293578,7051,-6179
ZCTA5 63549,870,492,378,2373,46.5,2308,10,5,0.002107038,1251,1122
ZCTA5 63551,93,728,-635,362,43.6,307,0,0,0,1952,-1590
ZCTA5 63552,3011,5833,-2822,7500,45,6756,63,213,0.0284,13653,-6153
ZCTA5 63555,1156,518,638,3312,37.7,3259,0,1,0.000301932,1147,2165
ZCTA5 63556,1126,438,688,3457,41.8,2788,37,131,0.037894128,1039,2418
ZCTA5 63557,83,782,-699,166,67.4,157,2,0,0,1587,-1421
ZCTA5 63558,235,154,81,648,51.9,624,0,18,0.027777778,373,275
ZCTA5 63559,599,914,-315,1951,39.4,1853,42,0,0,2346,-395
ZCTA5 63560,40,116,-76,98,26,94,0,0,0,323,-225
ZCTA5 63561,300,3259,-2959,968,39.4,951,7,10,0.010330579,7285,-6317
ZCTA5 63563,207,69,138,793,19.7,755,36,0,0,168,625
ZCTA5 63565,1366,601,765,3738,42.2,3649,0,13,0.003477796,1515,2223
ZCTA5 63566,37,1409,-1372,67,53.1,67,0,0,0,3781,-3714
ZCTA5 63567,29,596,-567,108,42.3,84,0,0,0,1464,-1356
ZCTA5 63601,6337,146,6191,16536,36,15596,3,74,0.004475085,384,16152
ZCTA5 63620,367,228,139,1124,38.2,1060,0,0,0,692,432
ZCTA5 63621,571,922,-351,1441,47.5,1400,0,8,0.0055517,2326,-885
ZCTA5 63622,425,318,107,698,48.5,682,0,0,0,746,-48
ZCTA5 63623,301,3295,-2994,824,47.6,799,0,15,0.018203883,8525,-7701
ZCTA5 63624,1371,623,748,3669,39.8,3338,31,73,0.01989643,1517,2152
ZCTA5 63625,152,603,-451,435,57.9,385,0,19,0.043678161,1404,-969
ZCTA5 63626,455,615,-160,1003,44.8,1003,0,0,0,1276,-273
ZCTA5 63627,1184,24,1160,3056,39.1,3013,0,35,0.01145288,70,2986
ZCTA5 63628,5022,165,4857,15327,40.5,13811,50,899,0.058654662,408,14919
ZCTA5 63629,460,236,224,1155,49.4,1103,8,6,0.005194805,652,503
ZCTA5 63630,1266,448,818,3543,34.1,3532,0,0,0,995,2548
ZCTA5 63631,351,291,60,886,48.3,871,0,0,0,728,158
ZCTA5 63633,235,5331,-5096,792,37.3,774,0,7,0.008838384,13660,-12868
ZCTA5 63636,192,1717,-1525,500,32.8,497,0,0,0,3688,-3188
ZCTA5 63637,401,218,183,1005,35.3,988,0,16,0.015920398,617,388
ZCTA5 63638,910,983,-73,2698,44.9,2539,0,49,0.018161601,2575,123
ZCTA5 63640,9865,323,9542,29125,40.1,26534,206,1268,0.043536481,819,28306
ZCTA5 63645,4152,49,4103,11492,41.1,11065,82,95,0.00826662,125,11367
ZCTA5 63648,505,332,173,1302,37.1,1186,22,0,0,753,549
ZCTA5 63650,1653,632,1021,4123,48.4,3895,0,76,0.01843318,1624,2499
ZCTA5 63653,492,626,-134,1739,27.8,1707,0,0,0,1471,268
ZCTA5 63654,283,344,-61,621,51.3,593,0,0,0,821,-200
ZCTA5 63655,503,14077,-13574,1281,48,1260,0,5,0.003903201,34457,-33176
ZCTA5 63656,172,15288,-15116,459,52.3,410,0,0,0,37947,-37488
ZCTA5 63660,1024,293,731,3902,36.1,3403,12,437,0.111993849,715,3187
ZCTA5 63662,417,2287,-1870,1408,47.6,1383,0,6,0.004261364,6097,-4689
ZCTA5 63663,301,334,-33,778,37.4,676,6,0,0,774,4
ZCTA5 63664,3300,33,3267,8812,43.2,8374,6,32,0.003631412,107,8705
ZCTA5 63665,94,3474,-3380,201,49.6,182,0,0,0,9509,-9308
ZCTA5 63670,4567,659,3908,11811,45.4,11239,88,112,0.009482686,1773,10038
ZCTA5 63673,741,8535,-7794,2072,38.7,2032,1,9,0.004343629,23934,-21862
ZCTA5 63674,19,1166,-1147,19,-,19,0,0,0,2999,-2980
ZCTA5 63675,15,149,-134,35,71.3,35,0,0,0,317,-282
ZCTA5 63701,14735,335,14400,38132,33.9,31823,1116,3519,0.092284695,899,37233
ZCTA5 63703,3588,1228,2360,8500,43.2,5683,13,2146,0.252470588,3474,5026
ZCTA5 63730,1414,1805,-391,3331,40.1,3291,0,3,0.00090063,4882,-1551
ZCTA5 63732,346,173,173,1056,35.9,1018,1,14,0.013257576,426,630
ZCTA5 63735,337,189,148,770,39.4,711,0,0,0,601,169
ZCTA5 63736,1548,65,1483,3823,38.8,3424,5,160,0.041851949,206,3617
ZCTA5 63738,0,8875,-8875,0,-,0,0,0,#DIV/0!,23757,-23757
ZCTA5 63739,224,1474,-1250,825,37.7,745,0,0,0,4334,-3509
ZCTA5 63740,2000,1009,991,5325,40.2,5045,0,99,0.018591549,3071,2254
ZCTA5 63742,30,1488,-1458,110,28.9,110,0,0,0,4064,-3954
ZCTA5 63743,17,145,-128,54,37.3,54,0,0,0,439,-385
ZCTA5 63744,67,79,-12,222,33.5,219,0,0,0,258,-36
ZCTA5 63745,38,437,-399,179,52.6,179,0,0,0,1070,-891
ZCTA5 63746,20,436,-416,33,65.2,33,0,0,0,1226,-1193
ZCTA5 63747,236,986,-750,659,44,621,0,0,0,2615,-1956
ZCTA5 63748,498,549,-51,1097,48.4,1061,0,8,0.007292616,1736,-639
ZCTA5 63750,13,1894,-1881,30,50.5,30,0,0,0,5150,-5120
ZCTA5 63751,412,459,-47,1431,38.9,1404,0,0,0,1346,85
ZCTA5 63755,9950,558,9392,26570,37.5,25288,66,274,0.010312382,1473,25097
ZCTA5 63758,170,5385,-5215,428,32.7,426,0,0,0,14443,-14015
ZCTA5 63760,179,292,-113,539,46.6,535,0,0,0,598,-59
ZCTA5 63763,60,361,-301,148,37.5,148,0,0,0,849,-701
ZCTA5 63764,1663,159,1504,4566,47.5,4203,0,48,0.010512484,367,4199
ZCTA5 63766,568,2418,-1850,1489,57,1449,0,14,0.009402283,5907,-4418
ZCTA5 63767,244,713,-469,547,47.8,518,0,2,0.003656307,2074,-1527
ZCTA5 63769,480,1286,-806,1535,34.1,1481,5,8,0.005211726,3013,-1478
ZCTA5 63770,72,1162,-1090,193,38.6,181,0,0,0,2659,-2466
ZCTA5 63771,935,559,376,2665,37.1,2363,8,145,0.054409006,1737,928
ZCTA5 63774,76,563,-487,281,29.4,281,0,0,0,1648,-1367
ZCTA5 63775,6148,3151,2997,16262,40.9,15464,178,80,0.004919444,7618,8644
ZCTA5 63780,2248,5368,-3120,5978,40.7,5828,1,13,0.00217464,14155,-8177
ZCTA5 63781,481,636,-155,1212,31.9,1190,0,0,0,1512,-300
ZCTA5 63782,102,434,-332,241,47.5,241,0,0,0,985,-744
ZCTA5 63783,62,269,-207,195,37.3,195,0,0,0,721,-526
ZCTA5 63784,59,4661,-4602,177,40,134,0,8,0.04519774,10928,-10751
ZCTA5 63785,496,612,-116,1224,48.8,1194,5,19,0.015522876,1601,-377
ZCTA5 63787,249,198,51,589,58.5,542,0,0,0,634,-45
ZCTA5 63801,8993,687,8306,21932,40.1,16683,132,4015,0.18306584,1827,20105
ZCTA5 63820,98,2133,-2035,259,40.8,256,0,3,0.011583012,4788,-4529
ZCTA5 63821,288,1005,-717,595,47.1,487,0,0,0,2562,-1967
ZCTA5 63822,1017,461,556,2448,48.3,2196,7,48,0.019607843,1289,1159
ZCTA5 63823,489,2360,-1871,1529,42.7,1405,0,42,0.027468934,5718,-4189
ZCTA5 63824,73,3759,-3686,193,38.3,157,0,0,0,9904,-9711
ZCTA5 63825,1550,510,1040,4334,40,4235,0,12,0.002768805,1337,2997
ZCTA5 63826,40,533,-493,148,25,92,0,0,0,1315,-1167
ZCTA5 63827,210,25,185,564,42.8,441,0,115,0.203900709,44,520
ZCTA5 63828,68,2965,-2897,175,39.4,170,0,0,0,6443,-6268
ZCTA5 63829,408,214,194,1105,23.9,997,0,0,0,870,235
ZCTA5 63830,2477,1870,607,6526,37.1,4003,0,2297,0.351976709,4835,1691
ZCTA5 63833,82,1536,-1454,134,64,132,0,1,0.007462687,4186,-4052
ZCTA5 63834,1686,487,1199,5944,38.6,2904,0,2915,0.490410498,1278,4666
ZCTA5 63837,570,238,332,1533,32.2,1369,11,54,0.035225049,651,882
ZCTA5 63839,136,458,-322,322,36.7,297,0,0,0,1269,-947
ZCTA5 63840,28,234,-206,75,37.7,68,0,0,0,510,-435
ZCTA5 63841,5454,329,5125,13471,41.1,13040,0,153,0.011357731,844,12627
ZCTA5 63845,2276,10,2266,5379,42.8,4937,11,136,0.02528351,21,5358
ZCTA5 63846,455,1476,-1021,1243,38.3,1121,0,118,0.094931617,4227,-2984
ZCTA5 63847,11,193,-182,18,-,18,0,0,0,404,-386
ZCTA5 63848,407,2840,-2433,1064,46,942,0,16,0.015037594,6943,-5879
ZCTA5 63849,104,2620,-2516,245,66.2,119,0,119,0.485714286,6551,-6306
ZCTA5 63850,8,144,-136,78,18.7,78,0,0,0,416,-338
ZCTA5 63851,1361,268,1093,3464,34.4,2085,5,1296,0.374133949,743,2721
ZCTA5 63852,550,292,258,1300,39.5,1196,0,0,0,715,585
ZCTA5 63853,68,689,-621,123,60.1,105,0,9,0.073170732,1633,-1510
ZCTA5 63855,353,1080,-727,843,40.8,783,0,33,0.039145907,3276,-2433
ZCTA5 63857,4781,302,4479,12184,39.1,9775,25,1784,0.146421536,787,11397
ZCTA5 63860,85,276,-191,205,53.6,205,0,0,0,754,-549
ZCTA5 63862,471,188,283,1344,36,908,0,297,0.220982143,460,884
ZCTA5 63863,2179,1471,708,5545,39.1,4112,28,1044,0.188277728,3432,2113
ZCTA5 63866,196,2085,-1889,528,36.2,331,0,184,0.348484848,4392,-3864
ZCTA5 63867,385,354,31,1007,40.9,971,0,8,0.007944389,798,209
ZCTA5 63868,386,975,-589,866,44.1,810,0,0,0,3931,-3065
ZCTA5 63869,1554,419,1135,3405,46.7,2386,0,879,0.25814978,1074,2331
ZCTA5 63870,421,90,331,1088,33.2,909,0,79,0.072610294,225,863
ZCTA5 63873,1626,2832,-1206,4063,40.8,3110,0,387,0.095249815,7562,-3499
ZCTA5 63874,112,421,-309,258,41.1,239,0,1,0.003875969,1124,-866
ZCTA5 63876,761,10901,-10140,2203,38.4,1809,0,23,0.010440309,29216,-27013
ZCTA5 63877,1333,16051,-14718,3372,41.6,2834,0,275,0.081553974,39251,-35879
ZCTA5 63878,34,14334,-14300,106,35.8,106,0,0,0,40537,-40431
ZCTA5 63879,316,18189,-17873,792,42.3,694,0,85,0.107323232,45136,-44344
ZCTA5 63880,32,22858,-22826,123,43,96,0,27,0.219512195,54409,-54286
ZCTA5 63882,150,0,150,347,33.5,309,0,25,0.07204611,293,54
ZCTA5 63901,13129,275,12854,34668,38.4,30523,61,2329,0.067180108,656,34012
ZCTA5 63932,350,1241,-891,875,51.1,860,0,9,0.010285714,3073,-2198
ZCTA5 63933,1230,75,1155,3166,43.3,2840,20,0,0,197,2969
ZCTA5 63934,9,4223,-4214,18,-,18,0,0,0,11516,-11498
ZCTA5 63935,2942,594,2348,8317,44.6,7915,69,30,0.00360707,1581,6736
ZCTA5 63936,173,362,-189,415,45.6,393,6,0,0,830,-415
ZCTA5 63937,911,443,468,2340,49.1,2264,1,1,0.00042735,1262,1078
ZCTA5 63939,392,3102,-2710,990,29.7,945,0,0,0,8046,-7056
ZCTA5 63940,521,823,-302,1274,55.7,1165,0,0,0,2914,-1640
ZCTA5 63941,59,157,-98,174,48.8,153,0,0,0,315,-141
ZCTA5 63942,201,41,160,544,46.8,541,0,0,0,105,439
ZCTA5 63943,189,327,-138,580,35.4,580,0,0,0,836,-256
ZCTA5 63944,582,1653,-1071,1457,53.1,1425,0,4,0.002745367,4512,-3055
ZCTA5 63945,439,211,228,1129,49.8,1129,0,0,0,560,569
ZCTA5 63950,15,8302,-8287,33,-,33,0,0,0,21990,-21957
ZCTA5 63951,93,736,-643,167,57.6,167,0,0,0,2099,-1932
ZCTA5 63952,98,1348,-1250,330,31.9,278,0,0,0,3435,-3105
ZCTA5 63953,380,607,-227,929,45.5,854,0,0,0,1595,-666
ZCTA5 63954,299,577,-278,856,48.1,747,0,78,0.091121495,1240,-384
ZCTA5 63955,78,180,-102,144,51.8,144,0,0,0,484,-340
ZCTA5 63956,292,1064,-772,942,48.2,901,3,13,0.013800425,2753,-1811
ZCTA5 63957,2096,207,1889,5514,45.1,5113,53,41,0.007435618,542,4972
ZCTA5 63960,1048,429,619,3193,39.5,3008,0,67,0.020983401,958,2235
ZCTA5 63961,711,338,373,2131,35.5,2051,0,27,0.012670108,763,1368
ZCTA5 63962,41,791,-750,224,26.3,224,0,0,0,2054,-1830
ZCTA5 63964,134,240,-106,290,52.8,290,0,0,0,643,-353
ZCTA5 63965,848,5945,-5097,2595,47,2487,0,3,0.001156069,15139,-12544
ZCTA5 63966,905,6199,-5294,2233,50.2,1995,45,0,0,18076,-15843
ZCTA5 63967,636,784,-148,1632,50.4,1598,0,4,0.00245098,1855,-223
ZCTA5 64001,287,1037,-750,788,39.1,662,92,18,0.02284264,2505,-1717
ZCTA5 64011,1427,694,733,4092,48.4,3915,36,3,0.000733138,1852,2240
ZCTA5 64012,11250,47,11203,27884,38.4,23795,146,1211,0.043429924,124,27760
ZCTA5 64014,10286,681,9605,28044,36.1,22875,294,2609,0.093032378,1487,26557
ZCTA5 64015,12125,103,12022,31269,39.5,27037,535,2019,0.064568742,276,30993
ZCTA5 64016,1876,1158,718,4858,39.8,4602,16,31,0.006381227,3062,1796
ZCTA5 64017,122,94,28,270,51.6,265,0,0,0,255,15
ZCTA5 64018,276,145,131,735,34.5,704,0,0,0,341,394
ZCTA5 64019,955,787,168,2395,44.3,1915,0,44,0.018371608,1909,486
ZCTA5 64020,1282,315,967,3273,50.1,3206,32,4,0.00122212,843,2430
ZCTA5 64021,203,27,176,681,36.3,605,0,12,0.017621145,89,592
ZCTA5 64022,50,160,-110,144,33.9,144,0,0,0,413,-269
ZCTA5 64024,5392,13545,-8153,15146,38.3,13414,103,597,0.039416348,34147,-19001
ZCTA5 64028,89,761,-672,242,53.9,219,19,0,0,3514,-3272
ZCTA5 64029,7385,24,7361,20731,36.9,18863,156,549,0.02648208,42,20689
ZCTA5 64030,10806,196,10610,25801,36.7,12836,508,8951,0.346924538,442,25359
ZCTA5 64034,3265,223,3042,8892,41.9,8253,24,243,0.027327935,602,8290
ZCTA5 64035,342,359,-17,1071,34.3,1051,0,0,0,886,185
ZCTA5 64036,135,680,-545,417,29.5,377,0,18,0.043165468,1521,-1104
ZCTA5 64037,2389,1301,1088,5916,44,5289,0,371,0.062711291,3472,2444
ZCTA5 64040,2325,730,1595,5915,41.6,5554,0,14,0.002366864,1647,4268
ZCTA5 64048,1357,105,1252,4371,37.8,4175,3,36,0.008236102,254,4117
ZCTA5 64050,9448,289,9159,21548,39.9,17077,102,1512,0.070168925,717,20831
ZCTA5 64052,9398,169,9229,22479,38.6,15638,351,1863,0.082877352,398,22081
ZCTA5 64053,2479,654,1825,6631,35,5015,54,776,0.11702609,1890,4741
ZCTA5 64054,1096,214,882,3048,37.1,2639,13,41,0.013451444,608,2440
ZCTA5 64055,15411,331,15080,36226,42.4,28824,457,3704,0.102247005,956,35270
ZCTA5 64056,5952,69,5883,17501,32.2,13701,98,2193,0.125307125,134,17367
ZCTA5 64057,6054,2261,3793,14116,44.6,11167,193,1369,0.096982148,5883,8233
ZCTA5 64058,2497,624,1873,6785,38.7,6361,97,127,0.01871776,1986,4799
ZCTA5 64060,5916,1243,4673,15575,41.7,14401,15,63,0.004044944,3072,12503
ZCTA5 64061,1124,206,918,2792,47.1,2607,0,51,0.018266476,575,2217
ZCTA5 64062,2136,5835,-3699,6401,39.9,6170,0,7,0.001093579,15833,-9432
ZCTA5 64063,8662,136,8526,21453,35.6,17123,551,1756,0.081853354,366,21087
ZCTA5 64064,7310,182,7128,19291,42.6,16231,298,1794,0.092996734,424,18867
ZCTA5 64065,7,339,-332,38,19.8,34,0,4,0.105263158,856,-818
ZCTA5 64066,21,547,-526,47,46.5,35,2,0,0,1507,-1460
ZCTA5 64067,2274,1055,1219,6139,34.7,5694,0,118,0.019221372,2536,3603
ZCTA5 64068,13467,624,12843,36780,37.2,32965,507,1541,0.041897771,1591,35189
ZCTA5 64070,1222,907,315,3179,45,2937,0,34,0.010695187,2372,807
ZCTA5 64071,249,198,51,746,48.7,553,86,67,0.089812332,482,264
ZCTA5 64072,158,4571,-4413,319,54.9,278,5,18,0.056426332,10257,-9938
ZCTA5 64074,238,1872,-1634,710,54.2,676,0,0,0,4619,-3909
ZCTA5 64075,4185,11709,-7524,11818,38.3,11321,76,239,0.020223388,32073,-20255
ZCTA5 64076,3273,26,3247,8955,43.8,8621,0,118,0.013176996,81,8874
ZCTA5 64077,565,1094,-529,1579,42.3,1421,11,10,0.006333122,2842,-1263
ZCTA5 64078,3712,103,3609,9883,40.5,9191,0,278,0.028129111,251,9632
ZCTA5 64079,4680,229,4451,13249,35.9,12220,84,223,0.016831459,507,12742
ZCTA5 64080,5108,2142,2966,14116,37.7,13144,1,471,0.033366393,5126,8990
ZCTA5 64081,9766,50,9716,25169,38.4,20072,638,2942,0.116889825,114,25055
ZCTA5 64082,6161,394,5767,18545,39.6,15223,342,1614,0.087031545,859,17686
ZCTA5 64083,9292,158,9134,24501,41.2,19903,332,2419,0.098730664,320,24181
ZCTA5 64084,644,139,505,1760,45.4,1705,23,0,0,410,1350
ZCTA5 64085,3376,1305,2071,8324,41.4,7779,0,203,0.024387314,3361,4963
ZCTA5 64086,8908,3211,5697,23635,37.7,20437,503,903,0.03820605,8509,15126
ZCTA5 64088,501,248,253,1374,42.8,1345,0,0,0,647,727
ZCTA5 64089,5021,126,4895,13723,38.1,12759,126,66,0.004809444,289,13434
ZCTA5 64090,54,2835,-2781,120,53.8,120,0,0,0,7323,-7203
ZCTA5 64092,19,47,-28,85,5.7,15,0,0,0,98,-13
ZCTA5 64093,10802,592,10210,27731,28.4,24344,641,980,0.035339512,1555,26176
ZCTA5 64096,437,400,37,1237,35.5,1102,0,19,0.015359741,849,388
ZCTA5 64097,384,246,138,1060,38.9,956,0,30,0.028301887,573,487
ZCTA5 64098,1228,783,445,3069,42.7,2868,10,22,0.007168459,1834,1235
ZCTA5 64101,5,93,-88,36,42.2,12,0,24,0.666666667,427,-391
ZCTA5 64102,0,442,-442,0,-,0,0,0,#DIV/0!,957,-957
ZCTA5 64105,3677,2300,1377,5168,29.9,4265,100,362,0.07004644,16383,-11215
ZCTA5 64106,5368,118,5250,10830,30.1,5063,891,4434,0.409418283,249,10581
ZCTA5 64108,4704,1934,2770,9057,33.8,5297,153,2281,0.251849398,4855,4202
ZCTA5 64109,4519,119,4400,9919,33.8,4147,244,4562,0.459925396,243,9676
ZCTA5 64110,7441,1515,5926,17400,30.7,8744,566,6510,0.374137931,4004,13396
ZCTA5 64111,10418,62,10356,17039,32.8,13549,262,1610,0.094489113,204,16835
ZCTA5 64112,4826,140,4686,8545,33.9,7243,439,217,0.025394968,282,8263
ZCTA5 64113,4679,301,4378,12323,41.1,11241,352,110,0.008926398,1211,11112
ZCTA5 64114,12707,608,12099,24700,42.2,19653,609,2900,0.117408907,1762,22938
ZCTA5 64116,8564,11732,-3168,16977,40.8,12987,508,1670,0.098368381,29603,-12626
ZCTA5 64117,6422,45,6377,14677,36.7,10705,482,1606,0.109422907,121,14556
ZCTA5 64118,18043,2085,15958,43305,35.8,33528,932,4280,0.098833853,6672,36633
ZCTA5 64119,13185,204,12981,32461,37.5,25817,603,2228,0.06863621,583,31878
ZCTA5 64120,184,2156,-1972,462,36.8,425,10,0,0,5358,-4896
ZCTA5 64123,3918,1332,2586,11285,32,5092,908,1421,0.125919362,3890,7395
ZCTA5 64124,3692,833,2859,11039,30.4,5088,630,1930,0.174834677,2375,8664
ZCTA5 64125,665,404,261,2506,26.7,1555,12,299,0.119313647,960,1546
ZCTA5 64126,2083,2391,-308,5613,35,2457,47,378,0.067343666,5716,-103
ZCTA5 64127,7112,46,7066,17360,35.2,4243,184,8597,0.495218894,106,17254
ZCTA5 64128,5056,3477,1579,12076,39,1808,0,9212,0.762835376,9045,3031
ZCTA5 64129,3623,5453,-1830,8768,36.2,3850,81,4272,0.487226277,14155,-5387
ZCTA5 64130,8559,86,8473,19355,39.5,1585,25,16606,0.857969517,304,19051
ZCTA5 64131,9735,2205,7530,22901,36.1,11255,395,9480,0.413955722,5389,17512
ZCTA5 64132,5112,363,4749,13100,33.9,2489,51,9389,0.716717557,857,12243
ZCTA5 64133,15298,416,14882,36700,40.1,19226,326,13077,0.356321526,1046,35654
ZCTA5 64134,8812,211,8601,22749,30.9,7178,159,13257,0.58275089,590,22159
ZCTA5 64136,673,830,-157,1491,48.1,842,95,538,0.360831657,1908,-417
ZCTA5 64137,4584,303,4281,10901,32,6670,306,3335,0.305935235,717,10184
ZCTA5 64138,10468,889,9579,24185,39.8,10317,439,11822,0.488815381,2108,22077
ZCTA5 64139,829,4483,-3654,2656,37.1,2102,11,396,0.149096386,11380,-8724
ZCTA5 64145,1935,3492,-1557,5054,51.5,3950,138,651,0.128808864,9564,-4510
ZCTA5 64146,780,9,771,1345,56.5,1033,29,160,0.118959108,18,1327
ZCTA5 64147,134,987,-853,497,16.7,117,0,250,0.503018109,2604,-2107
ZCTA5 64149,167,57,110,353,42.8,298,38,0,0,143,210
ZCTA5 64150,1820,421,1399,3964,35,2993,83,663,0.167255298,1016,2948
ZCTA5 64151,11577,591,10986,27653,39.2,21609,655,2769,0.100133801,1729,25924
ZCTA5 64152,11802,302,11500,31560,40.9,27263,856,1098,0.034790875,676,30884
ZCTA5 64153,2722,97,2625,6095,34.3,4165,359,568,0.09319114,271,5824
ZCTA5 64154,5685,1479,4206,12863,34.8,9686,638,1489,0.115758377,3743,9120
ZCTA5 64155,10574,4638,5936,28091,36.8,22627,469,2119,0.075433413,11283,16808
ZCTA5 64156,2261,1496,765,6101,33.1,5237,184,218,0.035731847,3465,2636
ZCTA5 64157,7118,3555,3563,21539,36.9,18207,1208,745,0.034588421,9439,12100
ZCTA5 64158,2374,247,2127,6302,36.5,4376,454,419,0.06648683,621,5681
ZCTA5 64161,134,2104,-1970,337,46.6,273,0,53,0.15727003,5153,-4816
ZCTA5 64163,453,707,-254,1011,40.5,778,4,79,0.078140455,1796,-785
ZCTA5 64164,23,485,-462,59,59.5,59,0,0,0,1442,-1383
ZCTA5 64165,63,6536,-6473,276,15.7,276,0,0,0,16826,-16550
ZCTA5 64166,168,241,-73,381,64.1,381,0,0,0,702,-321
ZCTA5 64167,190,9544,-9354,509,50.8,509,0,0,0,23786,-23277
ZCTA5 64401,396,700,-304,1057,44.8,1015,0,0,0,2812,-1755
ZCTA5 64402,924,126,798,2307,41.9,2228,20,18,0.007802341,287,2020
ZCTA5 64420,15,3021,-3006,35,66.4,35,0,0,0,7719,-7684
ZCTA5 64421,379,47,332,1067,38.7,1045,0,0,0,179,888
ZCTA5 64422,162,3554,-3392,439,35.2,439,0,0,0,9093,-8654
ZCTA5 64423,350,11,339,828,44.8,822,3,0,0,11,817
ZCTA5 64424,1514,723,791,3761,45.5,3606,39,62,0.016484977,1710,2051
ZCTA5 64426,141,3263,-3122,430,36.9,426,0,1,0.002325581,8424,-7994
ZCTA5 64427,265,657,-392,690,42.2,669,6,0,0,1919,-1229
ZCTA5 64428,259,244,15,659,33,651,0,3,0.004552352,478,181
ZCTA5 64429,3693,216,3477,12077,39.6,10622,15,951,0.078744721,499,11578
ZCTA5 64430,315,74,241,737,57.5,719,12,2,0.002713704,138,599
ZCTA5 64431,154,1649,-1495,352,47.9,347,0,0,0,4609,-4257
ZCTA5 64432,19,868,-849,110,49,86,0,24,0.218181818,2377,-2267
ZCTA5 64433,23,1693,-1670,283,21.1,248,35,0,0,4467,-4184
ZCTA5 64434,215,354,-139,505,47.8,495,0,0,0,935,-430
ZCTA5 64436,358,262,96,979,40.3,859,0,27,0.027579162,725,254
ZCTA5 64437,206,616,-410,497,52.7,491,3,0,0,1585,-1088
ZCTA5 64438,46,180,-134,89,54.5,89,0,0,0,375,-286
ZCTA5 64439,644,377,267,1514,41.4,1481,0,0,0,908,606
ZCTA5 64440,317,534,-217,842,36.8,834,0,0,0,1144,-302
ZCTA5 64441,47,1156,-1109,64,62.9,64,0,0,0,3094,-3030
ZCTA5 64442,301,849,-548,899,37.7,864,0,0,0,2155,-1256
ZCTA5 64443,647,993,-346,1852,46,1688,0,0,0,2606,-754
ZCTA5 64444,545,2140,-1595,1426,40.2,1335,0,0,0,5963,-4537
ZCTA5 64445,129,601,-472,294,33.3,227,0,0,0,1269,-975
ZCTA5 64446,456,564,-108,1000,52.9,925,0,4,0.004,1196,-196
ZCTA5 64448,440,1164,-724,1052,55,1032,0,0,0,3738,-2686
ZCTA5 64449,207,2342,-2135,572,42.2,572,0,0,0,5201,-4629
ZCTA5 64451,198,81,117,429,55.1,420,1,0,0,146,283
ZCTA5 64453,63,1371,-1308,165,42.6,165,0,0,0,3513,-3348
ZCTA5 64454,962,2058,-1096,2467,41.3,2397,0,6,0.002432104,5190,-2723
ZCTA5 64455,153,52,101,332,58,332,0,0,0,140,192
ZCTA5 64456,508,646,-138,1527,42.9,1497,0,18,0.011787819,1600,-73
ZCTA5 64457,89,81,8,218,46.3,209,0,1,0.004587156,174,44
ZCTA5 64458,62,939,-877,271,25,271,0,0,0,2112,-1841
ZCTA5 64459,215,436,-221,497,39,492,0,0,0,1068,-571
ZCTA5 64461,337,886,-549,834,41.8,823,2,1,0.001199041,2675,-1841
ZCTA5 64463,558,63,495,1473,44.4,1359,13,0,0,166,1307
ZCTA5 64465,1581,1241,340,4221,44.9,4024,60,12,0.002842928,3553,668
ZCTA5 64466,192,826,-634,391,56.3,382,4,0,0,1929,-1538
ZCTA5 64467,104,779,-675,230,52.1,225,0,0,0,1855,-1625
ZCTA5 64468,5720,3399,2321,14991,26.2,13786,210,560,0.037355747,9577,5414
ZCTA5 64469,938,1031,-93,2156,39.2,2095,4,14,0.006493506,2850,-694
ZCTA5 64470,651,225,426,1588,45.1,1506,1,56,0.035264484,503,1085
ZCTA5 64471,187,1106,-919,439,45.3,429,0,0,0,2912,-2473
ZCTA5 64473,541,545,-4,1364,46.5,1307,4,6,0.004398827,1195,169
ZCTA5 64474,347,1102,-755,801,49.2,775,3,0,0,2637,-1836
ZCTA5 64475,131,864,-733,293,43.1,289,1,0,0,2235,-1942
ZCTA5 64476,125,282,-157,292,40.1,270,15,0,0,566,-274
ZCTA5 64477,1485,2084,-599,3477,50.2,3100,61,179,0.051481162,4289,-812
ZCTA5 64479,349,1918,-1569,961,31.5,934,2,3,0.003121748,4682,-3721
ZCTA5 64480,118,110,8,211,61.5,157,43,0,0,244,-33
ZCTA5 64481,344,676,-332,1015,44.3,999,1,0,0,1717,-702
ZCTA5 64482,897,248,649,2086,42.9,2005,0,7,0.003355705,535,1551
ZCTA5 64483,192,1499,-1307,593,39.1,589,0,0,0,3487,-2894
ZCTA5 64484,382,1466,-1084,973,39.8,932,5,1,0.001027749,3608,-2635
ZCTA5 64485,3181,5751,-2570,7627,42.2,7408,0,16,0.00209781,14622,-6995
ZCTA5 64486,102,895,-793,231,57.8,223,1,0,0,2204,-1973
ZCTA5 64487,288,4603,-4315,614,48,590,0,1,0.001628664,13173,-12559
ZCTA5 64489,723,468,255,2203,34.9,2164,8,0,0,1387,816
ZCTA5 64490,696,3823,-3127,1951,38.4,1855,0,40,0.020502307,9726,-7775
ZCTA5 64491,798,3484,-2686,1752,44.4,1693,0,6,0.003424658,9148,-7396
ZCTA5 64492,704,973,-269,1728,47,1611,0,13,0.007523148,2628,-900
ZCTA5 64493,211,11200,-10989,801,36.4,778,3,0,0,29750,-28949
ZCTA5 64494,440,26,414,1045,40.4,993,26,9,0.00861244,75,970
ZCTA5 64496,98,1096,-998,204,49.6,197,0,0,0,2914,-2710
ZCTA5 64497,151,260,-109,475,37.8,463,0,10,0.021052632,738,-263
ZCTA5 64498,106,11018,-10912,230,55,216,0,0,0,29311,-29081
ZCTA5 64499,59,516,-457,141,44.5,141,0,0,0,1155,-1014
ZCTA5 64501,4508,1472,3036,10979,34.9,8105,128,1143,0.104107842,4262,6717
ZCTA5 64503,4833,684,4149,12060,38.9,10773,181,285,0.023631841,1340,10720
ZCTA5 64504,4119,921,3198,10695,39.5,9078,84,378,0.035343619,2328,8367
ZCTA5 64505,5116,151,4965,13656,40.4,11741,265,276,0.020210896,401,13255
ZCTA5 64506,8714,43,8671,22147,40.6,18280,523,1477,0.066690748,120,22027
ZCTA5 64507,5265,179,5086,14842,31.1,12936,12,1047,0.070543053,393,14449
ZCTA5 64601,4524,68,4456,12280,39.7,11245,81,403,0.03281759,210,12070
ZCTA5 64620,215,43,172,611,39.2,608,0,0,0,108,503
ZCTA5 64622,162,358,-196,328,54.9,320,0,0,0,667,-339
ZCTA5 64623,136,330,-194,388,45.7,385,0,0,0,758,-370
ZCTA5 64624,601,1170,-569,1433,52.4,1360,0,0,0,3143,-1710
ZCTA5 64625,287,66,221,771,39.8,694,0,2,0.002594034,203,568
ZCTA5 64628,2310,3322,-1012,5844,44.6,5634,28,66,0.011293634,7792,-1948
ZCTA5 64630,245,6747,-6502,602,44.1,595,0,0,0,17390,-16788
ZCTA5 64631,305,545,-240,754,46.2,734,0,0,0,1402,-648
ZCTA5 64632,158,1409,-1251,361,62.3,348,0,0,0,3618,-3257
ZCTA5 64633,1774,4394,-2620,4589,40,4314,8,78,0.016997167,11551,-6962
ZCTA5 64635,176,72,104,443,45.1,433,5,0,0,163,280
ZCTA5 64636,121,903,-782,317,36,303,0,0,0,2451,-2134
ZCTA5 64637,233,2401,-2168,585,43.9,561,7,0,0,7721,-7136
ZCTA5 64638,178,1743,-1565,670,28.6,656,0,3,0.004477612,3799,-3129
ZCTA5 64639,72,177,-105,150,58,142,0,8,0.053333333,325,-175
ZCTA5 64640,1206,1902,-696,2958,44.6,2877,3,0,0,4947,-1989
ZCTA5 64641,249,357,-108,560,49.6,560,0,0,0,878,-318
ZCTA5 64642,309,194,115,791,41.6,729,2,5,0.006321113,533,258
ZCTA5 64643,444,233,211,1109,45.8,1059,0,46,0.04147881,630,479
ZCTA5 64644,1118,2633,-1515,3045,37.8,2857,26,6,0.001970443,6806,-3761
ZCTA5 64645,77,508,-431,165,59.3,165,0,0,0,1315,-1150
ZCTA5 64646,85,234,-149,303,35.2,303,0,0,0,518,-215
ZCTA5 64647,195,576,-381,467,44.4,467,0,0,0,1110,-643
ZCTA5 64648,666,174,492,2599,27.2,2492,10,17,0.006540977,454,2145
ZCTA5 64649,308,451,-143,838,39.4,827,0,0,0,1430,-592
ZCTA5 64650,263,50,213,624,52.3,569,1,35,0.056089744,131,493
ZCTA5 64651,196,667,-471,452,52.1,421,0,3,0.006637168,1593,-1141
ZCTA5 64652,146,182,-36,364,46.3,346,0,0,0,596,-232
ZCTA5 64653,259,1158,-899,556,49.8,546,0,3,0.005395683,3296,-2740
ZCTA5 64654,14,1196,-1182,40,35.4,33,0,0,0,2749,-2709
ZCTA5 64655,85,522,-437,123,62.3,119,0,0,0,1771,-1648
ZCTA5 64656,133,774,-641,328,37.8,325,0,0,0,2321,-1993
ZCTA5 64657,121,283,-162,337,39.1,336,0,0,0,546,-209
ZCTA5 64658,1219,444,775,3278,38.2,3164,2,14,0.004270897,1020,2258
ZCTA5 64659,369,9590,-9221,994,37,968,2,0,0,24384,-23390
ZCTA5 64660,172,110,62,438,50.5,411,0,0,0,230,208
ZCTA5 64661,304,199,105,800,48,743,24,3,0.00375,480,320
ZCTA5 64664,105,1056,-951,283,48.2,252,0,0,0,2398,-2115
ZCTA5 64667,85,2960,-2875,319,51.1,309,0,0,0,8034,-7715
ZCTA5 64668,650,47,603,1590,44.8,1512,0,12,0.00754717,165,1425
ZCTA5 64670,326,0,326,993,37.5,942,3,21,0.021148036,0,993
ZCTA5 64671,722,2412,-1690,1791,42.4,1728,1,0,0,5443,-3652
ZCTA5 64672,53,950,-897,104,68.5,104,0,0,0,2547,-2443
ZCTA5 64673,842,610,232,2533,39.3,2434,0,10,0.003947888,1397,1136
ZCTA5 64674,125,162,-37,276,38.6,276,0,0,0,427,-151
ZCTA5 64676,46,681,-635,145,43.1,141,0,0,0,1786,-1641
ZCTA5 64679,300,299,1,812,43.6,785,0,0,0,641,171
ZCTA5 64681,59,1934,-1875,179,44.9,174,0,0,0,4726,-4547
ZCTA5 64682,151,2528,-2377,348,55.4,348,0,0,0,6852,-6504
ZCTA5 64683,2950,17877,-14927,7941,40.5,7424,111,44,0.005540864,43401,-35460
ZCTA5 64686,102,17250,-17148,200,52.1,194,0,0,0,42610,-42410
ZCTA5 64688,215,17364,-17149,792,23.4,777,6,0,0,36748,-35956
ZCTA5 64689,192,4785,-4593,551,31.1,531,0,2,0.003629764,9377,-8826
ZCTA5 64701,5715,23574,-17859,14608,38.8,13715,77,102,0.006982475,56381,-41773
ZCTA5 64720,1530,4173,-2643,4220,35.5,3936,0,63,0.01492891,10792,-6572
ZCTA5 64722,139,8476,-8337,407,43.7,397,0,0,0,21200,-20793
ZCTA5 64723,337,4877,-4540,767,47.9,760,0,0,0,13867,-13100
ZCTA5 64724,757,2808,-2051,1930,39.7,1864,0,8,0.004145078,7260,-5330
ZCTA5 64725,769,2171,-1402,2006,37.5,1914,0,0,0,6228,-4222
ZCTA5 64726,119,102,17,332,54.2,331,0,0,0,244,88
ZCTA5 64728,163,279,-116,468,45.8,458,0,0,0,603,-135
ZCTA5 64730,2457,3941,-1484,6397,43.8,5988,57,221,0.034547444,10810,-4413
ZCTA5 64733,465,693,-228,1316,35.7,1266,3,0,0,2065,-749
ZCTA5 64734,793,209,584,2165,40.9,2045,0,0,0,465,1700
ZCTA5 64735,5724,335,5389,13168,45.1,12325,47,193,0.014656744,777,12391
ZCTA5 64738,587,142,445,1501,41.5,1300,3,0,0,317,1184
ZCTA5 64739,338,146,192,1006,41.1,991,0,6,0.005964215,321,685
ZCTA5 64740,740,1947,-1207,1526,51.3,1451,0,15,0.00982962,5611,-4085
ZCTA5 64741,64,74,-10,117,65.2,112,0,0,0,334,-217
ZCTA5 64742,890,557,333,2176,39.7,2050,7,0,0,1696,480
ZCTA5 64743,90,812,-722,195,34.6,174,0,0,0,2212,-2017
ZCTA5 64744,2876,517,2359,8061,40.1,7716,0,6,0.000744325,1263,6798
ZCTA5 64745,27,316,-289,72,48.7,72,0,0,0,748,-676
ZCTA5 64746,624,2943,-2319,1519,40,1489,10,9,0.005924951,7843,-6324
ZCTA5 64747,1587,371,1216,3905,44.9,3638,17,20,0.005121639,968,2937
ZCTA5 64748,593,1447,-854,1434,44.6,1333,5,0,0,5675,-4241
ZCTA5 64750,117,7514,-7397,368,33.7,363,3,0,0,21225,-20857
ZCTA5 64752,257,0,257,726,39.4,687,0,0,0,398,328
ZCTA5 64755,873,2209,-1336,2446,34,2170,0,0,0,5424,-2978
ZCTA5 64756,283,266,17,638,56.8,600,0,0,0,672,-34
ZCTA5 64759,2907,374,2533,7692,38.7,7307,2,14,0.001820073,1417,6275
ZCTA5 64761,559,246,313,1599,35.7,1564,4,0,0,654,945
ZCTA5 64762,614,1237,-623,1636,39.1,1421,0,0,0,2980,-1344
ZCTA5 64763,588,251,337,1313,55.2,1241,6,6,0.004569688,707,606
ZCTA5 64765,3,281,-278,6,50,6,0,0,0,697,-691
ZCTA5 64767,267,2808,-2541,557,59,516,2,9,0.016157989,10673,-10116
ZCTA5 64769,274,11013,-10739,701,43.5,627,0,0,0,27800,-27099
ZCTA5 64770,522,35,487,1171,51.4,1139,0,2,0.001707942,2533,-1362
ZCTA5 64771,157,7891,-7734,362,50.8,357,0,0,0,19292,-18930
ZCTA5 64772,5437,7499,-2062,13051,41.6,12349,122,49,0.003754502,19172,-6121
ZCTA5 64776,1590,13102,-11512,3684,49.6,3464,16,43,0.011672096,35632,-31948
ZCTA5 64778,168,10687,-10519,456,47.4,449,0,0,0,25623,-25167
ZCTA5 64779,853,780,73,2499,41.2,2362,5,7,0.00280112,1989,510
ZCTA5 64780,162,719,-557,527,42.8,502,0,9,0.017077799,2054,-1527
ZCTA5 64781,45,2708,-2663,86,64.1,84,0,0,0,7496,-7410
ZCTA5 64783,284,1111,-827,682,45,682,0,0,0,2767,-2085
ZCTA5 64784,500,730,-230,1319,41.3,1280,3,0,0,1598,-279
ZCTA5 64788,622,144,478,1524,42.1,1474,2,0,0,387,1137
ZCTA5 64790,355,407,-52,888,45,866,0,0,0,1135,-247
ZCTA5 64801,15267,19648,-4381,36760,39.3,31330,654,1053,0.028645267,55422,-18662
ZCTA5 64804,14853,26360,-11507,37299,39.1,31960,785,871,0.023351832,74922,-37623
ZCTA5 64830,285,2193,-1908,766,30.4,673,0,0,0,5834,-5068
ZCTA5 64831,2416,995,1421,6782,37.6,5375,32,21,0.003096432,2553,4229
ZCTA5 64832,455,6441,-5986,1282,54.9,1171,0,0,0,16392,-15110
ZCTA5 64833,20,1041,-1021,64,34.5,64,0,0,0,2644,-2580
ZCTA5 64834,3510,4805,-1295,10184,35.4,9368,100,39,0.003829537,12305,-2121
ZCTA5 64835,701,498,203,2187,32.4,1962,20,21,0.009602195,1162,1025
ZCTA5 64836,9039,854,8185,24702,35.6,21343,103,215,0.008703749,2092,22610
ZCTA5 64840,1131,948,183,3108,37.9,2964,0,0,0,1973,1135
ZCTA5 64841,360,788,-428,1012,25.2,959,17,0,0,2050,-1038
ZCTA5 64842,312,348,-36,969,36.4,635,158,0,0,851,118
ZCTA5 64843,1158,229,929,3487,38,2953,14,8,0.002294236,578,2909
ZCTA5 64844,1693,319,1374,4524,37.7,4115,31,11,0.002431477,801,3723
ZCTA5 64847,169,3098,-2929,432,35.9,371,0,0,0,8920,-8488
ZCTA5 64848,197,2855,-2658,728,29.8,728,0,0,0,7853,-7125
ZCTA5 64849,71,3507,-3436,166,60.2,161,0,0,0,9655,-9489
ZCTA5 64850,8541,789,7752,23398,36.6,19684,217,332,0.014189247,1916,21482
ZCTA5 64854,1480,1027,453,4767,28.2,2828,19,281,0.058946927,2560,2207
ZCTA5 64855,988,1136,-148,2522,39.9,2375,8,7,0.002775575,2675,-153
ZCTA5 64856,1465,74,1391,3865,44.1,3359,85,52,0.013454075,158,3707
ZCTA5 64857,156,1477,-1321,451,38.2,410,0,0,0,4178,-3727
ZCTA5 64858,210,229,-19,440,58.7,440,0,0,0,546,-106
ZCTA5 64859,496,236,260,1255,44,1123,0,13,0.010358566,487,768
ZCTA5 64861,414,526,-112,1239,50.2,1014,81,73,0.058918483,1243,-4
ZCTA5 64862,1344,383,961,3642,45.3,3479,0,26,0.007138935,969,2673
ZCTA5 64863,506,4679,-4173,1419,39.1,1002,46,0,0,13729,-12310
ZCTA5 64865,1886,9438,-7552,5578,36.4,4664,42,0,0,28923,-23345
ZCTA5 64866,389,5906,-5517,964,46.7,889,31,0,0,13368,-12404
ZCTA5 64867,349,9264,-8915,938,37.5,856,12,4,0.004264392,24956,-24018
ZCTA5 64868,58,795,-737,131,67.2,120,0,0,0,2442,-2311
ZCTA5 64870,5887,8147,-2260,15630,33.3,14035,179,416,0.026615483,23150,-7520
ZCTA5 64873,294,7826,-7532,743,45.7,654,0,0,0,21365,-20622
ZCTA5 64874,237,3954,-3717,628,36.1,550,0,0,0,10823,-10195
ZCTA5 65001,126,4652,-4526,313,42.1,300,0,0,0,11194,-10881
ZCTA5 65010,2870,0,2870,6909,41.1,6629,47,15,0.002171081,0,6909
ZCTA5 65011,632,0,632,2460,27.4,2332,75,35,0.014227642,0,2460
ZCTA5 65013,1160,8107,-6947,2690,45.7,2609,0,0,0,16703,-14013
ZCTA5 65014,992,8477,-7485,2675,39,2604,0,0,0,19510,-16835
ZCTA5 65016,518,8933,-8415,1412,45.4,1412,0,0,0,18379,-16967
ZCTA5 65017,465,6256,-5791,1141,47.1,1079,0,0,0,13461,-12320
ZCTA5 65018,3053,4003,-950,7864,37.9,7363,37,121,0.015386572,10056,-2192
ZCTA5 65020,5320,5507,-187,15280,49.4,14443,82,115,0.007526178,12830,2450
ZCTA5 65023,698,9370,-8672,1680,47.1,1587,2,0,0,21354,-19674
ZCTA5 65024,432,8276,-7844,987,48.1,975,0,0,0,19211,-18224
ZCTA5 65025,299,8371,-8072,827,31.6,781,6,0,0,17648,-16821
ZCTA5 65026,4746,2337,2409,10713,39.2,10334,14,0,0,4678,6035
ZCTA5 65032,562,14748,-14186,1245,49.5,1192,0,41,0.032931727,32677,-31432
ZCTA5 65034,315,10772,-10457,1008,29.2,1008,0,0,0,28829,-27821
ZCTA5 65035,642,5276,-4634,1793,40.4,1784,0,0,0,11844,-10051
ZCTA5 65037,2195,10338,-8143,4606,57.9,4224,15,137,0.029743812,24764,-20158
ZCTA5 65039,1067,9378,-8311,2762,41.9,2677,43,0,0,25789,-23027
ZCTA5 65040,423,2168,-1745,1173,39.1,1131,0,0,0,4811,-3638
ZCTA5 65041,2278,2555,-277,5237,49,4964,0,62,0.011838839,7858,-2621
ZCTA5 65043,3705,4271,-566,9924,35.8,8871,68,240,0.024183797,10065,-141
ZCTA5 65046,578,2302,-1724,1457,41.1,1371,0,0,0,7171,-5714
ZCTA5 65047,464,4953,-4489,1554,37.6,1536,0,0,0,15510,-13956
ZCTA5 65048,87,7897,-7810,145,70.4,134,0,0,0,21093,-20948
ZCTA5 65049,2929,3671,-742,6673,52,6364,0,182,0.02727409,11661,-4988
ZCTA5 65050,175,3995,-3820,687,23.1,682,0,0,0,12407,-11720
ZCTA5 65051,1824,1577,247,4813,33,4657,0,14,0.002908789,4058,755
ZCTA5 65052,1208,680,528,3523,54.9,3418,1,42,0.011921658,1727,1796
ZCTA5 65053,577,1101,-524,1580,50.4,1404,84,0,0,2835,-1255
ZCTA5 65054,367,328,39,1111,39.6,1111,0,0,0,873,238
ZCTA5 65058,413,201,212,825,53.2,800,0,5,0.006060606,540,285
ZCTA5 65059,437,188,249,987,47.8,987,0,0,0,424,563
ZCTA5 65061,194,190,4,551,42.3,525,0,0,0,410,141
ZCTA5 65062,11,197,-186,32,56.5,32,0,0,0,505,-473
ZCTA5 65063,1279,1292,-13,3781,40.9,3628,7,0,0,3084,697
ZCTA5 65064,272,505,-233,664,51,664,0,0,0,1305,-641
ZCTA5 65065,2671,150,2521,7033,47,6545,0,121,0.017204607,327,6706
ZCTA5 65066,2415,785,1630,6089,47.3,5891,23,0,0,1861,4228
ZCTA5 65067,176,1110,-934,537,32.7,431,0,0,0,2563,-2026
ZCTA5 65068,307,346,-39,781,49.8,673,0,0,0,979,-198
ZCTA5 65069,191,215,-24,425,42.8,425,0,0,0,644,-219
ZCTA5 65072,721,95,626,1957,45.5,1939,1,1,0.000510986,290,1667
ZCTA5 65074,1176,218,958,2977,37.9,2900,15,8,0.002687269,629,2348
ZCTA5 65075,354,156,198,1070,38.8,1055,3,7,0.006542056,341,729
ZCTA5 65076,223,166,57,530,43.3,478,27,1,0.001886792,508,22
ZCTA5 65077,171,341,-170,427,40.6,427,0,0,0,962,-535
ZCTA5 65078,1327,263,1064,3284,48.8,3039,12,8,0.002436054,659,2625
ZCTA5 65079,1978,231,1747,4597,60.7,4462,7,10,0.002175332,484,4113
ZCTA5 65080,490,526,-36,1376,40.5,1376,0,0,0,1189,187
ZCTA5 65081,1104,158,946,4605,38.1,4124,6,434,0.094245385,332,4273
ZCTA5 65082,388,305,83,1183,42,1053,14,30,0.025359256,841,342
ZCTA5 65083,58,306,-248,174,22.8,174,0,0,0,731,-557
ZCTA5 65084,2341,172,2169,6823,37.6,6462,0,30,0.004396893,433,6390
ZCTA5 65085,514,2098,-1584,1332,34.4,1306,0,4,0.003003003,4762,-3430
ZCTA5 65101,10431,2345,8086,30381,36.7,23058,48,6067,0.199697179,5685,24696
ZCTA5 65109,16602,71,16531,40055,40.5,34409,1044,3053,0.076220197,158,39897
ZCTA5 65201,18057,1124,16933,47215,23.4,37688,3039,3562,0.075442126,2844,44371
ZCTA5 65202,18952,720,18232,48380,35,35578,1147,7598,0.157048367,1985,46395
ZCTA5 65203,25279,10141,15138,58863,36.4,45845,3733,5421,0.092095204,26226,32637
ZCTA5 65215,0,2799,-2799,279,19.9,271,0,2,0.007168459,14430,-14151
ZCTA5 65216,0,292,-292,224,19.6,195,4,11,0.049107143,699,-475
ZCTA5 65230,194,671,-477,552,33.9,545,0,3,0.005434783,1709,-1157
ZCTA5 65231,1166,89,1077,2982,39,2806,0,125,0.041918176,267,2715
ZCTA5 65232,133,18114,-17981,294,45.5,294,0,0,0,44126,-43832
ZCTA5 65233,3791,5366,-1575,11481,37.9,9676,47,988,0.086055222,13889,-2408
ZCTA5 65236,485,27,458,1304,47.1,1176,0,51,0.039110429,3898,-2594
ZCTA5 65237,446,407,39,1071,45.4,1020,0,15,0.014005602,1251,-180
ZCTA5 65239,661,1904,-1243,1637,43.4,1559,0,15,0.009163103,4382,-2745
ZCTA5 65240,3385,1133,2252,8659,35.7,8236,25,118,0.01362744,2739,5920
ZCTA5 65243,810,272,538,2567,37.8,2484,0,4,0.001558239,667,1900
ZCTA5 65244,162,1315,-1153,351,32.8,351,0,0,0,3315,-2964
ZCTA5 65246,23,644,-621,68,74.4,23,0,45,0.661764706,1733,-1665
ZCTA5 65247,237,127,110,862,22.2,845,0,0,0,388,474
ZCTA5 65248,1250,109,1141,4434,32.4,3927,7,369,0.083220568,290,4144
ZCTA5 65250,168,717,-549,476,48.3,476,0,0,0,1822,-1346
ZCTA5 65251,7148,64,7084,21739,38.7,19376,215,1310,0.060260362,184,21555
ZCTA5 65254,661,243,418,1799,39.9,1667,0,97,0.053918844,622,1177
ZCTA5 65255,1885,640,1245,5265,32.5,4931,4,84,0.015954416,1718,3547
ZCTA5 65256,733,15,718,1916,49.1,1884,4,7,0.003653445,31,1885
ZCTA5 65257,591,1591,-1000,1844,35.6,1765,0,7,0.003796095,3872,-2028
ZCTA5 65258,230,1013,-783,575,46.5,566,0,9,0.015652174,2689,-2114
ZCTA5 65259,977,293,684,2943,39.2,2792,6,49,0.016649677,804,2139
ZCTA5 65260,170,121,49,422,47.8,418,0,0,0,303,119
ZCTA5 65261,395,413,-18,1224,35,1171,0,4,0.003267974,1044,180
ZCTA5 65262,341,473,-132,917,29.6,887,0,16,0.017448201,1261,-344
ZCTA5 65263,568,262,306,1350,51,1285,3,13,0.00962963,679,671
ZCTA5 65264,379,548,-169,1030,45.4,1004,0,24,0.023300971,1427,-397
ZCTA5 65265,5717,1527,4190,15098,41.1,13426,82,623,0.041263744,3751,11347
ZCTA5 65270,6067,1080,4987,17141,39,14682,97,1438,0.083892422,2651,14490
ZCTA5 65274,641,1200,-559,2035,44.6,1663,3,55,0.027027027,4059,-2024
ZCTA5 65275,968,503,465,2511,46.3,2348,0,125,0.049780964,1319,1192
ZCTA5 65276,630,1278,-648,1610,45.3,1589,0,2,0.001242236,3126,-1516
ZCTA5 65278,38,1188,-1150,79,54.8,77,0,2,0.025316456,3126,-3047
ZCTA5 65279,615,206,409,1469,56.4,1410,35,21,0.014295439,431,1038
ZCTA5 65280,109,138,-29,282,57.8,276,0,0,0,329,-47
ZCTA5 65281,950,1276,-326,2750,46.7,2620,0,77,0.028,3274,-524
ZCTA5 65282,75,350,-275,79,70.3,79,0,0,0,1004,-925
ZCTA5 65283,243,147,96,546,63.8,546,0,0,0,301,245
ZCTA5 65284,761,480,281,1760,40.8,1715,0,0,0,1131,629
ZCTA5 65285,197,2809,-2612,399,62.4,385,0,0,0,7503,-7104
ZCTA5 65286,24,386,-362,128,58.3,128,0,0,0,852,-724
ZCTA5 65287,87,595,-508,177,59.6,145,4,0,0,1523,-1346
ZCTA5 65301,13513,213,13300,34856,37.5,30756,254,1022,0.029320633,512,34344
ZCTA5 65305,1002,235,767,4182,21.8,3255,69,363,0.086800574,509,3673
ZCTA5 65320,30,330,-300,60,38.5,55,0,0,0,816,-756
ZCTA5 65321,150,681,-531,342,54.3,336,0,3,0.00877193,1460,-1118
ZCTA5 65322,232,10206,-9974,621,33.4,611,0,0,0,22450,-21829
ZCTA5 65323,333,7807,-7474,924,40,829,2,0,0,20786,-19862
ZCTA5 65324,572,4993,-4421,1190,62.8,1077,0,6,0.005042017,11381,-10191
ZCTA5 65325,1153,3539,-2386,3428,47.1,3388,0,0,0,10961,-7533
ZCTA5 65326,819,2204,-1385,1581,61.1,1472,0,0,0,5597,-4016
ZCTA5 65327,79,3247,-3168,210,47.8,208,0,0,0,7362,-7152
ZCTA5 65329,92,3323,-3231,292,49.8,292,0,0,0,9118,-8826
ZCTA5 65330,180,4753,-4573,524,38.9,515,0,8,0.015267176,9204,-8680
ZCTA5 65332,595,1333,-738,1525,48.3,1419,7,25,0.016393443,2689,-1164
ZCTA5 65333,289,13960,-13671,522,61.1,521,0,0,0,31569,-31047
ZCTA5 65334,456,1106,-650,1036,34.7,977,0,40,0.038610039,2818,-1782
ZCTA5 65335,126,2498,-2372,355,49.3,333,0,0,0,6024,-5669
ZCTA5 65336,2576,3340,-764,6148,28.7,4879,258,329,0.053513338,8577,-2429
ZCTA5 65337,698,3573,-2875,1897,32.3,1517,3,8,0.004217185,9626,-7729
ZCTA5 65338,1094,978,116,3153,40.4,3024,0,59,0.018712337,2959,194
ZCTA5 65339,148,36,112,431,44.7,416,1,5,0.011600928,496,-65
ZCTA5 65340,5075,0,5075,15775,34.8,12411,114,979,0.062060222,187,15588
ZCTA5 65344,61,4700,-4639,173,39.8,173,0,0,0,12231,-12058
ZCTA5 65345,202,363,-161,396,68.1,391,0,0,0,977,-581
ZCTA5 65347,362,267,95,913,35.9,856,6,42,0.046002191,722,191
ZCTA5 65348,587,784,-197,1520,38,1451,54,0,0,1884,-364
ZCTA5 65349,1055,2137,-1082,2698,45.3,2464,37,96,0.035581913,6231,-3533
ZCTA5 65350,662,64,598,1828,38.2,1770,0,14,0.007658643,145,1683
ZCTA5 65351,794,254,540,2424,40.8,2319,25,10,0.004125413,610,1814
ZCTA5 65354,229,224,5,527,39.8,511,0,16,0.030360531,510,17
ZCTA5 65355,4593,4608,-15,10634,56,9847,0,48,0.004513824,11431,-797
ZCTA5 65360,1663,403,1260,4784,36.4,4540,0,1,0.00020903,1109,3675
ZCTA5 65401,13226,2211,11015,32947,32.7,28679,1437,959,0.029107354,5518,27429
ZCTA5 65409,8,0,8,8,-,8,0,0,0,0,8
ZCTA5 65436,0,142,-142,0,-,0,0,0,#DIV/0!,314,-314
ZCTA5 65438,1051,865,186,2926,43.1,2778,0,0,0,2196,730
ZCTA5 65439,33,85,-52,64,63.9,64,0,0,0,225,-161
ZCTA5 65440,133,235,-102,487,30.3,487,0,0,0,460,27
ZCTA5 65441,2142,1511,631,5300,38.7,4935,30,16,0.003018868,3370,1930
ZCTA5 65443,39,154,-115,98,51.3,98,0,0,0,407,-309
ZCTA5 65444,333,1902,-1569,672,57.9,615,0,0,0,5384,-4712
ZCTA5 65446,209,123,86,713,31.7,630,0,0,0,465,248
ZCTA5 65449,108,63,45,131,57.2,116,0,0,0,119,12
ZCTA5 65452,1004,1554,-550,2623,34.6,2516,0,7,0.0026687,4086,-1463
ZCTA5 65453,3317,88,3229,8906,39.6,8477,32,64,0.007186167,199,8707
ZCTA5 65456,157,1106,-949,559,36.3,559,0,0,0,2547,-1988
ZCTA5 65457,121,3259,-3138,241,63.5,238,3,0,0,7867,-7626
ZCTA5 65459,2511,407,2104,7533,38.5,7123,38,166,0.022036373,1079,6454
ZCTA5 65461,69,453,-384,104,65.7,104,0,0,0,1129,-1025
ZCTA5 65462,577,172,405,1255,52,1173,0,0,0,547,708
ZCTA5 65463,598,481,117,1311,27.3,1122,13,0,0,1054,257
ZCTA5 65464,267,408,-141,425,45.5,314,0,0,0,1128,-703
ZCTA5 65466,489,1348,-859,1331,47.8,1196,0,9,0.006761833,3510,-2179
ZCTA5 65468,3,111,-108,3,-,3,0,0,0,283,-280
ZCTA5 65470,361,27,334,836,47.4,821,0,0,0,39,797
ZCTA5 65473,2103,138,1965,15629,20.8,9377,741,2582,0.165205707,254,15375
ZCTA5 65479,84,9703,-9619,169,63.2,169,0,0,0,24693,-24524
ZCTA5 65483,1825,1325,500,4785,40.6,4338,210,16,0.003343783,3424,1361
ZCTA5 65484,25,240,-215,57,75.3,57,0,0,0,565,-508
ZCTA5 65486,1327,127,1200,3482,38.4,3373,35,0,0,366,3116
ZCTA5 65501,68,457,-389,143,61.4,143,0,0,0,1064,-921
ZCTA5 65529,102,487,-385,276,37.8,246,30,0,0,1197,-921
ZCTA5 65534,224,111,113,598,43.1,517,7,0,0,360,238
ZCTA5 65535,514,398,116,1411,32.9,1397,0,0,0,887,524
ZCTA5 65536,11909,47,11862,29987,39.1,27830,176,174,0.005802514,86,29901
ZCTA5 65541,92,515,-423,274,52.1,274,0,0,0,1329,-1055
ZCTA5 65542,2066,337,1729,6434,39.2,5737,12,482,0.074914517,793,5641
ZCTA5 65543,234,36,198,600,38.5,600,0,0,0,135,465
ZCTA5 65548,2169,286,1883,5910,41.6,5692,1,6,0.001015228,801,5109
ZCTA5 65550,1231,331,900,3047,43.5,2649,37,1,0.000328192,878,2169
ZCTA5 65552,684,535,149,2045,39.1,1995,40,0,0,1387,658
ZCTA5 65555,489,94,395,1480,37.6,1303,22,0,0,250,1230
ZCTA5 65556,2069,971,1098,5405,45,5142,11,23,0.004255319,2088,3317
ZCTA5 65557,31,11242,-11211,79,48.7,79,0,0,0,29345,-29266
ZCTA5 65559,3320,49,3271,8702,39,8300,24,35,0.004022064,121,8581
ZCTA5 65560,5632,229,5403,13466,44.2,12526,126,76,0.005643844,624,12842
ZCTA5 65564,45,349,-304,142,28.3,142,0,0,0,989,-847
ZCTA5 65565,2090,482,1608,4760,52,4512,0,30,0.006302521,1232,3528
ZCTA5 65566,295,112,183,811,45.1,721,0,0,0,264,547
ZCTA5 65567,582,1501,-919,1686,53.5,1659,0,3,0.001779359,3633,-1947
ZCTA5 65570,276,285,-9,626,63.3,592,0,0,0,655,-29
ZCTA5 65571,716,114,602,1964,46.6,1961,3,0,0,265,1699
ZCTA5 65580,293,61,232,599,49.6,599,0,0,0,73,526
ZCTA5 65582,909,530,379,2293,47.5,2159,0,4,0.00174444,1397,896
ZCTA5 65583,4857,1478,3379,13370,32.1,10454,127,1956,0.146297681,3207,10163
ZCTA5 65584,4061,207,3854,10980,31.4,7268,520,1104,0.100546448,571,10409
ZCTA5 65586,8,91,-83,94,16.7,94,0,0,0,180,-86
ZCTA5 65588,839,255,584,1930,55.9,1752,0,8,0.004145078,542,1388
ZCTA5 65589,34,272,-238,119,49.2,60,0,0,0,633,-514
ZCTA5 65590,839,208,631,2003,36.5,1746,0,0,0,515,1488
ZCTA5 65591,468,399,69,1582,32.6,1527,0,0,0,859,723
ZCTA5 65601,264,650,-386,598,51.6,513,0,0,0,1683,-1085
ZCTA5 65603,91,451,-360,179,54.1,178,0,0,0,1146,-967
ZCTA5 65604,1498,196,1302,3378,44.9,3273,0,4,0.001184133,462,2916
ZCTA5 65605,4955,72,4883,12208,43,11100,0,3,0.00024574,185,12023
ZCTA5 65606,1030,533,497,2361,46.5,2300,8,8,0.003388395,1209,1152
ZCTA5 65608,3201,1396,1805,8347,44,7904,13,12,0.001437642,3126,5221
ZCTA5 65609,270,35,235,695,44.7,670,0,0,0,61,634
ZCTA5 65610,1867,63,1804,4718,44.7,4529,0,8,0.001695634,162,4556
ZCTA5 65611,992,193,799,2187,62.6,2100,9,11,0.005029721,452,1735
ZCTA5 65612,682,459,223,1612,50,1578,0,0,0,1110,502
ZCTA5 65613,6513,700,5813,17651,35.5,16624,25,374,0.021188601,1874,15777
ZCTA5 65614,193,258,-65,562,40.2,546,0,0,0,681,-119
ZCTA5 65616,10522,273,10249,27712,40.2,24832,273,778,0.02807448,735,26977
ZCTA5 65617,586,70,516,1529,43.5,1467,0,15,0.009810334,112,1417
ZCTA5 65618,42,582,-540,183,37.7,183,0,0,0,1309,-1126
ZCTA5 65619,3696,447,3249,8616,37.1,7631,177,48,0.005571031,1195,7421
ZCTA5 65620,96,101,-5,170,54,170,0,0,0,267,-97
ZCTA5 65622,3252,2633,619,7892,43.3,7752,50,3,0.000380132,6585,1307
ZCTA5 65623,3,114,-111,9,1-,9,0,0,0,281,-272
ZCTA5 65624,656,53,603,1779,57.9,1669,0,0,0,106,1673
ZCTA5 65625,3025,141,2884,8176,42.7,7728,15,70,0.008561644,236,7940
ZCTA5 65626,871,1090,-219,2277,46.5,2132,0,0,0,2311,-34
ZCTA5 65627,320,173,147,735,47.3,735,0,0,0,335,400
ZCTA5 65629,227,292,-65,608,52.8,587,0,0,0,757,-149
ZCTA5 65630,155,471,-316,349,63,337,11,0,0,1041,-692
ZCTA5 65631,2304,250,2054,6627,35.1,6404,42,10,0.001508978,606,6021
ZCTA5 65632,966,160,806,2450,43.4,2412,0,0,0,378,2072
ZCTA5 65633,1204,93,1111,3687,34.4,3481,17,7,0.001898563,219,3468
ZCTA5 65634,133,119,14,496,36.8,483,0,0,0,269,227
ZCTA5 65635,205,228,-23,571,44.5,525,2,8,0.014010508,497,74
ZCTA5 65637,346,85,261,753,42.8,746,0,0,0,157,596
ZCTA5 65638,254,449,-195,693,56.2,669,0,0,0,1132,-439
ZCTA5 65640,265,65,200,1053,30.4,1037,0,0,0,156,897
ZCTA5 65641,507,233,274,1103,64.2,1076,0,0,0,576,527
ZCTA5 65644,727,295,432,1692,53.6,1629,45,0,0,604,1088
ZCTA5 65646,707,342,365,1655,56.8,1616,0,0,0,778,877
ZCTA5 65647,1202,230,972,3114,41.4,2580,236,7,0.002247913,552,2562
ZCTA5 65648,2111,297,1814,6601,38,6361,45,12,0.001817906,722,5879
ZCTA5 65649,878,42,836,2192,48.8,2016,39,0,0,97,2095
ZCTA5 65650,583,533,50,1968,34.3,1802,0,0,0,1172,796
ZCTA5 65652,1343,109,1234,4182,38.7,3950,0,97,0.023194644,273,3909
ZCTA5 65653,2545,126,2419,5817,54.3,5488,25,76,0.013065154,237,5580
ZCTA5 65654,116,88,28,262,35,240,0,0,0,178,84
ZCTA5 65655,1023,122,901,2163,54.9,2061,0,8,0.003698567,274,1889
ZCTA5 65656,1612,78,1534,4695,56.5,4563,0,0,0,161,4534
ZCTA5 65657,85,124,-39,350,38.2,350,0,0,0,199,151
ZCTA5 65658,619,291,328,1194,60.7,1027,1,0,0,566,628
ZCTA5 65660,134,969,-835,242,59.6,242,0,0,0,2025,-1783
ZCTA5 65661,897,709,188,2414,43,2139,13,23,0.009527755,1663,751
ZCTA5 65662,398,98,300,1122,53.4,1039,11,0,0,203,919
ZCTA5 65663,880,512,368,2362,39.9,2250,33,0,0,1887,475
ZCTA5 65664,16,4981,-4965,32,42.2,31,0,0,0,13791,-13759
ZCTA5 65666,53,1249,-1196,53,-,53,0,0,0,2693,-2640
ZCTA5 65667,1080,310,770,3317,40.1,3170,4,19,0.005728068,875,2442
ZCTA5 65668,725,6094,-5369,1662,60.9,1606,0,2,0.001203369,16415,-14753
ZCTA5 65669,871,178,693,2465,46.3,2299,0,5,0.002028398,442,2023
ZCTA5 65672,3491,358,3133,8711,42.3,7918,8,7,0.000803582,889,7822
ZCTA5 65674,979,5192,-4213,2825,38.8,2404,19,8,0.002831858,13458,-10633
ZCTA5 65675,10,20,-10,27,35.3,27,0,0,0,30,-3
ZCTA5 65676,200,1069,-869,505,53.1,480,0,0,0,2828,-2323
ZCTA5 65679,1325,179,1146,3227,46.3,2874,0,40,0.012395414,451,2776
ZCTA5 65680,455,878,-423,1135,53.9,1105,0,0,0,2533,-1398
ZCTA5 65681,885,27,858,1814,58.3,1788,0,26,0.014332966,70,1744
ZCTA5 65682,773,357,416,2099,40.1,2038,8,0,0,935,1164
ZCTA5 65685,340,574,-234,1141,37.9,1119,0,0,0,1576,-435
ZCTA5 65686,2157,42,2115,4883,64.3,4673,44,0,0,134,4749
ZCTA5 65688,28,711,-683,47,81.5,47,0,0,0,1669,-1622
ZCTA5 65689,2220,72,2148,5395,44.9,4764,140,10,0.001853568,153,5242
ZCTA5 65690,71,327,-256,153,56.1,149,0,0,0,692,-539
ZCTA5 65692,336,1407,-1071,936,46.3,847,2,0,0,3894,-2958
ZCTA5 65702,87,1924,-1837,137,52,108,0,0,0,4955,-4818
ZCTA5 65704,1596,103,1493,3780,36.8,3740,0,6,0.001587302,264,3516
ZCTA5 65705,1433,446,987,4181,37,3821,3,0,0,875,3306
ZCTA5 65706,6121,874,5247,16497,37.7,15447,86,85,0.005152452,2614,13883
ZCTA5 65707,796,831,-35,1990,44.2,1863,0,6,0.003015075,2532,-542
ZCTA5 65708,4887,432,4455,13437,36.7,10937,209,11,0.000818635,1014,12423
ZCTA5 65710,443,61,382,1105,34.9,1059,0,3,0.002714932,125,980
ZCTA5 65711,3207,10047,-6840,8567,42,7968,44,3,0.000350181,26631,-18064
ZCTA5 65712,3499,237,3262,8994,41.1,8579,0,34,0.003780298,626,8368
ZCTA5 65713,883,1337,-454,2549,36.4,2524,2,3,0.001176932,3823,-1274
ZCTA5 65714,12643,78,12565,33930,38.9,31310,435,613,0.018066608,239,33691
ZCTA5 65715,16,6578,-6562,59,21.5,59,0,0,0,17970,-17911
ZCTA5 65717,799,1521,-722,2602,37.1,2462,3,22,0.008455035,3608,-1006
ZCTA5 65720,269,358,-89,784,38.1,780,0,0,0,872,-88
ZCTA5 65721,12135,12,12123,33124,37,30642,92,308,0.009298394,20,33104
ZCTA5 65722,415,720,-305,1116,48.2,976,17,0,0,1949,-833
ZCTA5 65723,1114,187,927,2909,37.7,2464,29,2,0.000687521,481,2428
ZCTA5 65724,645,2586,-1941,1146,67.4,1118,21,0,0,8062,-6916
ZCTA5 65725,1104,202,902,3225,37.5,2764,0,5,0.001550388,539,2686
ZCTA5 65726,0,521,-521,954,19.6,840,30,29,0.030398323,1149,-195
ZCTA5 65727,71,61,10,128,63.8,128,0,0,0,122,6
ZCTA5 65728,13,1100,-1087,27,-,27,0,0,0,2763,-2736
ZCTA5 65729,84,139,-55,119,55.7,119,0,0,0,292,-173
ZCTA5 65730,9,935,-926,9,-,9,0,0,0,2117,-2108
ZCTA5 65731,78,396,-318,173,47,167,0,0,0,988,-815
ZCTA5 65732,401,4999,-4598,1208,33.2,1117,0,0,0,13920,-12712
ZCTA5 65733,274,99,175,1045,33.7,1035,4,0,0,187,858
ZCTA5 65734,1210,1391,-181,3130,33.6,2663,92,0,0,4100,-970
ZCTA5 65735,43,1416,-1373,88,27.9,88,0,0,0,3926,-3838
ZCTA5 65737,3057,80,2977,7595,51.3,7134,59,1,0.000131666,188,7407
ZCTA5 65738,7909,126,7783,20229,35.4,18723,250,342,0.016906421,317,19912
ZCTA5 65739,384,604,-220,843,57.6,763,0,54,0.06405694,1701,-858
ZCTA5 65740,1268,1800,-532,3708,42.6,3513,9,64,0.017259978,4328,-620
ZCTA5 65741,0,513,-513,0,-,0,0,0,#DIV/0!,1172,-1172
ZCTA5 65742,4965,41,4924,13770,38.7,13045,134,0,0,91,13679
ZCTA5 65744,24,105,-81,52,55,52,0,0,0,241,-189
ZCTA5 65745,924,90,834,2525,38.5,2249,0,0,0,197,2328
ZCTA5 65746,2863,817,2046,9238,30.4,8713,11,5,0.000541243,2133,7105
ZCTA5 65747,1713,993,720,3456,64.8,2717,0,0,0,3174,282
ZCTA5 65752,199,143,56,441,56.9,440,0,0,0,408,33
ZCTA5 65753,1849,1176,673,4902,45.2,4687,0,15,0.003059976,2409,2493
ZCTA5 65754,232,97,135,586,46.9,586,0,0,0,282,304
ZCTA5 65755,214,116,98,626,57.7,506,51,0,0,326,300
ZCTA5 65756,321,1197,-876,883,33.9,880,0,0,0,2976,-2093
ZCTA5 65757,2847,630,2217,7306,41.5,6769,107,31,0.004243088,1626,5680
ZCTA5 65759,385,172,213,1040,42.3,1023,7,0,0,436,604
ZCTA5 65760,236,3063,-2827,514,60.8,505,0,0,0,7853,-7339
ZCTA5 65761,531,127,404,1009,63.9,964,0,0,0,300,709
ZCTA5 65762,162,108,54,479,41.4,454,0,0,0,243,236
ZCTA5 65764,451,8642,-8191,1205,48.4,1189,0,0,0,22013,-20808
ZCTA5 65766,21,667,-646,73,34.5,71,0,0,0,1774,-1701
ZCTA5 65767,734,317,417,1760,47.2,1592,0,10,0.005681818,867,893
ZCTA5 65768,134,571,-437,335,50,322,0,0,0,1508,-1173
ZCTA5 65769,1046,589,457,2746,41.1,2542,0,3,0.001092498,1488,1258
ZCTA5 65770,1093,65,1028,2651,45.4,2353,36,2,0.000754432,133,2518
ZCTA5 65771,541,292,249,1479,50.8,1431,0,0,0,759,720
ZCTA5 65772,879,3476,-2597,2035,41.3,1769,0,23,0.011302211,8358,-6323
ZCTA5 65773,212,316,-104,564,45.1,552,0,0,0,846,-282
ZCTA5 65774,436,65,371,1214,44.4,1089,0,0,0,167,1047
ZCTA5 65775,9943,133,9810,25069,40.2,24014,47,70,0.002792293,447,24622
ZCTA5 65777,76,2359,-2283,197,48.3,197,0,0,0,6420,-6223
ZCTA5 65778,195,151,44,478,44.6,476,0,0,0,388,90
ZCTA5 65779,645,1265,-620,1292,57.1,1282,10,0,0,3514,-2222
ZCTA5 65781,3158,282,2876,9029,35.2,8591,4,2,0.000221508,594,8435
ZCTA5 65783,37,142,-105,144,45.2,144,0,0,0,325,-181
ZCTA5 65784,0,257,-257,0,-,0,0,0,#DIV/0!,636,-636
ZCTA5 65785,2290,226,2064,5603,47.7,5370,22,24,0.00428342,451,5152
ZCTA5 65786,633,29,604,1882,37,1770,28,6,0.003188098,60,1822
ZCTA5 65787,449,914,-465,1165,51.9,1078,33,0,0,2607,-1442
ZCTA5 65788,135,824,-689,292,40.3,281,1,0,0,2293,-2001
ZCTA5 65789,566,3271,-2705,1788,36.7,1581,0,0,0,9259,-7471
ZCTA5 65790,317,400,-83,1086,34.2,1032,0,0,0,973,113
ZCTA5 65791,1496,10,1486,4241,37.6,4016,6,0,0,20,4221
ZCTA5 65793,2331,248,2083,5575,44.1,5174,27,69,0.012376682,665,4910
ZCTA5 65801,0,3748,-3748,0,-,0,0,0,#DIV/0!,9426,-9426
ZCTA5 65802,19169,542,18627,45950,32.5,40654,714,2000,0.043525571,1401,44549
ZCTA5 65803,18143,49,18094,42617,37.7,36583,307,1478,0.034680996,172,42445
ZCTA5 65804,18992,5832,13160,38417,40.1,35619,766,752,0.019574667,15150,23267
ZCTA5 65806,7673,37,7636,14349,24.6,11266,881,865,0.060282947,57,14292
ZCTA5 65807,27017,721,26296,55798,33.5,48117,1146,2345,0.042026596,1241,54557
ZCTA5 65809,4665,13265,-8600,11140,49.5,10053,540,83,0.007450628,31327,-20187
ZCTA5 65810,9380,8032,1348,22027,46.6,19865,556,605,0.027466291,20960,1067
ZCTA5 65897,18,5504,-5486,3446,19.3,3100,40,230,0.066744051,16335,-12889
ZCTA5 66002,4632,6863,-2231,13125,33.9,11402,97,414,0.031542857,15587,-2462
ZCTA5 66006,2760,11048,-8288,7731,36.2,7111,55,137,0.017720864,27410,-19679
ZCTA5 66007,3513,7581,-4068,9625,39.9,9185,83,66,0.006857143,19102,-9477
ZCTA5 66008,100,5226,-5126,206,43,206,0,0,0,13576,-13370
ZCTA5 66010,258,3359,-3101,562,49.5,532,0,0,0,9562,-9000
ZCTA5 66012,3660,8544,-4884,10321,40.1,8355,0,660,0.063947292,21012,-10691
ZCTA5 66013,816,18382,-17566,2768,31.6,2499,0,0,0,44772,-42004
ZCTA5 66014,190,8917,-8727,525,37.7,525,0,0,0,22829,-22304
ZCTA5 66015,327,6232,-5905,795,42.5,764,4,7,0.008805031,15451,-14656
ZCTA5 66016,207,2109,-1902,858,20.7,788,0,0,0,6065,-5207
ZCTA5 66017,144,9063,-8919,329,43.7,325,0,0,0,24150,-23821
ZCTA5 66018,2358,11091,-8733,6417,35.3,5957,68,228,0.035530622,28341,-21924
ZCTA5 66020,524,9687,-9163,1828,44.4,1808,5,8,0.004376368,22264,-20436
ZCTA5 66021,893,4282,-3389,2820,38.4,2643,17,5,0.00177305,11741,-8921
ZCTA5 66023,430,5581,-5151,912,53,833,0,0,0,14313,-13401
ZCTA5 66024,257,176,81,717,36,629,0,75,0.10460251,572,145
ZCTA5 66025,2736,7447,-4711,7812,39,7116,44,73,0.009344598,17945,-10133
ZCTA5 66026,211,78,133,850,39.4,465,0,0,0,197,653
ZCTA5 66027,1568,464,1104,6698,24.8,4709,325,649,0.096894595,1450,5248
ZCTA5 66030,8552,3302,5250,24990,32.8,21202,596,1362,0.054501801,10373,14617
ZCTA5 66031,0,121,-121,617,34.1,443,9,93,0.150729335,417,200
ZCTA5 66032,1908,3793,-1885,4833,42.4,4591,0,32,0.006621146,11554,-6721
ZCTA5 66033,360,0,360,841,51.6,826,0,0,0,0,841
ZCTA5 66035,281,5247,-4966,1334,20.6,958,5,296,0.221889055,13579,-12245
ZCTA5 66039,280,624,-344,646,38.5,573,0,24,0.037151703,1575,-929
ZCTA5 66040,1493,52,1441,3286,49.7,3040,126,29,0.00882532,115,3171
ZCTA5 66041,374,1251,-877,915,45.1,902,6,1,0.001092896,3087,-2172
ZCTA5 66042,242,45,197,509,51.3,497,1,0,0,79,430
ZCTA5 66043,3066,1429,1637,10805,37.3,7995,64,1866,0.172697825,3534,7271
ZCTA5 66044,11620,789,10831,29266,24.9,23801,1407,1569,0.0536117,1815,27451
ZCTA5 66045,0,5362,-5362,1338,19.1,1037,147,70,0.052316891,12777,-11439
ZCTA5 66046,8221,156,8065,18675,30.2,13439,1312,991,0.053065596,311,18364
ZCTA5 66047,8986,116,8870,20592,29.9,15775,1322,664,0.032245532,304,20288
ZCTA5 66048,14077,345,13732,36185,41,28234,327,3971,0.109741606,897,35288
ZCTA5 66049,14340,410,13930,31458,36.8,25680,1753,1487,0.047269375,1090,30368
ZCTA5 66050,784,97,687,2017,44.9,1783,5,0,0,191,1826
ZCTA5 66052,735,114,621,1999,35.4,1846,0,0,0,334,1665
ZCTA5 66053,2899,200,2699,7652,41.7,7217,25,47,0.006142185,443,7209
ZCTA5 66054,1032,486,546,2943,39.5,2811,9,0,0,1080,1863
ZCTA5 66056,666,207,459,1393,39,1338,1,15,0.010768126,531,862
ZCTA5 66058,105,233,-128,346,58.8,335,0,5,0.014450867,648,-302
ZCTA5 66060,479,226,253,1245,40.3,1215,0,0,0,490,755
ZCTA5 66061,22894,281,22613,66267,36.1,54499,1738,3882,0.058581194,777,65490
ZCTA5 66062,27740,80,27660,76000,35.9,62518,4237,4315,0.056776316,213,75787
ZCTA5 66064,2153,1224,929,5771,40.7,5350,11,78,0.013515855,3129,2642
ZCTA5 66066,1037,5352,-4315,2351,41.6,2273,0,1,0.000425351,12769,-10418
ZCTA5 66067,6269,203,6066,15972,37.3,14618,93,112,0.007012271,441,15531
ZCTA5 66070,773,886,-113,2026,43.8,1949,19,29,0.014313919,2078,-52
ZCTA5 66071,5322,0,5322,12793,45.6,12124,156,84,0.006566091,0,12793
ZCTA5 66072,490,186,304,1403,37.2,1270,0,56,0.039914469,413,990
ZCTA5 66073,1032,20399,-19367,2863,38.6,2660,0,54,0.018861334,51209,-48346
ZCTA5 66075,910,3947,-3037,2338,39.6,2237,9,0,0,10283,-7945
ZCTA5 66076,864,582,282,2304,45,2101,0,0,0,1529,775
ZCTA5 66078,369,93,276,1118,41.5,1026,6,0,0,174,944
ZCTA5 66079,281,83,198,633,49.3,551,0,4,0.006319115,176,457
ZCTA5 66080,400,1956,-1556,1028,37.7,858,1,0,0,4738,-3710
ZCTA5 66083,3816,491,3325,11468,35.2,10925,37,161,0.014039065,1331,10137
ZCTA5 66085,3709,171,3538,10567,42.4,9696,436,180,0.017034163,305,10262
ZCTA5 66086,3783,285,3498,10370,37.8,8883,177,57,0.005496625,784,9586
ZCTA5 66087,866,168,698,2034,47.2,1950,1,1,0.000491642,389,1645
ZCTA5 66088,1074,629,445,2706,44.5,2621,0,17,0.006282336,1730,976
ZCTA5 66090,973,321,652,2477,44.2,2423,0,11,0.004440856,675,1802
ZCTA5 66091,199,988,-789,431,26.7,431,0,0,0,2512,-2081
ZCTA5 66092,1534,2573,-1039,4206,37.7,4065,6,8,0.001902045,6021,-1815
ZCTA5 66093,230,286,-56,640,39,640,0,0,0,648,-8
ZCTA5 66094,134,592,-458,349,41.4,214,2,0,0,1273,-924
ZCTA5 66095,355,131,224,1030,44.2,1022,0,0,0,316,714
ZCTA5 66097,468,1384,-916,978,49.3,954,0,0,0,3843,-2865
ZCTA5 66101,4904,394,4510,12410,31.8,5976,557,4221,0.340128928,985,11425
ZCTA5 66102,10043,87,9956,30874,28.6,10636,2514,5585,0.180896547,191,30683
ZCTA5 66103,6163,715,5448,13471,32.8,8636,703,1394,0.103481553,1948,11523
ZCTA5 66104,9418,302,9116,26638,34.7,9138,1386,10252,0.384863729,660,25978
ZCTA5 66105,877,265,612,2283,34.3,1622,17,0,0,573,1710
ZCTA5 66106,8392,233,8159,23817,35.4,17208,869,1778,0.074652559,480,23337
ZCTA5 66109,9566,145,9421,27507,37.7,16663,1525,5700,0.20721998,340,27167
ZCTA5 66111,3760,420,3340,10600,34.7,7370,81,910,0.085849057,951,9649
ZCTA5 66112,4884,1410,3474,12868,33.8,5854,914,4323,0.335949643,3290,9578
ZCTA5 66115,0,269,-269,0,-,0,0,0,#DIV/0!,518,-518
ZCTA5 66118,0,428,-428,0,-,0,0,0,#DIV/0!,983,-983
ZCTA5 66160,0,108,-108,0,-,0,0,0,#DIV/0!,222,-222
ZCTA5 66202,8474,268,8206,17068,33.8,14104,422,1327,0.077747832,496,16572
ZCTA5 66203,7881,838,7043,18812,38.9,16187,723,685,0.036412928,1986,16826
ZCTA5 66204,8582,1816,6766,18530,34,15084,271,1769,0.095466811,4698,13832
ZCTA5 66205,6294,294,6000,14046,38.2,12342,511,171,0.012174284,735,13311
ZCTA5 66206,4562,94,4468,11557,43.3,10226,492,69,0.005970408,231,11326
ZCTA5 66207,6194,77,6117,15183,43.3,14405,259,76,0.005005598,178,15005
ZCTA5 66208,9299,6061,3238,21662,40.4,20087,450,191,0.008817284,15016,6646
ZCTA5 66209,8076,388,7688,19288,49.6,16850,1457,520,0.026959768,984,18304
ZCTA5 66210,9021,379,8642,19603,39.1,14855,2011,1152,0.058766515,873,18730
ZCTA5 66211,2629,1112,1517,5593,48.9,5067,253,119,0.021276596,2775,2818
ZCTA5 66212,14579,87,14492,32996,36.6,26342,1047,2793,0.084646624,240,32756
ZCTA5 66213,12750,175,12575,30161,40,24098,3335,1254,0.041576871,492,29669
ZCTA5 66214,5181,736,4445,11706,34.1,8602,97,1595,0.136254912,1699,10007
ZCTA5 66215,11240,89,11151,25731,40.3,20926,773,1807,0.070226575,178,25553
ZCTA5 66216,9559,94,9465,24959,41.5,20673,1360,1304,0.052245683,276,24683
ZCTA5 66217,2553,31,2522,5659,49.3,5039,44,507,0.089591801,72,5587
ZCTA5 66218,2588,749,1839,8195,34.9,7172,295,403,0.049176327,1859,6336
ZCTA5 66219,6598,282,6316,13976,35.9,11382,668,688,0.049227247,585,13391
ZCTA5 66220,2848,33,2815,8342,42.1,7232,425,255,0.030568209,98,8244
ZCTA5 66221,8085,140,7945,24107,39.2,19980,2732,384,0.015928983,401,23706
ZCTA5 66223,9984,409,9575,26050,36.6,18445,5285,994,0.03815739,1003,25047
ZCTA5 66224,4626,171,4455,12349,43.5,10099,1353,298,0.024131509,389,11960
ZCTA5 66226,4684,548,4136,15353,35.1,13510,239,378,0.024620595,1565,13788
ZCTA5 66227,2926,459,2467,8445,38.6,7211,605,290,0.034339846,986,7459
ZCTA5 66251,7,181,-174,7,-,7,0,0,0,478,-471
ZCTA5 66401,733,69,664,1683,53.9,1614,0,5,0.002970885,175,1508
ZCTA5 66402,1145,10338,-9193,3162,37.7,2572,53,2,0.000632511,26436,-23274
ZCTA5 66403,272,10237,-9965,884,38.5,849,12,0,0,24145,-23261
ZCTA5 66404,142,1048,-906,395,43.1,395,0,0,0,2499,-2104
ZCTA5 66406,217,108,109,409,58.5,407,0,0,0,209,200
ZCTA5 66407,135,173,-38,274,40.7,254,0,0,0,348,-74
ZCTA5 66408,129,72,57,435,21.8,422,0,0,0,210,225
ZCTA5 66409,1635,25,1610,3502,54.4,3403,0,69,0.019703027,87,3415
ZCTA5 66411,525,283,242,1361,42.1,1298,0,4,0.002939015,651,710
ZCTA5 66412,111,43,68,355,32.6,355,0,0,0,67,288
ZCTA5 66413,805,225,580,1799,50,1715,0,6,0.003335186,618,1181
ZCTA5 66414,994,4,990,2302,48,2067,5,28,0.012163336,14,2288
ZCTA5 66415,268,63,205,667,49.9,640,5,3,0.004497751,166,501
ZCTA5 66416,177,136,41,496,37.5,468,0,0,0,338,158
ZCTA5 66417,182,71,111,474,41.6,464,0,0,0,114,360
ZCTA5 66418,155,761,-606,438,32.1,384,0,0,0,2027,-1589
ZCTA5 66419,116,172,-56,225,50.9,202,0,0,0,460,-235
ZCTA5 66422,304,242,62,1082,15.5,1049,0,0,0,630,452
ZCTA5 66423,337,468,-131,1186,41.4,1162,0,2,0.001686341,1063,123
ZCTA5 66424,211,1234,-1023,519,44.3,486,0,6,0.011560694,2826,-2307
ZCTA5 66425,252,153,99,448,61.5,354,18,15,0.033482143,348,100
ZCTA5 66427,507,7892,-7385,1229,45.2,1215,0,9,0.007323027,19558,-18329
ZCTA5 66428,98,738,-640,284,35.3,213,10,0,0,1905,-1621
ZCTA5 66429,175,1331,-1156,484,35.2,429,0,0,0,3216,-2732
ZCTA5 66431,192,99,93,556,50.6,535,0,0,0,251,305
ZCTA5 66432,172,968,-796,340,56.5,327,0,0,0,2582,-2242
ZCTA5 66434,1746,797,949,4615,42.7,4180,0,44,0.009534128,1748,2867
ZCTA5 66436,2395,698,1697,5912,40.9,5414,4,18,0.003044655,1548,4364
ZCTA5 66438,52,2072,-2020,128,45.1,119,0,0,0,5807,-5679
ZCTA5 66439,1010,309,701,2632,38.6,1845,8,21,0.007978723,766,1866
ZCTA5 66440,839,55,784,1750,49.4,1573,6,0,0,98,1652
ZCTA5 66441,10268,1768,8500,25780,28.7,15081,994,4861,0.188557021,4418,21362
ZCTA5 66442,4002,208,3794,16019,22.3,11153,333,2710,0.169174106,427,15592
ZCTA5 66449,449,244,205,1205,48.3,1122,4,0,0,631,574
ZCTA5 66451,583,35,548,1653,39,1587,0,25,0.015124017,39,1614
ZCTA5 66501,119,703,-584,380,29.5,373,0,0,0,1636,-1256
ZCTA5 66502,17645,626,17019,44789,25.1,36637,2070,2399,0.053562259,1712,43077
ZCTA5 66503,6893,185,6708,16715,38,13896,1020,884,0.052886629,416,16299
ZCTA5 66506,0,103,-103,3307,19.4,2813,87,148,0.044753553,219,3088
ZCTA5 66507,330,186,144,951,33.4,853,9,0,0,341,610
ZCTA5 66508,1754,248,1506,4193,38.4,3980,14,39,0.009301216,858,3335
ZCTA5 66509,1002,212,790,2923,40,1885,11,9,0.003079028,579,2344
ZCTA5 66510,295,135,160,736,46.5,713,0,5,0.006793478,299,437
ZCTA5 66512,1124,630,494,2800,44.7,2571,3,0,0,1664,1136
ZCTA5 66514,690,190,500,2000,38,1733,24,28,0.014,406,1594
ZCTA5 66515,120,61,59,460,24.1,392,0,0,0,146,314
ZCTA5 66516,117,122,-5,337,42.5,281,0,0,0,346,-9
ZCTA5 66517,683,168,515,1651,29.7,1344,15,139,0.084191399,370,1281
ZCTA5 66518,134,768,-634,217,62,207,10,0,0,1902,-1685
ZCTA5 66520,245,693,-448,593,39.9,577,0,0,0,1402,-809
ZCTA5 66521,555,1106,-551,1445,52.8,1368,0,0,0,3104,-1659
ZCTA5 66522,65,153,-88,219,20.4,177,0,2,0.00913242,369,-150
ZCTA5 66523,1564,416,1148,3739,39.5,3637,6,22,0.005883926,888,2851
ZCTA5 66524,970,137,833,2456,47.8,2410,15,0,0,280,2176
ZCTA5 66526,309,9813,-9504,853,44.8,806,0,0,0,24001,-23148
ZCTA5 66527,70,206,-136,170,38,160,0,0,0,517,-347
ZCTA5 66528,266,315,-49,712,38.7,656,0,0,0,681,31
ZCTA5 66531,664,99,565,1757,38.4,1728,0,0,0,264,1493
ZCTA5 66532,226,137,89,607,35.3,597,2,0,0,242,365
ZCTA5 66533,649,78,571,1826,39.5,1679,6,23,0.012595838,143,1683
ZCTA5 66534,1578,29,1549,3915,39.8,3792,0,24,0.006130268,65,3850
ZCTA5 66535,1368,81,1287,3376,35.7,3210,33,0,0,181,3195
ZCTA5 66536,1140,100,1040,4161,26.3,3589,129,21,0.005046864,225,3936
ZCTA5 66537,471,116,355,1237,42.2,1096,0,0,0,336,901
ZCTA5 66538,1309,120,1189,3312,41.5,3233,0,22,0.006642512,224,3088
ZCTA5 66539,1094,76,1018,2590,44.4,2541,0,0,0,137,2453
ZCTA5 66540,232,1059,-827,571,40.4,553,0,0,0,2467,-1896
ZCTA5 66541,112,147,-35,244,61.1,238,0,1,0.004098361,298,-54
ZCTA5 66542,1061,100,961,2881,44,2758,0,1,0.000347102,220,2661
ZCTA5 66543,443,302,141,1129,48.2,1080,0,0,0,572,557
ZCTA5 66544,120,803,-683,273,55.6,270,0,0,0,1771,-1498
ZCTA5 66546,391,122,269,988,51.1,798,9,102,0.103238866,223,765
ZCTA5 66547,2942,105,2837,8380,37.7,7902,0,197,0.023508353,195,8185
ZCTA5 66548,341,236,105,837,47.5,736,7,0,0,539,298
ZCTA5 66549,612,294,318,1500,43.7,1478,0,5,0.003333333,632,868
ZCTA5 66550,202,99,103,587,34.9,550,4,0,0,252,335
ZCTA5 66552,215,332,-117,450,40.5,410,0,11,0.024444444,693,-243
ZCTA5 66554,253,162,91,671,57.9,643,3,0,0,324,347
ZCTA5 66603,636,105,531,1171,29,567,0,151,0.128949616,249,922
ZCTA5 66604,10029,218,9811,23517,37.7,18709,541,1630,0.069311562,431,23086
ZCTA5 66605,7926,114,7812,20840,36.9,14057,43,3322,0.15940499,233,20607
ZCTA5 66606,4769,1679,3090,9647,40.8,8372,36,590,0.06115891,4371,5276
ZCTA5 66607,3251,21,3230,9374,32.8,5671,0,2015,0.214956262,34,9340
ZCTA5 66608,2117,151,1966,4936,42.5,4031,29,472,0.095623987,386,4550
ZCTA5 66609,2929,42,2887,7011,40.7,5292,9,920,0.131222365,88,6923
ZCTA5 66610,4339,51,4288,10886,47.4,9523,355,651,0.05980158,96,10790
ZCTA5 66611,4651,43,4608,10683,37.1,8008,14,1228,0.114948984,80,10603
ZCTA5 66612,1283,1442,-159,1968,47,1089,0,478,0.242886179,3333,-1365
ZCTA5 66614,14567,1193,13374,33332,40.4,27867,1139,1594,0.047821913,2580,30752
ZCTA5 66615,1423,144,1279,3256,41.2,2890,65,48,0.014742015,362,2894
ZCTA5 66616,2370,2266,104,5316,34.3,3885,7,655,0.123212942,4994,322
ZCTA5 66617,3338,89,3249,9060,41,7935,231,181,0.019977925,219,8841
ZCTA5 66618,3785,809,2976,10129,39.8,9470,9,172,0.016980946,1721,8408
ZCTA5 66619,917,631,286,3070,27,2302,0,509,0.165798046,1549,1521
ZCTA5 66621,0,1088,-1088,597,19,448,15,32,0.05360134,2621,-2024
ZCTA5 66622,0,57,-57,106,54.7,65,32,4,0.037735849,159,-53
ZCTA5 66701,4819,36,4783,11547,39.2,10556,113,361,0.031263532,138,11409
ZCTA5 66710,250,124,126,586,47.1,540,0,0,0,278,308
ZCTA5 66711,267,2671,-2404,624,44.6,603,0,0,0,6568,-5944
ZCTA5 66712,764,748,16,1678,51.9,1594,0,7,0.004171633,1593,85
ZCTA5 66713,2063,311,1752,5512,40.8,4858,0,16,0.002902758,636,4876
ZCTA5 66714,61,178,-117,178,39.6,132,0,7,0.039325843,449,-271
ZCTA5 66716,189,65,124,680,26.4,610,9,5,0.007352941,166,514
ZCTA5 66717,216,86,130,592,47.2,583,0,0,0,194,398
ZCTA5 66720,4255,2523,1732,10844,38.3,10320,6,135,0.012449281,5627,5217
ZCTA5 66724,366,109,257,1054,41,1016,0,0,0,286,768
ZCTA5 66725,2083,238,1845,5538,39.9,4903,12,101,0.018237631,583,4955
ZCTA5 66732,75,239,-164,261,33.7,215,10,0,0,541,-280
ZCTA5 66733,917,144,773,2356,45.2,2171,0,63,0.026740238,313,2043
ZCTA5 66734,112,753,-641,183,53.3,162,0,0,0,1748,-1565
ZCTA5 66735,248,110,138,760,33.1,748,0,0,0,180,580
ZCTA5 66736,1440,29,1411,3619,48.4,3407,4,13,0.003592153,69,3550
ZCTA5 66738,109,89,20,271,54.2,264,2,0,0,188,83
ZCTA5 66739,2136,189,1947,5243,48.4,4612,23,7,0.001335113,382,4861
ZCTA5 66740,74,57,17,202,57.3,202,0,0,0,118,84
ZCTA5 66741,84,1084,-1000,193,57.4,193,0,0,0,2321,-2128
ZCTA5 66742,17,1147,-1130,33,54.3,33,0,0,0,2315,-2282
ZCTA5 66743,1562,122,1440,4065,40.6,3816,0,19,0.004674047,232,3833
ZCTA5 66746,67,560,-493,174,36.7,155,0,0,0,1371,-1197
ZCTA5 66748,1135,220,915,2974,47.5,2849,42,14,0.004707465,611,2363
ZCTA5 66749,2873,982,1891,7250,37.3,6502,56,243,0.033517241,2042,5208
ZCTA5 66751,307,211,96,673,49.7,648,4,0,0,457,216
ZCTA5 66753,537,402,135,1277,40.2,1186,0,2,0.001566171,968,309
ZCTA5 66754,124,90,34,446,31.9,284,0,0,0,238,208
ZCTA5 66755,365,140,225,832,52.5,804,0,2,0.002403846,373,459
ZCTA5 66756,447,195,252,1086,39.9,1037,0,0,0,422,664
ZCTA5 66757,1297,9627,-8330,3261,38.4,3045,0,8,0.002453235,29968,-26707
ZCTA5 66758,73,530,-457,198,51.5,184,0,0,0,1303,-1105
ZCTA5 66760,0,418,-418,0,-,0,0,0,#DIV/0!,1251,-1251
ZCTA5 66761,90,1017,-927,297,31.8,297,0,0,0,2984,-2687
ZCTA5 66762,10029,51,9978,24997,29.3,22372,606,715,0.028603432,131,24866
ZCTA5 66763,1326,314,1012,3390,32.9,2999,112,79,0.023303835,915,2475
ZCTA5 66767,158,266,-108,387,58.6,366,14,0,0,726,-339
ZCTA5 66769,176,629,-453,556,38.4,494,0,0,0,1325,-769
ZCTA5 66770,315,24,291,965,47.1,896,0,10,0.010362694,57,908
ZCTA5 66771,368,154,214,1084,44.3,990,18,0,0,460,624
ZCTA5 66772,92,185,-93,193,44.7,191,0,0,0,491,-298
ZCTA5 66773,222,61,161,495,48.3,469,0,12,0.024242424,178,317
ZCTA5 66775,66,326,-260,185,37.3,184,0,0,0,738,-553
ZCTA5 66776,595,11354,-10759,1500,41.6,1343,8,0,0,33588,-32088
ZCTA5 66777,221,178,43,495,60.3,439,0,0,0,439,56
ZCTA5 66778,0,126,-126,0,-,0,0,0,#DIV/0!,334,-334
ZCTA5 66779,247,732,-485,723,32,704,0,0,0,2526,-1803
ZCTA5 66780,205,325,-120,500,41,462,0,0,0,948,-448
ZCTA5 66781,320,587,-267,985,25.8,971,0,0,0,1417,-432
ZCTA5 66782,45,684,-639,122,46.6,98,0,0,0,2028,-1906
ZCTA5 66783,879,56,823,2221,50,2022,0,2,0.000900495,93,2128
ZCTA5 66801,11433,199,11234,27926,32,22649,551,593,0.021234692,638,27288
ZCTA5 66830,87,1098,-1011,200,57,182,0,0,0,3120,-2920
ZCTA5 66833,245,759,-514,501,60.3,468,10,0,0,1949,-1448
ZCTA5 66834,362,91,271,922,38.6,815,44,23,0.02494577,225,697
ZCTA5 66835,442,163,279,1118,34.2,1069,5,0,0,310,808
ZCTA5 66838,69,862,-793,128,58,120,0,0,0,2239,-2111
ZCTA5 66839,1509,392,1117,3830,41.3,3548,24,40,0.010443864,919,2911
ZCTA5 66840,219,544,-325,616,37.8,600,0,0,0,1614,-998
ZCTA5 66842,183,53,130,538,43.9,513,0,0,0,120,418
ZCTA5 66843,54,562,-508,152,51.2,151,0,0,0,1448,-1296
ZCTA5 66845,451,577,-126,1053,46.3,957,0,26,0.024691358,1869,-816
ZCTA5 66846,1290,2104,-814,3194,44.2,3071,14,8,0.002504696,5029,-1835
ZCTA5 66849,190,465,-275,468,51.1,435,0,0,0,1085,-617
ZCTA5 66850,101,740,-639,257,45.2,244,0,5,0.019455253,2023,-1766
ZCTA5 66851,292,998,-706,563,56.4,550,0,0,0,2432,-1869
ZCTA5 66852,255,493,-238,541,46.5,541,0,0,0,1234,-693
ZCTA5 66853,169,2840,-2671,375,50.5,347,0,0,0,7923,-7548
ZCTA5 66854,266,144,122,631,46.3,593,2,3,0.004754358,443,188
ZCTA5 66856,669,7174,-6505,1814,41.9,1767,6,13,0.007166483,22302,-20488
ZCTA5 66857,475,978,-503,911,54.5,859,20,5,0.005488474,2584,-1673
ZCTA5 66858,149,1681,-1532,347,48.9,318,0,0,0,4781,-4434
ZCTA5 66859,84,277,-193,238,40.8,221,0,0,0,826,-588
ZCTA5 66860,554,49,505,1263,43.3,1205,0,2,0.001583531,157,1106
ZCTA5 66861,1316,230,1086,2778,47.8,2649,8,20,0.007199424,580,2198
ZCTA5 66862,54,48,6,82,59,82,0,0,0,123,-41
ZCTA5 66863,32,780,-748,48,62.3,48,0,0,0,2063,-2015
ZCTA5 66864,158,1680,-1522,437,34.6,415,0,3,0.006864989,4111,-3674
ZCTA5 66865,418,358,60,1142,32.4,1053,0,0,0,862,280
ZCTA5 66866,649,9467,-8818,1836,48.8,1720,0,4,0.002178649,23949,-22113
ZCTA5 66868,303,2445,-2142,779,45.8,766,0,0,0,7123,-6344
ZCTA5 66869,292,4639,-4347,669,40.6,640,4,0,0,12364,-11695
ZCTA5 66870,53,18,35,154,57.2,140,0,0,0,881,-727
ZCTA5 66871,536,132,404,1267,46.2,1256,0,0,0,316,951
ZCTA5 66872,427,491,-64,954,51.4,923,13,0,0,1134,-180
ZCTA5 66873,97,179,-82,215,49.1,199,0,0,0,369,-154
ZCTA5 66901,2478,587,1891,6220,37.3,5782,0,130,0.020900322,1413,4807
ZCTA5 66930,74,179,-105,137,60.9,118,0,0,0,531,-394
ZCTA5 66932,26,242,-216,58,55.2,56,0,0,0,583,-525
ZCTA5 66933,164,392,-228,319,54.5,313,4,0,0,905,-586
ZCTA5 66935,1039,5588,-4549,2451,45.1,2395,14,33,0.013463892,16134,-13683
ZCTA5 66936,140,849,-709,327,55.5,319,0,0,0,2049,-1722
ZCTA5 66937,330,12567,-12237,1002,28.9,964,23,0,0,30136,-29134
ZCTA5 66938,491,3641,-3150,1289,39.3,1270,0,0,0,10716,-9427
ZCTA5 66939,180,354,-174,432,40.6,432,0,0,0,894,-462
ZCTA5 66940,164,296,-132,306,57.9,306,0,0,0,772,-466
ZCTA5 66941,58,732,-674,83,63.5,77,0,0,0,1812,-1729
ZCTA5 66942,88,191,-103,272,40.7,216,0,0,0,450,-178
ZCTA5 66943,204,355,-151,494,39.7,463,2,0,0,954,-460
ZCTA5 66944,111,219,-108,383,61.8,383,0,0,0,500,-117
ZCTA5 66945,360,947,-587,913,40.2,902,6,3,0.003285871,2314,-1401
ZCTA5 66946,96,571,-475,146,58.1,144,0,0,0,1232,-1086
ZCTA5 66948,185,256,-71,426,47.3,421,0,0,0,1220,-794
ZCTA5 66949,229,141,88,551,43.6,512,0,5,0.00907441,601,-50
ZCTA5 66951,345,342,3,847,47.2,793,1,8,0.0094451,939,-92
ZCTA5 66952,195,43,152,396,59.2,366,0,0,0,128,268
ZCTA5 66953,253,279,-26,646,36.2,584,0,0,0,647,-1
ZCTA5 66955,33,793,-760,70,50.5,66,0,0,0,1954,-1884
ZCTA5 66956,469,9235,-8766,1169,51.2,1128,5,6,0.005132592,26274,-25105
ZCTA5 66958,120,666,-546,235,52.5,224,0,9,0.038297872,1758,-1523
ZCTA5 66959,100,4823,-4723,200,59.1,185,15,0,0,12580,-12380
ZCTA5 66960,47,344,-297,111,39.5,107,0,0,0,859,-748
ZCTA5 66961,11,146,-135,15,68.2,15,0,0,0,338,-323
ZCTA5 66962,104,659,-555,247,57.9,238,0,0,0,1496,-1249
ZCTA5 66963,104,138,-34,263,30.3,245,4,0,0,286,-23
ZCTA5 66964,87,1140,-1053,159,60.3,126,0,0,0,2965,-2806
ZCTA5 66966,288,967,-679,666,40.5,628,0,3,0.004504505,2324,-1658
ZCTA5 66967,800,121,679,1957,43.5,1867,13,5,0.002554931,321,1636
ZCTA5 66968,631,133,498,1339,49.4,1277,7,1,0.000746826,286,1053
ZCTA5 66970,29,1334,-1305,55,61.7,55,0,0,0,3224,-3169
ZCTA5 67001,754,534,220,2235,30.7,2202,0,6,0.002684564,1228,1007
ZCTA5 67002,5382,2038,3344,16585,35.7,14340,662,275,0.016581248,5106,11479
ZCTA5 67003,962,371,591,2455,40.7,2284,29,2,0.000814664,1241,1214
ZCTA5 67004,348,37,311,820,45.6,766,0,20,0.024390244,68,752
ZCTA5 67005,6059,971,5088,15332,37.6,12547,179,460,0.030002609,2373,12959
ZCTA5 67008,269,308,-39,514,50.2,507,0,0,0,947,-433
ZCTA5 67009,362,463,-101,931,36.9,905,0,0,0,2006,-1075
ZCTA5 67010,5578,9,5569,13937,42.7,13228,11,87,0.006242376,19,13918
ZCTA5 67012,6,744,-738,12,-,12,0,0,0,1959,-1947
ZCTA5 67013,1346,2664,-1318,3087,47.1,2923,35,1,0.000323939,5767,-2680
ZCTA5 67016,160,13816,-13656,462,42.6,434,0,2,0.004329004,35516,-35054
ZCTA5 67017,681,9580,-8899,1820,41.5,1489,38,0,0,24564,-22744
ZCTA5 67018,53,9282,-9229,100,63.4,100,0,0,0,19769,-19669
ZCTA5 67019,333,9009,-8676,914,34.2,860,0,0,0,28069,-27155
ZCTA5 67020,510,4925,-4415,1394,36.9,1313,0,4,0.00286944,14677,-13283
ZCTA5 67021,10,2772,-2762,22,68.5,19,0,0,0,8740,-8718
ZCTA5 67022,657,7986,-7329,1396,50.6,1305,0,0,0,22165,-20769
ZCTA5 67023,75,4338,-4263,160,58.5,151,0,6,0.0375,11699,-11539
ZCTA5 67024,464,271,193,1088,39,897,0,10,0.009191176,1232,-144
ZCTA5 67025,1261,8165,-6904,3694,39.7,3618,0,4,0.001082837,17011,-13317
ZCTA5 67026,1655,9403,-7748,4738,40.4,4422,53,10,0.002110595,25618,-20880
ZCTA5 67028,99,3187,-3088,187,36.7,162,1,0,0,8535,-8348
ZCTA5 67029,491,3205,-2714,1010,47,970,0,2,0.001980198,9358,-8348
ZCTA5 67030,875,3639,-2764,2802,41.1,2617,103,0,0,10729,-7927
ZCTA5 67031,873,9782,-8909,2386,33.3,2323,50,9,0.003772003,26510,-24124
ZCTA5 67035,358,6578,-6220,889,55.9,869,1,6,0.006749156,15740,-14851
ZCTA5 67036,59,9907,-9848,126,73,126,0,0,0,21511,-21385
ZCTA5 67037,11389,7389,4000,29180,37.1,25266,361,476,0.016312543,17892,11288
ZCTA5 67038,259,6568,-6309,813,32.1,738,0,0,0,17699,-16886
ZCTA5 67039,1057,5826,-4769,3025,37.6,2824,7,7,0.00231405,13269,-10244
ZCTA5 67041,87,6084,-5997,293,28.7,289,0,0,0,14054,-13761
ZCTA5 67042,6421,3329,3092,17132,36.9,14874,44,930,0.05428438,9739,7393
ZCTA5 67045,1284,12453,-11169,3182,44.3,2964,12,21,0.006599623,30026,-26844
ZCTA5 67047,310,8228,-7918,739,57.7,730,0,0,0,26269,-25530
ZCTA5 67049,20,4762,-4742,95,17.4,95,0,0,0,13472,-13377
ZCTA5 67050,724,9921,-9197,2302,33.3,2232,0,19,0.008253692,24241,-21939
ZCTA5 67051,155,4473,-4318,370,44.5,298,15,0,0,11869,-11499
ZCTA5 67052,2654,1252,1402,8738,34.3,8138,58,94,0.01075761,3290,5448
ZCTA5 67053,195,9946,-9751,576,45.3,549,0,0,0,24304,-23728
ZCTA5 67054,498,3636,-3138,1207,44.7,1140,13,4,0.003314002,10453,-9246
ZCTA5 67055,39,2559,-2520,75,48.6,75,0,0,0,6026,-5951
ZCTA5 67056,1147,9810,-8663,3226,35.7,2931,0,112,0.034717917,22917,-19691
ZCTA5 67057,125,1797,-1672,250,46.8,216,0,0,0,4621,-4371
ZCTA5 67058,738,11220,-10482,1829,39.3,1649,0,6,0.003280481,26982,-25153
ZCTA5 67059,299,0,299,947,37.9,820,19,16,0.016895459,1323,-376
ZCTA5 67060,5230,479,4751,14518,38.2,12758,68,19,0.00130872,1304,13214
ZCTA5 67061,61,118,-57,172,31.6,156,0,0,0,250,-78
ZCTA5 67062,1731,115,1616,4032,38.5,3818,20,14,0.003472222,237,3795
ZCTA5 67063,1285,1889,-604,3576,38.7,3321,55,87,0.024328859,4242,-666
ZCTA5 67065,119,223,-104,242,47.5,236,0,0,0,618,-376
ZCTA5 67066,165,43,122,308,60.2,277,0,0,0,86,222
ZCTA5 67067,795,6029,-5234,2313,39.6,1742,256,148,0.063986165,14549,-12236
ZCTA5 67068,1885,398,1487,4113,45.4,3813,0,5,0.001215658,1038,3075
ZCTA5 67070,391,161,230,886,44.5,788,0,16,0.018058691,375,511
ZCTA5 67071,55,47,8,219,12.8,219,0,0,0,75,144
ZCTA5 67072,175,157,18,363,23.8,343,0,10,0.027548209,350,13
ZCTA5 67073,118,548,-430,388,35.4,382,0,6,0.015463918,1499,-1111
ZCTA5 67074,539,178,361,1217,49.4,1193,0,0,0,429,788
ZCTA5 67101,2522,257,2265,5897,42.5,5224,157,38,0.006443955,650,5247
ZCTA5 67102,24,141,-117,142,16.2,126,0,0,0,324,-182
ZCTA5 67103,64,123,-59,180,31.5,177,0,0,0,296,-116
ZCTA5 67104,788,224,564,1824,45.3,1777,46,0,0,472,1352
ZCTA5 67105,69,105,-36,181,44.8,166,0,0,0,183,-2
ZCTA5 67106,171,51,120,531,26.6,531,0,0,0,115,416
ZCTA5 67107,1081,83,998,2663,46.6,2583,0,6,0.002253098,162,2501
ZCTA5 67108,614,116,498,1553,45.9,1466,0,0,0,263,1290
ZCTA5 67109,154,154,0,343,37.4,333,0,0,0,335,8
ZCTA5 67110,3204,186,3018,8455,41.7,7855,0,62,0.007332939,459,7996
ZCTA5 67111,94,308,-214,227,47.4,227,0,0,0,642,-415
ZCTA5 67112,108,396,-288,238,54.9,233,0,0,0,966,-728
ZCTA5 67114,8183,50,8133,20674,39.9,17761,56,486,0.023507788,109,20565
ZCTA5 67117,816,2764,-1948,1959,44.7,1730,27,60,0.030627871,8413,-6454
ZCTA5 67118,299,197,102,738,38.4,726,0,0,0,471,267
ZCTA5 67119,549,166,383,1298,45.1,1123,1,0,0,377,921
ZCTA5 67120,328,123,205,763,56.3,749,8,0,0,316,447
ZCTA5 67122,85,136,-51,259,53.1,259,0,0,0,346,-87
ZCTA5 67123,343,466,-123,857,44.9,719,0,2,0.002333722,1276,-419
ZCTA5 67124,3038,391,2647,7896,37.1,7307,17,182,0.023049645,1067,6829
ZCTA5 67127,313,399,-86,707,48.2,701,0,0,0,989,-282
ZCTA5 67131,112,237,-125,265,57.9,254,0,1,0.003773585,583,-318
ZCTA5 67132,105,374,-269,332,33,325,0,0,0,877,-545
ZCTA5 67133,2364,191,2173,6574,39.7,6172,58,74,0.011256465,516,6058
ZCTA5 67134,139,141,-2,422,36.1,389,0,0,0,302,120
ZCTA5 67135,1169,161,1008,3531,35.1,3169,26,3,0.000849618,412,3119
ZCTA5 67137,169,823,-654,376,51,365,0,0,0,2361,-1985
ZCTA5 67138,202,102,100,470,44.7,461,3,0,0,204,266
ZCTA5 67140,393,431,-38,1056,37.2,984,6,27,0.025568182,1209,-153
ZCTA5 67142,127,96,31,352,42.2,337,0,0,0,232,120
ZCTA5 67143,61,360,-299,158,33,156,0,0,0,889,-731
ZCTA5 67144,980,2239,-1259,2665,41.9,2575,24,0,0,5220,-2555
ZCTA5 67146,707,352,355,2068,40,1818,0,2,0.000967118,711,1357
ZCTA5 67147,3898,2240,1658,10864,35.6,9839,180,35,0.003221649,5019,5845
ZCTA5 67149,367,126,241,1252,34.1,1176,0,0,0,326,926
ZCTA5 67150,6,586,-580,11,82.4,8,0,0,0,1797,-1786
ZCTA5 67151,219,599,-380,503,38.5,494,0,0,0,1568,-1065
ZCTA5 67152,3322,191,3131,8937,39.8,7867,28,129,0.014434374,452,8485
ZCTA5 67154,651,1074,-423,2290,25.4,1991,2,176,0.076855895,2592,-302
ZCTA5 67155,44,7,37,100,61.5,100,0,0,0,25,75
ZCTA5 67156,5132,40,5092,14476,38.3,12535,465,320,0.022105554,74,14402
ZCTA5 67159,65,123,-58,141,59.5,141,0,0,0,260,-119
ZCTA5 67202,1200,412,788,1926,28.8,1328,0,293,0.152128764,1129,797
ZCTA5 67203,12899,220,12679,30771,37,23238,930,1971,0.064053817,490,30281
ZCTA5 67204,8604,173,8431,22188,39.8,15814,186,1602,0.07220119,393,21795
ZCTA5 67205,6825,893,5932,20642,40,18822,550,200,0.009688984,2036,18606
ZCTA5 67206,7719,558,7161,17598,40.7,13814,1101,1275,0.072451415,1435,16163
ZCTA5 67207,11072,1047,10025,26836,32,15955,4004,3459,0.128894023,3052,23784
ZCTA5 67208,7213,71,7142,17640,33.3,10624,464,4388,0.248752834,176,17464
ZCTA5 67209,5085,670,4415,13756,37.2,11561,403,293,0.021299796,1460,12296
ZCTA5 67210,3097,230,2867,9233,29.1,4807,1470,1238,0.134084263,498,8735
ZCTA5 67211,8022,329,7693,19854,34.7,12732,528,1604,0.080789765,801,19053
ZCTA5 67212,18369,25,18344,44128,36.3,37464,922,1552,0.035170413,40,44088
ZCTA5 67213,8579,108,8471,21881,33.8,15115,350,1656,0.075682099,179,21702
ZCTA5 67214,6216,102,6114,16726,31.8,5336,605,6248,0.373550161,277,16449
ZCTA5 67215,2041,17,2024,5771,37.7,4526,343,189,0.032749957,50,5721
ZCTA5 67216,8516,247,8269,21498,36.6,14198,1860,1450,0.067448135,625,20873
ZCTA5 67217,11926,447,11479,31016,33.3,23472,920,2020,0.065127676,1242,29774
ZCTA5 67218,9915,72,9843,22922,35.8,14672,686,3263,0.142352325,207,22715
ZCTA5 67219,4361,418,3943,12133,31.9,7104,888,2902,0.239182395,1099,11034
ZCTA5 67220,5422,1214,4208,13682,32.1,7530,1411,3197,0.233664669,3448,10234
ZCTA5 67221,0,233,-233,351,22.4,243,3,27,0.076923077,548,-197
ZCTA5 67223,188,279,-91,595,36.7,547,0,0,0,741,-146
ZCTA5 67226,8241,316,7925,21603,35.8,16140,1071,2666,0.123408786,803,20800
ZCTA5 67227,77,3571,-3494,226,33.3,226,0,0,0,8692,-8466
ZCTA5 67228,741,189,552,2718,33.2,2110,446,80,0.029433407,493,2225
ZCTA5 67230,3877,126,3751,11422,43.3,8928,1426,593,0.051917352,223,11199
ZCTA5 67232,254,252,2,625,33.1,591,34,0,0,698,-73
ZCTA5 67235,4867,105,4762,14967,35.3,12768,445,410,0.027393599,206,14761
ZCTA5 67260,0,136,-136,0,-,0,0,0,#DIV/0!,324,-324
ZCTA5 67301,5268,401,4867,12793,38,11244,20,509,0.039787384,1065,11728
ZCTA5 67330,561,111,450,1556,36.8,1416,0,0,0,290,1266
ZCTA5 67332,54,590,-536,167,46.5,140,0,0,0,1241,-1074
ZCTA5 67333,1031,345,686,2361,45.1,1950,26,12,0.005082592,1129,1232
ZCTA5 67334,29,153,-124,79,50.8,66,1,0,0,455,-376
ZCTA5 67335,1309,359,950,3523,39.8,3283,48,18,0.005109282,855,2668
ZCTA5 67336,561,290,271,1397,50.6,1348,0,0,0,629,768
ZCTA5 67337,4491,499,3992,11266,41.3,8154,86,1007,0.089383987,1406,9860
ZCTA5 67340,152,541,-389,390,42,365,0,0,0,1553,-1163
ZCTA5 67341,185,142,43,436,41.9,365,0,19,0.043577982,303,133
ZCTA5 67342,350,150,200,720,50.2,609,0,0,0,346,374
ZCTA5 67344,257,3078,-2821,787,39.3,717,0,0,0,8379,-7592
ZCTA5 67345,56,254,-198,103,65.8,81,0,0,0,540,-437
ZCTA5 67346,129,140,-11,364,47.7,315,0,0,0,243,121
ZCTA5 67347,174,76,98,515,44.7,376,0,0,0,174,341
ZCTA5 67349,391,202,189,809,44.6,758,6,2,0.002472188,589,220
ZCTA5 67351,154,61,93,298,59.1,276,0,0,0,118,180
ZCTA5 67352,227,124,103,634,46,574,0,0,0,329,305
ZCTA5 67353,187,215,-28,457,57.2,442,0,0,0,438,19
ZCTA5 67354,242,449,-207,641,38.7,582,0,0,0,1165,-524
ZCTA5 67355,66,28,38,208,53.8,139,0,0,0,72,136
ZCTA5 67356,1046,47,999,2896,35.4,2655,0,32,0.011049724,105,2791
ZCTA5 67357,4793,1127,3666,12046,41,10468,23,789,0.065498921,2601,9445
ZCTA5 67360,161,227,-66,431,50.8,366,0,0,0,498,-67
ZCTA5 67361,646,157,489,1601,48.4,1408,10,31,0.019362898,338,1263
ZCTA5 67363,56,1071,-1015,149,55.1,149,0,0,0,3159,-3010
ZCTA5 67364,105,60,45,193,58.9,167,0,0,0,117,76
ZCTA5 67401,20683,152,20531,50827,39.3,44319,1039,1576,0.031007142,416,50411
ZCTA5 67410,4378,327,4051,10570,40.8,10124,0,128,0.012109745,814,9756
ZCTA5 67416,373,226,147,888,51.1,852,0,0,0,486,402
ZCTA5 67417,60,437,-377,130,35.5,130,0,0,0,1096,-966
ZCTA5 67418,62,171,-109,151,29.7,114,0,0,0,381,-230
ZCTA5 67420,1652,68,1584,3993,42.1,3832,0,26,0.006511395,164,3829
ZCTA5 67422,511,367,144,1221,48.5,1185,15,0,0,905,316
ZCTA5 67423,87,165,-78,283,38.1,248,0,3,0.010600707,374,-91
ZCTA5 67425,205,1460,-1255,669,36.6,545,3,0,0,4017,-3348
ZCTA5 67427,179,562,-383,387,51.5,339,0,0,0,1490,-1103
ZCTA5 67428,514,217,297,1360,36.6,1294,0,32,0.023529412,490,870
ZCTA5 67430,259,900,-641,584,47.3,530,10,0,0,2468,-1884
ZCTA5 67431,809,810,-1,1824,40.7,1589,34,7,0.003837719,1928,-104
ZCTA5 67432,2525,3834,-1309,5496,42.9,5308,26,135,0.024563319,9302,-3806
ZCTA5 67436,218,11096,-10878,528,46.4,506,0,2,0.003787879,26268,-25740
ZCTA5 67437,416,5922,-5506,826,50.9,814,2,0,0,15014,-14188
ZCTA5 67438,87,7411,-7324,238,41.7,236,0,0,0,16374,-16136
ZCTA5 67439,1094,6387,-5293,3346,38.3,2891,79,171,0.051105798,14815,-11469
ZCTA5 67441,349,12464,-12115,987,34.9,908,17,10,0.010131712,28036,-27049
ZCTA5 67442,75,5818,-5743,364,11.5,229,0,0,0,13777,-13413
ZCTA5 67443,748,4321,-3573,1945,40.4,1937,0,5,0.002570694,14386,-12441
ZCTA5 67444,247,9428,-9181,494,57.3,471,0,0,0,20740,-20246
ZCTA5 67445,253,4498,-4245,589,53.1,578,0,0,0,11542,-10953
ZCTA5 67446,286,53,233,703,43.3,696,0,0,0,152,551
ZCTA5 67447,141,15070,-14929,288,57.1,280,0,0,0,38965,-38677
ZCTA5 67448,402,219,183,973,45.7,915,2,1,0.001027749,666,307
ZCTA5 67449,1336,434,902,2809,51.2,2283,87,38,0.013527946,969,1840
ZCTA5 67450,241,12182,-11941,528,47,480,0,33,0.0625,32618,-32090
ZCTA5 67451,400,4188,-3788,1051,38.9,1003,9,0,0,12749,-11698
ZCTA5 67452,115,458,-343,364,29.4,342,2,0,0,1432,-1068
ZCTA5 67454,334,1907,-1573,756,52.3,711,0,0,0,6158,-5402
ZCTA5 67455,700,1570,-870,1710,44.1,1649,0,1,0.000584795,4570,-2860
ZCTA5 67456,1569,363,1206,4419,35.7,4100,28,113,0.025571396,905,3514
ZCTA5 67457,254,2791,-2537,661,41.2,621,0,0,0,6625,-5964
ZCTA5 67458,156,39,117,471,35.2,410,0,0,0,86,385
ZCTA5 67459,131,215,-84,378,39.8,341,0,0,0,639,-261
ZCTA5 67460,6943,10880,-3937,16097,39.3,15050,194,263,0.016338448,27646,-11549
ZCTA5 67464,476,1225,-749,1057,51,1018,0,0,0,2886,-1829
ZCTA5 67466,309,277,32,795,41.1,774,0,0,0,507,288
ZCTA5 67467,1118,119,999,2583,41.9,2470,3,12,0.004645761,271,2312
ZCTA5 67468,104,142,-38,328,36.5,328,0,0,0,295,33
ZCTA5 67470,233,496,-263,486,46.5,483,2,0,0,1299,-813
ZCTA5 67473,822,321,501,1847,43.4,1707,0,15,0.008121278,684,1163
ZCTA5 67474,95,261,-166,254,50.4,252,0,0,0,618,-364
ZCTA5 67475,52,391,-339,118,53.5,118,0,0,0,901,-783
ZCTA5 67476,14,545,-531,14,-,14,0,0,0,1307,-1293
ZCTA5 67478,43,214,-171,82,51.7,80,0,0,0,565,-483
ZCTA5 67480,613,1509,-896,1707,40.4,1636,0,17,0.009958992,3710,-2003
ZCTA5 67481,309,657,-348,712,55.3,712,0,0,0,1504,-792
ZCTA5 67482,42,132,-90,114,33.8,114,0,0,0,347,-233
ZCTA5 67483,165,169,-4,619,30.5,572,11,0,0,374,245
ZCTA5 67484,389,438,-49,1010,39.5,984,0,21,0.020792079,973,37
ZCTA5 67485,180,102,78,322,49,314,2,0,0,223,99
ZCTA5 67487,549,797,-248,1227,45.3,1119,12,0,0,1807,-580
ZCTA5 67490,385,593,-208,1080,54,993,0,15,0.013888889,1546,-466
ZCTA5 67491,126,492,-366,286,37.3,283,0,0,0,1082,-796
ZCTA5 67492,78,671,-593,197,46.8,196,0,0,0,1814,-1617
ZCTA5 67501,9336,421,8915,24904,36.6,20429,107,1351,0.054248314,915,23989
ZCTA5 67502,9929,295,9634,23567,44.7,21898,227,70,0.002970255,749,22818
ZCTA5 67505,1376,178,1198,2811,44.5,2620,34,73,0.025969406,467,2344
ZCTA5 67510,105,189,-84,239,56.5,233,0,0,0,507,-268
ZCTA5 67511,96,704,-608,208,60.3,200,0,0,0,1878,-1670
ZCTA5 67512,102,594,-492,276,41.5,261,1,0,0,1445,-1169
ZCTA5 67513,50,345,-295,108,40.4,108,0,0,0,759,-651
ZCTA5 67514,342,343,-1,783,40.6,762,0,1,0.001277139,1058,-275
ZCTA5 67515,23,227,-204,43,58.6,43,0,0,0,464,-421
ZCTA5 67516,199,62,137,468,38.7,291,0,0,0,131,337
ZCTA5 67518,13,295,-282,36,62.2,36,0,0,0,679,-643
ZCTA5 67519,86,105,-19,136,72.3,136,0,0,0,229,-93
ZCTA5 67520,119,477,-358,272,41.8,245,6,0,0,1257,-985
ZCTA5 67521,63,2131,-2068,142,26.5,142,0,0,0,7133,-6991
ZCTA5 67522,727,484,243,1939,41.2,1829,0,7,0.003610108,1157,782
ZCTA5 67523,149,285,-136,423,39.3,350,0,26,0.061465721,515,-92
ZCTA5 67524,241,131,110,528,42,481,0,22,0.041666667,342,186
ZCTA5 67525,382,368,14,971,38.9,971,0,0,0,909,62
ZCTA5 67526,1002,672,330,2703,41.1,2634,0,2,0.000739919,1767,936
ZCTA5 67529,69,59,10,397,47.2,276,7,0,0,136,261
ZCTA5 67530,7118,197,6921,17951,38.7,15058,111,271,0.015096652,417,17534
ZCTA5 67543,902,12281,-11379,2363,41.1,2184,1,2,0.000846382,30266,-27903
ZCTA5 67544,1241,277,964,3059,37.5,2816,0,64,0.02092187,761,2298
ZCTA5 67545,78,101,-23,197,53.8,194,0,0,0,236,-39
ZCTA5 67546,1022,841,181,2900,49.4,2817,0,4,0.00137931,2070,830
ZCTA5 67547,710,538,172,1727,39.7,1595,3,5,0.002895194,1263,464
ZCTA5 67548,713,565,148,1433,46.7,1279,3,8,0.005582694,1419,14
ZCTA5 67550,2070,362,1708,5314,46.6,4729,0,409,0.076966504,819,4495
ZCTA5 67552,341,89,252,777,46.2,706,1,0,0,202,575
ZCTA5 67553,32,923,-891,100,38.5,97,0,0,0,1924,-1824
ZCTA5 67554,1750,70,1680,4069,39,3199,21,82,0.020152372,122,3947
ZCTA5 67556,82,171,-89,156,50.3,148,0,0,0,396,-240
ZCTA5 67557,267,238,29,700,42.8,571,0,0,0,577,123
ZCTA5 67559,23,222,-199,30,67.4,30,0,0,0,617,-587
ZCTA5 67560,618,54,564,1565,47.7,1397,12,21,0.01341853,131,1434
ZCTA5 67561,527,239,288,1353,46.1,1331,0,0,0,522,831
ZCTA5 67563,134,323,-189,344,45.9,264,5,0,0,840,-496
ZCTA5 67564,80,364,-284,199,42.4,199,0,0,0,879,-680
ZCTA5 67565,173,110,63,492,38.7,452,0,0,0,273,219
ZCTA5 67566,477,811,-334,823,66.8,786,0,0,0,1968,-1145
ZCTA5 67567,251,716,-465,671,38,620,0,0,0,1699,-1028
ZCTA5 67568,92,1016,-924,235,44.9,208,0,0,0,2909,-2674
ZCTA5 67570,505,99,406,1298,41.1,1242,0,4,0.003081664,222,1076
ZCTA5 67572,173,514,-341,366,58.7,349,4,0,0,1257,-891
ZCTA5 67573,65,52,13,195,40.5,184,0,0,0,146,49
ZCTA5 67574,58,429,-371,127,55.7,127,0,0,0,1149,-1022
ZCTA5 67575,193,242,-49,420,50.9,417,0,0,0,670,-250
ZCTA5 67576,717,1050,-333,2025,39.3,1916,0,0,0,2753,-728
ZCTA5 67578,445,263,182,1041,51.9,1005,4,11,0.010566763,646,395
ZCTA5 67579,1026,259,767,3029,31.9,2800,11,65,0.021459227,707,2322
ZCTA5 67581,148,77,71,334,49.5,321,0,0,0,185,149
ZCTA5 67583,421,253,168,906,49.7,841,0,0,0,681,225
ZCTA5 67584,87,668,-581,120,60.7,116,0,0,0,1796,-1676
ZCTA5 67601,9960,182,9778,24182,33.3,21818,486,407,0.016830701,417,23765
ZCTA5 67621,121,60,61,290,55.1,274,0,13,0.044827586,132,158
ZCTA5 67622,298,1161,-863,658,45.2,593,1,8,0.012158055,3573,-2915
ZCTA5 67623,76,14,62,205,40.3,203,0,2,0.009756098,34,171
ZCTA5 67625,132,32,100,203,45.5,135,0,56,0.275862069,101,102
ZCTA5 67626,123,354,-231,185,62.5,182,1,0,0,892,-707
ZCTA5 67627,35,25,10,110,27.2,110,0,0,0,53,57
ZCTA5 67628,55,133,-78,154,62.1,154,0,0,0,303,-149
ZCTA5 67629,53,930,-877,106,73.8,104,0,0,0,2094,-1988
ZCTA5 67631,49,307,-258,118,58.8,115,0,2,0.016949153,754,-636
ZCTA5 67632,125,427,-302,249,50.5,249,0,0,0,928,-679
ZCTA5 67634,83,145,-62,212,58.6,212,0,0,0,305,-93
ZCTA5 67635,47,620,-573,152,37.6,152,0,0,0,1490,-1338
ZCTA5 67637,1118,232,886,2780,35.9,2730,0,12,0.004316547,503,2277
ZCTA5 67638,93,2061,-1968,159,55.4,142,0,0,0,4818,-4659
ZCTA5 67639,86,251,-165,216,46.7,212,0,0,0,629,-413
ZCTA5 67640,169,564,-395,422,33.3,355,0,0,0,1379,-957
ZCTA5 67642,818,170,648,1852,43.4,1703,22,49,0.026457883,395,1457
ZCTA5 67643,99,1291,-1192,192,63,188,0,4,0.020833333,3374,-3182
ZCTA5 67644,89,265,-176,249,56.8,245,0,0,0,666,-417
ZCTA5 67645,231,745,-514,535,58.3,491,2,0,0,1575,-1040
ZCTA5 67646,372,676,-304,878,34.9,810,9,32,0.036446469,1697,-819
ZCTA5 67647,67,573,-506,204,22.8,193,6,0,0,1558,-1354
ZCTA5 67648,259,82,177,507,56.2,493,0,0,0,204,303
ZCTA5 67649,119,171,-52,243,63.9,229,0,0,0,325,-82
ZCTA5 67650,149,5189,-5040,233,59.6,217,0,3,0.012875536,15185,-14952
ZCTA5 67651,229,299,-70,532,42.5,506,0,0,0,648,-116
ZCTA5 67653,131,268,-137,277,34.3,242,0,8,0.028880866,546,-269
ZCTA5 67654,1262,1074,188,4182,41.4,3817,28,163,0.038976566,2715,1467
ZCTA5 67656,72,414,-342,149,58.7,149,0,0,0,1089,-940
ZCTA5 67657,121,567,-446,260,54.5,234,0,16,0.061538462,1345,-1085
ZCTA5 67658,37,454,-417,113,48.7,89,0,0,0,1027,-914
ZCTA5 67659,29,815,-786,37,83.5,37,0,0,0,2218,-2181
ZCTA5 67660,28,77,-49,34,68,32,0,0,0,166,-132
ZCTA5 67661,1328,415,913,2836,45.5,2714,12,51,0.017983075,998,1838
ZCTA5 67663,1016,2266,-1250,2560,39.4,2428,13,29,0.011328125,6565,-4005
ZCTA5 67664,108,2065,-1957,278,46.6,250,7,0,0,5112,-4834
ZCTA5 67665,2098,54,2044,5039,42.4,4561,0,113,0.022425084,144,4895
ZCTA5 67667,78,316,-238,185,42.5,178,0,0,0,915,-730
ZCTA5 67669,792,755,37,1826,46.1,1742,0,15,0.008214677,1722,104
ZCTA5 67671,674,139,535,1553,38.4,1468,10,0,0,334,1219
ZCTA5 67672,1099,11272,-10173,2369,45.9,2280,0,2,0.000844238,31357,-28988
ZCTA5 67673,43,8718,-8675,69,70.8,65,1,0,0,21552,-21483
ZCTA5 67674,27,417,-390,86,49.3,86,0,0,0,1108,-1022
ZCTA5 67675,83,296,-213,192,48.9,187,0,0,0,739,-547
ZCTA5 67701,2511,208,2303,6225,35.4,5741,89,64,0.010281124,518,5707
ZCTA5 67730,796,450,346,1815,45.2,1700,4,13,0.007162534,1051,764
ZCTA5 67731,334,254,80,823,36.8,742,0,0,0,626,197
ZCTA5 67732,201,72,129,637,28,616,0,0,0,179,458
ZCTA5 67733,33,205,-172,145,18.9,145,0,0,0,357,-212
ZCTA5 67734,109,2039,-1930,328,32,298,0,0,0,5322,-4994
ZCTA5 67735,2003,192,1811,5156,40,4522,3,82,0.015903801,411,4745
ZCTA5 67736,69,40,29,152,57.8,152,0,0,0,75,77
ZCTA5 67737,244,1884,-1640,447,48.7,436,0,1,0.002237136,4451,-4004
ZCTA5 67738,182,1008,-826,502,42.6,480,4,11,0.021912351,2434,-1932
ZCTA5 67739,115,445,-330,205,54.6,188,8,0,0,1297,-1092
ZCTA5 67740,689,489,200,1676,41.8,1575,0,4,0.002386635,1230,446
ZCTA5 67741,190,1635,-1445,556,39,466,0,6,0.010791367,3948,-3392
ZCTA5 67743,60,278,-218,134,40.3,126,0,0,0,668,-534
ZCTA5 67744,44,85,-41,100,57.3,100,0,0,0,199,-99
ZCTA5 67745,185,340,-155,392,47.3,356,6,3,0.007653061,823,-431
ZCTA5 67747,75,709,-634,215,38.4,209,6,0,0,1939,-1724
ZCTA5 67748,1045,173,872,2400,41.8,2224,8,6,0.0025,422,1978
ZCTA5 67749,987,123,864,2109,48.6,2034,9,10,0.004741584,315,1794
ZCTA5 67751,105,237,-132,207,54.2,201,0,0,0,589,-382
ZCTA5 67752,654,681,-27,1642,40.1,1537,32,15,0.009135201,1809,-167
ZCTA5 67753,232,25,207,484,42,456,9,3,0.006198347,47,437
ZCTA5 67756,890,116,774,1796,54.9,1666,0,0,0,270,1526
ZCTA5 67757,171,1029,-858,413,47.3,396,0,0,0,2651,-2238
ZCTA5 67758,486,207,279,1160,40.1,1108,10,2,0.001724138,633,527
ZCTA5 67761,96,289,-193,229,55.1,215,0,0,0,769,-540
ZCTA5 67762,95,281,-186,207,50.5,189,0,3,0.014492754,742,-535
ZCTA5 67764,142,98,44,389,35.4,369,0,0,0,240,149
ZCTA5 67801,10049,7100,2949,31044,31.5,23343,471,729,0.023482799,20575,10469
ZCTA5 67831,443,141,302,1026,48.5,895,5,0,0,297,729
ZCTA5 67834,432,6740,-6308,1004,45.8,986,0,0,0,16197,-15193
ZCTA5 67835,948,0,948,2508,34.4,2458,0,0,0,317,2191
ZCTA5 67836,53,3844,-3791,131,61.4,118,0,0,0,12231,-12100
ZCTA5 67837,414,303,111,1096,28.7,965,0,0,0,830,266
ZCTA5 67838,319,645,-326,1161,28.5,1042,0,0,0,1397,-236
ZCTA5 67839,467,304,163,1020,46.2,915,38,0,0,894,126
ZCTA5 67840,37,161,-124,87,69.8,72,11,0,0,416,-329
ZCTA5 67841,152,258,-106,308,57.3,283,0,0,0,586,-278
ZCTA5 67842,191,114,77,444,38.2,428,0,0,0,244,200
ZCTA5 67843,65,248,-183,122,73.8,115,3,0,0,529,-407
ZCTA5 67844,304,118,186,747,40.7,676,0,0,0,246,501
ZCTA5 67846,11810,47,11763,34694,32.1,24452,1475,1537,0.044301608,140,34554
ZCTA5 67849,136,1335,-1199,404,44.3,398,0,0,0,3034,-2630
ZCTA5 67850,194,447,-253,497,48.9,480,0,0,0,1205,-708
ZCTA5 67851,974,491,483,3165,30.6,2699,44,0,0,1231,1934
ZCTA5 67853,286,340,-54,928,31.2,777,11,10,0.010775862,905,23
ZCTA5 67854,486,374,112,1122,45.7,1090,0,2,0.001782531,871,251
ZCTA5 67855,729,835,-106,1797,35.2,1624,0,0,0,2143,-346
ZCTA5 67857,42,146,-104,153,41.1,145,0,0,0,353,-200
ZCTA5 67859,255,102,153,638,44.9,491,13,0,0,271,367
ZCTA5 67860,891,318,573,2691,34.4,2397,11,100,0.037160907,935,1756
ZCTA5 67861,782,1301,-519,1965,38.3,1619,0,16,0.008142494,3027,-1062
ZCTA5 67862,111,445,-334,303,39.2,219,0,0,0,1096,-793
ZCTA5 67863,172,256,-84,298,63.6,286,12,0,0,576,-278
ZCTA5 67864,778,572,206,1823,44.6,1715,46,0,0,1480,343
ZCTA5 67865,412,173,239,973,42.9,910,16,0,0,439,534
ZCTA5 67867,521,161,360,1598,36.9,1586,6,0,0,381,1217
ZCTA5 67868,59,28,31,237,28.3,237,0,0,0,105,132
ZCTA5 67869,577,210,367,1544,29.8,977,0,15,0.009715026,504,1040
ZCTA5 67870,455,859,-404,1383,38,1055,0,11,0.007953724,2274,-891
ZCTA5 67871,2134,10650,-8516,5211,36.9,4683,31,0,0,26291,-21080
ZCTA5 67876,628,662,-34,1568,42.1,1499,0,0,0,1367,201
ZCTA5 67877,775,553,222,2161,36.9,1637,6,1,0.000462749,1303,858
ZCTA5 67878,702,45,657,2348,35.2,2042,0,0,0,108,2240
ZCTA5 67879,543,458,85,1257,39.2,977,0,0,0,1150,107
ZCTA5 67880,2550,157,2393,7583,33.2,6178,87,7,0.000923117,468,7115
ZCTA5 67882,149,346,-197,217,64.5,177,0,0,0,793,-576
ZCTA5 67901,6886,468,6418,21334,29.6,11032,531,593,0.027796006,1205,20129
ZCTA5 67950,616,192,424,1761,34.2,1542,44,2,0.001135718,530,1231
ZCTA5 67951,1595,104,1491,4733,35.7,3417,0,22,0.004648215,244,4489
ZCTA5 67952,176,545,-369,555,40.7,488,0,0,0,1423,-868
ZCTA5 67953,42,156,-114,85,59.7,85,0,0,0,389,-304
ZCTA5 67954,293,413,-120,925,36.8,766,1,7,0.007567568,935,-10
ZCTA5 68001,16,53,-37,48,35.7,48,0,0,0,98,-50
ZCTA5 68002,1008,311,697,2393,42.4,2178,52,0,0,799,1594
ZCTA5 68003,1963,57,1906,4825,42,4679,4,27,0.005595855,100,4725
ZCTA5 68004,444,782,-338,989,46.4,966,6,0,0,1921,-932
ZCTA5 68005,8917,189,8728,22266,35.5,16517,666,1938,0.087038534,446,21820
ZCTA5 68007,5004,573,4431,14932,35.6,13627,267,363,0.024310206,1339,13593
ZCTA5 68008,4895,195,4700,12521,40.2,12081,9,140,0.011181216,509,12012
ZCTA5 68010,15,403,-388,818,16.4,479,0,219,0.267726161,915,-97
ZCTA5 68014,141,216,-75,392,30.8,392,0,0,0,466,-74
ZCTA5 68015,462,93,369,1220,43.8,1127,0,41,0.033606557,214,1006
ZCTA5 68016,165,421,-256,399,47.9,385,1,4,0.010025063,1079,-680
ZCTA5 68017,793,129,664,1986,47.8,1910,0,2,0.001007049,437,1549
ZCTA5 68018,163,60,103,560,28.7,536,0,0,0,131,429
ZCTA5 68019,195,261,-66,397,45.8,336,0,0,0,633,-236
ZCTA5 68020,322,90,232,654,61,581,0,0,0,250,404
ZCTA5 68022,10849,2823,8026,31127,34.9,28349,1097,327,0.010505349,6496,24631
ZCTA5 68023,1104,141,963,2665,45.5,2542,0,7,0.002626642,305,2360
ZCTA5 68025,12214,30,12184,31260,39,28676,135,267,0.008541267,92,31168
ZCTA5 68028,5625,46,5579,17434,33.8,16656,165,19,0.001089824,142,17292
ZCTA5 68029,332,704,-372,708,37.3,689,2,0,0,1968,-1260
ZCTA5 68030,281,508,-227,668,50.6,644,0,0,0,1323,-655
ZCTA5 68031,634,247,387,1820,39.3,1702,58,1,0.000549451,644,1176
ZCTA5 68033,135,267,-132,308,51.7,305,0,0,0,660,-352
ZCTA5 68034,297,1513,-1216,672,47,669,0,0,0,3652,-2980
ZCTA5 68036,211,54,157,511,41.3,414,0,0,0,119,392
ZCTA5 68037,993,429,564,2827,38.4,2543,25,11,0.003891051,875,1952
ZCTA5 68038,566,51,515,1220,46.8,1111,0,0,0,90,1130
ZCTA5 68039,268,288,-20,1286,19.9,50,2,0,0,779,507
ZCTA5 68040,142,564,-422,348,38.2,326,0,7,0.020114943,1286,-938
ZCTA5 68041,427,11,416,1003,35.8,988,0,0,0,26,977
ZCTA5 68042,24,657,-633,66,34.7,59,0,0,0,1384,-1318
ZCTA5 68044,255,221,34,679,40.3,470,0,0,0,427,252
ZCTA5 68045,774,104,670,2091,41.2,1924,0,12,0.005738881,202,1889
ZCTA5 68046,11159,179,10980,31695,37.1,27863,696,1288,0.040637324,431,31264
ZCTA5 68047,690,99,591,1873,39.1,1686,0,2,0.001067806,190,1683
ZCTA5 68048,5117,44,5073,13518,40.4,12641,57,42,0.003106968,88,13430
ZCTA5 68050,231,97,134,567,47.8,565,0,0,0,258,309
ZCTA5 68055,100,132,-32,286,39.8,173,1,0,0,335,-49
ZCTA5 68056,0,1097,-1097,15,34.2,13,0,0,0,2287,-2272
ZCTA5 68057,595,792,-197,1429,45.8,1284,3,3,0.00209937,2211,-782
ZCTA5 68058,114,176,-62,258,63.7,255,0,0,0,444,-186
ZCTA5 68059,1345,108,1237,3221,48.3,3156,20,9,0.002794163,245,2976
ZCTA5 68061,908,265,643,2399,40.7,2320,38,0,0,661,1738
ZCTA5 68062,113,4031,-3918,293,45.9,288,0,0,0,9177,-8884
ZCTA5 68063,102,157,-55,229,50.1,197,0,0,0,403,-174
ZCTA5 68064,1764,626,1138,3679,49.4,3575,0,42,0.011416146,1384,2295
ZCTA5 68065,507,757,-250,1210,45,1148,0,6,0.004958678,1647,-437
ZCTA5 68066,2093,140,1953,5474,37,5296,0,88,0.016075996,339,5135
ZCTA5 68067,308,616,-308,1172,27.9,287,13,0,0,1299,-127
ZCTA5 68068,71,419,-348,163,32.8,158,0,0,0,1138,-975
ZCTA5 68069,1304,85,1219,3043,50.9,2876,13,18,0.005915215,173,2870
ZCTA5 68070,395,65,330,1023,54.6,949,0,26,0.025415445,137,886
ZCTA5 68071,574,379,195,1969,25,116,48,0,0,866,1103
ZCTA5 68072,82,165,-83,111,56.4,103,0,0,0,341,-230
ZCTA5 68073,863,179,684,2475,34.9,2401,8,0,0,379,2096
ZCTA5 68102,4840,205,4635,8839,33.8,5999,349,1507,0.1704944,455,8384
ZCTA5 68104,15502,1119,14383,37274,35.9,19598,4129,9481,0.254359607,2513,34761
ZCTA5 68105,9863,453,9410,22974,32,16899,686,1080,0.047009663,1117,21857
ZCTA5 68106,10117,24,10093,21627,34.9,17291,992,1267,0.058584177,32,21595
ZCTA5 68107,9195,27,9168,29601,30.2,18207,84,2209,0.074625857,50,29551
ZCTA5 68108,5400,220,5180,14829,30.5,11781,221,409,0.027581091,512,14317
ZCTA5 68110,3163,40,3123,9372,34.7,3360,503,4018,0.428723858,88,9284
ZCTA5 68111,8490,281,8209,23591,28.9,7091,1259,12314,0.521978721,642,22949
ZCTA5 68112,4330,26,4304,12047,35.7,7795,136,2810,0.233253092,62,11985
ZCTA5 68113,232,16,216,780,21.3,655,9,51,0.065384615,33,747
ZCTA5 68114,8054,228,7826,17787,38,14878,659,1597,0.089784674,483,17304
ZCTA5 68116,12354,366,11988,33641,34.6,28082,1820,1506,0.044766802,837,32804
ZCTA5 68117,3082,500,2582,8941,37,6139,18,85,0.009506767,1265,7676
ZCTA5 68118,3414,74,3340,9486,41.8,8711,189,14,0.001475859,154,9332
ZCTA5 68122,4380,12564,-8184,12568,32.2,6896,1409,2764,0.219923616,29848,-17280
ZCTA5 68123,11956,434,11522,32945,30.8,25534,1531,2165,0.065715587,907,32038
ZCTA5 68124,6590,164,6426,15352,40.6,13591,535,718,0.046769151,449,14903
ZCTA5 68127,9666,280,9386,20681,34.1,16930,606,1240,0.059958416,665,20016
ZCTA5 68128,7812,353,7459,18972,36.2,16326,398,840,0.044275775,925,18047
ZCTA5 68130,7980,190,7790,20879,41.6,18419,1178,298,0.014272714,444,20435
ZCTA5 68131,6109,393,5716,13497,29,8825,1031,2447,0.181299548,944,12553
ZCTA5 68132,6063,155,5908,14341,34.7,11942,574,1325,0.092392441,360,13981
ZCTA5 68133,5069,597,4472,13470,39.6,11501,386,294,0.021826281,1334,12136
ZCTA5 68134,12782,2236,10546,30212,35.5,21962,250,5269,0.1744009,5443,24769
ZCTA5 68135,10315,220,10095,29860,35.5,26338,1662,450,0.015070328,477,29383
ZCTA5 68136,6573,52,6521,19482,35.4,18146,441,239,0.012267734,195,19287
ZCTA5 68137,10337,163,10174,24733,38,20697,1031,940,0.038005903,440,24293
ZCTA5 68138,4592,124,4468,11552,35.1,10331,174,276,0.023891967,273,11279
ZCTA5 68142,1932,34,1898,4779,40.9,4044,240,136,0.028457836,73,4706
ZCTA5 68144,10564,1815,8749,25923,39.1,23178,520,1030,0.039733056,4199,21724
ZCTA5 68147,4287,805,3482,11807,37.7,8950,172,528,0.044719234,1918,9889
ZCTA5 68152,2794,140,2654,7215,45.3,5135,77,1577,0.218572419,295,6920
ZCTA5 68154,9918,69,9849,23015,38.2,19092,799,1640,0.071257875,124,22891
ZCTA5 68157,2047,535,1512,5473,36.6,4033,155,108,0.019733236,1311,4162
ZCTA5 68164,12077,67,12010,29642,35.5,22923,1146,2922,0.098576344,185,29457
ZCTA5 68178,180,1412,-1232,2561,19.8,1943,297,123,0.048028114,3116,-555
ZCTA5 68182,0,129,-129,871,19.8,648,97,61,0.070034443,268,603
ZCTA5 68183,0,322,-322,0,-,0,0,0,#DIV/0!,676,-676
ZCTA5 68301,646,102,544,1596,45.9,1566,0,8,0.005012531,215,1381
ZCTA5 68303,126,292,-166,268,50.3,254,0,0,0,671,-403
ZCTA5 68304,122,198,-76,318,44,316,0,0,0,526,-208
ZCTA5 68305,1731,333,1398,4292,40.2,3999,48,14,0.003261883,808,3484
ZCTA5 68307,156,339,-183,430,35.5,427,0,1,0.002325581,799,-369
ZCTA5 68309,47,2602,-2555,127,61.4,75,0,0,0,5557,-5430
ZCTA5 68310,6160,544,5616,14235,42.6,13656,122,117,0.008219178,1331,12904
ZCTA5 68313,262,432,-170,720,44.8,598,16,22,0.030555556,1053,-333
ZCTA5 68314,146,278,-132,384,37.6,382,0,0,0,676,-292
ZCTA5 68315,34,11,23,78,54.3,78,0,0,0,29,49
ZCTA5 68316,206,24,182,477,39.3,449,20,0,0,57,420
ZCTA5 68317,767,3550,-2783,1948,39.7,1885,0,16,0.008213552,8017,-6069
ZCTA5 68318,172,376,-204,438,43.1,438,0,0,0,842,-404
ZCTA5 68319,207,691,-484,610,30.4,467,0,25,0.040983607,1863,-1253
ZCTA5 68320,163,283,-120,338,48,332,0,0,0,768,-430
ZCTA5 68321,154,132,22,322,51.5,266,0,0,0,249,73
ZCTA5 68322,165,93,72,499,29.7,475,0,0,0,187,312
ZCTA5 68323,103,264,-161,245,50.2,232,0,0,0,679,-434
ZCTA5 68324,27,151,-124,76,37.2,76,0,0,0,376,-300
ZCTA5 68325,58,19,39,129,58.2,129,0,0,0,38,91
ZCTA5 68326,116,1788,-1672,363,29.7,341,0,3,0.008264463,3877,-3514
ZCTA5 68327,170,1151,-981,358,53.3,347,0,0,0,2447,-2089
ZCTA5 68328,161,127,34,407,46.5,389,0,0,0,315,92
ZCTA5 68329,228,137,91,624,40.5,616,3,4,0.006410256,374,250
ZCTA5 68330,20,127,-107,40,49.5,40,0,0,0,247,-207
ZCTA5 68331,369,72,297,1045,42.2,977,7,2,0.001913876,209,836
ZCTA5 68332,46,218,-172,91,58.2,91,0,0,0,525,-434
ZCTA5 68333,3002,67,2935,8704,35.5,6930,166,136,0.015625,134,8570
ZCTA5 68335,215,48,167,567,41.2,489,0,0,0,131,436
ZCTA5 68336,263,23,240,765,35.4,761,0,0,0,42,723
ZCTA5 68337,156,73,83,330,53.7,329,0,0,0,169,161
ZCTA5 68338,106,4401,-4295,223,53.5,223,0,0,0,10154,-9931
ZCTA5 68339,457,9,448,1112,53.4,1081,8,0,0,40,1072
ZCTA5 68340,354,100,254,994,42.9,968,0,0,0,252,742
ZCTA5 68341,398,1006,-608,939,43.7,883,0,0,0,2314,-1375
ZCTA5 68342,280,11,269,642,35.1,632,0,0,0,18,624
ZCTA5 68343,375,996,-621,855,48.5,827,0,1,0.001169591,2560,-1705
ZCTA5 68344,201,2963,-2762,536,44.7,431,1,0,0,7528,-6992
ZCTA5 68345,82,678,-596,147,55.7,141,0,4,0.027210884,1384,-1237
ZCTA5 68346,198,56,142,468,54.5,460,0,1,0.002136752,185,283
ZCTA5 68347,896,4157,-3261,2334,42.9,2263,9,0,0,10835,-8501
ZCTA5 68348,120,1093,-973,249,65,229,0,0,0,2480,-2231
ZCTA5 68349,465,190,275,1146,37.7,1128,0,0,0,510,636
ZCTA5 68350,100,237,-137,258,48.1,258,0,0,0,491,-233
ZCTA5 68351,364,576,-212,771,54.1,767,0,0,0,1227,-456
ZCTA5 68352,2071,570,1501,4868,42.9,4618,21,42,0.008627773,1512,3356
ZCTA5 68354,442,147,295,908,57.5,893,0,5,0.005506608,334,574
ZCTA5 68355,2285,53,2232,4897,43.2,4458,0,10,0.002042067,113,4784
ZCTA5 68357,147,296,-149,351,48.6,351,0,0,0,772,-421
ZCTA5 68358,512,4,508,1536,43.2,1470,8,0,0,10,1526
ZCTA5 68359,604,49,555,1505,38.1,1489,0,0,0,126,1379
ZCTA5 68360,206,49,157,472,44.3,440,0,2,0.004237288,136,336
ZCTA5 68361,893,747,146,2340,40.3,2127,23,11,0.004700855,2028,312
ZCTA5 68362,15,1461,-1446,29,40.8,29,0,0,0,3748,-3719
ZCTA5 68364,114,690,-576,241,69.2,233,0,0,0,1616,-1375
ZCTA5 68365,114,621,-507,241,53.8,230,0,2,0.008298755,1438,-1197
ZCTA5 68366,328,7602,-7274,877,41.8,867,2,0,0,17910,-17033
ZCTA5 68367,148,18,130,316,44.5,312,0,0,0,31,285
ZCTA5 68368,177,115,62,515,39.5,507,0,0,0,299,216
ZCTA5 68370,794,105,689,1816,50.8,1728,1,9,0.004955947,204,1612
ZCTA5 68371,542,17121,-16579,1337,42.3,1225,0,9,0.006731488,38019,-36682
ZCTA5 68372,1322,7905,-6583,4153,34.3,4079,0,10,0.002407898,18657,-14504
ZCTA5 68375,72,15398,-15326,140,51.4,132,0,0,0,39449,-39309
ZCTA5 68376,579,11056,-10477,1416,49.1,1304,0,87,0.061440678,24552,-23136
ZCTA5 68377,194,6181,-5987,397,56.4,386,0,0,0,16355,-15958
ZCTA5 68378,251,1607,-1356,570,53.3,564,0,2,0.003508772,4281,-3711
ZCTA5 68379,33,571,-538,68,55.3,68,0,0,0,1239,-1171
ZCTA5 68380,22,1361,-1339,46,43.5,46,0,0,0,3687,-3641
ZCTA5 68381,55,537,-482,123,57.5,123,0,0,0,1150,-1027
ZCTA5 68382,19,5792,-5773,28,50.5,28,0,0,0,16093,-16065
ZCTA5 68401,356,210,146,925,27,885,0,11,0.011891892,771,154
ZCTA5 68402,405,805,-400,1069,44.8,1055,0,0,0,2202,-1133
ZCTA5 68403,103,692,-589,199,55,199,0,0,0,1677,-1478
ZCTA5 68404,439,870,-431,1141,45.3,1075,0,0,0,1843,-702
ZCTA5 68405,1269,6292,-5023,3493,35.3,3323,0,34,0.009733753,16663,-13170
ZCTA5 68406,191,4680,-4489,404,52.9,401,0,0,0,13175,-12771
ZCTA5 68407,339,915,-576,938,40,929,0,0,0,2455,-1517
ZCTA5 68409,294,18,276,730,41,694,0,0,0,18,712
ZCTA5 68410,3367,814,2553,8802,38.7,7351,33,102,0.011588275,1881,6921
ZCTA5 68413,193,1379,-1186,476,48.5,432,2,0,0,3712,-3236
ZCTA5 68414,104,6343,-6239,180,32.8,177,0,0,0,16554,-16374
ZCTA5 68415,229,13775,-13546,561,46,541,1,0,0,38903,-38342
ZCTA5 68416,97,1447,-1350,221,36.3,216,0,0,0,4593,-4372
ZCTA5 68417,117,13175,-13058,325,42.7,324,0,0,0,39856,-39531
ZCTA5 68418,451,6379,-5928,1150,40.5,1062,7,0,0,17242,-16092
ZCTA5 68419,103,18683,-18580,254,50.1,223,0,9,0.035433071,50957,-50703
ZCTA5 68420,496,1061,-565,1255,41.9,1202,0,0,0,3094,-1839
ZCTA5 68421,340,11616,-11276,1193,21.3,1026,3,92,0.077116513,34508,-33315
ZCTA5 68422,259,4372,-4113,643,37,631,0,0,0,12567,-11924
ZCTA5 68423,423,1267,-844,987,48.7,985,0,0,0,3567,-2580
ZCTA5 68424,303,19476,-19173,649,57.4,636,3,0,0,56307,-55658
ZCTA5 68428,498,1431,-933,1556,40.1,1463,55,0,0,4196,-2640
ZCTA5 68429,43,192,-149,90,45.5,90,0,0,0,697,-607
ZCTA5 68430,695,1197,-502,1635,56.4,1613,0,0,0,3110,-1475
ZCTA5 68431,109,403,-294,192,52.2,162,1,3,0.015625,1232,-1040
ZCTA5 68433,79,16,63,159,62.4,154,0,0,0,84,75
ZCTA5 68434,3222,763,2459,9100,35.3,8754,25,44,0.004835165,2445,6655
ZCTA5 68436,237,2517,-2280,553,50,527,0,0,0,7262,-6709
ZCTA5 68437,156,1512,-1356,311,56.1,291,0,15,0.048231511,4174,-3863
ZCTA5 68438,58,689,-631,106,52.8,104,0,0,0,2505,-2399
ZCTA5 68439,287,2904,-2617,648,31.9,637,2,0,0,8861,-8213
ZCTA5 68440,54,2648,-2594,79,68.5,79,0,0,0,7716,-7637
ZCTA5 68441,76,98,-22,210,39.3,210,0,0,0,289,-79
ZCTA5 68442,124,2485,-2361,237,66.3,225,0,0,0,7227,-6990
ZCTA5 68443,397,11671,-11274,1060,41.2,1027,0,6,0.005660377,32218,-31158
ZCTA5 68444,17,1740,-1723,41,47.8,41,0,0,0,3452,-3411
ZCTA5 68445,66,3437,-3371,181,30.8,181,0,0,0,6988,-6807
ZCTA5 68446,1184,9653,-8469,2747,45.2,2703,0,0,0,24794,-22047
ZCTA5 68447,251,16158,-15907,600,49.3,591,0,0,0,34096,-33496
ZCTA5 68448,149,6182,-6033,363,54.7,363,0,0,0,11644,-11281
ZCTA5 68450,925,9537,-8612,3244,36.8,2319,53,297,0.091553637,20705,-17461
ZCTA5 68452,37,13487,-13450,78,60.3,78,0,0,0,33797,-33719
ZCTA5 68453,131,15351,-15220,254,56.4,227,7,0,0,35187,-34933
ZCTA5 68454,279,5603,-5324,702,43.6,699,0,0,0,11945,-11243
ZCTA5 68455,267,11689,-11422,632,30.5,609,0,0,0,29038,-28406
ZCTA5 68456,510,11755,-11245,1317,38.5,1303,2,0,0,26574,-25257
ZCTA5 68457,197,7480,-7283,453,39.3,447,1,0,0,16962,-16509
ZCTA5 68458,77,5829,-5752,156,55.5,153,0,0,0,15967,-15811
ZCTA5 68460,256,8128,-7872,688,46.6,684,3,0,0,21569,-20881
ZCTA5 68461,315,7496,-7181,777,41.6,777,0,0,0,20329,-19552
ZCTA5 68462,1609,6264,-4655,4635,38.1,4564,0,14,0.003020496,16882,-12247
ZCTA5 68463,580,2924,-2344,1519,40.1,1432,0,8,0.005266623,8806,-7287
ZCTA5 68464,248,7423,-7175,504,50.8,492,0,0,0,12780,-12276
ZCTA5 68465,877,11073,-10196,2663,37.3,2323,38,0,0,28411,-25748
ZCTA5 68466,678,0,678,1869,34.6,1813,0,9,0.004815409,0,1869
ZCTA5 68467,3819,0,3819,9650,40.6,9056,9,156,0.016165803,0,9650
ZCTA5 68502,11476,16085,-4609,27546,33.9,21462,756,1517,0.055071517,43984,-16438
ZCTA5 68503,6311,2524,3787,15696,26.7,10116,1896,1692,0.107798165,5933,9763
ZCTA5 68504,7843,50,7793,16924,28,13756,766,762,0.045024817,183,16741
ZCTA5 68505,7264,1548,5716,17842,31.5,15234,704,537,0.030097523,4004,13838
ZCTA5 68506,12703,1747,10956,28464,39,25401,739,546,0.019182125,4930,23534
ZCTA5 68507,6511,1606,4905,15044,37.4,13608,132,180,0.011964903,4536,10508
ZCTA5 68508,5580,2167,3413,16848,21.2,13639,935,764,0.045346629,6551,10297
ZCTA5 68510,9128,3313,5815,19879,38.8,16733,798,918,0.046179385,9385,10494
ZCTA5 68512,5630,3938,1692,13830,36.8,11590,997,475,0.034345625,11131,2699
ZCTA5 68514,119,88,31,279,63.2,279,0,0,0,177,102
ZCTA5 68516,18258,479,17779,47520,37.1,41669,1311,1274,0.026809764,1133,46387
ZCTA5 68517,201,1582,-1381,554,46.9,554,0,0,0,4506,-3952
ZCTA5 68520,766,421,345,1731,60.6,1630,37,18,0.010398614,1153,578
ZCTA5 68521,14582,750,13832,37409,31.4,29875,2607,1961,0.052420541,2098,35311
ZCTA5 68522,4275,1233,3042,13527,32.8,10453,394,1033,0.076365787,3479,10048
ZCTA5 68523,670,361,309,1909,42,1836,0,0,0,874,1035
ZCTA5 68524,2102,2698,-596,6247,28.3,5196,115,129,0.020649912,7781,-1534
ZCTA5 68526,2860,9771,-6911,8009,39.6,7177,584,44,0.005493819,27234,-19225
ZCTA5 68527,606,9152,-8546,1639,51.6,1459,53,0,0,27779,-26140
ZCTA5 68528,2458,10843,-8385,6292,31.7,5348,455,168,0.026700572,30007,-23715
ZCTA5 68531,75,914,-839,256,39.8,256,0,0,0,2655,-2399
ZCTA5 68532,215,2620,-2405,592,44.4,501,43,0,0,6838,-6246
ZCTA5 68588,0,2539,-2539,0,-,0,0,0,#DIV/0!,6657,-6657
ZCTA5 68601,11640,38,11602,29699,37.9,25578,250,243,0.008182094,137,29562
ZCTA5 68620,1169,1564,-395,2842,46.8,2803,17,0,0,4619,-1777
ZCTA5 68621,122,8610,-8488,242,63.8,210,0,0,0,22044,-21802
ZCTA5 68622,131,2614,-2483,299,54.3,299,0,0,0,7730,-7431
ZCTA5 68623,170,124,46,352,46.8,352,0,0,0,301,51
ZCTA5 68624,360,3036,-2676,948,51.1,937,0,0,0,8297,-7349
ZCTA5 68626,246,200,46,560,53.2,539,7,0,0,479,81
ZCTA5 68627,264,5303,-5039,690,45.8,638,0,5,0.007246377,14540,-13850
ZCTA5 68628,324,1594,-1270,842,37.6,787,0,3,0.003562945,4607,-3765
ZCTA5 68629,484,412,72,1190,38.1,1183,0,0,0,1301,-111
ZCTA5 68631,139,8359,-8220,329,42.1,327,0,0,0,21553,-21224
ZCTA5 68632,1552,0,1552,3722,42.2,3502,0,7,0.001880709,799,2923
ZCTA5 68633,490,9832,-9342,1094,47.7,1087,0,0,0,26102,-25008
ZCTA5 68634,267,3109,-2842,757,36.9,722,1,0,0,9229,-8472
ZCTA5 68635,223,4808,-4585,478,46,478,0,0,0,14037,-13559
ZCTA5 68636,566,1964,-1398,1214,52.7,1208,0,0,0,6663,-5449
ZCTA5 68637,157,7361,-7204,322,59.1,315,1,0,0,20125,-19803
ZCTA5 68638,690,1863,-1173,1919,41,1771,10,19,0.00990099,4692,-2773
ZCTA5 68640,440,12256,-11816,1189,42.2,1180,0,0,0,31693,-30504
ZCTA5 68641,490,6497,-6007,1076,55,1035,0,18,0.016728625,17136,-16060
ZCTA5 68642,713,223,490,1917,36.4,1897,0,1,0.000521648,709,1208
ZCTA5 68643,392,2920,-2528,911,44.8,907,2,0,0,7398,-6487
ZCTA5 68644,287,7073,-6786,682,39.4,635,0,9,0.013196481,17575,-16893
ZCTA5 68647,302,1861,-1559,770,48.2,748,0,6,0.007792208,5279,-4509
ZCTA5 68648,138,153,-15,242,53.5,242,0,0,0,341,-99
ZCTA5 68649,813,3429,-2616,2110,41.8,2061,22,0,0,9573,-7463
ZCTA5 68651,459,3279,-2820,1287,40.6,1207,0,0,0,9037,-7750
ZCTA5 68652,296,4006,-3710,648,45.8,643,0,0,0,10232,-9584
ZCTA5 68653,260,2048,-1788,710,39.4,696,0,0,0,6101,-5391
ZCTA5 68654,227,3618,-3391,574,38.6,527,0,0,0,10625,-10051
ZCTA5 68655,38,9032,-8994,101,64.4,101,0,0,0,24692,-24591
ZCTA5 68658,278,1515,-1237,750,36.6,740,0,0,0,3853,-3103
ZCTA5 68659,80,1242,-1162,185,42.3,176,0,0,0,3152,-2967
ZCTA5 68660,454,9,445,1131,37.4,1110,3,0,0,37,1094
ZCTA5 68661,2211,4666,-2455,7417,33.2,4251,57,269,0.036268033,11831,-4414
ZCTA5 68662,453,473,-20,1331,41.9,1274,0,2,0.00150263,1108,223
ZCTA5 68663,419,9701,-9282,821,46,784,0,0,0,25461,-24640
ZCTA5 68664,112,473,-361,311,36.8,295,0,0,0,1258,-947
ZCTA5 68665,288,1139,-851,691,49.5,689,2,0,0,3255,-2564
ZCTA5 68666,567,13632,-13065,1598,45,1512,0,0,0,35004,-33406
ZCTA5 68667,53,8165,-8112,145,40.3,137,0,0,0,22464,-22319
ZCTA5 68669,209,10041,-9832,474,46.8,443,0,0,0,28002,-27528
ZCTA5 68701,12624,2037,10587,31155,36.7,27119,368,453,0.014540202,5157,25998
ZCTA5 68710,290,30,260,739,47,692,4,0,0,53,686
ZCTA5 68711,44,214,-170,62,52.6,62,0,0,0,638,-576
ZCTA5 68713,946,218,728,2334,43.7,2267,12,0,0,563,1771
ZCTA5 68714,496,3076,-2580,1148,41.6,1129,0,9,0.007839721,8737,-7589
ZCTA5 68715,611,8038,-7427,1796,38.8,1743,15,8,0.004454343,21186,-19390
ZCTA5 68716,407,11474,-11067,978,43.5,934,4,9,0.009202454,29462,-28484
ZCTA5 68717,107,10479,-10372,268,28.6,268,0,0,0,27577,-27309
ZCTA5 68718,779,17634,-16855,1688,48.5,1597,3,13,0.007701422,43584,-41896
ZCTA5 68719,80,6364,-6284,178,60.4,174,0,0,0,16013,-15835
ZCTA5 68720,108,14087,-13979,240,52,233,0,3,0.0125,35141,-34901
ZCTA5 68722,190,9725,-9535,471,51.6,423,0,0,0,25473,-25002
ZCTA5 68723,251,3770,-3519,627,39.4,619,1,0,0,10858,-10231
ZCTA5 68724,75,54,21,298,23.3,253,0,2,0.006711409,68,230
ZCTA5 68725,252,924,-672,609,41.2,594,0,1,0.001642036,2377,-1768
ZCTA5 68726,259,1213,-954,643,41.3,619,0,0,0,4098,-3455
ZCTA5 68727,246,468,-222,552,52.2,520,0,9,0.016304348,1433,-881
ZCTA5 68728,93,8892,-8799,239,43.9,239,0,0,0,25431,-25192
ZCTA5 68729,718,4617,-3899,1761,44.9,1688,11,26,0.014764338,12154,-10393
ZCTA5 68730,795,113,682,2061,44.1,1984,8,2,0.000970403,151,1910
ZCTA5 68731,1010,6833,-5823,3738,30.9,2310,167,17,0.004547887,18760,-15022
ZCTA5 68732,102,271,-169,187,48.7,187,0,0,0,644,-457
ZCTA5 68733,424,151,273,1096,44.9,967,7,21,0.019160584,367,729
ZCTA5 68734,47,4375,-4328,96,26.7,67,0,0,0,12930,-12834
ZCTA5 68735,362,6640,-6278,919,39.4,894,0,1,0.001088139,19008,-18089
ZCTA5 68736,272,881,-609,735,37.1,721,0,0,0,2520,-1785
ZCTA5 68739,1081,4097,-3016,2770,44,2714,0,0,0,11449,-8679
ZCTA5 68740,327,436,-109,873,40.8,871,1,0,0,1210,-337
ZCTA5 68741,271,1022,-751,771,37.7,705,9,0,0,2515,-1744
ZCTA5 68742,93,2680,-2587,288,33.5,197,0,0,0,7046,-6758
ZCTA5 68743,195,352,-157,574,41.9,569,0,0,0,1043,-469
ZCTA5 68745,606,6834,-6228,1550,36,1499,12,0,0,18459,-16909
ZCTA5 68746,184,221,-37,340,60.8,329,0,0,0,556,-216
ZCTA5 68747,56,5563,-5507,159,29.9,159,0,0,0,15563,-15404
ZCTA5 68748,839,131,708,2434,37,1871,94,16,0.006573541,335,2099
ZCTA5 68749,24,1491,-1467,48,58.3,43,0,0,0,3738,-3690
ZCTA5 68751,25,1463,-1438,68,41.6,68,0,0,0,4108,-4040
ZCTA5 68752,303,4138,-3835,694,53.8,687,0,4,0.005763689,11837,-11143
ZCTA5 68753,33,6206,-6173,68,64,68,0,0,0,16722,-16654
ZCTA5 68755,149,3920,-3771,391,40.3,335,4,0,0,10315,-9924
ZCTA5 68756,749,1528,-779,1882,41,1796,4,7,0.003719447,3907,-2025
ZCTA5 68757,309,99,210,812,52.2,804,0,0,0,377,435
ZCTA5 68758,484,610,-126,1341,34.7,1017,11,0,0,1599,-258
ZCTA5 68759,117,2356,-2239,391,33.6,367,0,0,0,5571,-5180
ZCTA5 68760,467,2743,-2276,1289,36.2,621,3,2,0.00155159,7691,-6402
ZCTA5 68761,181,127,54,434,42.9,398,6,15,0.034562212,292,142
ZCTA5 68763,1814,47,1767,4583,43.7,4442,40,39,0.00850971,112,4471
ZCTA5 68764,309,935,-626,837,44.1,820,0,1,0.001194743,2591,-1754
ZCTA5 68765,463,15078,-14615,1186,42.6,1169,1,4,0.003372681,42664,-41478
ZCTA5 68766,151,7016,-6865,485,34.5,482,0,0,0,18419,-17934
ZCTA5 68767,1362,14472,-13110,3563,40.3,3535,0,2,0.000561325,40667,-37104
ZCTA5 68768,266,11,255,626,44.4,584,12,16,0.025559105,35,591
ZCTA5 68769,713,302,411,1718,39.7,1546,18,0,0,1329,389
ZCTA5 68770,625,1679,-1054,1347,42.2,1281,0,3,0.002227171,4699,-3352
ZCTA5 68771,561,6171,-5610,1507,38.3,1403,0,0,0,16086,-14579
ZCTA5 68773,88,45,43,163,62.9,163,0,0,0,71,92
ZCTA5 68774,118,281,-163,331,44.2,330,0,0,0,617,-286
ZCTA5 68776,5300,7288,-1988,15156,31.1,7306,462,1589,0.104842966,19741,-4585
ZCTA5 68777,249,4252,-4003,502,55.4,495,0,5,0.009960159,10756,-10254
ZCTA5 68778,232,2701,-2469,648,49.1,642,0,1,0.00154321,7175,-6527
ZCTA5 68779,856,91,765,2517,35.1,2275,19,34,0.013508145,231,2286
ZCTA5 68780,346,7215,-6869,904,35.3,886,1,0,0,20131,-19227
ZCTA5 68781,589,1235,-646,1560,46.7,1463,4,50,0.032051282,3005,-1445
ZCTA5 68783,330,1957,-1627,886,56,731,0,0,0,5546,-4660
ZCTA5 68784,609,6907,-6298,1676,37.7,1177,0,0,0,19785,-18109
ZCTA5 68785,95,13126,-13031,211,44.6,175,28,0,0,31251,-31040
ZCTA5 68786,347,13325,-12978,967,40.6,930,10,0,0,34234,-33267
ZCTA5 68787,2557,10206,-7649,6931,25.9,6448,51,93,0.013417977,25818,-18887
ZCTA5 68788,1875,6694,-4819,4545,44.2,3818,4,31,0.006820682,18777,-14232
ZCTA5 68789,34,4190,-4156,72,54.5,54,0,0,0,12838,-12766
ZCTA5 68790,391,409,-18,808,36.8,747,5,8,0.00990099,1321,-513
ZCTA5 68791,762,340,422,1837,37,1781,0,3,0.001633097,876,961
ZCTA5 68792,182,123,59,375,53.8,366,0,0,0,355,20
ZCTA5 68801,10900,2899,8001,30176,33.2,20574,426,1209,0.040064952,7868,22308
ZCTA5 68803,10484,9172,1312,25966,40.3,21116,339,818,0.031502734,24595,1371
ZCTA5 68810,339,220,119,927,30.2,749,2,0,0,718,209
ZCTA5 68812,209,278,-69,562,40.5,555,0,0,0,842,-280
ZCTA5 68813,175,186,-11,391,54.9,350,0,0,0,540,-149
ZCTA5 68814,396,111,285,928,39.6,834,1,0,0,254,674
ZCTA5 68815,285,94,191,668,50.5,642,0,8,0.011976048,280,388
ZCTA5 68816,73,83,-10,138,42.9,138,0,0,0,160,-22
ZCTA5 68817,171,547,-376,343,51.1,341,0,0,0,1256,-913
ZCTA5 68818,2203,189,2014,5834,40.9,5769,0,0,0,755,5079
ZCTA5 68820,136,3069,-2933,262,56,257,0,0,0,8645,-8383
ZCTA5 68821,43,2574,-2531,76,70.5,76,0,0,0,8229,-8153
ZCTA5 68822,2021,145,1876,4808,41.3,4604,0,47,0.009775374,405,4403
ZCTA5 68823,915,32,883,2171,47.9,2106,1,6,0.002763703,119,2052
ZCTA5 68824,615,799,-184,1492,33.3,1313,5,0,0,2082,-590
ZCTA5 68825,428,1255,-827,994,46.9,983,0,2,0.002012072,2892,-1898
ZCTA5 68826,1446,62,1384,3928,39.9,3605,51,4,0.00101833,150,3778
ZCTA5 68827,251,1214,-963,691,37.6,689,0,0,0,3273,-2582
ZCTA5 68828,105,1438,-1333,190,58.3,190,0,0,0,4085,-3895
ZCTA5 68831,283,1711,-1428,626,49.2,610,1,0,0,4630,-4004
ZCTA5 68832,839,450,389,2050,50.3,2023,1,8,0.003902439,1214,836
ZCTA5 68833,76,463,-387,149,51.4,149,0,0,0,1299,-1150
ZCTA5 68834,87,811,-724,188,52.2,177,0,4,0.021276596,3600,-3412
ZCTA5 68835,256,824,-568,584,44.8,563,0,2,0.003424658,2178,-1594
ZCTA5 68836,660,178,482,1877,30.7,1828,23,3,0.001598295,468,1409
ZCTA5 68837,41,10419,-10378,92,51,92,0,0,0,28195,-28103
ZCTA5 68838,109,3752,-3643,233,65.2,231,0,0,0,11057,-10824
ZCTA5 68840,1134,2463,-1329,3131,38,2440,0,36,0.011497924,6723,-3592
ZCTA5 68841,224,3860,-3636,622,39.2,578,23,0,0,10085,-9463
ZCTA5 68842,241,7413,-7172,619,40.5,597,0,11,0.017770598,21809,-21190
ZCTA5 68843,292,1321,-1029,729,45.9,671,0,0,0,3676,-2947
ZCTA5 68844,107,1859,-1752,257,37.7,254,0,0,0,5583,-5326
ZCTA5 68845,8128,164,7964,20632,32.3,18977,296,163,0.007900349,4848,15784
ZCTA5 68846,111,7304,-7193,313,34.2,213,0,8,0.025559105,20166,-19853
ZCTA5 68847,7121,499,6622,16789,36.8,14732,322,175,0.010423492,1334,15455
ZCTA5 68849,0,1599,-1599,1566,19.5,1289,109,28,0.017879949,4203,-2637
ZCTA5 68850,3927,241,3686,12171,31.2,7172,114,1439,0.118231863,838,11333
ZCTA5 68852,224,2097,-1873,502,52.6,474,0,6,0.011952191,5752,-5250
ZCTA5 68853,640,648,-8,1436,51,1380,1,0,0,1726,-290
ZCTA5 68854,283,719,-436,756,46.2,661,9,0,0,2001,-1245
ZCTA5 68855,146,18209,-18063,303,53.3,299,0,1,0.00330033,52037,-51734
ZCTA5 68856,271,364,-93,702,33,661,0,0,0,1128,-426
ZCTA5 68858,140,1395,-1255,415,40.1,392,0,4,0.009638554,3452,-3037
ZCTA5 68859,237,453,-216,520,49.8,512,0,0,0,1030,-510
ZCTA5 68860,128,672,-544,255,49.3,224,0,0,0,1732,-1477
ZCTA5 68861,51,2238,-2187,90,70.7,90,0,0,0,7249,-7159
ZCTA5 68862,1211,153,1058,2874,43.4,2835,1,0,0,471,2403
ZCTA5 68863,551,13425,-12874,1342,41.2,1252,0,2,0.001490313,38135,-36793
ZCTA5 68864,418,4940,-4522,1099,40.7,1079,6,0,0,13688,-12589
ZCTA5 68865,371,544,-173,898,46.8,826,0,0,0,1500,-602
ZCTA5 68866,420,85,335,1126,37.2,1113,7,0,0,200,926
ZCTA5 68869,922,1979,-1057,2123,44,2020,0,0,0,5356,-3233
ZCTA5 68870,214,40,174,634,32.4,620,1,0,0,71,563
ZCTA5 68871,109,1697,-1588,255,54.8,249,3,0,0,6523,-6268
ZCTA5 68872,357,599,-242,864,47.1,852,12,0,0,1223,-359
ZCTA5 68873,1331,667,664,3649,40.4,3291,0,21,0.005755001,1644,2005
ZCTA5 68874,309,369,-60,727,48.3,709,0,5,0.006877579,975,-248
ZCTA5 68875,226,386,-160,562,40,537,0,2,0.003558719,1353,-791
ZCTA5 68876,691,3168,-2477,1949,34.2,1651,0,8,0.004104669,8766,-6817
ZCTA5 68878,178,809,-631,511,35.9,486,0,0,0,2291,-1780
ZCTA5 68879,155,128,27,402,35.2,320,0,0,0,208,194
ZCTA5 68881,23,1404,-1381,115,18.1,115,0,0,0,4000,-3885
ZCTA5 68882,198,648,-450,448,39.5,418,0,3,0.006696429,1495,-1047
ZCTA5 68883,935,2699,-1764,2590,39.4,2221,0,0,0,6496,-3906
ZCTA5 68901,10708,339,10369,26374,36.4,23616,383,163,0.006180329,1088,25286
ZCTA5 68920,607,347,260,1560,43.5,1524,4,1,0.000641026,782,778
ZCTA5 68922,465,1246,-781,1122,47.1,1094,6,0,0,3383,-2261
ZCTA5 68923,33,6427,-6394,100,31.9,99,0,0,0,17335,-17235
ZCTA5 68924,560,5462,-4902,1540,35.9,1514,0,2,0.001298701,14831,-13291
ZCTA5 68925,198,12438,-12240,499,40.6,423,0,5,0.01002004,36601,-36102
ZCTA5 68926,230,1181,-951,576,43.3,556,0,1,0.001736111,3356,-2780
ZCTA5 68927,505,249,256,1243,45.2,1206,0,7,0.005631537,662,581
ZCTA5 68928,143,89,54,374,45,341,0,0,0,206,168
ZCTA5 68929,77,3939,-3862,166,53.1,161,0,0,0,10673,-10507
ZCTA5 68930,570,3649,-3079,1341,42.5,1275,0,0,0,10358,-9017
ZCTA5 68932,140,738,-598,408,55.3,395,1,0,0,5502,-5094
ZCTA5 68933,377,1767,-1390,907,43.2,870,1,4,0.004410143,4791,-3884
ZCTA5 68934,69,794,-725,147,40.7,147,0,0,0,2101,-1954
ZCTA5 68935,275,458,-183,697,37.6,669,1,0,0,1298,-601
ZCTA5 68936,101,112,-11,212,54.8,212,0,0,0,269,-57
ZCTA5 68937,797,1090,-293,1764,58.3,1724,0,4,0.002267574,2804,-1040
ZCTA5 68938,233,7309,-7076,490,49.5,469,0,0,0,20462,-19972
ZCTA5 68939,442,66,376,1018,50.1,980,2,6,0.00589391,100,918
ZCTA5 68940,162,1508,-1346,525,32.9,495,1,0,0,4243,-3718
ZCTA5 68941,330,188,142,837,45.7,787,0,0,0,571,266
ZCTA5 68942,134,8611,-8477,469,35.8,429,0,0,0,24659,-24190
ZCTA5 68943,95,9,86,274,53.6,274,0,0,0,9,265
ZCTA5 68944,496,10324,-9828,1348,38.6,1119,0,21,0.015578635,26737,-25389
ZCTA5 68945,99,86,13,212,26.2,212,0,0,0,936,-724
ZCTA5 68946,23,10361,-10338,38,39.3,38,0,0,0,30119,-30081
ZCTA5 68947,269,12678,-12409,616,46.7,592,0,3,0.00487013,28253,-27637
ZCTA5 68948,174,6069,-5895,322,60,302,3,0,0,20626,-20304
ZCTA5 68949,2870,12830,-9960,6568,40.9,6119,3,12,0.00182704,33223,-26655
ZCTA5 68950,122,10866,-10744,267,47.8,263,0,0,0,23909,-23642
ZCTA5 68952,33,14707,-14674,63,64.4,62,0,0,0,37064,-37001
ZCTA5 68954,7,4594,-4587,7,-,7,0,0,0,14342,-14335
ZCTA5 68955,780,3867,-3087,2140,42.2,2020,2,41,0.019158879,11328,-9188
ZCTA5 68956,479,5366,-4887,1230,45.6,1180,4,5,0.004065041,14478,-13248
ZCTA5 68957,220,11093,-10873,558,53.3,552,0,0,0,30382,-29824
ZCTA5 68958,226,18618,-18392,581,41.1,563,0,0,0,43002,-42421
ZCTA5 68959,1563,11752,-10189,3800,39.5,3661,0,1,0.000263158,30598,-26798
ZCTA5 68960,84,3631,-3547,170,56.6,166,0,0,0,9397,-9227
ZCTA5 68961,286,1639,-1353,606,59.2,602,0,4,0.00660066,4891,-4285
ZCTA5 68964,23,6338,-6315,95,8.8,95,0,0,0,17050,-16955
ZCTA5 68966,206,0,206,480,55.4,441,26,2,0.004166667,0,480
ZCTA5 68967,444,1842,-1398,1054,40.8,937,0,14,0.013282732,4564,-3510
ZCTA5 68970,604,512,92,1352,47.8,1277,0,8,0.00591716,1463,-111
ZCTA5 68971,150,220,-70,331,55.9,329,0,0,0,546,-215
ZCTA5 68972,89,4299,-4210,264,43.9,232,2,0,0,11939,-11675
ZCTA5 68973,175,401,-226,423,39.1,405,15,0,0,1333,-910
ZCTA5 68974,112,321,-209,239,56.2,230,0,0,0,955,-716
ZCTA5 68975,43,765,-722,91,38.4,91,0,0,0,1883,-1792
ZCTA5 68976,72,601,-529,242,33.9,241,0,0,0,1256,-1014
ZCTA5 68977,89,3017,-2928,303,40.8,272,2,0,0,8682,-8379
ZCTA5 68978,994,286,708,2311,49.3,2184,31,4,0.001730852,597,1714
ZCTA5 68979,719,1454,-735,1717,43.4,1666,0,0,0,3581,-1864
ZCTA5 68980,161,589,-428,461,30.3,433,0,0,0,1441,-980
ZCTA5 68981,104,775,-671,235,39.5,229,0,0,0,2148,-1913
ZCTA5 68982,249,654,-405,666,40.3,622,1,0,0,1486,-820
ZCTA5 69001,3702,64,3638,8824,41.1,8309,3,46,0.005213055,147,8677
ZCTA5 69020,180,474,-294,683,34.5,642,0,0,0,1082,-399
ZCTA5 69021,598,432,166,1398,41.9,1386,0,0,0,1006,392
ZCTA5 69022,740,810,-70,1772,48.1,1751,0,3,0.001693002,1981,-209
ZCTA5 69023,137,1542,-1405,383,40.2,319,64,0,0,3329,-2946
ZCTA5 69024,449,139,310,1047,41.7,1006,0,0,0,413,634
ZCTA5 69025,386,6772,-6386,1024,35.1,925,0,21,0.020507813,19165,-18141
ZCTA5 69026,71,1688,-1617,211,40.4,83,0,0,0,4547,-4336
ZCTA5 69027,16,780,-764,23,53.9,23,0,0,0,2205,-2182
ZCTA5 69028,318,2702,-2384,722,54.8,715,0,0,0,8786,-8064
ZCTA5 69029,152,242,-90,371,41.1,363,0,0,0,672,-301
ZCTA5 69030,88,326,-238,215,35.6,189,0,3,0.013953488,625,-410
ZCTA5 69032,179,257,-78,455,53,428,0,0,0,788,-333
ZCTA5 69033,1038,612,426,2526,40.6,2254,14,2,0.000791766,1831,695
ZCTA5 69034,325,3979,-3654,1070,32.1,1045,0,0,0,12196,-11126
ZCTA5 69036,26,58,-32,66,51,64,0,0,0,128,-62
ZCTA5 69037,81,1197,-1116,195,45,195,0,0,0,3119,-2924
ZCTA5 69038,201,923,-722,482,45.3,462,0,4,0.008298755,2538,-2056
ZCTA5 69039,50,3991,-3941,122,36.5,122,0,0,0,10224,-10102
ZCTA5 69040,266,8007,-7741,616,42.4,584,0,0,0,20654,-20038
ZCTA5 69041,28,917,-889,37,63.6,37,0,0,0,2410,-2373
ZCTA5 69042,1,710,-709,1,-,1,0,0,0,1513,-1512
ZCTA5 69043,215,293,-78,494,55.4,462,0,0,0,824,-330
ZCTA5 69044,283,1475,-1192,735,44.8,727,0,2,0.002721088,3897,-3162
ZCTA5 69045,403,431,-28,918,58.2,886,0,10,0.010893246,1169,-251
ZCTA5 69046,104,1247,-1143,133,70.1,131,2,0,0,3701,-3568
ZCTA5 69101,11901,1458,10443,28311,41.4,25678,282,375,0.013245735,3689,24622
ZCTA5 69120,452,328,124,1138,39.2,1094,0,0,0,598,540
ZCTA5 69121,128,770,-642,294,53.2,271,0,0,0,2048,-1754
ZCTA5 69122,282,947,-665,686,43.4,622,4,2,0.002915452,2650,-1964
ZCTA5 69123,340,600,-260,926,43.6,873,2,1,0.001079914,1330,-404
ZCTA5 69125,118,969,-851,211,47.6,195,0,0,0,2195,-1984
ZCTA5 69127,334,2721,-2387,762,58,740,4,0,0,6540,-5778
ZCTA5 69128,161,2080,-1919,431,44.9,407,0,0,0,5608,-5177
ZCTA5 69129,553,81,472,1279,50.3,1177,11,0,0,357,922
ZCTA5 69130,2133,2086,47,5166,46.3,4680,66,151,0.029229578,4895,271
ZCTA5 69131,331,3425,-3094,773,48.3,769,0,0,0,8032,-7259
ZCTA5 69132,41,2800,-2759,109,31.3,109,0,0,0,7673,-7564
ZCTA5 69133,174,6450,-6276,420,48.3,414,0,3,0.007142857,15093,-14673
ZCTA5 69134,158,10556,-10398,398,37.8,398,0,0,0,22299,-21901
ZCTA5 69135,4,12613,-12609,8,-,8,0,0,0,34755,-34747
ZCTA5 69138,1650,12050,-10400,4143,40.7,3993,26,0,0,34475,-30332
ZCTA5 69140,691,6579,-5888,1741,42,1654,9,4,0.00229753,18572,-16831
ZCTA5 69141,193,8371,-8178,465,48.2,406,5,0,0,22215,-21750
ZCTA5 69142,51,707,-656,133,33.6,133,0,0,0,2962,-2829
ZCTA5 69143,681,15313,-14632,1645,45,1597,0,9,0.005471125,38999,-37354
ZCTA5 69144,55,12400,-12345,122,51.5,122,0,0,0,31498,-31376
ZCTA5 69145,1158,6210,-5052,2760,46.9,2526,6,9,0.00326087,14342,-11582
ZCTA5 69146,171,10072,-9901,240,66.3,240,0,0,0,26071,-25831
ZCTA5 69147,243,4630,-4387,438,60.3,416,0,0,0,12463,-12025
ZCTA5 69148,71,5207,-5136,165,52,165,0,0,0,13315,-13150
ZCTA5 69149,301,8907,-8606,719,39.8,692,4,0,0,19957,-19238
ZCTA5 69150,153,9239,-9086,437,37.5,428,0,0,0,30580,-30143
ZCTA5 69151,344,13374,-13030,990,38,927,0,5,0.005050505,36563,-35573
ZCTA5 69152,329,0,329,767,44.5,711,0,4,0.005215124,96,671
ZCTA5 69153,2786,509,2277,6063,49.4,5571,31,80,0.013194788,1175,4888
ZCTA5 69154,516,8637,-8121,1036,50.4,1019,4,0,0,23325,-22289
ZCTA5 69155,397,1264,-867,1120,38.3,1068,3,34,0.030357143,3569,-2449
ZCTA5 69156,282,176,106,644,49,632,0,1,0.001552795,424,220
ZCTA5 69157,54,2819,-2765,105,57.9,105,0,0,0,7505,-7400
ZCTA5 69161,44,640,-596,61,69.2,58,0,0,0,1783,-1722
ZCTA5 69162,3244,1375,1869,7130,39.6,6564,53,77,0.010799439,3606,3524
ZCTA5 69163,358,605,-247,973,37.8,902,0,0,0,1970,-997
ZCTA5 69165,701,2533,-1832,1916,39.3,1803,17,10,0.005219207,6596,-4680
ZCTA5 69166,260,100,160,575,35.6,539,0,0,0,207,368
ZCTA5 69167,154,1365,-1211,370,54.4,370,0,0,0,3496,-3126
ZCTA5 69168,77,1598,-1521,203,49.2,189,0,0,0,3875,-3672
ZCTA5 69169,235,432,-197,456,45.5,430,0,0,0,1973,-1517
ZCTA5 69170,116,1000,-884,258,43.3,241,0,0,0,2767,-2509
ZCTA5 69171,0,3683,-3683,0,-,0,0,0,#DIV/0!,10034,-10034
ZCTA5 69201,1510,67,1443,3917,37.8,3146,75,11,0.002808272,145,3772
ZCTA5 69210,925,1232,-307,2065,46.1,1937,0,1,0.000484262,4483,-2418
ZCTA5 69211,159,505,-346,382,40.3,360,0,0,0,1226,-844
ZCTA5 69212,157,9,148,378,32.6,166,0,0,0,21,357
ZCTA5 69214,85,3410,-3325,404,19.8,404,0,0,0,9168,-8764
ZCTA5 69216,91,113,-22,202,52.2,189,0,0,0,426,-224
ZCTA5 69217,161,1861,-1700,365,63.9,354,1,0,0,6449,-6084
ZCTA5 69218,164,290,-126,382,55.7,325,0,0,0,972,-590
ZCTA5 69219,22,650,-628,65,70.9,65,0,0,0,1790,-1725
ZCTA5 69220,17,1397,-1380,39,45.3,39,0,0,0,3861,-3822
ZCTA5 69221,39,671,-632,83,51.8,83,0,0,0,1423,-1340
ZCTA5 69301,4096,3130,966,9688,39.5,8337,77,350,0.036127168,7853,1835
ZCTA5 69331,30,404,-374,101,35.3,101,0,0,0,1136,-1035
ZCTA5 69333,77,609,-532,208,38.7,193,0,3,0.014423077,1678,-1470
ZCTA5 69334,846,971,-125,2091,41.9,1724,33,0,0,2358,-267
ZCTA5 69335,19,4391,-4372,62,47.4,62,0,0,0,12671,-12609
ZCTA5 69336,934,11730,-10796,2411,40.4,2253,14,4,0.001659063,30816,-28405
ZCTA5 69337,2670,0,2670,6765,29.9,5784,40,386,0.057058389,2175,4590
ZCTA5 69339,555,955,-400,1340,46.2,1228,6,0,0,2553,-1213
ZCTA5 69340,20,171,-151,60,57.3,60,0,0,0,434,-374
ZCTA5 69341,4245,516,3729,10912,36.6,9525,49,73,0.006689883,1412,9500
ZCTA5 69343,974,18,956,2400,43.8,1871,49,49,0.020416667,70,2330
ZCTA5 69345,152,1218,-1066,418,46.3,384,4,0,0,3246,-2828
ZCTA5 69346,206,3625,-3419,454,46.1,375,7,11,0.024229075,11153,-10699
ZCTA5 69347,552,287,265,1342,51.6,1271,6,14,0.010432191,680,662
ZCTA5 69348,516,13316,-12800,1231,43.4,1159,4,0,0,33803,-32572
ZCTA5 69350,177,7596,-7419,355,39.5,352,0,0,0,19821,-19466
ZCTA5 69351,73,5188,-5115,165,60.3,143,22,0,0,14517,-14352
ZCTA5 69352,276,7996,-7720,615,45.3,553,0,0,0,22830,-22215
ZCTA5 69353,32,5380,-5348,64,58.5,51,0,0,0,15647,-15583
ZCTA5 69354,63,7574,-7511,80,56.6,80,0,0,0,20376,-20296
ZCTA5 69355,61,41,20,122,56.3,120,0,2,0.016393443,73,49
ZCTA5 69356,716,2695,-1979,1966,40.6,1755,0,0,0,6888,-4922
ZCTA5 69357,1507,333,1174,3448,44.2,2848,3,8,0.002320186,958,2490
ZCTA5 69358,940,486,454,2014,48.3,1877,0,33,0.016385303,1337,677
ZCTA5 69360,529,423,106,1348,38.5,986,15,1,0.00074184,1004,344
ZCTA5 69361,7170,1446,5724,17370,37.5,14316,179,138,0.007944732,5942,11428
ZCTA5 69365,0,2697,-2697,0,-,0,0,0,#DIV/0!,7843,-7843
ZCTA5 69366,110,333,-223,354,28.7,348,1,0,0,919,-565
ZCTA5 69367,112,340,-228,218,61.6,218,0,0,0,799,-581
ZCTA5 70001,17834,3589,14245,40589,40.7,29251,987,6448,0.158860775,10080,30509
ZCTA5 70002,8463,746,7717,19359,37.4,13966,1307,2683,0.138591869,1516,17843
ZCTA5 70003,16232,86,16146,39198,46.3,30808,1805,3542,0.090361753,160,39038
ZCTA5 70005,11479,457,11022,24507,44.8,21672,275,483,0.019708655,1802,22705
ZCTA5 70006,5814,1495,4319,15455,42.7,11277,778,1062,0.068715626,3672,11783
ZCTA5 70030,1399,3358,-1959,3927,38.6,3503,0,125,0.031830914,8322,-4395
ZCTA5 70031,514,2900,-2386,1229,55.5,555,0,630,0.51261188,7706,-6477
ZCTA5 70032,1703,78,1625,4080,37.8,2831,227,570,0.139705882,113,3967
ZCTA5 70036,335,1109,-774,931,40.8,802,0,71,0.076262084,2697,-1766
ZCTA5 70037,5615,1526,4089,17120,35.3,12876,349,2452,0.143224299,3409,13711
ZCTA5 70038,13,4244,-4231,13,-,13,0,0,0,10838,-10825
ZCTA5 70039,806,676,130,2189,41.2,690,0,1424,0.650525354,1589,600
ZCTA5 70040,567,706,-139,1131,52.3,592,0,522,0.461538462,1739,-608
ZCTA5 70041,1062,1353,-291,2461,44.4,1318,515,404,0.16416091,3419,-958
ZCTA5 70043,7795,229,7566,21981,33.7,14295,598,5693,0.258996406,705,21276
ZCTA5 70047,4784,915,3869,13288,39.7,10223,243,2419,0.182043949,2462,10826
ZCTA5 70049,507,330,177,1290,52.8,104,0,1181,0.915503876,849,441
ZCTA5 70050,14,12781,-12767,14,-,14,0,0,0,35443,-35429
ZCTA5 70051,602,783,-181,1960,42.2,984,0,952,0.485714286,2024,-64
ZCTA5 70052,1056,687,369,3157,38.1,1258,0,1888,0.59803611,1669,1488
ZCTA5 70053,7432,361,7071,16842,39.6,8125,375,5633,0.334461465,1108,15734
ZCTA5 70056,14112,594,13518,41650,34.9,14966,1961,17555,0.421488595,1538,40112
ZCTA5 70057,1471,960,511,4868,40.1,2118,34,2293,0.471035333,2842,2026
ZCTA5 70058,14652,713,13939,40637,38.3,9753,2677,25158,0.619090976,1639,38998
ZCTA5 70062,6152,2716,3436,17422,39.1,8986,129,5362,0.307771783,7018,10404
ZCTA5 70065,20207,505,19702,50517,37.8,32001,2871,8094,0.160223291,1058,49459
ZCTA5 70067,1003,35,968,3152,39,2933,0,1,0.000317259,51,3101
ZCTA5 70068,11970,939,11031,33803,36.9,13211,389,18094,0.535277934,2560,31243
ZCTA5 70070,4975,0,4975,14142,37.3,10119,238,2984,0.211002687,0,14142
ZCTA5 70071,1123,1770,-647,3200,48.5,1445,0,1755,0.5484375,4721,-1521
ZCTA5 70072,20586,262,20324,56139,40.9,25450,3506,21384,0.380911666,651,55488
ZCTA5 70075,1721,2006,-285,5106,38.4,4226,247,314,0.061496279,5799,-693
ZCTA5 70076,49,149,-100,66,77.3,9,0,57,0.863636364,362,-296
ZCTA5 70079,1128,254,874,2825,37.4,2590,10,132,0.046725664,667,2158
ZCTA5 70080,339,2642,-2303,745,43.5,745,0,0,0,6736,-5991
ZCTA5 70082,110,34,76,340,54.3,0,0,340,1,94,246
ZCTA5 70083,753,1051,-298,2346,34.7,526,130,1071,0.456521739,2798,-452
ZCTA5 70084,2220,66,2154,6071,41.6,2202,0,3331,0.548674024,186,5885
ZCTA5 70085,1569,359,1210,4739,33.8,3920,0,296,0.062460435,1020,3719
ZCTA5 70086,714,2032,-1318,1963,39.6,103,0,1860,0.947529292,5153,-3190
ZCTA5 70087,2650,2484,166,7581,36.2,3073,0,3618,0.477245746,6512,1069
ZCTA5 70090,2797,1034,1763,7380,42.3,3295,0,3797,0.514498645,2531,4849
ZCTA5 70091,81,652,-571,351,30.9,272,0,37,0.105413105,1589,-1238
ZCTA5 70092,2508,1624,884,7675,39.2,3701,5,3643,0.47465798,4632,3043
ZCTA5 70094,11995,577,11418,32420,35.8,13637,957,14710,0.453732264,1601,30819
ZCTA5 70112,2205,95,2110,3869,33.5,1631,114,1908,0.493150685,124,3745
ZCTA5 70113,3748,76,3672,8427,39.7,1665,57,5883,0.698113208,210,8217
ZCTA5 70114,9622,153,9469,21911,41.6,4454,71,16024,0.731322167,298,21613
ZCTA5 70115,14437,1044,13393,34261,39.5,22231,626,9077,0.264936809,2568,31693
ZCTA5 70116,5730,878,4852,10901,44.7,5541,31,4659,0.427391982,2764,8137
ZCTA5 70117,12145,453,11692,27009,39.8,8111,87,17581,0.650931171,1295,25714
ZCTA5 70118,12880,1489,11391,35699,33.8,17429,1535,14521,0.406762094,3913,31786
ZCTA5 70119,16864,1626,15238,36969,37.3,16163,256,17046,0.461089021,3947,33022
ZCTA5 70121,5625,561,5064,11648,42.6,8546,114,2422,0.207932692,1416,10232
ZCTA5 70122,14939,705,14234,35886,40.1,6096,457,26699,0.743994873,1731,34155
ZCTA5 70123,12619,222,12397,28078,41.8,22625,627,3459,0.123192535,523,27555
ZCTA5 70124,7867,8766,-899,19578,38.6,16289,719,946,0.048319542,23082,-3504
ZCTA5 70125,6515,446,6069,19264,33.4,6537,297,10997,0.570857558,1249,18015
ZCTA5 70126,10691,3638,7053,31168,33.3,1602,80,27808,0.892197125,9446,21722
ZCTA5 70127,9714,416,9298,25177,35.3,361,242,23780,0.944512849,1329,23848
ZCTA5 70128,7917,24,7893,22307,36.6,1034,1461,19195,0.860492222,42,22265
ZCTA5 70129,3067,932,2135,10696,36.2,1042,3119,5557,0.519540015,2639,8057
ZCTA5 70130,7268,118,7150,13478,38.6,8627,169,3983,0.295518623,256,13222
ZCTA5 70131,10847,432,10415,27160,38.4,6674,1193,17431,0.641789396,990,26170
ZCTA5 70139,0,10640,-10640,0,-,0,0,0,#DIV/0!,27356,-27356
ZCTA5 70148,130,2980,-2850,214,20.2,32,31,151,0.705607477,11631,-11417
ZCTA5 70163,0,1042,-1042,0,-,0,0,0,#DIV/0!,2558,-2558
ZCTA5 70301,17614,426,17188,46063,36.2,33171,239,10046,0.218092612,1016,45047
ZCTA5 70310,0,3195,-3195,445,19.2,227,0,167,0.375280899,10331,-9886
ZCTA5 70339,2119,1112,1007,4630,51,4541,0,8,0.001727862,2975,1655
ZCTA5 70340,46,191,-145,140,-,0,0,140,1,555,-415
ZCTA5 70341,1458,1911,-453,3863,43.6,946,0,2892,0.748640953,7241,-3378
ZCTA5 70342,1775,335,1440,4871,36.4,4269,0,379,0.077807432,917,3954
ZCTA5 70343,1839,1175,664,4772,46.9,4518,1,0,0,3108,1664
ZCTA5 70344,2138,98,2040,5795,36.6,4472,82,428,0.073856773,183,5612
ZCTA5 70345,3661,178,3483,9250,40.5,7017,81,225,0.024324324,455,8795
ZCTA5 70346,3720,223,3497,10081,35.7,2934,35,6887,0.683166353,692,9389
ZCTA5 70352,116,280,-164,411,27.4,395,0,0,0,610,-199
ZCTA5 70353,346,240,106,812,53.8,359,0,0,0,1226,-414
ZCTA5 70354,1761,3979,-2218,4004,44.5,2926,2,189,0.047202797,11612,-7608
ZCTA5 70355,422,838,-416,1219,36.2,1198,0,0,0,2085,-866
ZCTA5 70356,730,2036,-1306,1621,50.8,847,0,690,0.425663171,5909,-4288
ZCTA5 70357,1088,6255,-5167,2789,42.6,2332,48,102,0.036572248,17252,-14463
ZCTA5 70358,414,6379,-5965,858,51.5,825,0,8,0.009324009,17430,-16572
ZCTA5 70359,3598,13146,-9548,9698,31.2,5670,55,2793,0.287997525,34785,-25087
ZCTA5 70360,11213,218,10995,29224,37.3,21434,302,4969,0.170031481,489,28735
ZCTA5 70363,9433,340,9093,25971,35.1,15734,453,6495,0.250086635,666,25305
ZCTA5 70364,10680,5211,5469,29176,35.6,21415,377,3660,0.125445572,12601,16575
ZCTA5 70372,954,1364,-410,2047,49.8,1691,0,200,0.097703957,3754,-1707
ZCTA5 70373,2368,2560,-192,6455,38,5561,79,99,0.015336948,6106,349
ZCTA5 70374,2494,1401,1093,6628,40.2,5991,36,205,0.03092939,3437,3191
ZCTA5 70375,51,248,-197,145,42.7,145,0,0,0,648,-503
ZCTA5 70377,1353,613,740,3843,41.6,3364,0,0,0,1801,2042
ZCTA5 70380,8251,404,7847,21040,41.4,15044,453,2605,0.123811787,3903,17137
ZCTA5 70390,2628,2511,117,7443,32.5,3889,0,3112,0.418110977,6502,941
ZCTA5 70391,92,795,-703,259,47.2,259,0,0,0,2080,-1821
ZCTA5 70392,2909,65,2844,8595,36.8,4837,113,3338,0.388365329,172,8423
ZCTA5 70393,38,479,-441,138,29.8,121,0,17,0.123188406,1087,-949
ZCTA5 70394,5620,2133,3487,14812,43,11067,100,3355,0.226505536,4929,9883
ZCTA5 70395,1641,1890,-249,4019,39.5,3067,39,617,0.153520776,4760,-741
ZCTA5 70397,323,6072,-5749,867,58.7,767,1,0,0,15542,-14675
ZCTA5 70401,7632,274,7358,19984,28.6,10502,360,8293,0.414981986,803,19181
ZCTA5 70402,0,46,-46,1631,19.8,713,39,843,0.516860822,78,1553
ZCTA5 70403,11266,318,10948,30510,34.1,19053,119,10387,0.340445755,836,29674
ZCTA5 70420,2933,133,2800,8378,35.7,6825,0,1017,0.121389353,324,8054
ZCTA5 70422,4787,63,4724,11730,44.4,6210,124,4821,0.410997442,192,11538
ZCTA5 70426,2140,289,1851,6407,41.1,3195,17,2991,0.466833151,725,5682
ZCTA5 70427,6910,2298,4612,18081,38.2,11899,59,5526,0.305624689,6252,11829
ZCTA5 70431,2028,25,2003,5070,49.9,4806,15,33,0.006508876,49,5021
ZCTA5 70433,15989,2902,13087,39957,40.2,33278,445,3849,0.096328553,7899,32058
ZCTA5 70435,7525,525,7000,19702,42,17531,0,1524,0.077352553,1394,18308
ZCTA5 70436,175,3768,-3593,467,49.1,56,0,411,0.880085653,8638,-8171
ZCTA5 70437,3057,325,2732,7794,49.8,7098,0,334,0.042853477,868,6926
ZCTA5 70438,7698,962,6736,19718,40.7,14545,0,4716,0.23917233,1941,17777
ZCTA5 70441,2187,288,1899,6381,42.3,2130,0,4163,0.652405579,679,5702
ZCTA5 70442,109,71,38,385,34.5,339,0,0,0,178,207
ZCTA5 70443,2724,8390,-5666,8223,36,4523,65,3035,0.369086708,19657,-11434
ZCTA5 70444,3835,0,3835,10456,35.4,6721,0,3461,0.331006121,11,10445
ZCTA5 70445,3977,1156,2821,10151,47,7061,27,2211,0.217811053,3047,7104
ZCTA5 70446,2354,36,2318,7434,34.1,6219,0,670,0.090126446,57,7377
ZCTA5 70447,5557,188,5369,17141,37.2,15464,96,252,0.014701593,363,16778
ZCTA5 70448,9590,264,9326,26485,39.6,23713,578,1008,0.038059279,603,25882
ZCTA5 70449,1233,494,739,2738,49.9,2641,0,24,0.008765522,1081,1657
ZCTA5 70450,1117,12833,-11716,2648,40.7,1748,0,877,0.331193353,32302,-29654
ZCTA5 70451,79,754,-675,79,-,79,0,0,0,2077,-1998
ZCTA5 70452,4788,2296,2492,12948,41.7,11878,26,557,0.043018227,6296,6652
ZCTA5 70453,318,1608,-1290,674,48.7,637,0,37,0.054896142,4222,-3548
ZCTA5 70454,12167,1359,10808,30869,38.5,24091,123,4935,0.159869124,3436,27433
ZCTA5 70455,699,104,595,1930,53.7,1930,0,0,0,284,1646
ZCTA5 70456,946,424,522,3011,43.5,1034,13,1935,0.64264364,1009,2002
ZCTA5 70457,0,888,-888,143,23.2,113,1,23,0.160839161,2372,-2229
ZCTA5 70458,15246,413,14833,38748,40.9,28550,629,6499,0.167724786,1094,37654
ZCTA5 70460,7896,406,7490,21709,35.6,13183,55,5906,0.272053066,972,20737
ZCTA5 70461,11795,6535,5260,32042,39.5,19698,1186,7547,0.235534611,17172,14870
ZCTA5 70462,1969,178,1791,4724,42.5,4205,138,307,0.064987299,377,4347
ZCTA5 70463,57,244,-187,119,64.5,92,0,23,0.193277311,733,-614
ZCTA5 70464,68,970,-902,249,18.9,249,0,0,0,2335,-2086
ZCTA5 70465,152,565,-413,543,31.3,16,0,527,0.97053407,1370,-827
ZCTA5 70466,3453,902,2551,10757,33.6,8562,8,1620,0.15059961,2128,8629
ZCTA5 70471,8630,955,7675,21949,43.4,19823,732,399,0.018178505,2369,19580
ZCTA5 70501,11037,287,10750,27944,37.5,6292,78,20521,0.73436158,640,27304
ZCTA5 70503,11730,1355,10375,29710,35.9,23028,1476,3076,0.103534164,3205,26505
ZCTA5 70506,17938,4,17934,40304,34.6,26321,1296,8800,0.218340611,13,40291
ZCTA5 70507,6964,6357,607,18398,37.2,8923,30,8428,0.458093271,17077,1321
ZCTA5 70508,16263,57,16206,39895,36.3,32245,1073,4594,0.115152275,198,39697
ZCTA5 70510,9606,3495,6111,24609,38.5,16845,537,5867,0.238408712,8890,15719
ZCTA5 70512,3801,35,3766,10100,37.5,8040,1,1903,0.188415842,59,10041
ZCTA5 70513,68,265,-197,128,58.1,79,0,0,0,697,-569
ZCTA5 70514,751,429,322,1798,44.9,467,0,1280,0.711902113,1267,531
ZCTA5 70515,1080,315,765,3931,32.2,2873,0,594,0.151106589,802,3129
ZCTA5 70516,388,3701,-3313,1230,27.9,1044,0,81,0.065853659,10933,-9703
ZCTA5 70517,9638,773,8865,26813,36.3,17277,460,8191,0.305486145,2364,24449
ZCTA5 70518,5733,504,5229,15620,34,12339,671,2374,0.151984635,1297,14323
ZCTA5 70519,67,484,-417,85,86.1,0,0,85,1,1177,-1092
ZCTA5 70520,7765,1257,6508,20352,36.2,13322,1,6407,0.314809355,2987,17365
ZCTA5 70522,74,2030,-1956,708,28.7,0,0,708,1,5886,-5178
ZCTA5 70523,217,383,-166,604,33.6,168,4,219,0.362582781,901,-297
ZCTA5 70524,114,144,-30,215,56,112,0,103,0.479069767,358,-143
ZCTA5 70525,5222,315,4907,14870,39.2,11247,54,2529,0.170073974,781,14089
ZCTA5 70526,6737,715,6022,17275,37.3,12371,37,3995,0.231259045,2393,14882
ZCTA5 70528,900,818,82,2540,42,2146,0,192,0.075590551,2358,182
ZCTA5 70529,5520,1046,4474,13437,37.6,9390,0,2683,0.199672546,2901,10536
ZCTA5 70531,770,311,459,2054,36.3,2054,0,0,0,698,1356
ZCTA5 70532,1088,977,111,2696,39.8,1516,50,595,0.220697329,2333,363
ZCTA5 70533,2565,3726,-1161,7170,36.7,6123,71,349,0.048675035,9829,-2659
ZCTA5 70534,214,121,93,597,31.3,586,0,0,0,309,288
ZCTA5 70535,6356,14055,-7699,16827,38.3,12144,0,4048,0.240565757,35908,-19081
ZCTA5 70537,174,204,-30,420,32.8,411,0,0,0,492,-72
ZCTA5 70538,4887,2391,2496,13462,38.9,6485,93,5805,0.431213787,5935,7527
ZCTA5 70541,387,859,-472,805,56.8,279,0,522,0.648447205,1908,-1103
ZCTA5 70542,1186,202,984,3288,42.2,3149,3,128,0.03892944,518,2770
ZCTA5 70543,1498,1109,389,3933,37.9,3770,17,45,0.011441648,3113,820
ZCTA5 70544,3865,666,3199,10394,41.2,4373,286,4932,0.474504522,1443,8951
ZCTA5 70546,6126,293,5833,16428,36.1,12846,0,2375,0.144570246,703,15725
ZCTA5 70548,3548,86,3462,9309,40.2,8406,2,596,0.064024063,228,9081
ZCTA5 70549,1215,221,994,3399,38.9,2903,0,296,0.087084437,456,2943
ZCTA5 70550,0,11499,-11499,0,-,0,0,0,#DIV/0!,29073,-29073
ZCTA5 70551,197,7839,-7642,731,28.3,536,0,172,0.235294118,14978,-14247
ZCTA5 70552,367,18813,-18446,1026,35.2,633,0,371,0.361598441,44188,-43162
ZCTA5 70554,2084,1263,821,5382,33.9,3202,0,1611,0.299331104,3615,1767
ZCTA5 70555,2867,87,2780,8181,35.6,6272,257,1492,0.182373793,211,7970
ZCTA5 70556,358,5591,-5233,804,52.3,638,0,139,0.172885572,15406,-14602
ZCTA5 70558,24,1777,-1753,24,-,2,0,22,0.916666667,4827,-4803
ZCTA5 70559,897,501,396,2908,28.7,2859,0,13,0.004470426,1518,1390
ZCTA5 70560,14261,332,13929,38102,35.9,20779,904,13291,0.348826833,796,37306
ZCTA5 70563,7852,862,6990,20009,40.2,15209,195,3792,0.189514718,2504,17505
ZCTA5 70570,14304,657,13647,38236,37.3,15116,34,21771,0.569384873,1429,36807
ZCTA5 70575,0,888,-888,0,-,0,0,0,#DIV/0!,2145,-2145
ZCTA5 70576,351,1718,-1367,1489,36.3,1045,59,96,0.064472801,4549,-3060
ZCTA5 70577,1570,268,1302,4138,35.2,2854,19,913,0.220637989,867,3271
ZCTA5 70578,6200,558,5642,17071,35.9,12694,1,3906,0.228809091,1619,15452
ZCTA5 70580,85,865,-780,172,23.1,55,0,117,0.680232558,2467,-2295
ZCTA5 70581,267,383,-116,901,35.7,887,0,14,0.015538291,813,88
ZCTA5 70582,7609,40,7569,19855,40.4,12796,44,6288,0.316696046,126,19729
ZCTA5 70583,3926,5883,-1957,9674,39.9,7440,0,1365,0.141099855,13920,-4246
ZCTA5 70584,2473,664,1809,7507,33.6,4703,404,1928,0.256826962,1599,5908
ZCTA5 70585,123,1313,-1190,292,36.8,292,0,0,0,3078,-2786
ZCTA5 70586,7333,976,6357,19428,39.1,12550,18,5967,0.307134033,2469,16959
ZCTA5 70589,1120,326,794,3143,36.9,2115,0,989,0.314667515,835,2308
ZCTA5 70591,1658,590,1068,5400,36,4534,0,683,0.126481481,1739,3661
ZCTA5 70592,9161,433,8728,27357,33.5,23030,493,3094,0.113097196,1121,26236
ZCTA5 70601,13469,351,13118,34365,36.5,10317,102,22645,0.658955332,829,33536
ZCTA5 70605,15508,1380,14128,40835,35.9,34198,1564,3410,0.083506796,4092,36743
ZCTA5 70607,10538,114,10424,29294,35,14791,939,11222,0.38308186,187,29107
ZCTA5 70609,0,1660,-1660,421,19.7,165,0,231,0.548693587,4732,-4311
ZCTA5 70611,7700,132,7568,20448,41,17626,80,2144,0.10485133,303,20145
ZCTA5 70615,4418,373,4045,13805,38.1,5527,5,7377,0.534371604,1062,12743
ZCTA5 70629,0,225,-225,0,-,0,0,0,#DIV/0!,660,-660
ZCTA5 70630,668,117,551,1965,42.8,1856,21,13,0.006615776,302,1663
ZCTA5 70631,126,428,-302,302,56.1,283,0,4,0.013245033,1374,-1072
ZCTA5 70632,199,21,178,291,61.2,213,0,66,0.226804124,562,-271
ZCTA5 70633,2344,0,2344,8046,30.7,7035,19,293,0.03641561,404,7642
ZCTA5 70634,9727,172,9555,25999,37.6,19689,258,4336,0.166775645,392,25607
ZCTA5 70637,388,4898,-4510,966,43,966,0,0,0,13534,-12568
ZCTA5 70638,277,379,-102,1018,30,897,0,10,0.009823183,1014,4
ZCTA5 70639,126,432,-306,349,56.8,332,0,0,0,1049,-700
ZCTA5 70640,116,44,72,186,62.3,92,1,93,0.5,96,90
ZCTA5 70643,123,1186,-1063,225,54.2,225,0,0,0,2587,-2362
ZCTA5 70644,221,2191,-1970,543,33.9,543,0,0,0,6174,-5631
ZCTA5 70645,353,2435,-2082,970,53.5,970,0,0,0,6582,-5612
ZCTA5 70646,114,1502,-1388,396,29.7,396,0,0,0,4349,-3953
ZCTA5 70647,3772,4619,-847,11439,35.9,8436,12,2554,0.223271265,11750,-311
ZCTA5 70648,2550,744,1806,7702,36.5,5651,91,1606,0.208517268,1903,5799
ZCTA5 70650,66,33,33,118,54.4,118,0,0,0,104,14
ZCTA5 70651,62,10034,-9972,230,17.9,230,0,0,0,27398,-27168
ZCTA5 70652,551,1238,-687,1526,43.8,1488,0,0,0,3203,-1677
ZCTA5 70653,1320,338,982,3634,35.8,3300,0,258,0.070996147,743,2891
ZCTA5 70654,36,9074,-9038,135,31.2,134,0,0,0,23497,-23362
ZCTA5 70655,945,1659,-714,2645,29.8,1776,0,740,0.279773157,4072,-1427
ZCTA5 70656,1250,1618,-368,3160,43.4,3051,0,0,0,3980,-820
ZCTA5 70657,1744,5846,-4102,5042,37,4941,0,34,0.006743356,14822,-9780
ZCTA5 70658,239,12734,-12495,749,37.2,742,4,2,0.002670227,34805,-34056
ZCTA5 70659,529,1476,-947,1450,34.7,1239,5,120,0.082758621,3444,-1994
ZCTA5 70660,652,186,466,2099,37.8,2099,0,0,0,668,1431
ZCTA5 70661,572,151,421,1532,49.9,1323,0,67,0.043733681,436,1096
ZCTA5 70662,126,626,-500,388,35.3,314,0,0,0,1710,-1322
ZCTA5 70663,10891,850,10041,30810,36,27388,95,2271,0.073709834,1879,28931
ZCTA5 70665,4203,259,3944,12475,34.8,11342,112,751,0.060200401,723,11752
ZCTA5 70668,2188,2809,-621,6556,35.5,5885,0,453,0.06909701,7376,-820
ZCTA5 70669,3573,11682,-8109,9457,37.7,8141,199,823,0.087025484,31455,-21998
ZCTA5 70706,7349,17316,-9967,22999,36,21196,0,1156,0.050263055,44598,-21599
ZCTA5 70710,2228,0,2228,6503,30.2,3425,0,2965,0.455943411,1830,4673
ZCTA5 70711,1815,378,1437,5297,35.4,4830,0,2,0.000377572,770,4527
ZCTA5 70712,131,17,114,4091,46.3,1314,107,2515,0.614764116,46,4045
ZCTA5 70714,6369,41,6328,18591,35.8,4872,83,13137,0.706632241,47,18544
ZCTA5 70715,401,928,-527,1229,35.8,810,0,419,0.340927583,2338,-1109
ZCTA5 70719,1340,1333,7,3564,36.7,2844,0,694,0.194725028,3157,407
ZCTA5 70721,212,623,-411,592,27.9,176,2,414,0.699324324,1335,-743
ZCTA5 70722,2075,2232,-157,4819,45.2,3169,11,1497,0.310645362,5209,-390
ZCTA5 70723,398,356,42,1083,34.1,279,0,802,0.740535549,900,183
ZCTA5 70725,616,525,91,1506,48.1,702,0,804,0.533864542,1442,64
ZCTA5 70726,20141,1782,18359,58949,35.7,48228,561,6570,0.111452272,4767,54182
ZCTA5 70729,241,318,-77,851,40.2,648,0,203,0.238542891,1027,-176
ZCTA5 70730,1309,26,1283,3409,42.3,2027,0,1372,0.402464066,64,3345
ZCTA5 70732,413,271,142,1180,42.9,846,0,246,0.208474576,637,543
ZCTA5 70733,480,343,137,1137,40.5,1123,0,0,0,784,353
ZCTA5 70734,2954,446,2508,9795,33.5,6333,256,1834,0.187238387,1135,8660
ZCTA5 70736,215,5758,-5543,616,18.9,298,0,318,0.516233766,15769,-15153
ZCTA5 70737,17603,25,17578,45161,37.6,29546,636,11241,0.248909457,37,45124
ZCTA5 70739,4710,187,4523,13445,38.5,11792,77,702,0.052212718,364,13081
ZCTA5 70740,403,62,341,884,42.8,793,0,91,0.102941176,166,718
ZCTA5 70743,190,652,-462,611,37.1,611,0,0,0,1704,-1093
ZCTA5 70744,1924,1103,821,6146,41.6,5871,0,5,0.000813537,2523,3623
ZCTA5 70747,172,1809,-1637,346,63.5,85,0,261,0.75433526,4350,-4004
ZCTA5 70748,1682,1280,402,7483,43.5,3076,0,3932,0.525457704,3153,4330
ZCTA5 70749,613,203,410,1233,45.1,972,1,236,0.191403082,470,763
ZCTA5 70750,540,739,-199,1313,44.8,1283,0,0,0,2046,-733
ZCTA5 70752,263,746,-483,712,46.4,582,0,93,0.130617978,1957,-1245
ZCTA5 70753,270,216,54,758,53.5,246,16,496,0.654353562,568,190
ZCTA5 70754,4484,404,4080,12564,35.3,11915,36,268,0.021330786,884,11680
ZCTA5 70755,604,65,539,1480,45.6,1386,0,94,0.063513514,114,1366
ZCTA5 70756,188,15161,-14973,860,15,785,0,75,0.087209302,39062,-38202
ZCTA5 70757,1240,306,934,2315,49.1,1219,0,829,0.358099352,773,1542
ZCTA5 70759,622,290,332,1458,45.9,844,0,573,0.393004115,941,517
ZCTA5 70760,2621,3196,-575,6574,41.4,2452,83,3984,0.60602373,8147,-1573
ZCTA5 70761,240,832,-592,520,52,265,0,254,0.488461538,1889,-1369
ZCTA5 70762,294,84,210,773,31.8,613,0,93,0.120310479,238,535
ZCTA5 70763,1658,505,1153,4487,39.2,3367,5,1067,0.237798083,1522,2965
ZCTA5 70764,5923,101,5822,15525,40.8,7921,0,6630,0.42705314,310,15215
ZCTA5 70767,5984,4040,1944,16209,40.9,8688,0,7214,0.445061386,11111,5098
ZCTA5 70769,16270,869,15401,46900,34.7,36493,748,6560,0.139872068,2305,44595
ZCTA5 70770,1387,1396,-9,3588,51.6,3365,73,48,0.013377926,2683,905
ZCTA5 70772,411,0,411,1134,30.8,844,0,290,0.255731922,450,684
ZCTA5 70773,73,1362,-1289,193,24.5,154,0,39,0.202072539,3356,-3163
ZCTA5 70774,3589,935,2654,10442,39,9873,0,275,0.026335951,2238,8204
ZCTA5 70775,3560,5025,-1465,10754,38.3,6577,0,4032,0.374930259,13679,-2925
ZCTA5 70776,1403,8420,-7017,6112,37.2,2679,14,3053,0.499509162,22641,-16529
ZCTA5 70777,1583,2256,-673,4365,35.3,3549,0,696,0.159450172,5409,-1044
ZCTA5 70778,1181,136,1045,3242,39.4,1952,6,1111,0.342689698,352,2890
ZCTA5 70780,403,13,390,1143,36.7,379,0,764,0.668416448,18,1125
ZCTA5 70782,48,4653,-4605,151,32.2,121,0,30,0.198675497,12132,-11981
ZCTA5 70783,956,505,451,2314,60.1,2168,0,90,0.038893691,1193,1121
ZCTA5 70785,7731,3872,3859,22571,35.6,20248,489,1229,0.054450401,11966,10605
ZCTA5 70786,0,8221,-8221,0,-,0,0,0,#DIV/0!,20977,-20977
ZCTA5 70787,113,5075,-4962,260,44.7,36,0,224,0.861538462,12197,-11937
ZCTA5 70788,1486,9427,-7941,4108,37.6,1531,0,2456,0.597857838,21287,-17179
ZCTA5 70789,323,4873,-4550,767,49.9,101,9,613,0.799217731,12668,-11901
ZCTA5 70791,10815,9290,1525,30494,36.9,15905,506,13199,0.432839247,24062,6432
ZCTA5 70801,189,0,189,229,33,113,23,93,0.406113537,82,147
ZCTA5 70802,10088,12424,-2336,25739,31.6,4677,1122,18624,0.723571234,30617,-4878
ZCTA5 70803,0,1065,-1065,2222,18.9,1419,13,622,0.279927993,2463,-241
ZCTA5 70805,8955,402,8553,25622,34.1,577,34,24180,0.94372024,976,24646
ZCTA5 70806,12499,170,12329,30545,34,15737,324,11672,0.382124734,398,30147
ZCTA5 70807,5348,403,4945,15771,34.8,261,3,14680,0.930822396,1285,14486
ZCTA5 70808,15472,1426,14046,35309,32.2,25712,1225,6677,0.189101929,3402,31907
ZCTA5 70809,11832,727,11105,26232,38.4,17326,984,6538,0.249237572,1852,24380
ZCTA5 70810,16214,319,15895,43092,37,26012,2337,11912,0.27643182,829,42263
ZCTA5 70811,4615,455,4160,14840,35.3,1265,95,13193,0.889016173,1218,13622
ZCTA5 70812,3697,175,3522,12325,35.9,132,0,11928,0.967789047,365,11960
ZCTA5 70813,0,1766,-1766,1506,18.9,209,0,1170,0.77689243,4657,-3151
ZCTA5 70814,4360,1145,3215,11582,38.6,1470,15,9421,0.813417372,2894,8688
ZCTA5 70815,10540,179,10361,30154,34.2,9730,2898,14807,0.491045964,408,29746
ZCTA5 70816,17452,1076,16376,43068,32.9,19716,1662,17647,0.409747376,2620,40448
ZCTA5 70817,13399,733,12666,35023,40.6,24057,1202,7014,0.200268395,1684,33339
ZCTA5 70818,3324,830,2494,10024,36.2,7662,130,1537,0.153332003,2077,7947
ZCTA5 70819,1335,122,1213,3911,38.8,1240,86,2168,0.55433393,264,3647
ZCTA5 70820,7816,97,7719,19957,23.6,11529,1222,5288,0.264969685,225,19732
ZCTA5 70825,0,289,-289,0,-,0,0,0,#DIV/0!,790,-790
ZCTA5 70836,241,1061,-820,403,34.9,168,0,202,0.501240695,2734,-2331
ZCTA5 71001,1756,13321,-11565,4155,44.8,1354,0,2680,0.645006017,35967,-31812
ZCTA5 71002,92,0,92,212,57.2,142,0,16,0.075471698,0,212
ZCTA5 71003,437,4430,-3993,1022,42.2,829,0,180,0.176125245,11772,-10750
ZCTA5 71004,202,143,59,539,42.1,322,0,168,0.311688312,261,278
ZCTA5 71006,5403,1001,4402,15467,40.7,12992,42,1323,0.08553695,2394,13073
ZCTA5 71007,527,180,347,1304,47.4,808,0,425,0.325920245,389,915
ZCTA5 71008,207,580,-373,524,42.4,344,1,121,0.230916031,1254,-730
ZCTA5 71009,44,4485,-4441,86,82,86,0,0,0,10710,-10624
ZCTA5 71016,626,15,611,1635,38.4,1454,1,153,0.093577982,55,1580
ZCTA5 71018,470,125,345,1283,32.9,757,0,513,0.399844115,297,986
ZCTA5 71019,2672,681,1991,7838,37.3,4563,0,3161,0.403291656,1954,5884
ZCTA5 71021,264,166,98,572,46.7,60,0,508,0.888111888,2135,-1563
ZCTA5 71023,1255,61,1194,3041,40.2,2622,0,197,0.064781322,113,2928
ZCTA5 71024,497,88,409,1332,36.2,968,2,322,0.241741742,231,1101
ZCTA5 71027,524,3486,-2962,1129,52.2,661,0,442,0.3914969,9564,-8435
ZCTA5 71028,555,116,439,1414,44.1,497,1,821,0.580622348,287,1127
ZCTA5 71029,63,2979,-2916,126,60.3,75,0,47,0.373015873,8734,-8608
ZCTA5 71030,394,136,258,1170,36.9,640,0,402,0.343589744,316,854
ZCTA5 71031,311,11,300,792,49.6,775,13,0,0,22,770
ZCTA5 71032,883,602,281,2592,41.3,2043,0,453,0.174768519,880,1712
ZCTA5 71033,1642,5431,-3789,3487,53.4,2274,11,1061,0.304273014,11005,-7518
ZCTA5 71034,105,12394,-12289,302,34.5,217,0,76,0.251655629,31309,-31007
ZCTA5 71037,7622,10017,-2395,21816,35.9,17711,172,3161,0.144893656,21503,313
ZCTA5 71038,1651,9687,-8036,4018,44.5,1718,0,2214,0.551020408,25203,-21185
ZCTA5 71039,593,4840,-4247,1789,37,1629,0,157,0.087758524,10640,-8851
ZCTA5 71040,2274,11844,-9570,7656,39.4,2923,27,4442,0.580198537,32605,-24949
ZCTA5 71043,184,6005,-5821,444,50.9,273,0,161,0.362612613,15020,-14576
ZCTA5 71044,307,9116,-8809,649,46.3,499,0,132,0.203389831,21748,-21099
ZCTA5 71045,240,5018,-4778,587,42,545,0,7,0.011925043,12691,-12104
ZCTA5 71046,372,7605,-7233,966,47.2,681,0,139,0.14389234,19033,-18067
ZCTA5 71047,3849,5384,-1535,11239,42.8,8559,33,2179,0.193878459,12283,-1044
ZCTA5 71048,84,9905,-9821,122,63.3,48,0,74,0.606557377,26006,-25884
ZCTA5 71049,1363,58,1305,3636,35.4,2618,0,844,0.232123212,180,3456
ZCTA5 71051,996,9321,-8325,2182,42.6,1736,40,321,0.147112741,24162,-21980
ZCTA5 71052,3603,63,3540,9011,40,2260,37,6488,0.720008878,1445,7566
ZCTA5 71055,7359,34,7325,18467,40,10083,66,7854,0.425299182,89,18378
ZCTA5 71060,1049,142,907,2546,44.6,2120,0,283,0.111154753,307,2239
ZCTA5 71061,716,893,-177,1673,37.1,1138,3,391,0.233711895,2203,-530
ZCTA5 71063,309,19,290,705,51.1,457,0,248,0.35177305,48,657
ZCTA5 71064,1249,792,457,3361,54.7,1564,7,1608,0.478429039,1785,1576
ZCTA5 71065,402,494,-92,927,52.6,617,0,208,0.22437972,1253,-326
ZCTA5 71066,13,8,5,46,28.4,2,0,44,0.956521739,15,31
ZCTA5 71067,1089,14,1075,3485,37.9,2272,0,1160,0.332855093,55,3430
ZCTA5 71068,1569,244,1325,3684,43.4,2111,0,1471,0.399294245,811,2873
ZCTA5 71069,235,1047,-812,513,42.5,326,0,167,0.325536062,3467,-2954
ZCTA5 71070,454,34,420,1173,52.4,707,4,428,0.364876385,109,1064
ZCTA5 71071,946,249,697,2255,47.5,2010,0,136,0.060310421,796,1459
ZCTA5 71072,605,5860,-5255,1480,46.1,1432,0,33,0.022297297,19693,-18213
ZCTA5 71073,906,31,875,2390,38.4,1215,14,1109,0.464016736,62,2328
ZCTA5 71075,2330,60,2270,5884,44.9,3736,0,2019,0.343133923,150,5734
ZCTA5 71078,2621,37,2584,7295,35.9,6763,5,340,0.046607265,68,7227
ZCTA5 71079,35,131,-96,35,64.8,29,0,6,0.171428571,399,-364
ZCTA5 71082,1922,1892,30,3941,39.9,2708,5,1112,0.282161888,5363,-1422
ZCTA5 71101,3338,282,3056,6920,51.3,1894,28,4716,0.68150289,738,6182
ZCTA5 71103,2225,334,1891,6093,52.1,823,7,5144,0.844247497,762,5331
ZCTA5 71104,5768,1159,4609,13239,33.8,7649,199,3850,0.290807463,3156,10083
ZCTA5 71105,9643,449,9194,20701,36.6,15514,872,3159,0.152601324,1304,19397
ZCTA5 71106,12373,261,12112,33849,40,17823,472,13860,0.409465568,685,33164
ZCTA5 71107,12007,74,11933,34777,36.1,14641,74,18727,0.538488081,253,34524
ZCTA5 71108,7093,905,6188,19944,30.5,1999,109,16902,0.847472924,2300,17644
ZCTA5 71109,7149,1128,6021,18530,35.2,1324,0,17003,0.917593092,2679,15851
ZCTA5 71110,1042,495,547,3719,23.3,2532,223,590,0.158644797,1581,2138
ZCTA5 71111,16339,261,16078,42217,34.9,25382,1115,13305,0.315157401,652,41565
ZCTA5 71112,12362,2272,10090,33240,35.8,22758,565,7748,0.233092659,6258,26982
ZCTA5 71115,6568,5554,1014,14066,38,9588,666,3272,0.23261766,15747,-1681
ZCTA5 71118,8920,1234,7686,23876,36.3,9879,480,12138,0.508376612,3183,20693
ZCTA5 71119,4500,1133,3367,10679,44,4262,225,5953,0.557449199,2570,8109
ZCTA5 71129,5654,53,5601,13419,38.3,4502,142,7664,0.571130487,119,13300
ZCTA5 71201,8900,554,8346,21490,38.9,13282,340,6907,0.321405305,1314,20176
ZCTA5 71202,8838,2998,5840,27503,33.9,3715,88,23017,0.836890521,8569,18934
ZCTA5 71203,14326,805,13521,39830,33.2,18118,600,19793,0.496936982,2118,37712
ZCTA5 71209,0,609,-609,1294,20.3,836,10,385,0.297527048,1563,-269
ZCTA5 71212,0,383,-383,0,-,0,0,0,#DIV/0!,965,-965
ZCTA5 71218,0,640,-640,0,-,0,0,0,#DIV/0!,1764,-1764
ZCTA5 71219,388,24,364,998,50.8,957,0,28,0.028056112,67,931
ZCTA5 71220,7421,56,7365,21160,39.1,9681,121,10914,0.515784499,85,21075
ZCTA5 71222,1144,0,1144,2638,48.7,1578,0,928,0.351781653,0,2638
ZCTA5 71223,147,371,-224,420,44.2,189,0,222,0.528571429,1048,-628
ZCTA5 71225,2721,700,2021,6948,39.5,6487,18,348,0.050086356,1763,5185
ZCTA5 71226,721,110,611,1977,38.4,1355,0,523,0.264542236,249,1728
ZCTA5 71227,1553,3397,-1844,4237,39.7,3541,102,323,0.076233184,8731,-4494
ZCTA5 71229,540,174,366,1303,51,808,0,444,0.340752111,337,966
ZCTA5 71230,0,290,-290,0,-,0,0,0,#DIV/0!,677,-677
ZCTA5 71232,2166,337,1829,5706,43,3144,0,2380,0.417104802,922,4784
ZCTA5 71233,56,4925,-4869,197,22.1,176,0,5,0.025380711,13251,-13054
ZCTA5 71234,1310,21195,-19885,4674,31.1,4017,3,202,0.043217801,54654,-49980
ZCTA5 71235,1691,8648,-6957,3807,46.3,3042,7,599,0.157341739,22548,-18741
ZCTA5 71237,420,226,194,1271,40.1,844,0,270,0.212431157,581,690
ZCTA5 71238,929,887,42,2512,43.6,2411,0,39,0.015525478,2229,283
ZCTA5 71241,2998,264,2734,8751,46.8,6215,5,2067,0.236201577,700,8051
ZCTA5 71242,6,257,-251,35,7.9,35,0,0,0,622,-587
ZCTA5 71243,68,211,-143,201,45.5,196,0,5,0.024875622,474,-273
ZCTA5 71245,1644,429,1215,4520,22.7,219,10,4249,0.940044248,1220,3300
ZCTA5 71247,470,2344,-1874,1246,38,535,54,606,0.48635634,6239,-4993
ZCTA5 71250,22,1476,-1454,43,59.6,43,0,0,0,3897,-3854
ZCTA5 71251,2634,718,1916,7909,39.6,4766,36,2621,0.331394614,1631,6278
ZCTA5 71253,198,149,49,358,67,292,0,30,0.083798883,326,32
ZCTA5 71254,2040,2251,-211,7113,33.8,1767,0,5029,0.707015324,5214,1899
ZCTA5 71256,275,40,235,1024,27.9,261,0,752,0.734375,75,949
ZCTA5 71259,769,173,596,1898,48.6,1577,0,228,0.120126449,484,1414
ZCTA5 71260,1144,96,1048,2802,41.9,2128,0,616,0.219842969,206,2596
ZCTA5 71261,636,81,555,1397,58.4,826,1,522,0.373657838,191,1206
ZCTA5 71263,2521,30,2491,6702,41.5,5416,0,1114,0.166219039,74,6628
ZCTA5 71264,456,165,291,1300,37.3,767,10,516,0.396923077,428,872
ZCTA5 71266,600,150,450,1686,30.9,1417,0,214,0.126927639,383,1303
ZCTA5 71268,1070,176,894,2682,47.8,2264,4,243,0.090604027,462,2220
ZCTA5 71269,4261,2326,1935,12724,36.4,7601,59,4802,0.377397045,6333,6391
ZCTA5 71270,11984,1146,10838,32707,27.8,18106,562,11977,0.366190724,2899,29808
ZCTA5 71272,0,830,-830,1521,19.5,883,69,407,0.267587114,1972,-451
ZCTA5 71275,1252,244,1008,2841,43.3,1626,0,1147,0.403731081,557,2284
ZCTA5 71276,26,313,-287,69,45.1,60,0,0,0,792,-723
ZCTA5 71277,665,1199,-534,1836,31.8,662,0,686,0.373638344,2863,-1027
ZCTA5 71279,56,908,-852,56,-,56,0,0,0,2560,-2504
ZCTA5 71280,1704,82,1622,5053,32.5,4009,25,933,0.184642786,211,4842
ZCTA5 71282,2826,37,2789,9728,36.1,3027,0,6461,0.664165296,83,9645
ZCTA5 71286,131,1845,-1714,297,50.7,297,0,0,0,4931,-4634
ZCTA5 71291,13793,1210,12583,35592,38.9,29587,492,4632,0.130141605,3139,32453
ZCTA5 71292,7899,690,7209,21157,42.2,15911,174,4285,0.20253344,1642,19515
ZCTA5 71295,5062,38,5024,14354,36.6,8588,33,5538,0.3858158,92,14262
ZCTA5 71301,7572,735,6837,20226,37.9,7468,522,11417,0.564471472,1940,18286
ZCTA5 71302,5171,124,5047,13726,36,2265,42,10812,0.787702171,283,13443
ZCTA5 71303,8709,14192,-5483,22581,38.4,14065,423,7135,0.315973606,36186,-13605
ZCTA5 71316,29,79,-50,74,61.2,74,0,0,0,141,-67
ZCTA5 71320,79,2202,-2123,99,62.3,99,0,0,0,5220,-5121
ZCTA5 71322,2209,5135,-2926,5140,50.1,2773,0,2208,0.429571984,12889,-7749
ZCTA5 71323,312,281,31,985,38.7,977,4,0,0,695,290
ZCTA5 71325,655,87,568,1883,36.2,1020,0,643,0.341476367,164,1719
ZCTA5 71326,305,297,8,732,48.8,336,0,392,0.535519126,682,50
ZCTA5 71327,1344,552,792,6100,34.1,2822,4,2926,0.479672131,1346,4754
ZCTA5 71328,2886,275,2611,7244,41.2,7010,0,0,0,581,6663
ZCTA5 71330,29,1448,-1419,39,80,39,0,0,0,3424,-3385
ZCTA5 71331,395,181,214,1016,41.9,882,0,14,0.013779528,416,600
ZCTA5 71333,239,30,209,753,35.7,484,0,253,0.335989376,52,701
ZCTA5 71334,3032,565,2467,10223,35.8,4484,60,5294,0.517851903,1699,8524
ZCTA5 71336,653,0,653,1395,46.3,1289,0,95,0.068100358,569,826
ZCTA5 71339,7,445,-438,14,-,14,0,0,0,1197,-1183
ZCTA5 71340,391,71,320,2208,36.1,1297,0,860,0.389492754,142,2066
ZCTA5 71341,1077,463,614,3446,35,2955,2,417,0.121009867,1079,2367
ZCTA5 71342,2467,3607,-1140,7018,39.8,5616,203,998,0.142205757,9536,-2518
ZCTA5 71343,2391,1072,1319,6321,38.8,4705,6,1574,0.249011232,2538,3783
ZCTA5 71345,55,2647,-2592,223,14.5,0,0,223,1,7220,-6997
ZCTA5 71346,878,111,767,1980,47.1,1323,0,545,0.275252525,322,1658
ZCTA5 71350,1565,684,881,3896,42.3,2524,147,1101,0.282597536,1739,2157
ZCTA5 71351,4578,512,4066,11739,37.5,7185,67,2884,0.245676804,1068,10671
ZCTA5 71353,597,9944,-9347,1490,38.3,1099,0,318,0.213422819,24666,-23176
ZCTA5 71354,469,1239,-770,1535,38.3,1428,0,6,0.003908795,2224,-689
ZCTA5 71355,987,911,76,2437,42.4,1835,3,467,0.191629052,2816,-379
ZCTA5 71356,236,18,218,656,34.1,276,0,211,0.321646341,27,629
ZCTA5 71357,596,216,380,1735,43.2,671,0,967,0.557348703,623,1112
ZCTA5 71358,449,1022,-573,1075,51.5,266,0,781,0.726511628,2747,-1672
ZCTA5 71359,0,147,-147,356,20.1,288,0,65,0.18258427,560,-204
ZCTA5 71360,13519,1885,11634,36582,37.5,26749,352,7185,0.19640807,4827,31755
ZCTA5 71362,774,171,603,1996,47.6,1874,0,54,0.027054108,467,1529
ZCTA5 71366,640,420,220,1429,57.8,829,0,594,0.415675297,1166,263
ZCTA5 71367,647,172,475,1523,36.6,1308,26,132,0.086671044,325,1198
ZCTA5 71368,426,51,375,1251,37.2,495,0,730,0.583533173,140,1111
ZCTA5 71369,935,205,730,2127,39.3,1432,0,655,0.307945463,487,1640
ZCTA5 71371,682,16,666,2527,38.8,2427,0,0,0,52,2475
ZCTA5 71373,2217,2191,26,5702,40.6,3960,2,1719,0.301473167,4771,931
ZCTA5 71375,266,712,-446,1105,36.5,305,6,706,0.638914027,1726,-621
ZCTA5 71378,866,187,679,2254,46,1418,0,801,0.355368234,383,1871
ZCTA5 71401,17,818,-801,27,58.4,27,0,0,0,2156,-2129
ZCTA5 71403,1494,167,1327,4052,40.8,3639,37,77,0.019002962,499,3553
ZCTA5 71404,223,680,-457,579,42.8,435,0,126,0.21761658,1473,-894
ZCTA5 71405,2067,125,1942,5954,31.8,5543,26,250,0.041988579,314,5640
ZCTA5 71406,29,242,-213,156,46.2,156,0,0,0,474,-318
ZCTA5 71407,375,168,207,1003,62.1,994,0,9,0.008973081,550,453
ZCTA5 71409,1986,62,1924,5222,47.5,3693,0,1422,0.27230946,115,5107
ZCTA5 71410,25,60,-35,100,21.9,100,0,0,0,172,-72
ZCTA5 71411,1312,1437,-125,3166,40,1922,0,957,0.302274163,3517,-351
ZCTA5 71414,98,4987,-4889,231,45.6,8,0,223,0.965367965,12599,-12368
ZCTA5 71415,122,276,-154,313,51.2,199,0,107,0.341853035,643,-330
ZCTA5 71416,313,143,170,853,46.4,551,0,223,0.261430246,273,580
ZCTA5 71417,1790,381,1409,5283,40,3371,81,1747,0.330683324,901,4382
ZCTA5 71418,1911,23,1888,5300,37.5,3873,10,1350,0.254716981,67,5233
ZCTA5 71419,629,1341,-712,1863,40.3,1582,21,6,0.003220612,3230,-1367
ZCTA5 71422,598,71,527,1675,37.9,1554,0,102,0.060895522,150,1525
ZCTA5 71423,1413,1444,-31,4250,36.9,3909,0,45,0.010588235,3154,1096
ZCTA5 71424,468,3752,-3284,1354,30.1,1354,0,0,0,8872,-7518
ZCTA5 71425,10,449,-439,20,-,20,0,0,0,995,-975
ZCTA5 71426,42,979,-937,164,51.7,72,0,77,0.469512195,2463,-2299
ZCTA5 71427,93,248,-155,256,53.2,256,0,0,0,563,-307
ZCTA5 71428,0,366,-366,0,-,0,0,0,#DIV/0!,883,-883
ZCTA5 71429,1262,241,1021,3042,41.6,2415,1,389,0.127876397,970,2072
ZCTA5 71430,1066,163,903,3121,34.9,2119,1,184,0.058955463,298,2823
ZCTA5 71432,404,745,-341,1039,48.9,999,4,0,0,1753,-714
ZCTA5 71433,1371,186,1185,3585,40.4,2591,165,537,0.149790795,394,3191
ZCTA5 71434,8,127,-119,37,51.1,35,0,0,0,282,-245
ZCTA5 71435,1312,131,1181,3776,41.1,3286,0,448,0.118644068,396,3380
ZCTA5 71438,519,67,452,1225,47.7,1225,0,0,0,228,997
ZCTA5 71439,667,1694,-1027,2110,36.2,2052,0,0,0,4294,-2184
ZCTA5 71441,341,285,56,795,43.4,795,0,0,0,716,79
ZCTA5 71446,8259,184,8075,21469,37.2,16295,448,3236,0.150728958,375,21094
ZCTA5 71447,493,458,35,1293,51.3,918,0,121,0.09358082,1121,172
ZCTA5 71449,3199,408,2791,8444,44.8,6022,35,1618,0.191615348,990,7454
ZCTA5 71450,420,596,-176,849,52.9,781,0,31,0.036513545,1394,-545
ZCTA5 71452,93,233,-140,169,28.5,58,0,110,0.650887574,559,-390
ZCTA5 71454,839,94,745,2200,45.4,1737,0,298,0.135454545,209,1991
ZCTA5 71455,82,101,-19,319,12.9,319,0,0,0,180,139
ZCTA5 71456,464,12149,-11685,878,54.4,304,0,386,0.439635535,30823,-29945
ZCTA5 71457,9119,684,8435,26128,31.7,11605,45,13316,0.509644825,1849,24279
ZCTA5 71459,3189,4102,-913,11363,22.3,7158,376,2267,0.199507172,10187,1176
ZCTA5 71461,995,83,912,2377,33.9,926,59,955,0.401766933,171,2206
ZCTA5 71462,674,961,-287,1848,38.5,949,12,48,0.025974026,1859,-11
ZCTA5 71463,2862,264,2598,9285,42.8,6623,120,2007,0.216155089,588,8697
ZCTA5 71465,1050,251,799,3483,36.9,3169,0,263,0.075509618,541,2942
ZCTA5 71466,244,688,-444,703,22.6,702,0,0,0,1489,-786
ZCTA5 71467,1840,369,1471,8581,36.5,6715,57,1487,0.173289826,847,7734
ZCTA5 71468,306,214,92,613,49.1,608,0,5,0.008156607,405,208
ZCTA5 71469,836,106,730,2346,39.8,2146,1,120,0.051150895,223,2123
ZCTA5 71472,82,1985,-1903,352,25.5,288,52,0,0,4314,-3962
ZCTA5 71473,158,2006,-1848,407,46.4,387,0,0,0,4060,-3653
ZCTA5 71474,147,647,-500,431,38.4,403,4,0,0,1672,-1241
ZCTA5 71475,2,2012,-2010,9,17.8,9,0,0,0,4969,-4960
ZCTA5 71479,243,1375,-1132,727,26.9,690,4,18,0.024759285,3516,-2789
ZCTA5 71480,224,38,186,1338,40,775,0,500,0.373692078,46,1292
ZCTA5 71483,3235,2537,698,9860,40.3,5679,1,3878,0.393306288,6862,2998
ZCTA5 71485,1000,264,736,2958,34.6,2415,0,493,0.166666667,834,2124
ZCTA5 71486,1907,190,1717,5352,35.1,2702,6,899,0.167974589,512,4840
ZCTA5 71497,230,1123,-893,1213,19.7,527,0,588,0.484748557,2623,-1410
ZCTA5 71601,4859,887,3972,14037,31.3,1615,83,11622,0.827954691,1745,12292
ZCTA5 71602,5711,1017,4694,16094,37.8,9594,264,5323,0.330744377,2412,13682
ZCTA5 71603,11659,660,10999,30376,41.3,10763,144,18521,0.609724783,1334,29042
ZCTA5 71630,189,250,-61,451,52.2,253,0,198,0.43902439,592,-141
ZCTA5 71631,238,1827,-1589,628,43.2,540,0,71,0.113057325,4354,-3726
ZCTA5 71635,4184,566,3618,10879,44,7568,24,3029,0.278426326,1165,9714
ZCTA5 71638,1143,12780,-11637,3251,46.3,1371,0,1813,0.557674562,29003,-25752
ZCTA5 71639,2318,214,2104,5640,37.9,2517,27,3061,0.542730496,398,5242
ZCTA5 71640,1175,736,439,2800,42,634,0,2111,0.753928571,1925,875
ZCTA5 71642,271,231,40,787,32.9,593,6,182,0.231257942,577,210
ZCTA5 71643,478,166,312,5654,38.9,2322,0,3094,0.547223205,398,5256
ZCTA5 71644,223,1097,-874,387,61.4,140,0,223,0.57622739,2862,-2475
ZCTA5 71646,2319,146,2173,6575,39,5471,0,819,0.124562738,358,6217
ZCTA5 71647,647,110,537,1817,33.3,1441,0,360,0.198128784,193,1624
ZCTA5 71651,28,259,-231,35,60.9,34,0,1,0.028571429,479,-444
ZCTA5 71652,356,57,299,1104,35.7,747,0,351,0.317934783,170,934
ZCTA5 71653,1745,34,1711,4489,43.1,2579,36,1676,0.373357095,117,4372
ZCTA5 71654,1813,139,1674,4647,37.6,2409,0,1968,0.423499032,321,4326
ZCTA5 71655,5716,523,5193,14286,35.9,9706,6,4206,0.294414112,1313,12973
ZCTA5 71658,208,201,7,561,34.9,312,0,240,0.427807487,484,77
ZCTA5 71659,11,32,-21,11,-,0,0,11,1,47,-36
ZCTA5 71660,343,391,-48,869,42.4,699,0,170,0.195627158,737,132
ZCTA5 71661,98,75,23,287,41.9,140,0,147,0.512195122,150,137
ZCTA5 71662,24,67,-43,87,21.3,59,0,0,0,121,-34
ZCTA5 71663,231,519,-288,607,42.4,340,0,179,0.294892916,1374,-767
ZCTA5 71665,1871,96,1775,5186,47.1,4505,0,589,0.11357501,270,4916
ZCTA5 71666,8,2704,-2696,8,-,8,0,0,0,6531,-6523
ZCTA5 71667,2523,15642,-13119,6600,38.4,5548,0,688,0.104242424,40259,-33659
ZCTA5 71670,507,13270,-12763,987,50.2,636,0,349,0.353596758,29075,-28088
ZCTA5 71671,2912,8538,-5626,8552,41.3,5151,9,2360,0.27595884,21114,-12562
ZCTA5 71674,243,15153,-14910,564,56.8,515,0,49,0.086879433,41015,-40451
ZCTA5 71675,768,4570,-3802,1808,46.5,1141,0,583,0.322455752,11895,-10087
ZCTA5 71676,196,6694,-6498,527,57.6,181,0,346,0.65654649,14832,-14305
ZCTA5 71677,51,351,-300,100,56.5,17,0,78,0.78,732,-632
ZCTA5 71678,0,581,-581,0,-,0,0,0,#DIV/0!,1754,-1754
ZCTA5 71701,6560,3261,3299,17730,39.5,9875,0,7559,0.426339538,9295,8435
ZCTA5 71720,883,150,733,2011,49.9,1434,0,565,0.280954749,295,1716
ZCTA5 71721,0,982,-982,0,-,0,0,0,#DIV/0!,2866,-2866
ZCTA5 71722,25,2213,-2188,37,74.3,23,0,14,0.378378378,5958,-5921
ZCTA5 71724,137,56,81,363,34.9,234,0,129,0.355371901,91,272
ZCTA5 71725,140,2893,-2753,274,57.8,48,0,226,0.824817518,7717,-7443
ZCTA5 71726,500,1752,-1252,1029,56.8,432,7,578,0.561710398,4652,-3623
ZCTA5 71728,24,2451,-2427,59,-,35,0,0,0,7373,-7314
ZCTA5 71730,11034,2068,8966,29344,38.5,18747,236,9356,0.318838604,5773,23571
ZCTA5 71740,417,974,-557,1511,29.4,1114,4,369,0.244209133,2603,-1092
ZCTA5 71742,1501,189,1312,4780,37.8,2244,0,2366,0.494979079,599,4181
ZCTA5 71743,1284,3607,-2323,3351,37,2455,0,788,0.235153685,9475,-6124
ZCTA5 71744,1054,171,883,3049,46.2,2466,0,576,0.188914398,286,2763
ZCTA5 71745,47,1774,-1727,191,53.6,54,0,137,0.717277487,4403,-4212
ZCTA5 71747,365,4179,-3814,1206,48.2,448,0,757,0.627694859,10501,-9295
ZCTA5 71748,31,43,-12,75,38.6,75,0,0,0,159,-84
ZCTA5 71749,1312,20,1292,3366,44.8,2180,0,1125,0.334224599,69,3297
ZCTA5 71751,327,2106,-1779,897,51.8,612,0,285,0.317725753,6025,-5128
ZCTA5 71752,303,208,95,672,44.1,384,0,286,0.425595238,348,324
ZCTA5 71753,5540,2862,2678,16707,32.3,10078,133,6077,0.36373975,7581,9126
ZCTA5 71758,59,14596,-14537,183,39.6,183,0,0,0,37803,-37620
ZCTA5 71759,165,12021,-11856,415,53.5,379,0,22,0.053012048,35583,-35168
ZCTA5 71762,1112,108,1004,2881,45.2,2157,0,709,0.246095106,192,2689
ZCTA5 71763,577,7613,-7036,1704,53.5,1239,6,392,0.230046948,21688,-19984
ZCTA5 71764,520,12064,-11544,1663,46.6,924,0,713,0.428743235,34481,-32818
ZCTA5 71765,941,16987,-16046,2182,45.2,1110,75,982,0.45004583,51840,-49658
ZCTA5 71766,180,532,-352,624,53.8,438,0,161,0.258012821,1416,-792
ZCTA5 71770,1188,506,682,3053,49.5,1768,0,1282,0.419914838,1434,1619
ZCTA5 71772,7,394,-387,17,31.4,17,0,0,0,1120,-1103
ZCTA5 71801,5740,2387,3353,15972,39.3,8632,27,4919,0.307976459,6328,9644
ZCTA5 71820,38,220,-182,129,29.9,129,0,0,0,613,-484
ZCTA5 71822,3154,6385,-3231,7895,43.3,5958,40,1538,0.19480684,17903,-10008
ZCTA5 71823,18,8020,-8002,66,19,51,0,0,0,21886,-21820
ZCTA5 71825,125,636,-511,415,29.8,274,0,50,0.120481928,1774,-1359
ZCTA5 71826,395,2313,-1918,994,44.1,584,0,350,0.352112676,6365,-5371
ZCTA5 71827,350,645,-295,925,54.6,629,6,277,0.299459459,1902,-977
ZCTA5 71831,21,11,10,76,79.9,76,0,0,0,38,38
ZCTA5 71832,3521,48,3473,10617,35.3,5527,0,286,0.02693793,106,10511
ZCTA5 71833,806,61,745,1781,45.3,1706,0,10,0.005614823,138,1643
ZCTA5 71834,555,5761,-5206,1516,53.7,1215,35,247,0.16292876,15308,-13792
ZCTA5 71835,355,528,-173,1024,42.9,893,0,71,0.069335938,1163,-139
ZCTA5 71836,1071,1327,-256,2965,40.2,1882,0,826,0.278583474,4269,-1304
ZCTA5 71837,1541,4104,-2563,4752,35.7,4438,0,17,0.003577441,11025,-6273
ZCTA5 71838,446,390,56,1007,52.6,399,0,572,0.568023833,908,99
ZCTA5 71839,226,3061,-2835,443,51.5,234,0,209,0.471783296,8084,-7641
ZCTA5 71841,288,50,238,793,45.9,719,1,0,0,163,630
ZCTA5 71842,781,23,758,2106,38.6,1296,26,15,0.007122507,48,2058
ZCTA5 71845,697,811,-114,1945,44.1,1131,0,730,0.375321337,2146,-201
ZCTA5 71846,904,145,759,2552,30.3,2223,0,169,0.066222571,322,2230
ZCTA5 71847,165,463,-298,354,52.4,202,0,112,0.316384181,1360,-1006
ZCTA5 71851,843,891,-48,2044,41.8,1076,0,836,0.409001957,2384,-340
ZCTA5 71852,3935,432,3503,10137,38.4,6335,124,1974,0.194732169,1096,9041
ZCTA5 71853,144,1493,-1349,243,52.8,189,1,35,0.144032922,4213,-3970
ZCTA5 71854,13918,1047,12871,36164,40.3,23880,22,10453,0.289044354,2485,33679
ZCTA5 71855,138,204,-66,283,53.4,105,0,116,0.409893993,568,-285
ZCTA5 71857,1895,93,1802,5160,46,3099,0,1980,0.38372093,233,4927
ZCTA5 71858,699,787,-88,1854,44.3,1149,0,679,0.366235167,1944,-90
ZCTA5 71859,195,276,-81,346,63.5,307,0,32,0.092485549,628,-282
ZCTA5 71860,822,2258,-1436,2027,42.7,901,45,950,0.468672916,6091,-4064
ZCTA5 71861,717,232,485,1884,50.7,1603,0,267,0.141719745,490,1394
ZCTA5 71862,290,535,-245,631,39.5,425,0,196,0.310618067,1437,-806
ZCTA5 71864,23,1100,-1077,58,48,37,0,21,0.362068966,3078,-3020
ZCTA5 71865,114,118,-4,294,45.6,156,0,57,0.193877551,290,4
ZCTA5 71866,232,590,-358,578,36,550,0,0,0,1568,-990
ZCTA5 71901,11829,532,11297,29241,40.8,22921,291,4030,0.137820184,1562,27679
ZCTA5 71909,9027,8637,390,18141,68.5,17361,67,218,0.012016978,22591,-4450
ZCTA5 71913,19744,11272,8472,46803,42.3,39317,341,4000,0.085464607,25725,21078
ZCTA5 71921,1165,7250,-6085,3706,34.4,3335,0,29,0.007825148,21287,-17581
ZCTA5 71922,67,5754,-5687,184,24.8,140,0,32,0.173913043,13648,-13464
ZCTA5 71923,5887,2687,3200,14624,34,9995,106,3829,0.261829869,7022,7602
ZCTA5 71929,1715,4909,-3194,4394,46.4,4372,1,0,0,13828,-9434
ZCTA5 71933,507,1880,-1373,1128,42.4,1107,0,0,0,4787,-3659
ZCTA5 71935,279,213,66,567,53.8,551,0,7,0.012345679,464,103
ZCTA5 71937,862,3351,-2489,2274,45,2006,0,0,0,8937,-6663
ZCTA5 71940,639,303,336,1536,43.9,1334,3,38,0.024739583,827,709
ZCTA5 71941,808,126,682,2127,42.3,2012,1,5,0.002350729,267,1860
ZCTA5 71942,51,729,-678,151,34.5,151,0,0,0,2045,-1894
ZCTA5 71943,1625,1517,108,3891,45.2,3226,68,60,0.0154202,4486,-595
ZCTA5 71944,263,419,-156,803,32.9,681,0,0,0,1395,-592
ZCTA5 71945,621,213,408,1294,52.5,1200,0,8,0.00618238,477,817
ZCTA5 71949,477,5298,-4821,898,56.8,832,0,0,0,15064,-14166
ZCTA5 71950,249,1433,-1184,609,51.1,599,0,0,0,3568,-2959
ZCTA5 71952,17,582,-565,42,68.6,42,0,0,0,1649,-1607
ZCTA5 71953,5377,758,4619,13098,47,12104,56,65,0.00496259,1804,11294
ZCTA5 71956,632,2124,-1492,1415,39.5,1269,0,67,0.047349823,5940,-4525
ZCTA5 71957,1312,975,337,2979,55.2,2889,27,24,0.008056395,2392,587
ZCTA5 71958,991,1105,-114,2381,46,1985,5,268,0.112557749,2768,-387
ZCTA5 71959,203,151,52,689,32.2,689,0,0,0,391,298
ZCTA5 71960,539,1529,-990,1228,44.3,1129,0,0,0,3516,-2288
ZCTA5 71961,446,1772,-1326,1151,52.5,1123,4,0,0,4800,-3649
ZCTA5 71962,321,180,141,914,32.8,511,0,403,0.440919037,429,485
ZCTA5 71964,2002,3896,-1894,4817,46.6,4667,0,0,0,10331,-5514
ZCTA5 71965,116,203,-87,233,38.6,233,0,0,0,473,-240
ZCTA5 71968,1998,509,1489,5470,43.5,5177,0,32,0.005850091,1153,4317
ZCTA5 71969,147,966,-819,275,51.4,219,0,15,0.054545455,2785,-2510
ZCTA5 71970,244,109,135,593,47.2,545,0,0,0,196,397
ZCTA5 71971,221,12790,-12569,404,54.3,404,0,0,0,33058,-32654
ZCTA5 71972,122,2877,-2755,416,31.1,314,0,0,0,7909,-7493
ZCTA5 71973,570,1166,-596,1754,26.5,1349,0,6,0.003420753,3052,-1298
ZCTA5 71998,0,385,-385,545,20,363,15,121,0.222018349,994,-449
ZCTA5 71999,0,7968,-7968,537,19.7,375,0,127,0.236499069,20114,-19577
ZCTA5 72001,292,262,30,611,49.8,584,0,0,0,677,-66
ZCTA5 72002,7044,3112,3932,19474,34.9,14819,1,3433,0.17628633,9188,10286
ZCTA5 72003,286,1433,-1147,837,38.8,789,0,38,0.045400239,3775,-2938
ZCTA5 72004,297,685,-388,769,46.4,120,0,643,0.836150845,1709,-940
ZCTA5 72005,43,7493,-7450,103,27.6,56,0,0,0,19752,-19649
ZCTA5 72006,969,494,475,2236,48.5,1343,0,848,0.379248658,1348,888
ZCTA5 72007,3207,6057,-2850,8974,35,8440,159,210,0.023400936,17462,-8488
ZCTA5 72010,2222,190,2032,5638,41.2,5348,0,58,0.010287336,424,5214
ZCTA5 72011,1649,9052,-7403,4671,38.4,4488,0,15,0.003211304,26300,-21629
ZCTA5 72012,4800,16640,-11840,13130,36.9,12121,124,271,0.020639756,44714,-31584
ZCTA5 72013,860,527,333,1990,46.8,1811,0,8,0.004020101,1424,566
ZCTA5 72014,16,1154,-1138,45,51.3,41,0,0,0,2752,-2707
ZCTA5 72015,10815,604,10211,27575,36.7,23242,112,3006,0.109011786,1618,25957
ZCTA5 72016,979,637,342,2667,44,2482,6,11,0.004124484,1796,871
ZCTA5 72017,214,7999,-7785,426,52.7,311,0,114,0.267605634,20368,-19942
ZCTA5 72019,10743,0,10743,28491,38.7,25074,635,1309,0.045944333,80,28411
ZCTA5 72020,1252,7733,-6481,3511,44.3,3226,2,7,0.001993734,21085,-17574
ZCTA5 72021,1476,162,1314,3666,45,1843,8,1764,0.481178396,320,3346
ZCTA5 72022,7135,225,6910,17189,38.1,14415,248,1897,0.110361278,618,16571
ZCTA5 72023,13635,3712,9923,36333,36.5,32576,651,965,0.026559877,11334,24999
ZCTA5 72024,1567,4118,-2551,4188,41.3,3746,0,304,0.072588348,11341,-7153
ZCTA5 72025,310,573,-263,733,45.7,671,0,16,0.021828104,1612,-879
ZCTA5 72026,65,1271,-1206,228,27.3,77,0,148,0.649122807,3272,-3044
ZCTA5 72027,587,697,-110,1422,47.2,1377,0,29,0.020393812,1700,-278
ZCTA5 72028,0,1613,-1613,0,-,0,0,0,#DIV/0!,4306,-4306
ZCTA5 72029,639,115,524,1764,44.6,1173,12,504,0.285714286,314,1450
ZCTA5 72030,396,165,231,868,47.9,609,0,169,0.194700461,482,386
ZCTA5 72031,2662,14477,-11815,6526,46.5,6170,14,65,0.009960159,40829,-34303
ZCTA5 72032,12940,6597,6343,34137,33,26063,207,5348,0.156662858,18618,15519
ZCTA5 72034,19259,868,18391,47096,31.5,35067,1222,7967,0.16916511,2309,44787
ZCTA5 72035,0,780,-780,2107,19.2,1455,26,462,0.219269103,1895,212
ZCTA5 72036,269,180,89,595,51.2,141,0,423,0.71092437,373,222
ZCTA5 72038,53,408,-355,100,71.4,100,0,0,0,1012,-912
ZCTA5 72039,835,65,770,2454,39.8,2078,0,276,0.112469438,152,2302
ZCTA5 72040,993,7391,-6398,2253,50.7,1958,0,211,0.093652907,20126,-17873
ZCTA5 72041,525,3860,-3335,1235,51,1105,0,130,0.105263158,10286,-9051
ZCTA5 72042,2059,1186,873,5011,45.6,4188,0,634,0.126521652,4847,164
ZCTA5 72044,440,797,-357,1309,51.6,1237,0,0,0,1993,-684
ZCTA5 72045,509,2008,-1499,1193,50.9,1142,0,0,0,5682,-4489
ZCTA5 72046,1636,9,1627,4105,45.2,2638,15,1053,0.256516443,816,3289
ZCTA5 72047,323,2618,-2295,840,32.3,840,0,0,0,9987,-9147
ZCTA5 72048,18,2391,-2373,77,40.5,77,0,0,0,6310,-6233
ZCTA5 72051,151,274,-123,528,42.4,524,0,0,0,692,-164
ZCTA5 72052,38,1539,-1501,114,34.7,114,0,0,0,4073,-3959
ZCTA5 72053,62,3655,-3593,188,21.3,10,0,178,0.946808511,9749,-9561
ZCTA5 72055,261,235,26,652,48.6,609,0,32,0.049079755,590,62
ZCTA5 72057,479,901,-422,1315,38.8,1315,0,0,0,2338,-1023
ZCTA5 72058,6484,181,6303,18663,35.3,17466,66,101,0.005411777,450,18213
ZCTA5 72059,27,1011,-984,46,72.3,19,0,27,0.586956522,2535,-2489
ZCTA5 72060,257,703,-446,583,43.5,560,0,0,0,1695,-1112
ZCTA5 72061,37,611,-574,77,55,72,0,0,0,1435,-1358
ZCTA5 72063,714,257,457,1770,40.6,1606,0,0,0,654,1116
ZCTA5 72064,1018,7347,-6329,2793,41.8,2198,29,429,0.153598281,20869,-18076
ZCTA5 72065,1963,2333,-370,5552,38.4,4656,141,699,0.125900576,6619,-1067
ZCTA5 72066,52,129,-77,196,48.3,185,0,11,0.056122449,344,-148
ZCTA5 72067,1253,870,383,2540,56.4,2314,0,3,0.001181102,2068,472
ZCTA5 72068,307,3787,-3480,962,31.6,749,75,0,0,11061,-10099
ZCTA5 72069,484,9970,-9486,1015,46.1,349,0,646,0.636453202,24109,-23094
ZCTA5 72070,713,14926,-14213,1932,44.7,1721,0,192,0.099378882,36741,-34809
ZCTA5 72072,140,15556,-15416,320,48.4,312,0,8,0.025,43536,-43216
ZCTA5 72073,294,257,37,834,37.6,669,0,155,0.185851319,624,210
ZCTA5 72074,39,372,-333,123,39.9,116,0,0,0,1121,-998
ZCTA5 72075,1,3575,-3574,3,-,3,0,0,0,9628,-9625
ZCTA5 72076,15490,2939,12551,39117,36.1,21392,585,14242,0.364087226,7171,31946
ZCTA5 72079,165,2769,-2604,520,53.5,483,9,16,0.030769231,7917,-7397
ZCTA5 72080,199,226,-27,440,40.9,429,0,0,0,667,-227
ZCTA5 72081,2822,3473,-651,7643,41.7,7266,10,66,0.008635353,9522,-1879
ZCTA5 72082,821,1002,-181,2226,35.5,1605,0,458,0.205750225,2464,-238
ZCTA5 72083,87,2616,-2529,214,50.6,150,0,61,0.285046729,6726,-6512
ZCTA5 72084,373,3094,-2721,1267,29,1080,0,77,0.060773481,8227,-6960
ZCTA5 72085,113,4315,-4202,275,31.6,253,8,0,0,12281,-12006
ZCTA5 72086,4348,404,3944,11919,37.2,9784,7,1280,0.10739156,1663,10256
ZCTA5 72087,639,367,272,1624,42.3,1567,1,37,0.022783251,986,638
ZCTA5 72088,1383,1021,362,2235,68.1,2145,20,16,0.007158837,2804,-569
ZCTA5 72099,0,761,-761,674,22,438,38,130,0.192878338,1865,-1191
ZCTA5 72101,1249,5020,-3771,3160,43.1,2684,0,458,0.144936709,13100,-9940
ZCTA5 72102,1130,49,1081,2795,52.5,2622,3,30,0.010733453,221,2574
ZCTA5 72103,5248,1739,3509,14422,36.3,9623,244,2609,0.180904174,4725,9697
ZCTA5 72104,8223,21528,-13305,23606,40.2,18799,91,3586,0.151910531,58595,-34989
ZCTA5 72106,2120,960,1160,5946,42.2,5304,2,321,0.053985873,2666,3280
ZCTA5 72107,21,2487,-2466,46,56.5,3,0,43,0.934782609,4350,-4304
ZCTA5 72108,0,800,-800,0,-,0,0,0,#DIV/0!,1732,-1732
ZCTA5 72110,4684,2574,2110,11600,38.2,9730,0,1387,0.119568966,5708,5892
ZCTA5 72111,464,4352,-3888,1240,47.9,1228,0,8,0.006451613,12672,-11432
ZCTA5 72112,3771,10997,-7226,10851,39,7636,0,1779,0.163948023,26099,-15248
ZCTA5 72113,11348,4803,6545,27190,35.1,16880,784,7928,0.291577786,15465,11725
ZCTA5 72114,4849,7145,-2296,10550,35.8,2373,83,7552,0.715829384,20515,-9965
ZCTA5 72116,9388,14475,-5087,20651,42,16537,290,2532,0.122609075,32904,-12253
ZCTA5 72117,5465,4733,732,14495,36.8,4034,105,9356,0.645463953,11386,3109
ZCTA5 72118,8992,14857,-5865,21975,37,10972,17,8720,0.396814562,31396,-9421
ZCTA5 72119,0,6988,-6988,0,-,0,0,0,#DIV/0!,18482,-18482
ZCTA5 72120,13654,7914,5740,33397,42.3,23292,350,8019,0.240111387,20843,12554
ZCTA5 72121,1201,4536,-3335,3120,39.8,2934,1,0,0,9644,-6524
ZCTA5 72122,440,2332,-1892,1100,55.2,1100,0,0,0,5157,-4057
ZCTA5 72123,129,6343,-6214,312,42.3,224,0,62,0.198717949,13485,-13173
ZCTA5 72125,306,10194,-9888,795,43.9,701,0,2,0.002515723,29958,-29163
ZCTA5 72126,1330,17326,-15996,3821,41.4,3625,0,21,0.005495943,35981,-32160
ZCTA5 72127,950,1362,-412,2212,51.3,1517,125,417,0.188517179,3369,-1157
ZCTA5 72128,274,5412,-5138,764,43.5,715,0,6,0.007853403,14429,-13665
ZCTA5 72129,457,8870,-8413,1251,48.9,1098,0,148,0.118305356,24183,-22932
ZCTA5 72130,140,1325,-1185,414,24.1,414,0,0,0,3814,-3400
ZCTA5 72131,1831,6582,-4751,4296,53.5,4105,16,10,0.002327747,19820,-15524
ZCTA5 72132,1256,7630,-6374,3486,37.2,3133,77,171,0.049053356,19303,-15817
ZCTA5 72133,12,1178,-1166,12,-,12,0,0,0,3099,-3087
ZCTA5 72134,238,11074,-10836,513,50.7,409,0,65,0.126705653,26977,-26464
ZCTA5 72135,1376,2042,-666,3356,50.3,3043,19,164,0.0488677,4315,-959
ZCTA5 72136,769,7338,-6569,2370,34.9,2223,0,0,0,20187,-17817
ZCTA5 72137,799,7214,-6415,2243,39.9,2123,16,0,0,17543,-15300
ZCTA5 72139,118,1116,-998,288,33.2,284,0,1,0.003472222,2835,-2547
ZCTA5 72140,106,4414,-4308,326,33,315,0,3,0.009202454,10141,-9815
ZCTA5 72141,171,493,-322,515,35.7,515,0,0,0,2362,-1847
ZCTA5 72142,933,1809,-876,2326,52.8,1474,0,743,0.319432502,4797,-2471
ZCTA5 72143,12595,1675,10920,34033,34.4,29270,372,2553,0.075015426,4447,29586
ZCTA5 72150,4767,522,4245,12338,39.6,11512,47,200,0.016210083,1630,10708
ZCTA5 72152,264,11567,-11303,487,44.5,111,0,183,0.375770021,29988,-29501
ZCTA5 72153,1280,19734,-18454,3672,37.4,3524,12,24,0.006535948,53446,-49774
ZCTA5 72156,230,11677,-11447,524,56,512,0,0,0,29304,-28780
ZCTA5 72157,478,2192,-1714,1167,47.1,1054,0,77,0.065981148,6064,-4897
ZCTA5 72160,3546,677,2869,9433,38.3,5677,8,3442,0.364889219,1665,7768
ZCTA5 72165,28,12892,-12864,85,42.2,85,0,0,0,35244,-35159
ZCTA5 72166,73,426,-353,182,68.4,182,0,0,0,1360,-1178
ZCTA5 72167,566,1088,-522,1394,40.9,1364,0,0,0,3112,-1718
ZCTA5 72168,72,12816,-12744,1999,41.9,993,0,951,0.475737869,35020,-33021
ZCTA5 72169,34,41,-7,80,48,73,0,0,0,116,-36
ZCTA5 72170,135,521,-386,270,47.5,244,0,20,0.074074074,1278,-1008
ZCTA5 72173,3522,322,3200,9726,39.1,9489,9,48,0.004935225,915,8811
ZCTA5 72175,148,988,-840,436,43.2,70,0,366,0.839449541,2509,-2073
ZCTA5 72176,3183,205,2978,9352,31.7,8591,105,187,0.019995723,557,8795
ZCTA5 72178,17,20,-3,31,65.3,30,0,1,0.032258065,45,-14
ZCTA5 72179,140,1381,-1241,342,52.3,342,0,0,0,3883,-3541
ZCTA5 72180,20,2867,-2847,93,70.4,0,0,93,1,7393,-7300
ZCTA5 72181,6,125,-119,6,-,6,0,0,0,232,-226
ZCTA5 72182,81,109,-28,104,63.1,104,0,0,0,288,-184
ZCTA5 72183,0,266,-266,832,37,410,0,332,0.399038462,679,153
ZCTA5 72199,0,1168,-1168,0,-,0,0,0,#DIV/0!,3384,-3384
ZCTA5 72201,553,59,494,875,29.9,670,24,117,0.133714286,70,805
ZCTA5 72202,5219,2936,2283,9694,39.1,4888,185,4021,0.414792655,8149,1545
ZCTA5 72204,12219,495,11724,30628,37.3,6864,226,21325,0.696258326,1286,29342
ZCTA5 72205,10422,2065,8357,21654,39.4,13814,1109,5300,0.244758474,5910,15744
ZCTA5 72206,8300,1337,6963,22103,41,9896,111,10654,0.482016016,3251,18852
ZCTA5 72207,5329,485,4844,11408,41.1,9736,116,1200,0.105189341,1283,10125
ZCTA5 72209,11739,196,11543,33585,30.1,7817,108,21725,0.64686616,477,33108
ZCTA5 72210,6197,271,5926,14809,38.8,7595,211,6327,0.427240192,604,14205
ZCTA5 72211,10803,794,10009,23519,36.2,14522,1681,6375,0.271057443,2156,21363
ZCTA5 72212,5111,354,4757,12940,40.2,10367,640,1252,0.09675425,1001,11939
ZCTA5 72223,10790,429,10361,25765,42.6,17973,1977,4764,0.184901999,1059,24706
ZCTA5 72227,5032,1761,3271,11965,39.5,8584,74,2411,0.201504388,4568,7397
ZCTA5 72301,9796,375,9421,24722,33.2,8141,114,15499,0.626931478,1023,23699
ZCTA5 72311,36,1350,-1314,64,36.7,58,0,6,0.09375,3678,-3614
ZCTA5 72313,0,367,-367,0,-,0,0,0,#DIV/0!,910,-910
ZCTA5 72315,7927,73,7854,20478,37.3,10249,115,9241,0.451264772,148,20330
ZCTA5 72320,30,334,-304,1478,37.1,591,0,825,0.558186739,966,512
ZCTA5 72322,17,7168,-7151,46,66.3,28,0,18,0.391304348,19794,-19748
ZCTA5 72324,878,1392,-514,2190,45.2,1746,0,43,0.019634703,10468,-8278
ZCTA5 72325,3,19677,-19674,12,25.8,12,0,0,0,50015,-50003
ZCTA5 72326,946,9391,-8445,2202,51.3,1547,0,583,0.26475931,24220,-22018
ZCTA5 72327,561,51,510,1415,40,805,0,327,0.231095406,124,1291
ZCTA5 72328,16,8531,-8515,44,57.6,44,0,0,0,21834,-21790
ZCTA5 72329,0,845,-845,0,-,0,0,0,#DIV/0!,2016,-2016
ZCTA5 72330,172,1584,-1412,609,36.3,447,0,86,0.141215107,4638,-4029
ZCTA5 72331,929,221,708,2408,44.6,587,0,1502,0.623754153,558,1850
ZCTA5 72332,46,1995,-1949,142,15,7,0,120,0.845070423,4968,-4826
ZCTA5 72333,165,173,-8,341,52.2,132,0,188,0.551319648,489,-148
ZCTA5 72335,5424,139,5285,16977,36.9,5513,30,10460,0.616127702,392,16585
ZCTA5 72338,14,285,-271,14,-,14,0,0,0,575,-561
ZCTA5 72339,74,11366,-11292,157,39.8,13,0,123,0.78343949,28199,-28042
ZCTA5 72340,42,284,-242,90,68.3,14,0,76,0.844444444,571,-481
ZCTA5 72341,92,1781,-1689,202,57.2,94,0,108,0.534653465,4494,-4292
ZCTA5 72342,1626,98,1528,4024,42.5,1154,0,2782,0.691351889,178,3846
ZCTA5 72346,209,183,26,611,45.1,412,0,78,0.127659574,478,133
ZCTA5 72347,319,1087,-768,868,52.1,724,0,0,0,2937,-2069
ZCTA5 72348,1007,1646,-639,2201,49.9,1262,2,617,0.280327124,4485,-2284
ZCTA5 72350,405,664,-259,989,44.4,514,0,408,0.412537917,1865,-876
ZCTA5 72351,300,68,232,739,34.1,625,0,31,0.041948579,189,550
ZCTA5 72352,5,436,-431,6,64,2,0,4,0.666666667,1265,-1259
ZCTA5 72353,13,611,-598,19,-,19,0,0,0,2311,-2292
ZCTA5 72354,866,217,649,2351,44.3,1854,0,203,0.086346236,363,1988
ZCTA5 72355,816,174,642,1915,52.2,879,0,1014,0.529503916,426,1489
ZCTA5 72358,487,960,-473,1662,33.7,833,0,611,0.367629362,2541,-879
ZCTA5 72359,153,34,119,284,52.2,0,0,257,0.904929577,125,159
ZCTA5 72360,1975,464,1511,5351,41.8,1807,0,3410,0.637264063,1404,3947
ZCTA5 72364,5792,17,5775,16126,34.9,8662,215,5375,0.333312663,33,16093
ZCTA5 72365,996,1403,-407,2447,48.3,2008,2,221,0.090314671,3515,-1068
ZCTA5 72366,849,88,761,2240,45.6,1068,0,1161,0.518303571,300,1940
ZCTA5 72367,0,66,-66,0,-,0,0,0,#DIV/0!,149,-149
ZCTA5 72368,441,143,298,1238,47.4,1002,20,182,0.147011309,259,979
ZCTA5 72369,0,295,-295,0,-,0,0,0,#DIV/0!,631,-631
ZCTA5 72370,2829,234,2595,7544,33.8,3330,35,3592,0.476139979,605,6939
ZCTA5 72372,668,274,394,1722,41.1,1252,0,409,0.237514518,660,1062
ZCTA5 72373,368,230,138,913,43.1,365,0,377,0.412924425,509,404
ZCTA5 72374,260,393,-133,626,48.4,537,0,89,0.142172524,939,-313
ZCTA5 72376,584,683,-99,1454,53.9,923,27,460,0.316368638,1759,-305
ZCTA5 72377,23,279,-256,23,-,23,0,0,0,625,-602
ZCTA5 72379,6,469,-463,11,-,0,0,11,1,1286,-1275
ZCTA5 72383,44,243,-199,70,49.2,70,0,0,0,716,-646
ZCTA5 72384,277,421,-144,821,38.6,204,0,503,0.612667479,1083,-262
ZCTA5 72386,616,71,545,1595,38.1,1439,2,47,0.029467085,142,1453
ZCTA5 72387,0,1413,-1413,0,-,0,0,0,#DIV/0!,3698,-3698
ZCTA5 72389,190,965,-775,532,45.9,302,0,230,0.432330827,2457,-1925
ZCTA5 72390,2473,3581,-1108,7383,31.4,1822,0,5447,0.737775972,9810,-2427
ZCTA5 72391,18,472,-454,50,33.8,50,0,0,0,1206,-1156
ZCTA5 72392,171,102,69,576,39.5,311,0,216,0.375,234,342
ZCTA5 72394,104,778,-674,347,25.4,154,0,178,0.5129683,2472,-2125
ZCTA5 72395,515,264,251,1281,33.2,982,4,264,0.206088993,600,681
ZCTA5 72396,4748,400,4348,12687,40,9250,0,2217,0.174745803,825,11862
ZCTA5 72401,16785,193,16592,41354,34.7,27424,490,10254,0.247956667,533,40821
ZCTA5 72404,11396,661,10735,29973,36.9,23092,673,4672,0.15587362,1932,28041
ZCTA5 72405,5950,1382,4568,17022,32.4,13186,26,1796,0.105510516,3415,13607
ZCTA5 72410,135,63,72,330,40.8,309,0,0,0,133,197
ZCTA5 72411,1058,277,781,3021,31.7,2621,0,52,0.017212843,605,2416
ZCTA5 72412,204,341,-137,480,43.2,480,0,0,0,898,-418
ZCTA5 72413,245,67,178,535,56.9,448,0,3,0.005607477,157,378
ZCTA5 72414,142,5262,-5120,316,47,260,0,0,0,13995,-13679
ZCTA5 72415,398,529,-131,1280,36.4,1257,0,0,0,1414,-134
ZCTA5 72416,1973,114,1859,5089,35.1,4969,0,72,0.014148163,316,4773
ZCTA5 72417,2018,295,1723,5508,30.7,5451,0,0,0,731,4777
ZCTA5 72419,690,291,399,1774,41.3,1682,0,0,0,983,791
ZCTA5 72421,143,1619,-1476,498,31.5,430,3,3,0.006024096,4283,-3785
ZCTA5 72422,1799,364,1435,4463,39.1,4173,0,54,0.012099485,911,3552
ZCTA5 72424,34,360,-326,94,34.5,91,0,0,0,708,-614
ZCTA5 72425,132,110,22,346,51.1,345,0,0,0,340,6
ZCTA5 72426,68,81,-13,141,46.1,133,8,0,0,233,-92
ZCTA5 72427,22,150,-128,44,48,42,0,0,0,357,-313
ZCTA5 72428,53,178,-125,115,43.3,107,0,0,0,467,-352
ZCTA5 72429,122,2030,-1908,218,51.3,198,0,2,0.009174312,6790,-6572
ZCTA5 72430,182,457,-275,461,41.3,420,0,0,0,1215,-754
ZCTA5 72431,167,462,-295,416,57,374,0,0,0,1095,-679
ZCTA5 72432,2290,51,2239,6574,37.8,6005,0,73,0.01110435,132,6442
ZCTA5 72433,1053,240,813,2555,38,2447,0,59,0.023091977,562,1993
ZCTA5 72434,847,673,174,2137,38.2,1989,0,0,0,1825,312
ZCTA5 72435,161,136,25,268,49.3,256,0,0,0,330,-62
ZCTA5 72436,342,8943,-8601,1008,44.9,1004,0,0,0,25071,-24063
ZCTA5 72437,1313,11902,-10589,3178,40.4,3063,8,26,0.008181246,27282,-24104
ZCTA5 72438,930,0,930,2542,35.5,2245,0,14,0.005507474,267,2275
ZCTA5 72440,80,188,-108,164,51.4,157,0,0,0,411,-247
ZCTA5 72441,16,2676,-2660,20,70.3,20,0,0,0,6675,-6655
ZCTA5 72442,1702,275,1427,4522,42,4401,0,18,0.00398054,622,3900
ZCTA5 72443,1323,22,1301,3268,37.6,3147,0,0,0,30,3238
ZCTA5 72444,656,116,540,1592,50.3,1517,0,0,0,278,1314
ZCTA5 72445,17,191,-174,34,50,34,0,0,0,554,-520
ZCTA5 72447,737,461,276,1893,43.3,1795,0,11,0.005810882,1092,801
ZCTA5 72449,64,237,-173,154,61.4,154,0,0,0,527,-373
ZCTA5 72450,15127,61,15066,39323,37.3,36133,244,1110,0.028227755,120,39203
ZCTA5 72453,66,829,-763,116,61,109,7,0,0,1832,-1716
ZCTA5 72454,2039,240,1799,4684,44.3,4545,0,32,0.006831768,590,4094
ZCTA5 72455,5178,323,4855,13539,37.5,12288,50,135,0.009971194,773,12766
ZCTA5 72456,218,98,120,447,52.1,446,0,0,0,167,280
ZCTA5 72457,99,69,30,239,39.4,237,0,0,0,172,67
ZCTA5 72458,195,307,-112,578,32.7,559,0,0,0,912,-334
ZCTA5 72459,596,243,353,1295,54.1,1254,0,0,0,618,677
ZCTA5 72460,331,152,179,648,54.7,590,0,0,0,327,321
ZCTA5 72461,1508,1426,82,3736,43.4,3498,0,0,0,3258,478
ZCTA5 72462,163,453,-290,414,29.3,413,1,0,0,1202,-788
ZCTA5 72464,7,130,-123,16,25,16,0,0,0,276,-260
ZCTA5 72466,402,327,75,1238,32.5,1172,4,0,0,1759,-521
ZCTA5 72467,41,1594,-1553,1399,19.5,1151,21,154,0.110078628,4387,-2988
ZCTA5 72469,470,54,416,1183,40.7,1139,1,19,0.016060862,117,1066
ZCTA5 72470,102,89,13,230,50.9,230,0,0,0,247,-17
ZCTA5 72471,390,4,386,1284,27.6,1206,0,3,0.002336449,8,1276
ZCTA5 72472,3799,112,3687,9177,40,7831,0,451,0.049144601,291,8886
ZCTA5 72473,908,193,715,2264,44.6,1943,0,37,0.016342756,414,1850
ZCTA5 72476,2821,2616,205,7327,39.3,6692,1,139,0.018970929,6838,489
ZCTA5 72478,101,197,-96,259,62.2,221,0,38,0.146718147,552,-293
ZCTA5 72479,506,436,70,1300,39.8,1152,3,3,0.002307692,1184,116
ZCTA5 72482,511,354,157,1409,45.9,1348,0,0,0,741,668
ZCTA5 72501,9852,115,9737,26573,37.9,22178,282,693,0.026079103,238,26335
ZCTA5 72512,873,75,798,2432,48.3,2195,1,1,0.000411184,203,2229
ZCTA5 72513,1103,74,1029,2616,52.3,2523,0,14,0.005351682,199,2417
ZCTA5 72515,0,659,-659,0,-,0,0,0,#DIV/0!,1428,-1428
ZCTA5 72517,102,182,-80,261,52.4,200,0,0,0,534,-273
ZCTA5 72519,936,203,733,3188,40.5,2422,0,113,0.03544542,436,2752
ZCTA5 72520,263,854,-591,337,73.1,310,0,0,0,2096,-1759
ZCTA5 72521,1904,620,1284,5410,37.5,5174,0,148,0.027356747,1461,3949
ZCTA5 72522,194,62,132,444,47.6,412,0,0,0,166,278
ZCTA5 72523,426,485,-59,963,45.3,943,13,0,0,1228,-265
ZCTA5 72524,177,541,-364,393,47.6,344,0,0,0,1485,-1092
ZCTA5 72526,34,212,-178,59,60.3,55,4,0,0,483,-424
ZCTA5 72527,201,1746,-1545,543,56.4,543,0,0,0,5193,-4650
ZCTA5 72528,153,698,-545,258,56.1,256,0,0,0,1768,-1510
ZCTA5 72529,2002,5802,-3800,5001,53.3,4663,0,0,0,15362,-10361
ZCTA5 72530,622,434,188,1222,57.2,1060,3,0,0,963,259
ZCTA5 72531,271,745,-474,709,49.8,709,0,0,0,1808,-1099
ZCTA5 72532,426,125,301,1019,56,911,0,0,0,363,656
ZCTA5 72533,133,219,-86,269,68.3,261,0,0,0,537,-268
ZCTA5 72534,594,314,280,1470,45.7,1397,0,0,0,713,757
ZCTA5 72536,118,182,-64,333,36.8,299,0,0,0,1246,-913
ZCTA5 72537,355,177,178,747,61.6,671,0,0,0,443,304
ZCTA5 72538,327,410,-83,1008,51.1,1008,0,0,0,923,85
ZCTA5 72539,129,95,34,341,37.4,193,50,0,0,195,146
ZCTA5 72540,35,800,-765,106,44.5,106,0,0,0,1941,-1835
ZCTA5 72542,1558,17,1541,3632,50.9,3236,35,6,0.001651982,35,3597
ZCTA5 72543,5329,795,4534,12874,42.5,12481,32,53,0.004116825,2129,10745
ZCTA5 72544,384,153,231,661,66.7,630,0,0,0,342,319
ZCTA5 72546,32,50,-18,52,67.5,52,0,0,0,102,-50
ZCTA5 72550,296,235,61,675,54.4,675,0,0,0,573,102
ZCTA5 72553,76,665,-589,238,53.1,238,0,0,0,1590,-1352
ZCTA5 72554,1035,606,429,2979,41.2,2845,0,0,0,1590,1389
ZCTA5 72555,138,565,-427,237,60.8,237,0,0,0,1427,-1190
ZCTA5 72556,1296,41,1255,3760,47.2,3553,1,6,0.001595745,101,3659
ZCTA5 72560,3175,252,2923,7929,51.4,7256,50,15,0.00189179,698,7231
ZCTA5 72561,208,823,-615,682,47.4,681,0,0,0,1985,-1303
ZCTA5 72562,957,735,222,2325,40.2,2091,0,0,0,1650,675
ZCTA5 72564,139,69,70,399,38.7,375,0,7,0.01754386,154,245
ZCTA5 72565,306,238,68,932,47.6,909,0,0,0,808,124
ZCTA5 72566,199,522,-323,516,41.4,485,0,0,0,1578,-1062
ZCTA5 72567,88,4392,-4304,290,51,290,0,0,0,12582,-12292
ZCTA5 72568,432,163,269,1270,35.6,1173,2,0,0,490,780
ZCTA5 72569,210,1153,-943,594,44.2,565,0,0,0,3456,-2862
ZCTA5 72571,193,31,162,372,48.5,372,0,0,0,63,309
ZCTA5 72572,147,213,-66,347,28.9,347,0,0,0,521,-174
ZCTA5 72573,133,573,-440,453,55.3,453,0,0,0,1521,-1068
ZCTA5 72576,1333,583,750,3116,53.8,2960,3,10,0.003209243,1746,1370
ZCTA5 72577,339,373,-34,921,44.8,863,0,0,0,1034,-113
ZCTA5 72578,80,145,-65,162,57.7,162,0,0,0,347,-185
ZCTA5 72579,549,882,-333,1315,40.9,1206,7,25,0.019011407,2437,-1122
ZCTA5 72581,585,6046,-5461,1097,60.7,956,0,0,0,14677,-13580
ZCTA5 72583,595,10998,-10403,1944,32.4,1831,0,22,0.011316872,25577,-23633
ZCTA5 72584,92,8197,-8105,303,55.1,303,0,0,0,22875,-22572
ZCTA5 72585,100,4224,-4124,199,71.9,199,0,0,0,10870,-10671
ZCTA5 72587,6,9398,-9392,12,-,12,0,0,0,25233,-25221
ZCTA5 72601,12270,20566,-8296,29788,41.5,28457,246,48,0.001611387,56789,-27001
ZCTA5 72611,641,12448,-11807,1814,50.9,1628,0,6,0.003307607,35588,-33774
ZCTA5 72615,13,3492,-3479,44,26,44,0,0,0,8722,-8678
ZCTA5 72616,3831,2179,1652,10346,39.1,8183,170,131,0.012661898,5798,4548
ZCTA5 72617,80,10873,-10793,432,30.5,432,0,0,0,26960,-26528
ZCTA5 72619,766,6724,-5958,1700,60.7,1599,63,0,0,18715,-17015
ZCTA5 72623,295,2829,-2534,867,44.1,861,0,0,0,7313,-6446
ZCTA5 72624,123,6663,-6540,418,48.3,418,0,0,0,18108,-17690
ZCTA5 72626,749,783,-34,1549,59.9,1482,0,0,0,1920,-371
ZCTA5 72628,405,4405,-4000,946,56.1,899,0,0,0,11952,-11006
ZCTA5 72629,215,434,-219,436,52.1,436,0,0,0,1220,-784
ZCTA5 72630,55,346,-291,112,59.2,105,0,0,0,878,-766
ZCTA5 72631,2025,614,1411,4310,59.3,4136,0,0,0,1676,2634
ZCTA5 72632,2070,2119,-49,4537,53.4,4245,21,10,0.0022041,5173,-636
ZCTA5 72633,790,1287,-497,2073,42.9,2026,8,0,0,3705,-1632
ZCTA5 72634,1724,853,871,4169,52.5,3941,24,0,0,2135,2034
ZCTA5 72635,1415,3273,-1858,3607,36.3,3353,22,20,0.005544774,10052,-6445
ZCTA5 72636,5,63,-58,5,68.3,5,0,0,0,180,-175
ZCTA5 72638,2588,1291,1297,7258,40,5894,88,0,0,4320,2938
ZCTA5 72639,233,2317,-2084,738,45.8,628,0,28,0.037940379,5851,-5113
ZCTA5 72640,237,5336,-5099,699,34.8,569,0,0,0,15301,-14602
ZCTA5 72641,831,874,-43,2204,44.9,2073,0,4,0.001814882,2162,42
ZCTA5 72642,1011,1308,-297,1943,62.9,1706,38,0,0,3936,-1993
ZCTA5 72644,1028,745,283,2637,44.5,2433,6,38,0.014410315,2240,397
ZCTA5 72645,652,242,410,1624,49.4,1479,8,0,0,736,888
ZCTA5 72648,114,2721,-2607,424,43.5,330,0,0,0,7089,-6665
ZCTA5 72650,1683,196,1487,4274,51.7,3809,0,5,0.001169864,478,3796
ZCTA5 72651,571,64,507,1387,39.4,1361,0,0,0,145,1242
ZCTA5 72653,13065,2331,10734,28209,52.1,26649,62,92,0.00326137,6300,21909
ZCTA5 72655,191,2336,-2145,358,66.6,343,7,0,0,5846,-5488
ZCTA5 72658,575,126,449,1276,58.2,1170,4,1,0.000783699,346,930
ZCTA5 72660,273,866,-593,649,62.7,462,7,0,0,2252,-1603
ZCTA5 72661,377,440,-63,875,60.4,875,0,0,0,1294,-419
ZCTA5 72662,1042,1534,-492,2750,39.7,2695,0,0,0,4251,-1501
ZCTA5 72663,98,321,-223,244,50.7,244,0,0,0,813,-569
ZCTA5 72666,64,13632,-13568,117,66.5,117,0,0,0,38410,-38293
ZCTA5 72668,109,2346,-2237,278,52.4,278,0,0,0,5171,-4893
ZCTA5 72669,42,1660,-1618,121,39.5,121,0,0,0,4184,-4063
ZCTA5 72670,49,1928,-1879,183,38,129,0,0,0,5023,-4840
ZCTA5 72672,108,240,-132,283,32.3,283,0,0,0,690,-407
ZCTA5 72675,559,783,-224,1461,43.8,1393,0,0,0,1812,-351
ZCTA5 72677,254,386,-132,720,42.5,716,4,0,0,1023,-303
ZCTA5 72679,9,11653,-11644,9,-,9,0,0,0,30276,-30267
ZCTA5 72680,341,11692,-11351,909,56.3,670,0,0,0,30213,-29304
ZCTA5 72682,53,22,31,142,52.3,142,0,0,0,60,82
ZCTA5 72683,146,5310,-5164,405,61.1,405,0,0,0,13961,-13556
ZCTA5 72685,468,42,426,1269,59.3,1231,0,0,0,117,1152
ZCTA5 72686,73,687,-614,226,50.6,226,0,0,0,1824,-1598
ZCTA5 72687,2933,2030,903,7210,49.5,6788,8,127,0.017614424,5825,1385
ZCTA5 72701,17206,11442,5764,46959,24.6,37620,1096,2903,0.061819885,29187,17772
ZCTA5 72703,15642,10178,5464,34274,32.5,27643,1347,1688,0.04925016,23637,10637
ZCTA5 72704,11967,0,11967,27740,32,22895,371,1057,0.038103821,2427,25313
ZCTA5 72712,13964,1820,12144,37794,35.2,28712,2922,1180,0.031221887,4408,33386
ZCTA5 72713,8231,1056,7175,22269,30.4,14711,4353,594,0.026673852,2742,19527
ZCTA5 72714,5486,593,4893,14010,41.8,12457,162,31,0.002212705,1717,12293
ZCTA5 72715,7067,47,7020,16173,59.5,14652,102,113,0.006986954,113,16060
ZCTA5 72717,495,413,82,1236,44.4,748,0,0,0,1132,104
ZCTA5 72718,1601,247,1354,4750,34.3,4158,91,0,0,576,4174
ZCTA5 72719,5780,889,4891,16400,31.1,12954,357,770,0.04695122,2300,14100
ZCTA5 72721,236,84,152,550,59.4,530,0,0,0,1925,-1375
ZCTA5 72722,1034,5451,-4417,2780,34.2,2027,179,80,0.028776978,12608,-9828
ZCTA5 72727,2541,12996,-10455,6575,40.5,5873,37,17,0.002585551,26844,-20269
ZCTA5 72729,98,6659,-6561,104,63.6,33,0,0,0,16698,-16594
ZCTA5 72730,3597,8113,-4516,10101,38.5,8677,176,65,0.006435006,19867,-9766
ZCTA5 72732,2043,2604,-561,5344,50.4,4306,17,32,0.005988024,6720,-1376
ZCTA5 72734,3398,5092,-1694,9386,37.3,7586,135,20,0.002130833,14111,-4725
ZCTA5 72736,2493,9225,-6732,7987,36.4,7012,0,124,0.015525228,20870,-12883
ZCTA5 72738,779,7193,-6414,2446,39.9,1875,81,0,0,15890,-13444
ZCTA5 72739,215,8240,-8025,507,36.8,433,9,0,0,23746,-23239
ZCTA5 72740,3257,1537,1720,9565,38.1,8268,26,14,0.00146367,4366,5199
ZCTA5 72742,265,79,186,443,59.6,443,0,0,0,180,263
ZCTA5 72744,1783,2538,-755,4701,40.1,4062,188,15,0.00319081,3688,1013
ZCTA5 72745,4640,2404,2236,13453,36.8,10036,299,69,0.005128968,5172,8281
ZCTA5 72747,46,3810,-3764,84,-,84,0,0,0,10332,-10248
ZCTA5 72749,65,7232,-7167,477,16.7,467,0,1,0.002096436,16837,-16360
ZCTA5 72751,3052,4613,-1561,8832,34.1,6747,76,314,0.035552536,12351,-3519
ZCTA5 72752,119,7234,-7115,151,66.8,139,0,0,0,18207,-18056
ZCTA5 72753,3640,782,2858,9797,37.1,8470,21,87,0.008880269,2124,7673
ZCTA5 72756,15360,1181,14179,40916,37.3,31046,732,336,0.008211946,3202,37714
ZCTA5 72758,15243,2902,12341,43705,33.2,33786,1263,826,0.018899439,7489,36216
ZCTA5 72760,108,19170,-19062,339,52.4,257,0,0,0,43765,-43426
ZCTA5 72761,7562,5696,1866,21263,32.9,15480,606,254,0.011945633,16237,5026
ZCTA5 72762,14821,9871,4950,44081,35.4,29532,1267,741,0.016809963,21332,22749
ZCTA5 72764,19337,13765,5572,58283,31,30105,1648,2051,0.035190364,30765,27518
ZCTA5 72768,450,10588,-10138,1253,41.3,1156,0,1,0.000798085,26494,-25241
ZCTA5 72769,440,7733,-7293,1355,38.8,815,414,0,0,18325,-16970
ZCTA5 72773,530,5522,-4992,1463,35,1367,0,0,0,13934,-12471
ZCTA5 72774,2584,4588,-2004,7161,40.8,6078,108,12,0.001675744,12121,-4960
ZCTA5 72776,322,1064,-742,750,48.5,724,0,0,0,2863,-2113
ZCTA5 72801,6222,3011,3211,18601,26,14897,663,781,0.04198699,6858,11743
ZCTA5 72802,8726,646,8080,23170,39.9,20355,41,636,0.027449288,1680,21490
ZCTA5 72821,675,439,236,1904,39.2,1735,0,0,0,1214,690
ZCTA5 72823,2299,1960,339,5887,42.4,5570,0,110,0.018685239,5133,754
ZCTA5 72824,676,1931,-1255,2084,35.3,1686,93,95,0.045585413,5345,-3261
ZCTA5 72826,1,922,-921,4,34.5,4,0,0,0,2608,-2604
ZCTA5 72827,75,101,-26,137,49.1,133,0,0,0,190,-53
ZCTA5 72828,65,1108,-1043,95,56.6,89,0,0,0,2532,-2437
ZCTA5 72829,0,1186,-1186,0,-,0,0,0,#DIV/0!,2921,-2921
ZCTA5 72830,6147,6128,19,16498,36.4,13865,554,378,0.022911868,14166,2332
ZCTA5 72832,325,3006,-2681,770,56.1,757,0,0,0,8381,-7611
ZCTA5 72833,1225,910,315,3760,33.7,2405,35,65,0.017287234,2855,905
ZCTA5 72834,3593,139,3454,9797,39.7,7391,116,171,0.017454323,314,9483
ZCTA5 72835,316,353,-37,808,46.5,717,0,0,0,807,1
ZCTA5 72837,3145,2684,461,7777,43.3,7207,3,47,0.006043461,7430,347
ZCTA5 72838,102,7007,-6905,235,56.2,235,0,0,0,18189,-17954
ZCTA5 72839,192,76,116,472,53.1,472,0,0,0,250,222
ZCTA5 72840,801,230,571,2080,38.8,1787,104,7,0.003365385,730,1350
ZCTA5 72841,93,50,43,260,60.4,260,0,0,0,158,102
ZCTA5 72842,411,6581,-6170,1133,47.9,813,5,38,0.033539276,16689,-15556
ZCTA5 72843,843,1045,-202,2270,45.3,2160,0,31,0.013656388,2862,-592
ZCTA5 72845,357,650,-293,767,49.9,756,2,0,0,1809,-1042
ZCTA5 72846,1422,1813,-391,3648,37.3,3376,23,24,0.006578947,4572,-924
ZCTA5 72847,1121,611,510,3150,39.7,3042,7,6,0.001904762,1567,1583
ZCTA5 72851,300,205,95,614,63.2,614,0,0,0,488,126
ZCTA5 72852,65,15,50,148,66.6,148,0,0,0,45,103
ZCTA5 72853,950,774,176,2401,47.9,2084,0,8,0.003331945,1820,581
ZCTA5 72854,238,1411,-1173,621,50.1,572,0,9,0.014492754,3923,-3302
ZCTA5 72855,2433,7045,-4612,6079,42.4,5173,213,87,0.014311564,17983,-11904
ZCTA5 72856,104,12362,-12258,320,47.8,304,0,0,0,30808,-30488
ZCTA5 72857,619,1878,-1259,1387,46.9,1342,0,25,0.018024513,4566,-3179
ZCTA5 72858,1188,293,895,3091,34.5,2851,50,0,0,612,2479
ZCTA5 72860,49,397,-348,72,64.5,72,0,0,0,961,-889
ZCTA5 72863,619,355,264,1691,46.1,1569,64,10,0.005913661,891,800
ZCTA5 72865,481,3783,-3302,1261,45.4,1178,15,13,0.010309278,9764,-8503
ZCTA5 72901,9046,442,8604,21183,37.4,13991,656,2125,0.100316291,1036,20147
ZCTA5 72903,11024,391,10633,25855,39,19581,1254,1737,0.067182363,1046,24809
ZCTA5 72904,7848,5072,2776,22592,32.6,8413,1723,2893,0.128054178,13857,8735
ZCTA5 72905,0,231,-231,0,-,0,0,0,#DIV/0!,595,-595
ZCTA5 72908,5875,353,5522,13445,41.6,10015,788,412,0.030643362,1010,12435
ZCTA5 72916,4292,4144,148,11203,39.8,8869,964,385,0.034365795,9920,1283
ZCTA5 72921,4586,3493,1093,12895,36.2,11568,1,223,0.017293525,9561,3334
ZCTA5 72923,2048,1149,899,4866,33.4,4618,144,17,0.003493629,2716,2150
ZCTA5 72926,260,1688,-1428,818,35.8,509,0,291,0.355745721,4390,-3572
ZCTA5 72927,3067,3808,-741,8390,39.8,7542,0,162,0.019308701,10321,-1931
ZCTA5 72928,340,85,255,739,43.3,557,94,16,0.02165088,290,449
ZCTA5 72930,112,1830,-1718,225,63.1,218,0,7,0.031111111,5435,-5210
ZCTA5 72932,647,438,209,1542,47.2,1389,13,0,0,1001,541
ZCTA5 72933,2029,1104,925,5133,43.1,4890,7,31,0.006039353,2862,2271
ZCTA5 72934,507,204,303,1165,62.2,1104,0,0,0,608,557
ZCTA5 72935,231,6821,-6590,527,48.9,428,0,32,0.060721063,17287,-16760
ZCTA5 72936,5547,675,4872,13801,38.3,12528,72,154,0.011158612,1823,11978
ZCTA5 72937,1405,1708,-303,3248,49.9,2945,19,0,0,4479,-1231
ZCTA5 72938,504,149,355,1272,40.8,1074,48,0,0,391,881
ZCTA5 72940,584,1043,-459,1567,45.5,1382,131,3,0.001914486,2826,-1259
ZCTA5 72941,1875,1105,770,5048,36.1,4693,2,41,0.008122029,2555,2493
ZCTA5 72943,992,82,910,2574,40.5,2404,48,34,0.013209013,217,2357
ZCTA5 72944,1072,222,850,2797,41,2496,17,54,0.0193064,575,2222
ZCTA5 72945,174,39,135,325,25.8,280,0,0,0,109,216
ZCTA5 72946,1249,38,1211,3255,41.5,3079,0,0,0,79,3176
ZCTA5 72947,1293,106,1187,3237,44.7,2966,17,22,0.006796416,286,2951
ZCTA5 72948,64,2896,-2832,151,70.4,151,0,0,0,7744,-7593
ZCTA5 72949,3953,104,3849,10057,41.3,9313,24,84,0.008352391,2135,7922
ZCTA5 72950,275,10722,-10447,578,42.1,533,36,0,0,29809,-29231
ZCTA5 72951,317,6105,-5788,715,49.6,672,25,0,0,15713,-14998
ZCTA5 72952,943,105,838,2082,47.5,1982,0,0,0,257,1825
ZCTA5 72955,132,798,-666,894,15.4,788,106,0,0,2321,-1427
ZCTA5 72956,13296,588,12708,35273,37.7,29983,662,662,0.018767896,1376,33897
ZCTA5 72958,2699,629,2070,6666,41.4,5699,40,0,0,1888,4778
ZCTA5 72959,1172,223,949,2929,41.5,2850,10,0,0,547,2382
ZCTA5 73001,20,0,20,50,32.6,47,0,0,0,0,50
ZCTA5 73002,381,11755,-11374,1118,42.6,925,0,8,0.007155635,29528,-28410
ZCTA5 73003,9176,100,9076,23120,37.2,17507,661,1922,0.083131488,221,22899
ZCTA5 73004,326,99,227,847,39.8,746,0,0,0,220,627
ZCTA5 73005,2958,2481,477,8765,36,3712,26,405,0.046206503,5818,2947
ZCTA5 73006,1068,3761,-2693,2737,43.8,1700,0,12,0.004384362,9678,-6941
ZCTA5 73007,1074,101,973,2531,50.2,2089,41,82,0.032398262,173,2358
ZCTA5 73008,8023,73,7950,21389,33,15028,159,1828,0.085464491,171,21218
ZCTA5 73009,380,362,18,907,51.8,646,2,24,0.02646086,867,40
ZCTA5 73010,6640,306,6334,19646,38,16662,11,185,0.009416675,814,18832
ZCTA5 73011,232,125,107,612,41.3,577,0,3,0.004901961,245,367
ZCTA5 73012,14450,85,14365,42003,35.5,29514,3092,3851,0.091683927,230,41773
ZCTA5 73013,20754,797,19957,56547,34.9,41465,3678,5660,0.100093727,1877,54670
ZCTA5 73014,434,1641,-1207,1329,33,1018,0,0,0,4036,-2707
ZCTA5 73015,937,86,851,2617,41.4,1564,0,37,0.014138326,165,2452
ZCTA5 73016,702,173,529,2312,35.1,1922,0,10,0.00432526,452,1860
ZCTA5 73017,498,333,165,1413,48.6,1070,0,23,0.016277424,725,688
ZCTA5 73018,7782,1284,6498,19734,39.5,15586,145,1086,0.055031925,3108,16626
ZCTA5 73019,0,48,-48,0,-,0,0,0,#DIV/0!,99,-99
ZCTA5 73020,8983,371,8612,25134,40.2,20411,409,1294,0.051484046,1001,24133
ZCTA5 73021,107,493,-386,229,62.4,174,0,24,0.104803493,1100,-871
ZCTA5 73022,0,889,-889,0,-,0,0,0,#DIV/0!,2198,-2198
ZCTA5 73024,220,280,-60,657,44.8,569,0,0,0,735,-78
ZCTA5 73025,5068,150,4918,15936,38.9,13897,211,410,0.025727912,461,15475
ZCTA5 73026,4165,190,3975,10984,46.1,9312,5,159,0.014475601,437,10547
ZCTA5 73027,560,202,358,1355,41.5,1088,0,44,0.032472325,517,838
ZCTA5 73028,1537,258,1279,3893,47.7,3438,0,33,0.008476753,647,3246
ZCTA5 73029,518,850,-332,1593,35.4,1196,0,0,0,2270,-677
ZCTA5 73030,1566,295,1271,4394,39.3,3404,34,67,0.015248066,727,3667
ZCTA5 73031,21,895,-874,26,56.9,20,0,0,0,2204,-2178
ZCTA5 73032,78,270,-192,200,43.1,123,0,15,0.075,619,-419
ZCTA5 73033,140,91,49,572,24.7,326,0,1,0.001748252,168,404
ZCTA5 73034,16712,254,16458,45632,35.9,36819,1367,1493,0.032718268,1035,44597
ZCTA5 73036,7107,437,6670,19888,36.7,13548,79,1154,0.05802494,1123,18765
ZCTA5 73038,642,1416,-774,1639,46.6,1149,0,35,0.021354484,3643,-2004
ZCTA5 73040,623,285,338,1260,44.5,960,0,25,0.01984127,669,591
ZCTA5 73041,135,560,-425,343,59.7,331,0,0,0,1180,-837
ZCTA5 73042,381,77,304,1030,42.3,728,0,1,0.000970874,153,877
ZCTA5 73043,72,116,-44,156,54.7,108,0,0,0,365,-209
ZCTA5 73044,8739,2397,6342,24013,40.5,19816,30,1890,0.078707367,6535,17478
ZCTA5 73045,3962,7773,-3811,10899,39.5,9125,211,53,0.004862831,20057,-9158
ZCTA5 73047,1292,5117,-3825,4816,37.5,3922,1,126,0.026162791,12217,-7401
ZCTA5 73048,961,264,697,2478,36.9,2075,0,52,0.020984665,684,1794
ZCTA5 73049,2256,3241,-985,6354,38.6,5058,0,341,0.053666981,7593,-1239
ZCTA5 73050,89,248,-159,1393,20.7,82,0,1267,0.909547739,517,876
ZCTA5 73051,2795,193,2602,9704,41.8,7267,27,635,0.065436933,582,9122
ZCTA5 73052,2378,102,2276,6286,38.2,5189,43,9,0.001431753,234,6052
ZCTA5 73053,237,907,-670,706,39.4,522,1,0,0,2323,-1617
ZCTA5 73054,1736,159,1577,4500,44.4,3678,4,92,0.020444444,373,4127
ZCTA5 73055,3760,270,3490,9877,42,8467,15,23,0.002328642,594,9283
ZCTA5 73056,210,200,10,521,47.2,469,0,0,0,535,-14
ZCTA5 73057,911,167,744,2262,43.2,1894,0,4,0.001768347,462,1800
ZCTA5 73058,60,149,-89,184,63.2,161,0,23,0.125,279,-95
ZCTA5 73059,1135,1428,-293,2856,41.3,2499,9,31,0.010854342,3768,-912
ZCTA5 73061,683,263,420,1732,35.7,1377,7,5,0.002886836,678,1054
ZCTA5 73062,533,264,269,1179,49.6,849,0,0,0,689,490
ZCTA5 73063,316,322,-6,682,50.3,602,0,0,0,738,-56
ZCTA5 73064,9504,1370,8134,25803,39.3,20807,552,704,0.027283649,3957,21846
ZCTA5 73065,3598,8336,-4738,9716,37.1,8224,0,65,0.006689996,22344,-12628
ZCTA5 73066,48,269,-221,173,37.1,68,0,0,0,699,-526
ZCTA5 73067,684,114,570,1903,40.5,1694,0,2,0.001050972,307,1596
ZCTA5 73068,4476,594,3882,12171,39.5,10351,0,1,8.22E-05,1554,10617
ZCTA5 73069,10946,153,10793,27314,32.1,19774,756,1115,0.040821557,456,26858
ZCTA5 73070,0,972,-972,124,59.8,119,0,1,0.008064516,2142,-2018
ZCTA5 73071,17735,808,16927,43589,28.8,31013,1894,3377,0.077473675,2067,41522
ZCTA5 73072,18817,4398,14419,47776,31.9,37010,2781,1559,0.032631447,11269,36507
ZCTA5 73073,316,1219,-903,544,63.1,505,0,0,0,3182,-2638
ZCTA5 73074,427,1666,-1239,1244,37.2,935,51,1,0.000803859,4269,-3025
ZCTA5 73075,3687,792,2895,9518,41,7590,27,329,0.034566085,2128,7390
ZCTA5 73077,2312,1020,1292,6337,41.5,5620,0,22,0.003471674,2537,3800
ZCTA5 73078,4184,467,3717,11649,35,9509,316,302,0.025924972,1103,10546
ZCTA5 73079,192,652,-460,497,49.4,453,0,0,0,1504,-1007
ZCTA5 73080,3676,412,3264,10060,39.6,8472,20,122,0.012127237,1103,8957
ZCTA5 73082,1141,270,871,2893,43.9,2525,0,4,0.001382648,645,2248
ZCTA5 73084,2741,905,1836,6336,44.5,1934,21,3635,0.573705808,2365,3971
ZCTA5 73086,2999,379,2620,8564,42.6,6135,75,48,0.005604858,911,7653
ZCTA5 73089,4727,3328,1399,13930,40.6,12074,76,21,0.001507538,8386,5544
ZCTA5 73090,223,3919,-3696,778,40.7,625,10,76,0.097686375,9558,-8780
ZCTA5 73092,304,73,231,818,36,626,3,19,0.023227384,129,689
ZCTA5 73093,1240,221,1019,3563,36.4,2802,15,4,0.001122649,549,3014
ZCTA5 73095,796,164,632,2088,39.6,1608,0,44,0.021072797,457,1631
ZCTA5 73096,5188,0,5188,14036,25.4,11152,231,258,0.018381305,0,14036
ZCTA5 73097,49,101,-52,103,56.6,102,0,0,0,162,-59
ZCTA5 73098,1340,34,1306,3605,43.6,2860,0,100,0.027739251,84,3521
ZCTA5 73099,29538,379,29159,80457,35.7,64778,2651,2443,0.030364045,987,79470
ZCTA5 73102,1103,561,542,3448,35.4,2089,134,661,0.191705336,1374,2074
ZCTA5 73103,3110,90,3020,5427,34.3,4476,118,363,0.066887783,243,5184
ZCTA5 73104,2018,46,1972,3389,29.1,1959,289,863,0.254647389,72,3317
ZCTA5 73105,2933,1500,1433,5822,30.6,1964,318,2863,0.491755411,4024,1798
ZCTA5 73106,4766,520,4246,12531,29,8303,673,825,0.065836725,1357,11174
ZCTA5 73107,11013,8354,2659,25144,35.5,18136,746,1312,0.052179446,21857,3287
ZCTA5 73108,5118,7321,-2203,14392,31.7,9039,69,1080,0.07504169,20069,-5677
ZCTA5 73109,7095,12350,-5255,20652,31.6,13168,285,1544,0.074762735,31144,-10492
ZCTA5 73110,14143,464,13679,33014,34.3,19113,286,8988,0.272248137,1449,31565
ZCTA5 73111,4693,743,3950,11497,40.5,1243,52,9380,0.815865008,2023,9474
ZCTA5 73112,15276,473,14803,32893,35.6,20814,1566,3800,0.1155261,1054,31839
ZCTA5 73114,8164,215,7949,18470,29.6,7117,214,8146,0.441039524,472,17998
ZCTA5 73115,8383,217,8166,20555,35.6,11910,297,4488,0.218341036,1427,19128
ZCTA5 73116,4411,73,4338,9745,39.8,7712,367,443,0.04545921,236,9509
ZCTA5 73117,2801,350,2451,6233,35,1214,80,4543,0.728862506,856,5377
ZCTA5 73118,7079,368,6711,14599,36.1,10497,604,1330,0.09110213,1084,13515
ZCTA5 73119,10254,234,10020,30420,29.9,18532,132,1633,0.053681788,615,29805
ZCTA5 73120,17948,2799,15149,35083,36.7,21986,865,7321,0.208676567,6839,28244
ZCTA5 73121,1237,28,1209,3125,49.3,1224,56,1787,0.57184,36,3089
ZCTA5 73122,5435,129,5306,12619,34.1,8051,388,1768,0.140106189,510,12109
ZCTA5 73127,8928,317,8611,25616,31.2,15637,710,3460,0.13507183,708,24908
ZCTA5 73128,2713,626,2087,6683,31.9,4167,948,473,0.070776597,1622,5061
ZCTA5 73129,6646,45,6601,20930,31,12226,185,2025,0.096751075,94,20836
ZCTA5 73130,8238,128,8110,20876,40.6,13741,283,3666,0.175608354,335,20541
ZCTA5 73131,1337,87,1250,3282,50.5,2748,23,181,0.055149299,261,3021
ZCTA5 73132,11070,238,10832,28062,34.6,16839,1628,5363,0.191112537,670,27392
ZCTA5 73134,3610,2709,901,6756,29.6,3987,524,1375,0.203522795,8321,-1565
ZCTA5 73135,8210,1136,7074,21532,32.3,9771,1153,6984,0.324354449,3158,18374
ZCTA5 73139,7898,187,7711,18408,35.2,11564,371,1726,0.093763581,436,17972
ZCTA5 73141,909,3166,-2257,2340,40.7,1274,4,676,0.288888889,9785,-7445
ZCTA5 73142,6799,607,6192,14822,36.4,10186,922,1359,0.091688031,1479,13343
ZCTA5 73145,607,640,-33,3602,21.5,2656,112,361,0.100222099,1724,1878
ZCTA5 73149,1818,1897,-79,5655,31,3661,255,340,0.060123784,5354,301
ZCTA5 73150,1937,306,1631,5304,49.1,4171,71,249,0.046945701,890,4414
ZCTA5 73151,669,3073,-2404,2293,40.6,1918,95,107,0.046663759,8076,-5783
ZCTA5 73159,12553,2329,10224,32300,35.4,21126,1797,2490,0.077089783,6269,26031
ZCTA5 73160,23146,746,22400,61470,33.6,45789,1462,3599,0.058548886,2192,59278
ZCTA5 73162,11754,1911,9843,28727,42.4,19851,1663,4208,0.146482403,5248,23479
ZCTA5 73165,2620,669,1951,8281,40.2,5902,295,669,0.080787345,1981,6300
ZCTA5 73169,996,393,603,3574,26.2,2771,0,115,0.032176833,1150,2424
ZCTA5 73170,15710,4825,10885,41241,39.6,28922,3746,2337,0.056666909,12771,28470
ZCTA5 73173,1278,261,1017,3988,36.4,3135,106,87,0.021815446,691,3297
ZCTA5 73179,2220,867,1353,5843,35.3,3763,620,448,0.076672942,2155,3688
ZCTA5 73401,13870,1380,12490,36162,38.2,24497,684,2656,0.073447265,3712,32450
ZCTA5 73425,83,4367,-4284,134,61.3,76,0,0,0,12327,-12193
ZCTA5 73430,526,426,100,1416,45.7,1186,0,41,0.028954802,1318,98
ZCTA5 73432,383,599,-216,1023,39.9,792,0,12,0.011730205,1517,-494
ZCTA5 73433,959,774,185,2466,36.9,2084,0,60,0.0243309,1993,473
ZCTA5 73434,204,1625,-1421,571,49.7,477,0,0,0,4064,-3493
ZCTA5 73435,26,997,-971,64,37.5,64,0,0,0,2448,-2384
ZCTA5 73436,44,2311,-2267,152,32.7,110,0,6,0.039473684,5900,-5748
ZCTA5 73437,28,799,-771,80,40.3,73,0,0,0,1984,-1904
ZCTA5 73438,1262,1719,-457,2762,45.6,2324,0,28,0.010137581,4098,-1336
ZCTA5 73439,2543,706,1837,6421,48.1,5083,10,31,0.004827908,1901,4520
ZCTA5 73440,88,519,-431,197,51.7,124,0,0,0,1644,-1447
ZCTA5 73441,71,977,-906,180,49,143,0,0,0,2666,-2486
ZCTA5 73442,150,56,94,373,56.7,310,4,0,0,148,225
ZCTA5 73443,1116,529,587,3338,34.7,2440,45,102,0.03055722,1608,1730
ZCTA5 73444,83,1914,-1831,188,53.2,95,0,61,0.324468085,5662,-5474
ZCTA5 73446,3001,327,2674,8771,39.2,5086,3,194,0.022118345,1499,7272
ZCTA5 73447,416,934,-518,1146,40.5,824,0,0,0,2632,-1486
ZCTA5 73448,2088,971,1117,6057,36.8,4553,14,182,0.030047878,2529,3528
ZCTA5 73449,1302,89,1213,3048,45.4,2366,0,19,0.006233596,219,2829
ZCTA5 73450,522,56,466,1321,46.9,906,2,8,0.006056018,91,1230
ZCTA5 73453,242,449,-207,573,43.6,482,0,2,0.003490401,1273,-700
ZCTA5 73455,236,185,51,600,36.1,431,0,0,0,560,40
ZCTA5 73456,648,42,606,1664,40.9,1396,1,2,0.001201923,130,1534
ZCTA5 73458,345,4612,-4267,1026,31.1,866,0,24,0.023391813,12709,-11683
ZCTA5 73459,457,118,339,1233,40.8,1011,39,9,0.00729927,332,901
ZCTA5 73460,1641,618,1023,4356,38.3,2805,0,99,0.022727273,1581,2775
ZCTA5 73461,233,4351,-4118,728,34.2,517,0,48,0.065934066,12020,-11292
ZCTA5 73463,1431,1691,-260,3801,39.5,3386,0,13,0.003420153,4838,-1037
ZCTA5 73481,333,5613,-5280,992,36.6,831,0,38,0.038306452,14688,-13696
ZCTA5 73487,56,817,-761,169,38.1,12,0,145,0.857988166,2198,-2029
ZCTA5 73488,6,451,-445,16,64.3,6,0,0,0,960,-944
ZCTA5 73491,306,2362,-2056,749,42.5,639,0,0,0,6303,-5554
ZCTA5 73501,7635,4520,3115,20508,36.6,10533,388,4242,0.206846109,12814,7694
ZCTA5 73503,1701,1928,-227,11253,20.2,7273,371,1898,0.168666133,5153,6100
ZCTA5 73505,18718,293,18425,48867,34.4,26693,1897,9406,0.192481634,763,48104
ZCTA5 73507,8494,943,7551,20907,36.9,13031,439,2970,0.142057684,2444,18463
ZCTA5 73520,44,1996,-1952,109,45.9,96,0,8,0.073394495,5737,-5628
ZCTA5 73521,7935,1464,6471,20298,34.3,14293,344,1679,0.082717509,3720,16578
ZCTA5 73523,0,7001,-7001,196,19.8,133,12,25,0.12755102,13033,-12837
ZCTA5 73526,765,21082,-20317,2052,40.3,1671,0,17,0.0082846,64067,-62015
ZCTA5 73527,1719,16710,-14991,4564,38.8,3413,83,132,0.028921998,46557,-41993
ZCTA5 73528,187,18422,-18235,558,35,463,2,0,0,51735,-51177
ZCTA5 73529,1774,2752,-978,4671,45.8,3998,10,23,0.004923999,8342,-3671
ZCTA5 73530,172,8310,-8138,423,50.5,287,0,4,0.009456265,22848,-22425
ZCTA5 73531,120,9995,-9875,377,42.6,314,0,27,0.071618037,29971,-29594
ZCTA5 73532,216,14064,-13848,515,36.4,427,0,10,0.019417476,39212,-38697
ZCTA5 73533,10704,8917,1787,27616,38.9,21649,189,669,0.024225087,22525,5091
ZCTA5 73537,237,3231,-2994,631,41.4,431,0,4,0.006339144,8004,-7373
ZCTA5 73538,2212,6912,-4700,6431,33.2,5006,44,168,0.026123464,22449,-16018
ZCTA5 73539,78,17539,-17461,142,54.3,130,0,0,0,46339,-46197
ZCTA5 73540,128,15335,-15207,314,49.4,213,3,0,0,37708,-37394
ZCTA5 73541,1490,18150,-16660,3621,42.1,2915,13,189,0.052195526,51202,-47581
ZCTA5 73542,1511,13856,-12345,4167,40.8,2786,16,405,0.097192225,42878,-38711
ZCTA5 73543,793,9722,-8929,1887,37.8,1456,17,69,0.036565978,29088,-27201
ZCTA5 73544,105,24076,-23971,301,55,250,0,2,0.006644518,71123,-70822
ZCTA5 73546,494,16375,-15881,1137,45.5,643,0,91,0.08003518,48691,-47554
ZCTA5 73547,546,11839,-11293,1832,38.7,1327,0,156,0.085152838,27393,-25561
ZCTA5 73548,147,6423,-6276,392,56.7,373,18,0,0,10932,-10540
ZCTA5 73549,117,17591,-17474,310,53.1,292,0,0,0,59244,-58934
ZCTA5 73550,795,9354,-8559,2072,39,1297,10,264,0.127413127,29793,-27721
ZCTA5 73551,14,11176,-11162,44,54,44,0,0,0,39193,-39149
ZCTA5 73552,475,19940,-19465,1401,42.6,1111,6,1,0.000713776,57596,-56195
ZCTA5 73553,4,14850,-14846,9,62.3,9,0,0,0,42012,-42003
ZCTA5 73554,1320,6655,-5335,3309,39,2745,0,123,0.037171351,20215,-16906
ZCTA5 73555,55,14875,-14820,247,18.3,150,0,45,0.182186235,39994,-39747
ZCTA5 73556,46,12904,-12858,141,29.1,83,0,0,0,40023,-39882
ZCTA5 73557,111,28346,-28235,193,49.7,176,0,0,0,89829,-89636
ZCTA5 73559,187,1437,-1250,467,40.8,375,0,5,0.010706638,4769,-4302
ZCTA5 73560,320,17262,-16942,802,38.3,600,0,0,0,48266,-47464
ZCTA5 73562,206,4875,-4669,611,37.8,570,0,0,0,13194,-12583
ZCTA5 73564,188,1008,-820,495,48.9,468,0,8,0.016161616,3145,-2650
ZCTA5 73565,329,14589,-14260,864,38.7,661,0,69,0.079861111,46617,-45753
ZCTA5 73566,507,17292,-16785,1370,36.7,1156,0,22,0.016058394,52243,-50873
ZCTA5 73567,329,16624,-16295,826,45.2,746,11,0,0,46027,-45201
ZCTA5 73568,378,15419,-15041,907,52.1,770,0,73,0.080485116,35443,-34536
ZCTA5 73569,196,4081,-3885,481,50.1,370,0,4,0.008316008,11029,-10548
ZCTA5 73570,370,24240,-23870,945,47.7,702,0,50,0.052910053,60477,-59532
ZCTA5 73571,31,11378,-11347,115,38,115,0,0,0,36021,-35906
ZCTA5 73572,1184,12035,-10851,3447,41,2527,0,16,0.004641717,34635,-31188
ZCTA5 73573,869,25006,-24137,2387,40.6,1976,0,30,0.012568077,74753,-72366
ZCTA5 73601,4025,12166,-8141,9477,38.8,6102,126,662,0.069853329,36928,-27451
ZCTA5 73620,492,14986,-14494,1667,38.1,1387,0,8,0.00479904,45573,-43906
ZCTA5 73622,121,13053,-12932,334,34.5,271,0,0,0,33529,-33195
ZCTA5 73624,707,3161,-2454,2231,34.5,1657,4,83,0.037203048,7666,-5435
ZCTA5 73625,190,12753,-12563,454,40.8,396,0,0,0,36773,-36319
ZCTA5 73626,342,3347,-3005,1075,38.5,893,0,11,0.010232558,10823,-9748
ZCTA5 73627,187,17482,-17295,496,50.5,376,0,0,0,44601,-44105
ZCTA5 73628,642,13249,-12607,1668,38,1446,0,2,0.001199041,34138,-32470
ZCTA5 73632,1174,7657,-6483,3112,37.4,2971,1,44,0.014138817,21336,-18224
ZCTA5 73638,44,10015,-9971,118,53,118,0,0,0,29292,-29174
ZCTA5 73639,287,8521,-8234,842,43,767,0,0,0,25394,-24552
ZCTA5 73641,202,9237,-9035,442,56.5,428,0,0,0,29539,-29097
ZCTA5 73642,61,8184,-8123,105,61.2,103,0,0,0,23298,-23193
ZCTA5 73644,5779,9538,-3759,14029,36,12041,143,308,0.021954523,22803,-8774
ZCTA5 73645,445,18776,-18331,1105,33.7,897,0,5,0.004524887,46690,-45585
ZCTA5 73646,157,5695,-5538,356,57.4,269,0,0,0,20029,-19673
ZCTA5 73647,220,15730,-15510,579,61.3,511,10,0,0,46887,-46308
ZCTA5 73650,331,198,133,925,45,692,0,0,0,589,336
ZCTA5 73651,1513,365,1148,4076,36.5,3158,40,271,0.066486752,1118,2958
ZCTA5 73654,287,4899,-4612,760,43,724,5,0,0,13526,-12766
ZCTA5 73655,311,15298,-14987,827,46.1,665,0,21,0.025392987,45349,-44522
ZCTA5 73658,108,133,-25,302,59,260,0,0,0,283,19
ZCTA5 73659,55,1634,-1579,276,32.1,234,0,0,0,4330,-4054
ZCTA5 73660,139,9944,-9805,348,35.3,320,0,0,0,27458,-27110
ZCTA5 73661,187,1365,-1178,691,43.7,656,0,0,0,4467,-3776
ZCTA5 73662,1595,18102,-16507,6953,37.2,5176,28,841,0.120954983,48860,-41907
ZCTA5 73663,399,6699,-6300,1334,39.2,1071,0,0,0,19635,-18301
ZCTA5 73664,548,1375,-827,1118,41.8,881,0,2,0.001788909,3205,-2087
ZCTA5 73666,157,8959,-8802,289,46.2,285,0,0,0,25687,-25398
ZCTA5 73667,180,1504,-1324,469,36.8,431,0,0,0,4160,-3691
ZCTA5 73668,17,2097,-2080,20,66.3,20,0,0,0,6904,-6884
ZCTA5 73669,562,10157,-9595,1666,38.1,1480,0,0,0,31825,-30159
ZCTA5 73673,195,540,-345,332,53.9,318,0,0,0,1629,-1297
ZCTA5 73701,9060,143,8917,25580,34.1,17525,177,612,0.023924941,391,25189
ZCTA5 73703,11696,6916,4780,29374,37.2,24788,509,654,0.022264588,20153,9221
ZCTA5 73705,21,1794,-1773,331,22.5,214,0,58,0.175226586,4944,-4613
ZCTA5 73716,213,6787,-6574,512,33.9,478,0,0,0,18955,-18443
ZCTA5 73717,2550,2329,221,6917,30.7,6129,23,295,0.042648547,6811,106
ZCTA5 73718,231,1350,-1119,508,46,493,0,0,0,5258,-4750
ZCTA5 73719,27,6310,-6283,92,44.2,81,0,0,0,18920,-18828
ZCTA5 73720,86,6167,-6081,146,56.5,146,0,0,0,16073,-15927
ZCTA5 73722,85,1274,-1189,370,26.7,308,31,0,0,3394,-3024
ZCTA5 73724,318,6421,-6103,803,40.6,619,5,0,0,17432,-16629
ZCTA5 73726,180,2679,-2499,420,50.5,400,0,0,0,7897,-7477
ZCTA5 73727,52,2490,-2438,78,59.3,78,0,0,0,6706,-6628
ZCTA5 73728,778,18500,-17722,2124,40.6,1812,1,84,0.039548023,56253,-54129
ZCTA5 73729,229,21646,-21417,618,40.3,593,0,0,0,58538,-57920
ZCTA5 73730,307,1731,-1424,682,41,657,0,0,0,5577,-4895
ZCTA5 73731,80,203,-123,137,58.3,104,0,0,0,665,-528
ZCTA5 73733,67,11621,-11554,184,42.5,140,0,0,0,35067,-34883
ZCTA5 73734,320,874,-554,565,60.5,517,0,9,0.015929204,2673,-2108
ZCTA5 73735,274,6411,-6137,686,39.4,569,0,0,0,14538,-13852
ZCTA5 73736,247,138,109,649,40,598,0,15,0.023112481,382,267
ZCTA5 73737,1512,1460,52,3710,39,3102,35,2,0.000539084,4359,-649
ZCTA5 73738,382,5694,-5312,892,40.1,820,0,17,0.019058296,18322,-17430
ZCTA5 73739,177,7897,-7720,353,52.9,351,0,0,0,23102,-22749
ZCTA5 73741,173,2393,-2220,1437,47.4,956,0,133,0.092553932,6859,-5422
ZCTA5 73742,1347,920,427,3919,33.6,3354,14,8,0.002041337,1899,2020
ZCTA5 73743,36,152,-116,100,47.7,82,0,0,0,457,-357
ZCTA5 73744,37,13248,-13211,72,55.6,66,0,0,0,38251,-38179
ZCTA5 73746,11,1179,-1168,39,14.1,39,0,0,0,3381,-3342
ZCTA5 73747,100,2961,-2861,228,35.6,228,0,0,0,9842,-9614
ZCTA5 73749,229,5539,-5310,523,55,507,0,0,0,14813,-14290
ZCTA5 73750,2565,1156,1409,7203,36.3,6170,274,39,0.005414411,3965,3238
ZCTA5 73753,231,1674,-1443,555,47.3,515,0,2,0.003603604,5175,-4620
ZCTA5 73754,467,6931,-6464,1189,45.1,1084,3,16,0.013456686,22861,-21672
ZCTA5 73755,274,7626,-7352,642,46.3,567,0,2,0.003115265,26498,-25856
ZCTA5 73756,138,1723,-1585,359,45.2,305,0,0,0,5085,-4726
ZCTA5 73757,62,6695,-6633,156,38.4,152,0,0,0,20634,-20478
ZCTA5 73758,73,5829,-5756,170,45.1,161,5,0,0,9331,-9161
ZCTA5 73759,483,1267,-784,1156,49.9,1102,1,4,0.003460208,2005,-849
ZCTA5 73760,151,5451,-5300,340,41.5,296,0,0,0,16232,-15892
ZCTA5 73761,119,14082,-13963,326,62.6,295,0,5,0.015337423,26207,-25881
ZCTA5 73762,720,8965,-8245,2131,39.3,1851,2,10,0.004692633,24116,-21985
ZCTA5 73763,621,20033,-19412,1415,38,1312,0,0,0,36320,-34905
ZCTA5 73764,125,458,-333,229,51.8,229,0,0,0,9738,-9509
ZCTA5 73766,415,10114,-9699,1236,31.7,1130,0,15,0.012135922,32077,-30841
ZCTA5 73768,599,6340,-5741,1486,42.5,1185,7,0,0,14971,-13485
ZCTA5 73770,0,2352,-2352,0,-,0,0,0,#DIV/0!,5927,-5927
ZCTA5 73771,154,20067,-19913,410,39.7,349,0,4,0.009756098,73775,-73365
ZCTA5 73772,1339,6695,-5356,4040,39.2,3015,0,355,0.087871287,24997,-20957
ZCTA5 73773,856,15355,-14499,1901,41.9,1851,1,0,0,32293,-30392
ZCTA5 73801,6293,5949,344,15449,35.9,13373,70,95,0.006149265,14430,1019
ZCTA5 73832,473,16653,-16180,1015,58.2,912,16,0,0,47558,-46543
ZCTA5 73834,606,21795,-21189,1616,42.4,1309,0,2,0.001237624,82842,-81226
ZCTA5 73835,103,9976,-9873,285,35.5,282,0,0,0,22103,-21818
ZCTA5 73838,227,11768,-11541,547,47.5,488,0,0,0,20965,-20418
ZCTA5 73840,199,13682,-13483,603,43,561,0,0,0,43459,-42856
ZCTA5 73841,186,4245,-4059,1229,39.1,787,3,202,0.164361269,13191,-11962
ZCTA5 73842,234,10221,-9987,500,48.9,484,1,1,0.002,33942,-33442
ZCTA5 73843,305,8197,-7892,763,45.7,689,0,0,0,20047,-19284
ZCTA5 73844,114,1305,-1191,310,44.7,227,0,7,0.022580645,2811,-2501
ZCTA5 73848,565,16859,-16294,1610,39.2,1382,0,0,0,56150,-54540
ZCTA5 73851,65,23717,-23652,163,48.4,159,0,0,0,68605,-68442
ZCTA5 73852,720,11016,-10296,1972,39.7,1868,17,5,0.002535497,32820,-30848
ZCTA5 73853,193,12164,-11971,575,39.3,526,0,0,0,26717,-26142
ZCTA5 73855,55,13912,-13857,167,36,128,0,0,0,34306,-34139
ZCTA5 73857,357,9461,-9104,909,36.4,808,10,9,0.00990099,26426,-25517
ZCTA5 73858,553,4313,-3760,1594,37.4,1415,14,7,0.004391468,14633,-13039
ZCTA5 73859,492,10044,-9552,1379,41.7,1148,0,0,0,28726,-27347
ZCTA5 73860,468,6403,-5935,1181,36.5,1001,0,0,0,19334,-18153
ZCTA5 73901,77,5282,-5205,263,29.1,140,0,0,0,15081,-14818
ZCTA5 73931,254,7484,-7230,556,44.4,508,7,0,0,17952,-17396
ZCTA5 73932,694,11819,-11125,1977,35.9,1481,0,12,0.006069803,29853,-27876
ZCTA5 73933,520,9706,-9186,1465,36.5,1306,0,4,0.002730375,25813,-24348
ZCTA5 73937,80,9557,-9477,253,46.8,195,0,0,0,28162,-27909
ZCTA5 73938,229,23162,-22933,727,41,601,0,0,0,55747,-55020
ZCTA5 73939,379,5707,-5328,1520,22.2,1193,36,45,0.029605263,13247,-11727
ZCTA5 73942,4482,1244,3238,14131,31.4,6940,587,1014,0.07175713,3022,11109
ZCTA5 73944,154,156,-2,468,28.9,167,0,0,0,509,-41
ZCTA5 73945,926,15725,-14799,2260,39.6,1745,0,18,0.007964602,34911,-32651
ZCTA5 73946,9,4331,-4322,41,12.1,41,0,0,0,13684,-13643
ZCTA5 73947,214,1639,-1425,494,62.4,487,0,0,0,2910,-2416
ZCTA5 73949,460,12080,-11620,1357,34.8,1022,0,0,0,25129,-23772
ZCTA5 73950,417,5130,-4713,1425,35.2,1001,0,0,0,16873,-15448
ZCTA5 73951,391,11417,-11026,1363,31.6,713,0,0,0,24097,-22734
ZCTA5 73960,21,0,21,33,73.3,33,0,0,0,0,33
ZCTA5 74001,115,26191,-26076,320,40.2,194,0,0,0,49403,-49083
ZCTA5 74002,622,0,622,1904,39.3,1219,15,6,0.003151261,0,1904
ZCTA5 74003,5414,6197,-783,14185,36.5,10014,126,677,0.047726472,18743,-4558
ZCTA5 74006,10765,6076,4689,27266,39.9,21011,962,637,0.023362429,15846,11420
ZCTA5 74008,10831,4896,5935,30671,36.2,24167,721,549,0.017899645,14085,16586
ZCTA5 74010,3856,3811,45,10399,39.7,7683,1,468,0.045004327,11766,-1367
ZCTA5 74011,11744,1572,10172,31236,37.6,24256,639,1192,0.038161096,4018,27218
ZCTA5 74012,23769,450,23319,63319,36.6,45552,3221,4082,0.064467222,1165,62154
ZCTA5 74014,14142,320,13822,40063,38.4,29615,1340,1399,0.034920001,916,39147
ZCTA5 74015,3438,82,3356,9130,41,6127,147,77,0.008433735,243,8887
ZCTA5 74016,2201,1288,913,5589,38.9,3495,76,5,0.000894614,3265,2324
ZCTA5 74017,10541,65,10476,28272,39.6,19661,337,337,0.011919921,168,28104
ZCTA5 74019,7397,1230,6167,19791,39.6,14581,231,154,0.007781315,3178,16613
ZCTA5 74020,2800,975,1825,7325,41.5,5803,4,32,0.004368601,2502,4823
ZCTA5 74021,7758,4578,3180,22357,36.5,16642,692,234,0.010466521,13918,8439
ZCTA5 74022,790,401,389,1794,45.1,1270,3,3,0.001672241,873,921
ZCTA5 74023,4476,370,4106,11963,37.1,9447,22,467,0.039037031,941,11022
ZCTA5 74026,283,1011,-728,806,35.8,698,0,17,0.021091811,2783,-1977
ZCTA5 74027,322,1112,-790,932,40.9,629,3,25,0.026824034,3238,-2306
ZCTA5 74028,612,1132,-520,1574,43,1224,0,19,0.012071156,3113,-1539
ZCTA5 74029,1916,1780,136,4749,49.8,3792,6,21,0.004421984,4576,173
ZCTA5 74030,1408,3334,-1926,3184,46,2648,0,65,0.020414573,10183,-6999
ZCTA5 74032,808,739,69,2025,42,1797,0,0,0,1862,163
ZCTA5 74033,4340,1262,3078,12648,34.6,8805,303,415,0.032811512,3372,9276
ZCTA5 74034,50,1096,-1046,109,54.5,83,0,0,0,2917,-2808
ZCTA5 74035,1338,539,799,4199,42.7,2248,0,318,0.075732317,1482,2717
ZCTA5 74036,2628,793,1835,7564,36.7,5891,126,38,0.005023797,2041,5523
ZCTA5 74037,7930,453,7477,23234,34.7,16379,2281,537,0.02311268,1264,21970
ZCTA5 74038,798,353,445,2142,44.8,1711,0,0,0,970,1172
ZCTA5 74039,1455,346,1109,4002,41,3314,0,4,0.0009995,957,3045
ZCTA5 74041,985,2628,-1643,3073,33.3,2094,75,7,0.002277904,6759,-3686
ZCTA5 74042,153,47,106,412,33.7,223,0,5,0.012135922,118,294
ZCTA5 74044,2911,3140,-229,7726,41.4,5965,10,127,0.016438002,9379,-1653
ZCTA5 74045,123,1146,-1023,298,41.3,254,0,0,0,3048,-2750
ZCTA5 74046,45,384,-339,130,30.5,116,0,0,0,1072,-942
ZCTA5 74047,2384,243,2141,7200,38.9,5646,12,72,0.01,530,6670
ZCTA5 74048,2245,500,1745,5552,41.8,3609,43,43,0.007744957,1094,4458
ZCTA5 74050,199,102,97,583,38.4,404,0,0,0,347,236
ZCTA5 74051,770,318,452,2178,38.3,1360,3,0,0,823,1355
ZCTA5 74052,417,1526,-1109,1002,36,894,0,0,0,4634,-3632
ZCTA5 74053,1814,1196,618,5488,35.2,3964,80,30,0.005466472,3112,2376
ZCTA5 74054,252,1617,-1365,665,46.9,470,0,0,0,5288,-4623
ZCTA5 74055,17299,9081,8218,47504,36.6,35785,1224,1359,0.028608117,27801,19703
ZCTA5 74056,1988,2368,-380,5033,43.7,3295,11,31,0.006159348,5883,-850
ZCTA5 74058,1362,1453,-91,3483,41.9,2449,20,35,0.010048808,4104,-621
ZCTA5 74059,2138,9385,-7247,5438,30.8,4768,0,230,0.042294961,23183,-17745
ZCTA5 74060,171,4131,-3960,447,35.8,329,2,0,0,11313,-10866
ZCTA5 74061,796,269,527,2404,40.2,1614,0,2,0.000831947,676,1728
ZCTA5 74062,336,156,180,834,48.5,748,3,2,0.002398082,545,289
ZCTA5 74063,12036,78,11958,31420,40.7,24416,186,508,0.016168046,179,31241
ZCTA5 74066,12026,430,11596,31564,39.6,23980,317,748,0.023697884,1185,30379
ZCTA5 74068,10,1390,-1380,27,40.7,27,0,0,0,3679,-3652
ZCTA5 74070,5292,1564,3728,14585,39,10618,52,45,0.003085362,4303,10282
ZCTA5 74071,96,5510,-5414,145,61.8,114,0,3,0.020689655,14438,-14293
ZCTA5 74072,675,44,631,1630,42.7,1114,0,54,0.033128834,141,1489
ZCTA5 74073,1886,517,1369,5618,35.8,4018,122,122,0.021715913,1433,4185
ZCTA5 74074,12253,323,11930,32123,26.2,25543,1367,1290,0.040158142,816,31307
ZCTA5 74075,10590,513,10077,25762,25.2,19463,1979,865,0.033576586,1232,24530
ZCTA5 74077,0,645,-645,2056,19.4,1576,19,141,0.068579767,1876,180
ZCTA5 74078,36,794,-758,352,19.6,199,27,33,0.09375,2123,-1771
ZCTA5 74079,1690,197,1493,4550,37.8,3705,13,96,0.021098901,534,4016
ZCTA5 74080,973,9159,-8186,2910,40.1,2158,83,0,0,24593,-21683
ZCTA5 74081,675,847,-172,1995,43.5,1585,0,0,0,2365,-370
ZCTA5 74082,96,593,-497,281,40.5,175,0,0,0,1560,-1279
ZCTA5 74083,378,407,-29,922,49.9,667,0,7,0.007592191,1068,-146
ZCTA5 74084,196,354,-158,395,61.5,289,0,0,0,1082,-687
ZCTA5 74085,1022,784,238,2500,45,2149,13,0,0,2263,237
ZCTA5 74103,421,1820,-1399,2075,32.9,1402,0,410,0.197590361,4884,-2809
ZCTA5 74104,5253,210,5043,11966,32,9088,398,877,0.073290991,518,11448
ZCTA5 74105,12612,215,12397,26580,41.1,19880,409,2308,0.086832205,712,25868
ZCTA5 74106,7080,3846,3234,16867,35.3,3449,35,9718,0.576154621,10106,6761
ZCTA5 74107,8020,2632,5388,19812,34.9,13126,214,2004,0.101150818,6906,12906
ZCTA5 74108,2870,1289,1581,7694,34.2,4441,512,583,0.07577333,3401,4293
ZCTA5 74110,5042,1505,3537,15462,30.9,5674,72,3849,0.248932868,3253,12209
ZCTA5 74112,9503,13206,-3703,21919,38.2,15213,167,2438,0.111227702,36888,-14969
ZCTA5 74114,7356,9107,-1751,16838,40.4,14187,187,444,0.026368927,24032,-7194
ZCTA5 74115,8300,372,7928,23534,32.1,12116,53,3228,0.137163253,950,22584
ZCTA5 74116,1266,4165,-2899,3211,36,1619,64,283,0.088134538,10738,-7527
ZCTA5 74117,0,814,-814,0,-,0,0,0,#DIV/0!,1970,-1970
ZCTA5 74119,2072,589,1483,3071,41,2315,111,226,0.073591664,1559,1512
ZCTA5 74120,2776,392,2384,5207,35.3,3978,120,134,0.025734588,1084,4123
ZCTA5 74126,3951,601,3350,11127,34.1,2942,182,5651,0.507863755,1545,9582
ZCTA5 74127,6613,2304,4309,16057,41.2,8520,58,4648,0.289468768,6141,9916
ZCTA5 74128,4411,444,3967,13399,31.8,8799,401,1457,0.108739458,998,12401
ZCTA5 74129,7070,2146,4924,19233,32.3,12301,527,2774,0.144231269,5463,13770
ZCTA5 74130,731,35,696,1941,35.6,705,28,615,0.316846986,71,1870
ZCTA5 74131,892,1874,-982,2279,50.8,1837,0,58,0.025449759,5089,-2810
ZCTA5 74132,4006,125,3881,10478,35.6,7769,537,264,0.025195648,371,10107
ZCTA5 74133,20426,397,20029,47158,38,32021,3504,4758,0.100894864,951,46207
ZCTA5 74134,7924,1576,6348,21719,34.5,12482,862,2605,0.119941065,4543,17176
ZCTA5 74135,9326,1034,8292,20096,41.6,14407,591,1406,0.069964172,2826,17270
ZCTA5 74136,14079,1117,12962,31154,35.8,19209,2636,4793,0.153848623,2951,28203
ZCTA5 74137,11449,3550,7899,28271,41.9,22166,1909,1071,0.037883343,9953,18318
ZCTA5 74145,7597,1267,6330,18611,34.6,11504,582,2362,0.126914191,2911,15700
ZCTA5 74146,5541,1509,4032,16084,27.6,9723,519,2028,0.126088038,3558,12526
ZCTA5 74171,0,36,-36,1816,19.8,1157,62,339,0.186674009,57,1759
ZCTA5 74301,3983,748,3235,11017,42.1,6747,115,472,0.042842879,2169,8848
ZCTA5 74330,1110,5848,-4738,2748,41.4,1925,0,0,0,16353,-13605
ZCTA5 74331,3220,7166,-3946,6933,53,4995,58,0,0,22369,-15436
ZCTA5 74332,612,2407,-1795,1606,43.5,1153,2,5,0.003113325,5833,-4227
ZCTA5 74333,346,11183,-10837,917,39.6,533,8,2,0.002181025,31398,-30481
ZCTA5 74337,1651,11545,-9894,4387,41,3053,7,29,0.00661044,27400,-23013
ZCTA5 74338,1704,1249,455,4732,41.2,2575,135,18,0.003803888,2546,2186
ZCTA5 74339,813,963,-150,2321,34.6,1391,5,9,0.003877639,2290,31
ZCTA5 74340,80,5356,-5276,146,56,101,0,0,0,15197,-15051
ZCTA5 74342,949,2208,-1259,2579,46.5,1485,105,0,0,5790,-3211
ZCTA5 74343,1246,1214,32,3072,43.1,2104,10,13,0.004231771,2795,277
ZCTA5 74344,6283,1310,4973,14465,50.6,11089,34,100,0.006913239,3528,10937
ZCTA5 74346,2703,93,2610,7853,38.8,4090,121,21,0.002674137,264,7589
ZCTA5 74347,1139,64,1075,2677,50.9,1633,27,8,0.00298842,217,2460
ZCTA5 74349,343,871,-528,846,60.6,691,0,0,0,2145,-1299
ZCTA5 74350,292,4383,-4091,705,45.8,436,12,10,0.014184397,11325,-10620
ZCTA5 74352,2092,3753,-1661,5585,43.2,3024,8,27,0.004834378,10306,-4721
ZCTA5 74354,6649,4845,1804,17279,36.3,11150,125,317,0.018345969,13418,3861
ZCTA5 74358,87,3026,-2939,247,35.9,132,2,1,0.004048583,8508,-8261
ZCTA5 74359,61,774,-713,239,31.7,54,12,25,0.10460251,2395,-2156
ZCTA5 74360,9,4461,-4452,12,52,9,0,0,0,16335,-16323
ZCTA5 74361,6550,4300,2250,17125,36.6,11514,119,50,0.002919708,12139,4986
ZCTA5 74363,1031,1593,-562,2795,41.5,1769,28,7,0.002504472,4523,-1728
ZCTA5 74364,691,3480,-2789,1871,42.2,827,28,1,0.000534474,8013,-6142
ZCTA5 74365,1623,1089,534,4358,40.1,1854,15,9,0.002065168,2131,2227
ZCTA5 74366,598,9399,-8801,1549,49.3,1012,1,0,0,24080,-22531
ZCTA5 74367,238,471,-233,585,40.2,463,0,0,0,1016,-431
ZCTA5 74368,30,825,-795,99,23.5,60,0,0,0,2233,-2134
ZCTA5 74369,679,295,384,1831,43.6,1380,0,17,0.009284544,785,1046
ZCTA5 74370,1479,5896,-4417,3858,44.6,2549,38,11,0.002851218,18981,-15123
ZCTA5 74401,6437,6185,252,15874,38.8,7368,74,3969,0.250031498,16710,-836
ZCTA5 74403,11268,938,10330,29648,35.5,16789,263,1838,0.061994064,2321,27327
ZCTA5 74421,1525,214,1311,4284,39,2864,6,216,0.050420168,610,3674
ZCTA5 74422,405,1519,-1114,1071,43.9,645,0,233,0.217553688,4003,-2932
ZCTA5 74423,310,2510,-2200,862,40.4,542,0,3,0.003480278,7614,-6752
ZCTA5 74425,422,4621,-4199,1231,56.7,925,11,65,0.0528026,12981,-11750
ZCTA5 74426,3420,1556,1864,9149,44.9,5987,85,298,0.032571866,4319,4830
ZCTA5 74427,583,1911,-1328,1368,56.1,879,6,9,0.006578947,4929,-3561
ZCTA5 74428,326,2417,-2091,745,50.7,606,0,3,0.004026846,6819,-6074
ZCTA5 74429,5315,13849,-8534,15389,35.4,11606,85,420,0.027292222,35443,-20054
ZCTA5 74430,285,8320,-8035,613,54.4,558,2,0,0,26345,-25732
ZCTA5 74431,344,15748,-15404,920,38.7,525,0,21,0.022826087,36854,-35934
ZCTA5 74432,3945,2783,1162,9941,50.4,7598,18,109,0.010964692,7941,2000
ZCTA5 74434,3763,844,2919,9442,39.1,5061,109,113,0.011967803,2404,7038
ZCTA5 74435,1159,3146,-1987,3226,50.6,2173,0,27,0.008369498,10165,-6939
ZCTA5 74436,1909,5754,-3845,5098,43.2,3616,25,287,0.056296587,14536,-9438
ZCTA5 74437,3616,2005,1611,9232,41.4,6111,0,254,0.027512998,6242,2990
ZCTA5 74438,117,2171,-2054,331,42.2,202,0,0,0,5280,-4949
ZCTA5 74441,1878,1228,650,5783,38.2,3037,38,56,0.009683555,3363,2420
ZCTA5 74442,260,6092,-5832,710,37.5,547,6,0,0,17098,-16388
ZCTA5 74445,1040,2606,-1566,2949,37.7,2034,0,50,0.0169549,6713,-3764
ZCTA5 74446,199,2184,-1985,538,42.3,279,7,19,0.035315985,5623,-5085
ZCTA5 74447,6009,2145,3864,15530,39.9,8702,166,2225,0.143271088,5978,9552
ZCTA5 74450,580,1269,-689,1429,45,923,12,22,0.015395381,3672,-2243
ZCTA5 74451,1588,3934,-2346,3733,40.7,1955,0,5,0.001339405,10495,-6762
ZCTA5 74452,108,3085,-2977,239,58.4,123,0,8,0.033472803,8489,-8250
ZCTA5 74454,1326,60,1266,3511,41.8,2166,6,164,0.046710339,170,3341
ZCTA5 74455,1079,942,137,2857,35.5,2121,15,17,0.005950298,2224,633
ZCTA5 74456,56,4893,-4837,139,46.1,61,0,48,0.345323741,12686,-12547
ZCTA5 74457,116,2380,-2264,242,63.2,125,0,0,0,6866,-6624
ZCTA5 74458,36,32,4,103,61.1,30,0,34,0.330097087,61,42
ZCTA5 74459,40,2946,-2906,66,56,5,0,38,0.575757576,8125,-8059
ZCTA5 74460,192,8839,-8647,354,55.1,284,0,0,0,25611,-25257
ZCTA5 74462,2882,1102,1780,7140,44.2,5120,3,6,0.000840336,2962,4178
ZCTA5 74463,75,6235,-6160,1990,38.3,1071,6,322,0.161809045,18104,-16114
ZCTA5 74464,11412,4630,6782,30909,32.6,14307,274,435,0.014073571,12443,18466
ZCTA5 74467,5523,1427,4096,13950,43.1,9581,21,712,0.051039427,3695,10255
ZCTA5 74468,152,40,112,375,40.8,304,0,0,0,144,231
ZCTA5 74469,697,60,637,2200,31.8,1376,7,49,0.022272727,205,1995
ZCTA5 74470,679,2819,-2140,1499,49,896,28,0,0,7527,-6028
ZCTA5 74471,521,205,316,1334,42,596,22,11,0.008245877,654,680
ZCTA5 74472,250,3277,-3027,606,39.7,453,0,0,0,11917,-11311
ZCTA5 74477,9,128,-119,9,-,9,0,0,0,167,-158
ZCTA5 74501,10828,2727,8101,28202,38.2,20108,160,889,0.031522587,6861,21341
ZCTA5 74521,25,1358,-1333,77,36.9,43,0,0,0,3630,-3553
ZCTA5 74522,87,4442,-4355,162,51.3,113,0,5,0.030864198,13014,-12852
ZCTA5 74523,2112,1282,830,5362,43.2,3754,29,57,0.010630362,3429,1933
ZCTA5 74525,3379,5880,-2501,10226,38.9,7091,55,401,0.039213769,16841,-6615
ZCTA5 74528,43,5764,-5721,116,40.5,76,0,4,0.034482759,24637,-24521
ZCTA5 74530,88,1989,-1901,206,44.4,170,0,0,0,5850,-5644
ZCTA5 74531,297,21,276,1066,31.7,845,0,41,0.038461538,39,1027
ZCTA5 74533,346,1363,-1017,1019,37.2,765,0,0,0,3291,-2272
ZCTA5 74534,58,4401,-4343,143,32.2,122,0,0,0,12216,-12073
ZCTA5 74535,34,321,-287,93,27.3,67,0,0,0,690,-597
ZCTA5 74536,621,1845,-1224,1494,48.3,993,0,10,0.00669344,5615,-4121
ZCTA5 74538,1538,2804,-1266,3945,41,2562,16,19,0.004816223,7053,-3108
ZCTA5 74540,67,2193,-2126,158,50.8,87,5,0,0,5987,-5829
ZCTA5 74543,174,1125,-951,443,56.4,329,7,0,0,4548,-4105
ZCTA5 74546,274,1040,-766,685,39.1,365,0,0,0,2940,-2255
ZCTA5 74547,1163,682,481,3178,37.2,1954,19,36,0.011327879,1993,1185
ZCTA5 74549,35,46,-11,96,35.8,50,0,0,0,121,-25
ZCTA5 74552,377,59,318,986,36.6,651,0,71,0.072008114,196,790
ZCTA5 74553,487,202,285,1285,37.9,809,0,27,0.021011673,507,778
ZCTA5 74554,864,954,-90,2009,38.2,1440,0,36,0.017919363,4073,-2064
ZCTA5 74555,225,586,-361,598,45.5,472,0,0,0,4386,-3788
ZCTA5 74556,144,397,-253,308,38.9,239,0,0,0,1086,-778
ZCTA5 74557,230,1001,-771,628,44.4,539,3,0,0,2490,-1862
ZCTA5 74558,143,117,26,423,51.5,319,0,11,0.026004728,209,214
ZCTA5 74560,179,25,154,463,48.7,279,0,0,0,38,425
ZCTA5 74561,739,826,-87,1762,43.3,1128,0,18,0.010215664,2324,-562
ZCTA5 74562,294,1842,-1548,799,48.3,557,1,11,0.013767209,6205,-5406
ZCTA5 74563,774,686,88,1860,42.2,1180,0,28,0.015053763,5166,-3306
ZCTA5 74565,171,3024,-2853,507,47.1,343,0,0,0,8412,-7905
ZCTA5 74567,51,10066,-10015,102,53.7,74,0,0,0,28785,-28683
ZCTA5 74569,226,13087,-12861,615,42.2,404,0,45,0.073170732,34585,-33970
ZCTA5 74570,458,1758,-1300,1174,59.2,983,0,0,0,4609,-3435
ZCTA5 74571,1405,402,1003,3320,46.4,2100,88,24,0.007228916,1219,2101
ZCTA5 74572,286,408,-122,815,40.6,589,0,0,0,1134,-319
ZCTA5 74574,482,738,-256,1203,48.2,789,0,10,0.008312552,1553,-350
ZCTA5 74576,88,720,-632,149,45.5,76,0,0,0,1545,-1396
ZCTA5 74577,122,1101,-979,230,58.3,147,0,0,0,2323,-2093
ZCTA5 74578,2238,631,1607,5728,37.8,3810,35,65,0.011347765,1546,4182
ZCTA5 74601,7239,490,6749,19424,35.2,13330,145,637,0.032794481,1193,18231
ZCTA5 74604,4736,48,4688,12144,45.7,10291,79,108,0.008893281,156,11988
ZCTA5 74630,191,5099,-4908,582,47.2,508,0,0,0,13976,-13394
ZCTA5 74631,2632,422,2210,6991,37.7,5769,0,61,0.008725504,988,6003
ZCTA5 74632,218,295,-77,435,58.1,414,0,2,0.004597701,723,-288
ZCTA5 74633,151,904,-753,667,23.4,544,0,0,0,2392,-1725
ZCTA5 74636,86,1328,-1242,301,27,184,0,57,0.189368771,3739,-3438
ZCTA5 74637,619,2594,-1975,1618,47,1007,3,42,0.025957973,9759,-8141
ZCTA5 74640,90,131,-41,196,57.7,162,0,0,0,147,49
ZCTA5 74641,249,451,-202,591,53.7,476,2,0,0,1170,-579
ZCTA5 74643,174,471,-297,530,39.6,437,0,0,0,1250,-720
ZCTA5 74644,205,1401,-1196,540,53.7,261,3,0,0,3446,-2906
ZCTA5 74646,65,2576,-2511,188,53,181,1,0,0,6068,-5880
ZCTA5 74647,1200,2944,-1744,3297,40.8,2604,18,0,0,7480,-4183
ZCTA5 74650,184,6062,-5878,540,38.1,340,0,3,0.005555556,16120,-15580
ZCTA5 74651,360,1136,-776,863,39.5,364,2,0,0,3098,-2235
ZCTA5 74652,384,3211,-2827,786,48.1,623,0,6,0.007633588,8201,-7415
ZCTA5 74653,1584,289,1295,3827,36.4,2802,30,21,0.005487327,981,2846
ZCTA5 74701,9777,358,9419,25934,33.9,18066,226,587,0.02263438,908,25026
ZCTA5 74720,166,5828,-5662,409,40.7,308,0,5,0.012224939,14883,-14474
ZCTA5 74721,0,0,0,0,-,0,0,0,#DIV/0!,3526,-3526
ZCTA5 74722,58,6601,-6543,208,33.5,131,0,0,0,19780,-19572
ZCTA5 74723,512,7568,-7056,1256,47.5,861,14,7,0.005573248,18454,-17198
ZCTA5 74724,56,1690,-1634,195,33.5,88,0,5,0.025641026,4425,-4230
ZCTA5 74726,849,647,202,1774,52.2,1429,0,0,0,2012,-238
ZCTA5 74727,862,1120,-258,2048,38.1,1335,10,60,0.029296875,3281,-1233
ZCTA5 74728,3953,2548,1405,11168,39.2,6863,13,536,0.047994269,6996,4172
ZCTA5 74729,1016,1133,-117,2596,42.8,1969,0,2,0.000770416,2740,-144
ZCTA5 74730,1940,1208,732,5192,36,3513,22,154,0.029661017,3056,2136
ZCTA5 74731,583,1367,-784,1614,47,1341,8,0,0,3309,-1695
ZCTA5 74733,1236,301,935,3070,43,2459,5,136,0.044299674,855,2215
ZCTA5 74734,354,340,14,866,41.6,590,0,39,0.045034642,1266,-400
ZCTA5 74735,695,26,669,2076,42.8,1515,10,31,0.014932563,108,1968
ZCTA5 74736,313,3960,-3647,865,46.1,552,92,10,0.011560694,11269,-10404
ZCTA5 74737,17,1112,-1095,58,43.5,43,0,0,0,2837,-2779
ZCTA5 74738,184,9924,-9740,460,44.5,202,0,115,0.25,31533,-31073
ZCTA5 74740,777,8635,-7858,2046,43.5,1307,0,161,0.078690127,30600,-28554
ZCTA5 74741,347,11847,-11500,870,45.9,676,0,31,0.035632184,23771,-22901
ZCTA5 74743,3298,4501,-1203,7890,41.5,4467,14,1161,0.147148289,13943,-6053
ZCTA5 74745,3543,6503,-2960,9801,35.7,5592,137,1311,0.133761861,19964,-10163
ZCTA5 74747,165,16838,-16673,411,42.7,308,0,7,0.01703163,54169,-53758
ZCTA5 74748,196,9140,-8944,582,32.3,465,15,5,0.008591065,22590,-22008
ZCTA5 74750,75,10029,-9954,230,37.6,158,0,5,0.02173913,24962,-24732
ZCTA5 74753,35,13311,-13276,56,70.7,56,0,0,0,31753,-31697
ZCTA5 74754,177,10750,-10573,573,30.3,420,0,103,0.179755672,34736,-34163
ZCTA5 74755,18,6536,-6518,44,31.6,36,0,0,0,15662,-15618
ZCTA5 74756,241,11581,-11340,675,45.8,485,4,15,0.022222222,31559,-30884
ZCTA5 74759,492,16778,-16286,1216,41.8,761,9,4,0.003289474,43245,-42029
ZCTA5 74760,64,8753,-8689,137,29.8,81,0,0,0,27253,-27116
ZCTA5 74761,25,10080,-10055,59,28.2,53,0,0,0,27284,-27225
ZCTA5 74764,1253,14969,-13716,3391,43.5,2431,72,112,0.033028605,33615,-30224
ZCTA5 74766,435,5787,-5352,1213,37,707,5,44,0.036273702,13737,-12524
ZCTA5 74801,8381,2291,6090,21751,38,15147,85,1028,0.047262195,6247,15504
ZCTA5 74804,7783,21399,-13616,21560,35.3,15948,222,704,0.032653061,60235,-38675
ZCTA5 74820,11852,5547,6305,30898,35.2,19951,323,933,0.030196129,16360,14538
ZCTA5 74824,412,9115,-8703,1387,32.8,1240,0,1,0.000720981,24303,-22916
ZCTA5 74825,683,7948,-7265,1784,40.1,1220,5,0,0,23040,-21256
ZCTA5 74826,503,535,-32,1307,41.9,1025,0,0,0,1403,-96
ZCTA5 74827,135,7542,-7407,342,39.3,292,0,7,0.020467836,21682,-21340
ZCTA5 74829,202,14194,-13992,1545,45.7,753,0,533,0.344983819,32396,-30851
ZCTA5 74830,57,11531,-11474,198,41.3,104,0,13,0.065656566,28914,-28716
ZCTA5 74831,258,100,158,708,44.3,552,6,2,0.002824859,280,428
ZCTA5 74832,309,2768,-2459,825,33.4,711,0,4,0.004848485,7377,-6552
ZCTA5 74833,193,1356,-1163,535,32.6,310,0,83,0.155140187,3908,-3373
ZCTA5 74834,2844,8590,-5746,7458,43.7,6119,17,320,0.042906946,21471,-14013
ZCTA5 74836,131,10316,-10185,220,64.1,182,0,0,0,25069,-24849
ZCTA5 74837,74,2174,-2100,144,51.7,101,0,0,0,5912,-5768
ZCTA5 74839,229,18227,-17998,927,44.3,629,0,20,0.021574973,46496,-45569
ZCTA5 74840,711,5202,-4491,1987,41.5,1485,7,38,0.019124308,15990,-14003
ZCTA5 74842,116,10883,-10767,258,41.3,169,0,0,0,28663,-28405
ZCTA5 74843,90,4449,-4359,341,57.6,301,0,0,0,11222,-10881
ZCTA5 74844,120,1145,-1025,303,33.4,176,0,11,0.03630363,3224,-2921
ZCTA5 74845,123,5795,-5672,381,36.2,162,0,22,0.057742782,18491,-18110
ZCTA5 74848,2090,1531,559,7735,36.6,5006,49,418,0.054040078,5187,2548
ZCTA5 74849,1153,2343,-1190,2854,40,1873,0,38,0.013314646,6993,-4139
ZCTA5 74850,102,68,34,290,54.8,194,0,0,0,137,153
ZCTA5 74851,3562,19716,-16154,11005,38.2,8014,103,412,0.037437528,60686,-49681
ZCTA5 74852,540,487,53,1362,43.5,1157,22,0,0,1558,-196
ZCTA5 74854,642,9476,-8834,1846,39.3,1371,0,0,0,28110,-26264
ZCTA5 74855,1620,1274,346,4503,46.9,3548,75,58,0.012880302,3658,845
ZCTA5 74856,240,7229,-6989,735,53.2,545,0,0,0,21741,-21006
ZCTA5 74857,4056,301,3755,10384,43.4,8687,37,152,0.014637904,628,9756
ZCTA5 74859,2257,1164,1093,6107,38.6,3930,0,107,0.017520878,3450,2657
ZCTA5 74860,582,1951,-1369,1662,36.4,1264,23,0,0,5004,-3342
ZCTA5 74864,1719,131,1588,4627,42.1,3983,37,20,0.004322455,393,4234
ZCTA5 74865,744,2719,-1975,2100,35.9,1568,0,0,0,8822,-6722
ZCTA5 74866,29,6224,-6195,68,45.7,52,0,0,0,18253,-18185
ZCTA5 74867,229,2295,-2066,570,44.3,334,2,14,0.024561404,8398,-7828
ZCTA5 74868,4380,2949,1431,12421,38.7,8623,40,405,0.03260607,8351,4070
ZCTA5 74869,283,8018,-7735,605,50.1,515,0,9,0.014876033,20448,-19843
ZCTA5 74871,1004,8970,-7966,2489,42.2,1786,4,30,0.012053033,24364,-21875
ZCTA5 74872,1130,4247,-3117,2849,36.7,2165,0,11,0.003861004,11762,-8913
ZCTA5 74873,3880,8279,-4399,11448,36.7,8805,69,149,0.013015374,26778,-15330
ZCTA5 74875,354,853,-499,1087,37.3,943,0,3,0.00275989,2517,-1430
ZCTA5 74878,684,3151,-2467,1633,41.6,1437,0,0,0,8438,-6805
ZCTA5 74880,683,4966,-4283,1945,43.1,1178,33,106,0.054498715,14863,-12918
ZCTA5 74881,1956,5531,-3575,5045,42.2,4433,0,49,0.009712587,15869,-10824
ZCTA5 74883,788,6266,-5478,2210,40.5,1120,0,71,0.032126697,21607,-19397
ZCTA5 74884,2088,9525,-7437,5693,39.1,3228,2,580,0.101879501,36950,-31257
ZCTA5 74901,718,12161,-11443,1915,34.5,1568,2,17,0.008877285,25642,-23727
ZCTA5 74902,1676,13899,-12223,4264,38.7,3284,32,116,0.027204503,37836,-33572
ZCTA5 74930,777,9702,-8925,1962,47.1,1398,30,2,0.001019368,21488,-19526
ZCTA5 74931,452,10215,-9763,1260,42.6,488,1,0,0,31957,-30697
ZCTA5 74932,885,6538,-5653,2499,38.6,1959,0,0,0,20891,-18392
ZCTA5 74935,64,15486,-15422,186,39.5,97,1,0,0,38016,-37830
ZCTA5 74936,454,8647,-8193,1327,44.1,818,0,23,0.017332329,24302,-22975
ZCTA5 74937,1776,5742,-3966,5274,37.4,3518,62,38,0.007205157,20902,-15628
ZCTA5 74939,213,20922,-20709,1173,40.5,700,0,239,0.203751066,47726,-46553
ZCTA5 74940,855,10806,-9951,2785,34.7,2132,2,12,0.004308797,31203,-28418
ZCTA5 74941,882,5123,-4241,2549,39.2,1841,25,5,0.001961554,14184,-11635
ZCTA5 74942,53,13076,-13023,134,37.5,87,0,0,0,41877,-41743
ZCTA5 74943,41,6861,-6820,128,35.5,86,0,0,0,16463,-16335
ZCTA5 74944,445,9262,-8817,1138,34.1,779,3,3,0.002636204,30175,-29037
ZCTA5 74945,61,7623,-7562,176,40.3,65,0,0,0,19646,-19470
ZCTA5 74946,29,88,-59,72,47.2,39,0,21,0.291666667,1968,-1896
ZCTA5 74947,33,0,33,111,21.4,93,4,0,0,2735,-2624
ZCTA5 74948,4298,9623,-5325,11274,44.1,7198,67,148,0.01312755,29512,-18238
ZCTA5 74949,131,12451,-12320,207,55.4,144,0,0,0,24978,-24771
ZCTA5 74951,562,17639,-17077,1371,34.3,948,22,7,0.005105762,48069,-46698
ZCTA5 74953,4280,7975,-3695,12172,37.6,9161,64,91,0.007476175,23985,-11813
ZCTA5 74954,1627,8064,-6437,4862,34.2,3282,63,299,0.061497326,20209,-15347
ZCTA5 74955,5519,19557,-14038,14970,37.7,9343,234,199,0.013293253,53252,-38282
ZCTA5 74956,721,8454,-7733,1982,38.9,1517,76,40,0.020181635,26381,-24399
ZCTA5 74957,340,7972,-7632,863,52.3,532,18,0,0,23919,-23056
ZCTA5 74959,2340,1881,459,6110,40.9,4282,51,278,0.045499182,3136,2974
ZCTA5 74960,4105,5193,-1088,12146,35.5,3663,6,64,0.005269224,18541,-6395
ZCTA5 74962,1622,1644,-22,4147,44.8,2313,0,119,0.028695442,4542,-395
ZCTA5 74963,194,16170,-15976,507,41.7,311,0,0,0,47335,-46828
ZCTA5 74964,822,13276,-12454,2300,40.4,1325,84,12,0.005217391,33325,-31025
ZCTA5 74965,1689,10414,-8725,4962,38.6,2737,129,11,0.002216848,28996,-24034
ZCTA5 74966,1276,9842,-8566,3367,40.2,2472,0,16,0.004752005,27210,-23843
ZCTA5 75001,8835,6559,2276,16287,33.3,9145,1490,2762,0.169583103,17732,-1445
ZCTA5 75002,22095,4179,17916,71102,39.1,46589,7998,8794,0.123681472,10384,60718
ZCTA5 75006,18161,6686,11475,48104,36.5,33741,3602,4507,0.093692832,19233,28871
ZCTA5 75007,19938,8755,11183,54448,40.3,33244,8529,4362,0.080113135,25487,28961
ZCTA5 75009,7649,13235,-5586,24737,37.7,19390,1094,1525,0.061648543,40132,-15395
ZCTA5 75010,11912,1247,10665,30129,38.1,14654,8061,4537,0.150585814,3348,26781
ZCTA5 75013,15596,6155,9441,44807,37.7,26793,12952,1864,0.041600643,18909,25898
ZCTA5 75019,16834,7263,9571,44324,39.2,25153,13654,2450,0.055274795,22013,22311
ZCTA5 75020,9179,433,8746,23184,39.6,18685,204,1873,0.080788475,1089,22095
ZCTA5 75021,3462,3991,-529,9327,43.6,8079,59,352,0.037739895,9898,-571
ZCTA5 75022,8756,1275,7481,26543,40.5,19696,3802,852,0.032098858,3471,23072
ZCTA5 75023,18162,5118,13044,48586,39.4,33509,6073,4277,0.088029474,14949,33637
ZCTA5 75024,17539,165,17374,43331,36.5,19144,16498,4038,0.093189633,428,42903
ZCTA5 75025,18342,463,17879,52881,40.4,25163,19005,4351,0.082279079,1214,51667
ZCTA5 75028,16938,9981,6957,46934,42.7,36172,5045,1920,0.04090851,26257,20677
ZCTA5 75032,11621,18488,-6867,35056,38.7,27210,1284,3233,0.09222387,59597,-24541
ZCTA5 75033,14047,704,13343,44703,35.6,30204,5426,4061,0.090844015,1714,42989
ZCTA5 75034,19088,3964,15124,45759,35.6,29663,8048,3748,0.081907384,12566,33193
ZCTA5 75035,26190,11701,14489,81512,37.6,37890,26843,7398,0.090759643,35003,46509
ZCTA5 75036,10912,2261,8651,30925,40.6,19270,7437,2574,0.08323363,6537,24388
ZCTA5 75038,13540,331,13209,32128,32.2,9725,9721,10478,0.326132968,912,31216
ZCTA5 75039,11027,364,10663,22046,32.1,8525,8104,3905,0.177129638,787,21259
ZCTA5 75040,20033,1185,18848,64565,35.9,33050,7223,7919,0.122651591,3368,61197
ZCTA5 75041,9799,78,9721,31451,30.7,19087,847,1930,0.061365298,194,31257
ZCTA5 75042,11552,2346,9206,38184,33.4,18741,6211,5611,0.146946365,5336,32848
ZCTA5 75043,21955,2270,19685,64845,34.7,32249,4505,13945,0.215051276,6093,58752
ZCTA5 75044,15958,1587,14371,45895,36.9,22737,7866,7433,0.16195664,4847,41048
ZCTA5 75048,9387,108,9279,26956,41.9,16869,5001,3189,0.118303903,352,26604
ZCTA5 75050,15559,10891,4668,43422,31.8,23807,789,7675,0.176753719,29880,13542
ZCTA5 75051,13150,14,13136,39783,31.8,20246,730,5976,0.150214916,43,39740
ZCTA5 75052,30366,441,29925,95745,34.8,38062,9868,26984,0.281831949,1084,94661
ZCTA5 75054,4789,625,4164,15820,36.9,6754,2234,5179,0.327370417,1638,14182
ZCTA5 75056,25494,4700,20794,64243,36.1,39155,10276,6422,0.099964198,13477,50766
ZCTA5 75057,6198,65,6133,16855,31.3,10885,436,1977,0.117294571,156,16699
ZCTA5 75058,984,651,333,3369,34.2,2766,13,12,0.003561888,1736,1633
ZCTA5 75060,14542,510,14032,49473,33,24392,2541,2382,0.048147474,1217,48256
ZCTA5 75061,18502,1811,16691,56959,31.1,26081,2535,5028,0.088274022,5007,51952
ZCTA5 75062,17490,3304,14186,51846,31.2,24668,7154,6787,0.130906917,8570,43276
ZCTA5 75063,17190,6839,10351,43705,33.8,10342,24579,5936,0.1358197,17137,26568
ZCTA5 75065,4693,4958,-265,12549,39.7,10647,503,498,0.039684437,13216,-667
ZCTA5 75067,27002,1831,25171,67837,32.8,38621,8000,10642,0.156876041,4659,63178
ZCTA5 75068,20531,5898,14633,65880,35.5,39055,6145,11274,0.171129326,15103,50777
ZCTA5 75069,14537,8193,6344,37479,38.3,28298,630,4484,0.119640332,19586,17893
ZCTA5 75070,20576,5371,15205,54444,36,34144,9245,6381,0.117202998,13099,41345
ZCTA5 75071,20893,7193,13700,63828,36.9,42383,5607,8553,0.134000752,18369,45459
ZCTA5 75072,17585,532,17053,54446,39,39086,5584,5033,0.092440216,6073,48373
ZCTA5 75074,17678,695,16983,51820,33.4,30782,6619,5267,0.101640293,1682,50138
ZCTA5 75075,14473,4563,9910,36221,42.4,26330,4685,2185,0.060324121,11090,25131
ZCTA5 75076,3384,293,3091,8592,47,7861,109,0,0,704,7888
ZCTA5 75077,13420,1468,11952,39125,40.6,29680,3135,2566,0.065584665,3537,35588
ZCTA5 75078,10613,147,10466,35939,35,26257,3569,3289,0.09151618,278,35661
ZCTA5 75080,18861,85,18776,52420,32.3,34814,5633,4453,0.084948493,188,52232
ZCTA5 75081,13677,1996,11681,36683,35.4,21751,5045,6638,0.180955756,5024,31659
ZCTA5 75082,11054,869,10185,26801,40,16319,6200,2040,0.076116563,2382,24419
ZCTA5 75087,13795,3491,10304,39202,38.7,31119,1245,1857,0.047370032,14227,24975
ZCTA5 75088,9261,112,9149,26363,39.6,18765,1184,3542,0.134354967,312,26051
ZCTA5 75089,11218,684,10534,35203,37.6,18663,3020,9496,0.269749737,1531,33672
ZCTA5 75090,8466,389,8077,24866,35.5,18105,264,2637,0.10604842,945,23921
ZCTA5 75092,11395,53,11342,26794,39.1,21999,1007,1563,0.058333955,231,26563
ZCTA5 75093,19245,1590,17655,46868,42.4,30458,8048,4021,0.085794145,3883,42985
ZCTA5 75094,6377,284,6093,23345,39.4,11858,7983,2529,0.108331549,716,22629
ZCTA5 75098,20326,266,20060,64326,34.5,42201,5393,7364,0.114479371,755,63571
ZCTA5 75101,222,1784,-1562,679,34.4,361,0,155,0.228276878,3805,-3126
ZCTA5 75102,596,4914,-4318,1795,40.2,1471,0,24,0.013370474,12815,-11020
ZCTA5 75103,6220,129,6091,15900,45.7,15014,181,257,0.016163522,294,15606
ZCTA5 75104,16342,438,15904,49566,34.8,16176,1577,25724,0.518984788,1277,48289
ZCTA5 75105,37,9970,-9933,207,20.1,162,0,45,0.217391304,25657,-25450
ZCTA5 75109,1626,0,1626,4288,48.8,3698,6,47,0.010960821,947,3341
ZCTA5 75110,10160,3278,6882,30555,35,19042,329,4203,0.137555228,9016,21539
ZCTA5 75114,1996,3665,-1669,6438,36.3,5536,47,160,0.024852439,10625,-4187
ZCTA5 75115,19906,370,19536,55879,40,11306,380,37575,0.672435083,1040,54839
ZCTA5 75116,7030,32,6998,21105,35.2,10453,436,5357,0.253826108,101,21004
ZCTA5 75117,1543,1054,489,4753,34.3,4322,31,183,0.038501999,2683,2070
ZCTA5 75119,9900,1155,8745,28765,34.6,21599,45,2429,0.084442899,3573,25192
ZCTA5 75124,1776,449,1327,5205,40.7,4802,18,176,0.033813641,1348,3857
ZCTA5 75125,2210,636,1574,7198,38.1,4388,3,773,0.107390942,1933,5265
ZCTA5 75126,19298,225,19073,60232,32.4,38791,1673,12639,0.209838624,555,59677
ZCTA5 75127,762,71,691,1854,51,1760,12,7,0.00377562,151,1703
ZCTA5 75132,0,2087,-2087,0,-,0,0,0,#DIV/0!,5614,-5614
ZCTA5 75134,6653,2956,3697,19341,34.4,3350,138,13444,0.695103666,7804,11537
ZCTA5 75135,2504,748,1756,8075,37.8,6618,58,335,0.041486068,1930,6145
ZCTA5 75137,6832,1254,5578,19352,41.6,8725,217,7215,0.372829682,3355,15997
ZCTA5 75140,2589,154,2435,7365,39.1,6727,18,20,0.002715547,349,7016
ZCTA5 75141,1005,3282,-2277,3868,25.9,1573,3,1694,0.43795243,8573,-4705
ZCTA5 75142,7291,2287,5004,22870,35.5,18003,3,972,0.042501093,5622,17248
ZCTA5 75143,5815,1023,4792,15270,40.7,14115,34,192,0.012573674,2457,12813
ZCTA5 75144,1326,5260,-3934,4030,42.8,2519,0,1045,0.259305211,13567,-9537
ZCTA5 75146,8585,14,8571,24873,31.9,5312,266,16975,0.682466932,70,24803
ZCTA5 75147,2621,437,2184,6922,43,6189,24,181,0.026148512,936,5986
ZCTA5 75148,2552,601,1951,6237,47.2,5045,8,599,0.096039763,1524,4713
ZCTA5 75149,19362,379,18983,59225,33.3,31423,666,13513,0.228163782,905,58320
ZCTA5 75150,22642,1470,21172,64817,33,33929,2325,13320,0.205501643,4106,60711
ZCTA5 75152,1871,1906,-35,5686,33.9,4639,0,80,0.014069645,6220,-534
ZCTA5 75153,146,92,54,515,35.9,510,0,0,0,206,309
ZCTA5 75154,14798,211,14587,47111,36.6,25360,446,13968,0.296491265,376,46735
ZCTA5 75155,963,1139,-176,3167,33.8,2316,0,192,0.060625197,3256,-89
ZCTA5 75156,6734,235,6499,16500,48.2,15151,109,379,0.022969697,608,15892
ZCTA5 75157,111,181,-70,209,51.7,140,0,20,0.09569378,355,-146
ZCTA5 75158,1766,118,1648,5496,37.5,4863,0,189,0.034388646,251,5245
ZCTA5 75159,6356,21,6335,22514,34.6,15107,201,2657,0.118015457,55,22459
ZCTA5 75160,8486,1273,7213,24465,36.7,16096,110,4212,0.172164316,3569,20896
ZCTA5 75161,2869,705,2164,8040,47,5845,0,583,0.072512438,1703,6337
ZCTA5 75163,1118,530,588,2450,59.4,1905,0,225,0.091836735,1532,918
ZCTA5 75164,151,135,16,281,59.9,271,0,10,0.035587189,318,-37
ZCTA5 75165,16267,494,15773,47183,34,35571,322,5340,0.113176356,961,46222
ZCTA5 75166,1853,1023,830,5589,35,4313,103,420,0.075147611,2899,2690
ZCTA5 75167,3984,63,3921,12332,39.5,9996,183,975,0.079062601,224,12108
ZCTA5 75169,5583,435,5148,14496,42.1,12845,0,786,0.054221854,885,13611
ZCTA5 75172,1779,410,1369,5248,33.1,2894,18,1536,0.292682927,1044,4204
ZCTA5 75173,2488,566,1922,8298,37.4,6646,81,317,0.038201976,1406,6892
ZCTA5 75180,7483,741,6742,26560,31.2,13186,159,6930,0.260918675,1835,24725
ZCTA5 75181,7865,24,7841,27336,32.3,12219,1173,8816,0.322505121,94,27242
ZCTA5 75182,2569,240,2329,7647,42.4,4830,1585,880,0.115077808,597,7050
ZCTA5 75189,11731,5844,5887,35243,35.5,27369,424,2301,0.065289561,16109,19134
ZCTA5 75201,11165,12242,-1077,17491,31.9,12390,1190,2370,0.135498256,33426,-15935
ZCTA5 75202,1461,8256,-6795,2212,33.1,1506,116,301,0.136075949,22583,-20371
ZCTA5 75203,6229,0,6229,16455,32.7,8190,177,5683,0.34536615,5,16450
ZCTA5 75204,18689,654,18035,31860,30.8,21288,2130,4187,0.131418707,2062,29798
ZCTA5 75205,9143,10756,-1613,24804,33.9,21246,1360,454,0.018303499,33555,-8751
ZCTA5 75206,20910,555,20355,38209,31.1,28375,3241,2915,0.076290926,1481,36728
ZCTA5 75207,2209,256,1953,8163,32.7,3966,240,2829,0.346563763,803,7360
ZCTA5 75208,11638,3007,8631,29941,34.8,21837,236,1923,0.064226312,7808,22133
ZCTA5 75209,6721,11854,-5133,14205,41.7,11181,289,1744,0.122773671,36085,-21880
ZCTA5 75210,2855,0,2855,9270,28.2,3321,117,4632,0.499676375,0,9270
ZCTA5 75211,22504,989,21515,75213,30.9,48533,502,6657,0.088508635,3014,72199
ZCTA5 75212,8099,391,7708,26673,30.6,13108,723,7088,0.265736887,1114,25559
ZCTA5 75214,15278,1374,13904,33621,37.2,27936,791,2347,0.069807561,3633,29988
ZCTA5 75215,7008,5830,1178,17960,36.8,4335,51,12114,0.674498886,18619,-659
ZCTA5 75216,18934,863,18071,55108,33.2,16308,148,28619,0.519325688,2345,52763
ZCTA5 75217,23912,1799,22113,87767,27.6,48624,293,17321,0.19735208,4938,82829
ZCTA5 75218,9434,682,8752,21355,40.2,17556,81,1112,0.052072114,2055,19300
ZCTA5 75219,15936,1248,14688,24100,34.2,16892,2158,2674,0.110954357,3803,20297
ZCTA5 75220,14009,306,13703,40671,30.8,24686,695,1946,0.047847361,884,39787
ZCTA5 75223,4580,2667,1913,14270,34.8,9505,259,1631,0.114295725,7248,7022
ZCTA5 75224,11712,7592,4120,36373,32,19862,140,9950,0.27355456,18932,17441
ZCTA5 75225,8869,13488,-4619,21703,47.9,20055,820,88,0.004054739,39631,-17928
ZCTA5 75226,2381,10858,-8477,5133,31.9,3348,77,926,0.180401325,29806,-24673
ZCTA5 75227,18465,6473,11992,58395,30.8,27782,418,16256,0.278379998,35268,23127
ZCTA5 75228,24624,8587,16037,71450,30.7,39997,1270,13540,0.189503149,26407,45043
ZCTA5 75229,11429,13700,-2271,32924,37.5,23865,1445,726,0.022050784,45638,-12714
ZCTA5 75230,12934,4122,8812,26335,47.7,21470,1006,2049,0.077805202,12168,14167
ZCTA5 75231,17536,706,16830,38823,31.1,16638,4060,10154,0.261545991,1913,36910
ZCTA5 75232,11559,577,10982,33561,40.8,8600,15,17884,0.532880427,1577,31984
ZCTA5 75233,4984,1634,3350,16743,32.5,8101,56,5168,0.308666308,4816,11927
ZCTA5 75234,11789,1543,10246,32728,35.4,23499,2260,2160,0.065998533,4818,27910
ZCTA5 75235,8698,302,8396,19042,31.9,12473,1466,2709,0.142264468,859,18183
ZCTA5 75236,6501,14,6487,17545,29.6,6604,276,7688,0.438187518,27,17518
ZCTA5 75237,7943,62,7881,18823,28.1,2108,231,14823,0.787494023,195,18628
ZCTA5 75238,12950,3506,9444,31953,35.7,20287,1637,5684,0.17788627,9198,22755
ZCTA5 75240,10230,650,9580,26442,30.4,7944,522,4410,0.166780123,1992,24450
ZCTA5 75241,10481,971,9510,31749,33.7,5644,149,21455,0.675769316,2652,29097
ZCTA5 75243,27814,2164,25650,65118,33.8,21677,4256,29859,0.45853681,5771,59347
ZCTA5 75244,5701,24,5677,12806,37.5,8294,1321,1018,0.079493987,45,12761
ZCTA5 75246,1250,6560,-5310,2307,39.1,1308,62,621,0.269180754,17775,-15468
ZCTA5 75247,229,1310,-1081,870,56.5,397,0,293,0.336781609,3468,-2598
ZCTA5 75248,16306,609,15697,36317,40.2,24241,1819,4247,0.116942479,1714,34603
ZCTA5 75249,5315,1516,3799,17629,33.8,4263,1038,8412,0.477168302,4693,12936
ZCTA5 75251,2292,0,2292,3804,30.7,2002,110,1293,0.339905363,956,2848
ZCTA5 75252,12458,0,12458,27310,37.4,14626,5497,3393,0.124240205,1430,25880
ZCTA5 75253,6468,0,6468,24090,25.6,15457,171,2589,0.10747198,390,23700
ZCTA5 75254,11285,0,11285,24047,30.8,10772,1291,5303,0.220526469,1239,22808
ZCTA5 75261,0,474,-474,0,-,0,0,0,#DIV/0!,1130,-1130
ZCTA5 75270,0,415,-415,0,-,0,0,0,#DIV/0!,1083,-1083
ZCTA5 75287,26947,51,26896,51855,34.4,25782,3514,14222,0.274264777,165,51690
ZCTA5 75390,0,761,-761,0,-,0,0,0,#DIV/0!,2151,-2151
ZCTA5 75401,7952,659,7293,21087,35.5,12745,38,2947,0.139754351,1922,19165
ZCTA5 75402,6933,610,6323,18412,37.7,15235,314,1200,0.065174886,1771,16641
ZCTA5 75407,7998,36,7962,24864,34.4,17601,427,3275,0.131716538,93,24771
ZCTA5 75409,6823,641,6182,20437,32.5,16041,415,2619,0.128149924,1816,18621
ZCTA5 75410,2029,641,1388,4470,59.2,4154,4,31,0.006935123,1925,2545
ZCTA5 75411,327,180,147,832,53.1,760,0,0,0,478,354
ZCTA5 75412,240,539,-299,562,41.8,556,0,4,0.007117438,1506,-944
ZCTA5 75413,70,1932,-1862,188,49.4,169,0,16,0.085106383,5570,-5382
ZCTA5 75414,1116,2649,-1533,2989,37.2,2850,36,0,0,7054,-4065
ZCTA5 75415,122,477,-355,317,56.3,298,0,0,0,1493,-1176
ZCTA5 75416,1083,571,512,2890,41.1,2590,0,46,0.015916955,1515,1375
ZCTA5 75417,878,209,669,2479,39.2,2108,56,18,0.007260992,445,2034
ZCTA5 75418,4953,1040,3913,14726,40.7,12107,68,1268,0.086106207,2960,11766
ZCTA5 75420,604,666,-62,1384,34.3,1322,0,0,0,1588,-204
ZCTA5 75421,235,1139,-904,851,28.8,727,0,78,0.091656874,3279,-2428
ZCTA5 75422,1161,632,529,2862,47.7,2539,67,54,0.018867925,1809,1053
ZCTA5 75423,1146,1973,-827,3055,43.4,2625,0,35,0.011456628,7268,-4213
ZCTA5 75424,1282,4828,-3546,3679,40.2,3246,3,3,0.000815439,13494,-9815
ZCTA5 75426,1704,4100,-2396,3774,53,2169,0,1308,0.346581876,11357,-7583
ZCTA5 75428,3742,1058,2684,11000,26.2,6769,316,1976,0.179636364,2669,8331
ZCTA5 75429,0,313,-313,0,-,0,0,0,#DIV/0!,705,-705
ZCTA5 75431,506,26,480,1745,39.2,1539,16,67,0.038395415,48,1697
ZCTA5 75432,1082,1158,-76,3055,37,2607,17,391,0.127986907,3011,44
ZCTA5 75433,1175,371,804,3145,45.3,2814,2,154,0.048966614,895,2250
ZCTA5 75434,0,390,-390,0,-,0,0,0,#DIV/0!,1034,-1034
ZCTA5 75435,471,78,393,1137,54.5,1055,0,31,0.027264732,166,971
ZCTA5 75436,749,2923,-2174,2155,40.1,1880,0,204,0.094663573,9183,-7028
ZCTA5 75437,434,903,-469,1094,39.7,1069,0,0,0,2711,-1617
ZCTA5 75438,350,3030,-2680,953,41.3,893,0,35,0.036726128,8830,-7877
ZCTA5 75439,417,175,242,1141,34.1,990,5,21,0.018404908,405,736
ZCTA5 75440,2578,2477,101,6665,50.3,6032,126,242,0.036309077,8419,-1754
ZCTA5 75441,102,1106,-1004,134,72.3,134,0,0,0,3374,-3240
ZCTA5 75442,3843,887,2956,10453,41.4,8609,74,634,0.060652444,2545,7908
ZCTA5 75446,1377,100,1277,3536,41.7,2987,0,310,0.087669683,190,3346
ZCTA5 75447,423,4118,-3695,1067,36.1,1060,0,1,0.000937207,11360,-10293
ZCTA5 75448,343,445,-102,919,39.3,678,0,42,0.04570185,1230,-311
ZCTA5 75449,438,854,-416,1165,42.6,890,0,225,0.193133047,2110,-945
ZCTA5 75450,177,486,-309,309,34.5,173,0,0,0,1191,-882
ZCTA5 75451,541,194,347,1475,47.3,1371,3,46,0.031186441,504,971
ZCTA5 75452,1484,78,1406,4688,37.7,3918,60,109,0.023250853,196,4492
ZCTA5 75453,1046,511,535,2757,35.3,2714,1,6,0.002176279,1277,1480
ZCTA5 75454,4705,141,4564,15341,36.2,11869,815,1373,0.089498729,399,14942
ZCTA5 75455,9116,238,8878,26687,32.7,18248,232,2674,0.100198599,616,26071
ZCTA5 75457,1936,900,1036,6228,36.7,4829,0,501,0.08044316,2365,3863
ZCTA5 75459,1988,9,1979,5709,35.2,4883,4,200,0.035032405,42,5667
ZCTA5 75460,10235,106,10129,24287,37.3,16675,362,5783,0.238110924,239,24048
ZCTA5 75462,4294,562,3732,11232,39.5,9417,0,655,0.058315527,1522,9710
ZCTA5 75468,379,1273,-894,1068,45,1046,0,22,0.020599251,3415,-2347
ZCTA5 75469,142,418,-276,346,55.3,331,0,12,0.034682081,1055,-709
ZCTA5 75470,108,2244,-2136,202,56.2,175,0,27,0.133663366,6093,-5891
ZCTA5 75471,645,4002,-3357,1932,34.8,1239,66,3,0.001552795,9318,-7386
ZCTA5 75472,1623,604,1019,4405,44.9,4179,4,99,0.022474461,1414,2991
ZCTA5 75473,1410,509,901,3773,49.3,3402,0,14,0.003710575,1412,2361
ZCTA5 75474,5969,3147,2822,16394,44.8,14364,216,105,0.006404782,8135,8259
ZCTA5 75475,25,10016,-9991,31,58.3,31,0,0,0,28312,-28281
ZCTA5 75476,491,11874,-11383,1072,54.3,987,0,0,0,35500,-34428
ZCTA5 75477,380,5082,-4702,1100,43.2,977,0,49,0.044545455,15812,-14712
ZCTA5 75478,317,8659,-8342,825,44.7,699,0,13,0.015757576,25038,-24213
ZCTA5 75479,730,10553,-9823,2122,44.6,1905,47,14,0.006597549,23155,-21033
ZCTA5 75480,739,2939,-2200,1786,57.5,1619,0,0,0,8190,-6404
ZCTA5 75481,145,9042,-8897,401,36.7,362,22,0,0,23492,-23091
ZCTA5 75482,9550,0,9550,25220,39.4,20232,246,2318,0.091911182,1922,23298
ZCTA5 75486,939,8838,-7899,2442,47.4,2331,16,10,0.004095004,25035,-22593
ZCTA5 75487,480,1700,-1220,1534,39.2,1279,0,119,0.077574967,5342,-3808
ZCTA5 75488,281,50,231,798,31.5,740,0,12,0.015037594,114,684
ZCTA5 75489,368,1829,-1461,939,37.3,882,10,11,0.01171459,4910,-3971
ZCTA5 75490,1025,1182,-157,2891,43.1,2643,32,69,0.023867174,3332,-441
ZCTA5 75491,1859,0,1859,4914,43.9,4283,6,177,0.036019536,0,4914
ZCTA5 75492,129,2612,-2483,341,45.7,335,0,6,0.017595308,7227,-6886
ZCTA5 75493,180,92,88,720,23,312,0,10,0.013888889,258,462
ZCTA5 75494,3812,102,3710,10785,40.5,9699,74,147,0.013630042,184,10601
ZCTA5 75495,3043,31,3012,9208,38.7,7189,0,459,0.049847958,83,9125
ZCTA5 75496,1265,185,1080,3578,45.1,3295,0,190,0.053102292,571,3007
ZCTA5 75497,1587,2235,-648,3623,53.6,3316,61,12,0.003312172,5744,-2121
ZCTA5 75501,13008,6,13002,35111,38.7,20841,183,12065,0.343624505,12,35099
ZCTA5 75503,10214,630,9584,27361,38.3,18971,883,6084,0.222360294,3233,24128
ZCTA5 75550,298,19,279,876,45.1,674,0,171,0.195205479,58,818
ZCTA5 75551,4283,47,4236,11040,40.8,7898,168,2459,0.222735507,87,10953
ZCTA5 75554,837,1409,-572,2078,46.8,1977,15,41,0.01973051,3730,-1652
ZCTA5 75555,668,77,591,1424,54.2,1259,7,154,0.108146067,162,1262
ZCTA5 75556,414,36,378,1162,37.8,1088,1,19,0.016351119,82,1080
ZCTA5 75558,640,1703,-1063,1958,48.1,1367,0,19,0.009703779,4153,-2195
ZCTA5 75559,2154,123,2031,5392,44.2,4246,22,862,0.159866469,247,5145
ZCTA5 75560,432,566,-134,1071,37.8,773,0,232,0.216619981,1394,-323
ZCTA5 75561,1932,128,1804,4626,44.4,4111,13,347,0.075010808,189,4437
ZCTA5 75562,33,1556,-1523,80,60.3,80,0,0,0,3678,-3598
ZCTA5 75563,1570,750,820,3816,49.3,3247,4,518,0.135744235,2010,1806
ZCTA5 75564,0,85,-85,0,-,0,0,0,#DIV/0!,203,-203
ZCTA5 75565,34,776,-742,207,13.6,203,0,0,0,2064,-1857
ZCTA5 75566,243,749,-506,631,49.8,474,2,137,0.217115689,2076,-1445
ZCTA5 75567,1601,66,1535,4087,42.5,3619,36,339,0.082945926,309,3778
ZCTA5 75568,1223,246,977,2873,39.9,2269,167,315,0.10964149,677,2196
ZCTA5 75569,1200,62,1138,3478,23.9,1640,0,1791,0.514951121,153,3325
ZCTA5 75570,3166,194,2972,11162,36.4,7885,39,1873,0.167801469,465,10697
ZCTA5 75571,973,12,961,2367,50.3,1751,0,526,0.222222222,20,2347
ZCTA5 75572,1458,79,1379,3474,44.3,2785,10,606,0.174438687,190,3284
ZCTA5 75573,68,247,-179,218,26.8,215,0,0,0,799,-581
ZCTA5 75574,482,266,216,1157,55.7,1137,0,0,0,683,474
ZCTA5 75601,5714,48,5666,15683,36.3,10465,411,2889,0.184212204,81,15602
ZCTA5 75602,7272,37,7235,21024,32.8,11061,93,6463,0.307410578,37,20987
ZCTA5 75603,2632,296,2336,6733,38.1,3777,9,2344,0.348136046,714,6019
ZCTA5 75604,11638,1550,10088,30349,34.5,21757,161,4832,0.159214472,4515,25834
ZCTA5 75605,14201,726,13475,33730,37.5,25049,593,5825,0.17269493,1804,31926
ZCTA5 75630,1028,69,959,2306,56,1993,0,190,0.082393755,189,2117
ZCTA5 75631,897,83,814,2696,39.4,2313,0,226,0.083827893,212,2484
ZCTA5 75633,4811,23,4788,12799,38.2,9653,169,1637,0.127900617,126,12673
ZCTA5 75638,1939,46,1893,5001,43.3,3014,0,1416,0.283143371,119,4882
ZCTA5 75639,918,32,886,2525,46.2,1858,0,628,0.248712871,57,2468
ZCTA5 75640,2000,371,1629,5791,36.8,5379,18,139,0.024002763,940,4851
ZCTA5 75641,45,10777,-10732,88,48.7,20,0,68,0.772727273,28149,-28061
ZCTA5 75642,25,11704,-11679,53,-,53,0,0,0,31457,-31404
ZCTA5 75643,867,13402,-12535,2138,40.5,1864,0,61,0.028531338,32199,-30061
ZCTA5 75644,4342,4358,-16,12594,38.7,9677,20,1703,0.135223122,12434,160
ZCTA5 75645,3901,231,3670,10125,44.3,8726,54,545,0.05382716,2381,7744
ZCTA5 75647,4670,57,4613,12405,38.1,10631,95,1061,0.085530028,160,12245
ZCTA5 75650,3239,1210,2029,9239,38.1,7780,37,580,0.062777357,3504,5735
ZCTA5 75651,841,546,295,2101,48.4,1925,5,147,0.069966683,1405,696
ZCTA5 75652,4015,338,3677,14011,38.5,9073,170,3761,0.268431946,1122,12889
ZCTA5 75654,4797,548,4249,12945,38.7,10244,52,1177,0.090923136,1587,11358
ZCTA5 75656,1649,1084,565,4768,38.3,3819,0,530,0.111157718,3253,1515
ZCTA5 75657,3026,9,3017,7366,48,4891,24,2013,0.27328265,18,7348
ZCTA5 75658,8,38,-30,8,-,0,0,8,1,90,-82
ZCTA5 75659,0,11,-11,0,-,0,0,0,#DIV/0!,18,-18
ZCTA5 75661,885,497,388,2482,52.8,1776,0,529,0.213134569,1361,1121
ZCTA5 75662,8510,1246,7264,25153,37.4,18264,132,2807,0.111597026,3560,21593
ZCTA5 75667,528,694,-166,1457,43,934,0,446,0.306108442,1536,-79
ZCTA5 75668,967,3,964,2272,44.6,1686,10,505,0.222271127,6,2266
ZCTA5 75669,261,1347,-1086,1124,38.1,894,0,211,0.18772242,4142,-3018
ZCTA5 75670,6303,464,5839,18855,34.6,9033,159,7006,0.371572527,1223,17632
ZCTA5 75671,0,32,-32,0,-,0,0,0,#DIV/0!,40,-40
ZCTA5 75672,5886,0,5886,16700,40.1,10650,240,3817,0.228562874,0,16700
ZCTA5 75680,0,0,0,0,-,0,0,0,#DIV/0!,0,0
ZCTA5 75681,1059,103,956,2563,47.2,1950,0,477,0.186110027,267,2296
ZCTA5 75682,256,2866,-2610,667,51.2,591,1,6,0.008995502,11473,-10806
ZCTA5 75683,1450,4098,-2648,3998,44.7,3396,0,242,0.060530265,10215,-6217
ZCTA5 75684,2144,12361,-10217,7558,33.2,5515,3,919,0.121593014,29853,-22295
ZCTA5 75686,4628,9386,-4758,13396,36.9,8952,96,2161,0.161316811,25740,-12344
ZCTA5 75687,0,11234,-11234,0,-,0,0,0,#DIV/0!,19856,-19856
ZCTA5 75689,56,15059,-15003,213,26.4,171,0,0,0,29545,-29332
ZCTA5 75691,1500,14368,-12868,4465,34.8,3546,0,395,0.088465845,29424,-24959
ZCTA5 75692,1813,14063,-12250,4698,49.7,3866,12,578,0.123031077,39050,-34352
ZCTA5 75693,2146,244,1902,6353,35.3,5591,7,220,0.034629309,342,6011
ZCTA5 75694,0,5628,-5628,0,-,0,0,0,#DIV/0!,19396,-19396
ZCTA5 75701,12080,6212,5868,34296,34.6,24522,534,7012,0.20445533,21619,12677
ZCTA5 75702,8409,5425,2984,28236,31.2,13369,47,11567,0.409654342,19448,8788
ZCTA5 75703,16830,9810,7020,42414,37.7,30788,1719,7649,0.180341397,29673,12741
ZCTA5 75704,3091,16404,-13313,9575,39.8,7097,73,2008,0.209712794,54386,-44811
ZCTA5 75705,804,9359,-8555,2722,40.4,1127,0,1443,0.530124908,27634,-24912
ZCTA5 75706,3139,9940,-6801,10142,34,7308,60,1389,0.136955236,33470,-23328
ZCTA5 75707,5635,10965,-5330,14455,43.5,12070,611,1179,0.081563473,27627,-13172
ZCTA5 75708,3028,10006,-6978,10419,31.2,9552,108,427,0.04098282,19450,-9031
ZCTA5 75709,2018,7914,-5896,4596,38,3527,148,786,0.171018277,26381,-21785
ZCTA5 75711,0,9743,-9743,219,19.6,111,0,75,0.342465753,25640,-25421
ZCTA5 75750,1293,9231,-7938,3644,44.3,2904,5,423,0.116081229,29821,-26177
ZCTA5 75751,5776,9462,-3686,17098,38.1,12451,313,2395,0.140074863,30696,-13598
ZCTA5 75752,2773,14275,-11502,7450,43.1,6803,16,136,0.018255034,34622,-27172
ZCTA5 75754,2910,11592,-8682,7961,45.5,7409,9,67,0.008416028,25935,-17974
ZCTA5 75755,1762,8049,-6287,4576,44.4,3983,6,527,0.115166084,23963,-19387
ZCTA5 75756,1599,8609,-7010,4403,38.4,3927,0,128,0.029071088,14745,-10342
ZCTA5 75757,4967,5619,-652,13699,40.5,11857,15,572,0.041754873,16551,-2852
ZCTA5 75758,3721,5631,-1910,9726,46,8735,24,199,0.020460621,17570,-7844
ZCTA5 75759,33,5175,-5142,110,37.5,16,0,47,0.427272727,11184,-11074
ZCTA5 75760,1118,5760,-4642,2481,47.7,2168,6,130,0.052398227,17822,-15341
ZCTA5 75762,5219,4104,1115,14609,39.2,10893,133,1668,0.114176193,13517,1092
ZCTA5 75763,2334,8882,-6548,6507,44.7,5577,23,286,0.043952666,28001,-21494
ZCTA5 75764,74,11357,-11283,208,31.3,167,0,0,0,34856,-34648
ZCTA5 75765,3059,13036,-9977,7705,49,6215,11,1143,0.14834523,35481,-27776
ZCTA5 75766,9562,22890,-13328,25577,36.2,17657,168,3401,0.132971029,67788,-42211
ZCTA5 75770,1010,5047,-4037,2517,50.3,2096,44,334,0.132697656,20191,-17674
ZCTA5 75771,7680,7328,352,21260,42.5,18958,281,1310,0.061618062,27529,-6269
ZCTA5 75773,5245,7087,-1842,13478,47.2,11454,60,655,0.048597715,27339,-13861
ZCTA5 75778,1038,15439,-14401,2443,45.2,1960,1,266,0.108882521,43182,-40739
ZCTA5 75779,0,11242,-11242,0,-,0,0,0,#DIV/0!,36537,-36537
ZCTA5 75780,123,16838,-16715,362,27.8,179,0,0,0,34456,-34094
ZCTA5 75782,20,7830,-7810,33,81.4,13,0,0,0,22940,-22907
ZCTA5 75783,3293,9186,-5893,8316,46,7344,14,112,0.013468013,31067,-22751
ZCTA5 75784,217,9358,-9141,768,41,473,0,286,0.372395833,32155,-31387
ZCTA5 75785,3389,859,2530,10813,38.5,8178,60,1860,0.172015167,1106,9707
ZCTA5 75788,28,7764,-7736,28,-,28,0,0,0,21316,-21288
ZCTA5 75789,3128,5242,-2114,8919,35.7,6989,15,1059,0.118735284,15397,-6478
ZCTA5 75790,1287,8433,-7146,3383,37.1,2880,0,152,0.044930535,29100,-25717
ZCTA5 75791,5005,1298,3707,14093,37.4,12729,158,588,0.041722841,4226,9867
ZCTA5 75792,1046,5515,-4469,3134,47.2,1839,0,747,0.238353542,14219,-11085
ZCTA5 75801,5930,8659,-2729,15740,35.2,9522,131,4616,0.293265565,30478,-14738
ZCTA5 75803,5845,11659,-5814,21941,39.8,15487,122,4009,0.182717287,21766,175
ZCTA5 75831,1871,14255,-12384,4981,40.1,3842,12,679,0.136318008,43603,-38622
ZCTA5 75833,933,9288,-8355,2223,52.7,1907,1,162,0.072874494,16356,-14133
ZCTA5 75835,4411,19708,-15297,11597,46.3,7474,62,3150,0.271621971,39463,-27866
ZCTA5 75838,143,8625,-8482,457,48.6,422,0,0,0,16349,-15892
ZCTA5 75839,1993,6026,-4033,6001,38,4746,62,435,0.072487919,18904,-12903
ZCTA5 75840,2321,13165,-10844,6504,37.2,5301,0,741,0.113929889,44625,-38121
ZCTA5 75844,1779,8482,-6703,4622,48.4,3582,0,974,0.210731285,24115,-19493
ZCTA5 75845,939,9627,-8688,2105,51.4,1972,0,83,0.039429929,25337,-23232
ZCTA5 75846,1128,17527,-16399,2786,36.4,2569,0,91,0.032663317,36204,-33418
ZCTA5 75847,554,14989,-14435,1635,43,1458,0,125,0.076452599,43907,-42272
ZCTA5 75848,35,13852,-13817,90,46.3,80,0,7,0.077777778,35703,-35613
ZCTA5 75849,43,9506,-9463,106,34.7,75,0,14,0.132075472,31486,-31380
ZCTA5 75850,499,8990,-8491,1544,51.4,1279,1,0,0,29719,-28175
ZCTA5 75851,840,3643,-2803,4956,42.2,3108,10,1302,0.262711864,10271,-5315
ZCTA5 75852,467,7326,-6859,3306,34.1,1820,18,1141,0.345130067,15323,-12017
ZCTA5 75853,343,17210,-16867,775,45.9,637,0,130,0.167741935,45349,-44574
ZCTA5 75855,1160,9492,-8332,2862,56.5,2085,0,654,0.22851153,26180,-23318
ZCTA5 75856,76,16915,-16839,173,22.3,173,0,0,0,54901,-54728
ZCTA5 75858,31,10872,-10841,46,51.9,46,0,0,0,36910,-36864
ZCTA5 75859,948,11620,-10672,2125,59,1803,0,179,0.084235294,35210,-33085
ZCTA5 75860,1665,11615,-9950,6248,39,4375,78,933,0.149327785,38421,-32173
ZCTA5 75861,731,8958,-8227,1727,40.4,1262,147,154,0.089171975,33049,-31322
ZCTA5 75862,4365,23644,-19279,10245,49.6,8279,12,971,0.09477794,53081,-42836
ZCTA5 75865,3,4554,-4551,3,-,3,0,0,0,15811,-15808
ZCTA5 75884,0,11891,-11891,3804,40.4,2028,0,1347,0.354100946,30626,-26822
ZCTA5 75886,0,14993,-14993,3193,43.2,1448,0,1240,0.388349515,48137,-44944
ZCTA5 75901,10313,15460,-5147,28979,35.7,20448,505,3533,0.12191587,42801,-13822
ZCTA5 75903,57,19124,-19067,98,45.9,43,0,55,0.56122449,49228,-49130
ZCTA5 75904,12687,19976,-7289,34663,35.3,24685,245,6233,0.179817096,71032,-36369
ZCTA5 75925,1316,31310,-29994,3446,35.1,2270,0,843,0.244631457,98697,-95251
ZCTA5 75926,522,4629,-4107,1220,42.4,1064,0,138,0.113114754,16792,-15572
ZCTA5 75928,420,7698,-7278,1070,52.2,281,0,778,0.727102804,27705,-26635
ZCTA5 75929,603,10750,-10147,1553,57.3,1527,0,0,0,38747,-37194
ZCTA5 75930,690,16019,-15329,1649,51.7,1637,0,0,0,51809,-50160
ZCTA5 75931,824,16075,-15251,1821,53.2,1705,10,44,0.024162548,50894,-49073
ZCTA5 75932,527,13032,-12505,1343,48.8,1119,0,175,0.130305287,33747,-32404
ZCTA5 75933,552,8328,-7776,1624,32.4,1357,79,121,0.074507389,23791,-22167
ZCTA5 75934,56,12624,-12568,195,39.1,78,0,110,0.564102564,34390,-34195
ZCTA5 75935,4439,11406,-6967,12426,39.2,8768,99,2406,0.193626268,42808,-30382
ZCTA5 75936,291,2890,-2599,967,41.4,792,0,115,0.118924509,8143,-7176
ZCTA5 75937,444,22766,-22322,1298,40,1059,6,182,0.140215716,65603,-64305
ZCTA5 75938,944,13688,-12744,2217,51,2134,4,0,0,33892,-31675
ZCTA5 75939,1604,7426,-5822,5440,40.6,3565,56,779,0.143198529,12524,-7084
ZCTA5 75941,2484,14553,-12069,8470,40.8,5455,95,1458,0.172136954,46114,-37644
ZCTA5 75942,39,0,39,171,42.3,171,0,0,0,0,171
ZCTA5 75943,421,9219,-8798,1171,39.5,1045,19,93,0.0794193,31298,-30127
ZCTA5 75944,421,5931,-5510,904,56,864,7,0,0,17637,-16733
ZCTA5 75946,1466,5604,-4138,3714,40.3,2936,12,650,0.175013463,16629,-12915
ZCTA5 75948,2570,8569,-5999,5595,58.1,4809,124,331,0.059159964,21155,-15560
ZCTA5 75949,3290,3638,-348,8469,43,7891,8,254,0.029991735,11973,-3504
ZCTA5 75951,5691,5532,159,15026,42.5,9334,131,4303,0.286370291,15082,-56
ZCTA5 75954,1006,5127,-4121,2550,47,2320,5,108,0.042352941,13446,-10896
ZCTA5 75956,3167,9311,-6144,8275,43.1,6645,0,876,0.105861027,36204,-27929
ZCTA5 75959,245,0,245,742,41,690,0,0,0,0,742
ZCTA5 75960,205,6928,-6723,606,38.8,308,0,48,0.079207921,19844,-19238
ZCTA5 75961,6276,4692,1584,14909,32,8724,12,4831,0.324032464,15823,-914
ZCTA5 75962,0,2502,-2502,3149,20,2453,22,484,0.153699587,6060,-2911
ZCTA5 75964,6775,45,6730,19889,34.7,12530,249,3307,0.166272814,143,19746
ZCTA5 75965,7619,1060,6559,18231,28.4,13943,347,2567,0.140804125,2860,15371
ZCTA5 75966,1540,4269,-2729,4462,42,2924,6,1120,0.251008516,12116,-7654
ZCTA5 75968,855,11411,-10556,2235,39.3,1978,0,167,0.074720358,33298,-31063
ZCTA5 75969,1434,15294,-13860,3719,48.7,3256,3,384,0.103253563,38532,-34813
ZCTA5 75972,2492,9072,-6580,6190,48.1,3801,4,1837,0.296768982,26017,-19827
ZCTA5 75973,1111,0,1111,2809,41.7,2441,0,362,0.128871485,456,2353
ZCTA5 75974,1194,9566,-8372,3296,35.7,2014,0,957,0.290351942,28029,-24733
ZCTA5 75975,1319,17368,-16049,3868,35.2,2765,18,826,0.213547053,53077,-49209
ZCTA5 75976,347,34,313,1239,26.9,950,0,119,0.096045198,96,1143
ZCTA5 75977,158,11835,-11677,378,38.6,112,0,259,0.685185185,32780,-32402
ZCTA5 75979,3519,9793,-6274,12023,39.6,9291,89,1946,0.161856442,30449,-18426
ZCTA5 75980,1009,8114,-7105,2407,45.7,2325,11,0,0,24317,-21910
ZCTA5 76001,11238,9656,1582,37134,34.7,20500,1704,9963,0.268298594,24116,13018
ZCTA5 76002,9625,6173,3452,34402,32.4,13522,3550,12675,0.368437882,18831,15571
ZCTA5 76005,1267,1935,-668,3967,36.6,2394,661,746,0.188051424,4763,-796
ZCTA5 76006,12127,289,11838,24547,32.4,10711,1419,8782,0.357762659,864,23683
ZCTA5 76008,7224,2253,4971,22091,36.6,19991,243,330,0.01493821,4771,17320
ZCTA5 76009,6814,1576,5238,20751,37.2,17653,28,713,0.03435979,5225,15526
ZCTA5 76010,17995,1187,16808,57448,26.8,25169,2355,9230,0.160667038,3202,54246
ZCTA5 76011,9863,905,8958,21701,30.7,10326,610,6736,0.310400442,2526,19175
ZCTA5 76012,10905,8779,2126,28750,39.1,18056,1042,4974,0.173008696,26967,1783
ZCTA5 76013,13098,68,13030,34457,32.9,23730,2121,4665,0.135386133,210,34247
ZCTA5 76014,10639,71,10568,32460,31,12448,2678,8298,0.255637708,118,32342
ZCTA5 76015,6226,388,5838,17629,31.9,9881,839,3314,0.187985705,1023,16606
ZCTA5 76016,11043,2690,8353,31008,42.5,22618,2198,2993,0.096523478,8025,22983
ZCTA5 76017,15906,4008,11898,45429,38.3,26729,2958,9347,0.205749631,12339,33090
ZCTA5 76018,8375,17928,-9553,28553,31.3,11778,4438,8369,0.293104052,55351,-26798
ZCTA5 76020,11697,146,11551,32443,39.5,29705,150,274,0.008445581,418,32025
ZCTA5 76021,14596,13307,1289,35401,38.3,25035,2142,3826,0.108076043,40815,-5414
ZCTA5 76022,5717,150,5567,14224,37.1,8510,953,2651,0.186375141,478,13746
ZCTA5 76023,2430,9284,-6854,7203,41.2,6674,0,17,0.002360128,29269,-22066
ZCTA5 76028,25330,4793,20537,74217,37.4,60602,1267,4199,0.056577334,14590,59627
ZCTA5 76031,6163,23709,-17546,18996,35.9,17089,137,581,0.030585386,71184,-52188
ZCTA5 76033,9925,9919,6,26174,39.1,22131,296,1269,0.048483228,23584,2590
ZCTA5 76034,9002,13664,-4662,25717,46.5,21511,1688,559,0.021736594,36405,-10688
ZCTA5 76035,897,11781,-10884,2844,36.4,2296,18,390,0.137130802,35585,-32741
ZCTA5 76036,9607,4985,4622,29594,35.2,18765,659,6295,0.212712036,11768,17826
ZCTA5 76039,17165,6567,10598,40657,35.8,22437,4950,6471,0.159160784,19572,21085
ZCTA5 76040,11623,12514,-891,30787,34.5,14774,4398,6835,0.22200929,38004,-7217
ZCTA5 76041,173,13757,-13584,370,48.9,317,0,0,0,40457,-40087
ZCTA5 76043,2410,7284,-4874,7094,44.9,5543,97,140,0.019734987,22627,-15533
ZCTA5 76044,2331,13206,-10875,6466,37.5,5479,242,328,0.050726879,43861,-37395
ZCTA5 76048,10566,6481,4085,25691,44.3,23401,112,303,0.011794013,17522,8169
ZCTA5 76049,11845,10567,1278,29154,51.4,27178,248,36,0.001234822,34513,-5359
ZCTA5 76050,2483,9076,-6593,6760,41.3,6386,4,6,0.000887574,29180,-22420
ZCTA5 76051,20488,61,20427,50066,38.7,37181,3344,3260,0.065114049,96,49970
ZCTA5 76052,8180,8607,-427,26240,35,20414,200,2353,0.089672256,23618,2622
ZCTA5 76053,11202,35,11167,31513,35.6,20621,1620,3407,0.108114112,166,31347
ZCTA5 76054,4650,845,3805,11989,42.9,9711,740,571,0.047626991,2451,9538
ZCTA5 76055,1126,3796,-2670,3255,42.2,2586,0,161,0.049462366,9120,-5865
ZCTA5 76058,7054,439,6615,20702,34.5,19010,28,151,0.007293981,1218,19484
ZCTA5 76059,1589,639,950,4982,26.7,4277,181,125,0.025090325,1780,3202
ZCTA5 76060,2908,4784,-1876,8183,44.4,5913,531,1272,0.155444214,12919,-4736
ZCTA5 76061,79,2762,-2683,262,32.5,262,0,0,0,9342,-9080
ZCTA5 76063,24778,785,23993,76867,37.7,49607,2713,15938,0.207345155,1864,75003
ZCTA5 76064,702,0,702,1999,44.5,1518,0,45,0.022511256,0,1999
ZCTA5 76065,13446,23632,-10186,40814,36.3,32969,257,3599,0.088180526,71439,-30625
ZCTA5 76066,1547,844,703,5030,34.5,3984,17,0,0,2287,2743
ZCTA5 76067,7037,15,7022,20420,36.8,17417,251,706,0.034573947,66,20354
ZCTA5 76070,307,15083,-14776,814,25,814,0,0,0,51200,-50386
ZCTA5 76071,1346,1716,-370,4242,33.1,3571,41,166,0.039132485,4910,-668
ZCTA5 76073,2231,1674,557,6443,42.3,6082,15,31,0.004811423,4465,1978
ZCTA5 76077,183,0,183,491,51.4,425,0,50,0.101832994,0,491
ZCTA5 76078,2974,5736,-2762,8753,37.4,7503,48,82,0.009368217,16975,-8222
ZCTA5 76082,7281,0,7281,22082,37.8,19568,109,89,0.004030432,0,22082
ZCTA5 76084,2967,1864,1103,10375,33.6,7513,298,803,0.07739759,5217,5158
ZCTA5 76085,3695,358,3337,11143,43.2,10131,100,31,0.002782016,774,10369
ZCTA5 76086,8301,114,8187,21054,35,17789,103,1038,0.049301795,134,20920
ZCTA5 76087,10920,277,10643,28779,43.5,25608,386,393,0.013655791,944,27835
ZCTA5 76088,5154,4279,875,14669,43.7,13651,38,15,0.001022565,12165,2504
ZCTA5 76092,9454,1028,8426,31276,42,24097,5521,245,0.007833483,5156,26120
ZCTA5 76093,1291,3848,-2557,3239,44.5,3100,0,0,0,12555,-9316
ZCTA5 76102,3897,52,3845,10650,35.6,7234,315,2074,0.194741784,144,10506
ZCTA5 76103,5364,26855,-21491,17363,30.7,7943,227,3294,0.189713759,90599,-73236
ZCTA5 76104,7178,23249,-16071,18956,32.9,7337,432,5945,0.313621017,69622,-50666
ZCTA5 76105,6934,35,6899,24277,27.6,5230,35,8388,0.345512213,63,24214
ZCTA5 76106,10809,107,10702,37437,30,15219,380,3087,0.08245853,370,37067
ZCTA5 76107,15053,108,14945,29929,37.4,21419,748,3850,0.128637776,356,29573
ZCTA5 76108,16071,652,15419,44125,36,32439,675,3076,0.069711048,1936,42189
ZCTA5 76109,9528,528,9000,24606,31.7,19805,1400,1231,0.050028448,1179,23427
ZCTA5 76110,11280,226,11054,33505,32.1,21014,411,635,0.018952395,527,32978
ZCTA5 76111,7298,158,7140,21591,33.6,12019,625,738,0.034180909,432,21159
ZCTA5 76112,17012,18082,-1070,42404,34.1,15309,1364,17594,0.414913687,55975,-13571
ZCTA5 76114,9572,28,9544,27683,34.6,19113,99,692,0.024997291,91,27592
ZCTA5 76115,6125,3327,2798,21824,28.6,10678,1082,1931,0.088480572,9294,12530
ZCTA5 76116,22075,74,22001,49319,34.5,32191,1090,9466,0.191934143,195,49124
ZCTA5 76117,10991,2579,8412,32438,34.2,18560,2426,2064,0.063629077,6884,25554
ZCTA5 76118,5740,315,5425,16674,38.2,11203,1039,1343,0.08054456,1017,15657
ZCTA5 76119,14645,42,14603,51037,32.1,15046,1980,20039,0.392636715,85,50952
ZCTA5 76120,7592,149,7443,20518,34.9,7777,1005,8719,0.424943952,217,20301
ZCTA5 76123,11887,10531,1356,38575,34.1,14783,2725,16089,0.417083603,34697,3878
ZCTA5 76126,8922,103,8819,24946,38,20089,394,592,0.02373126,250,24696
ZCTA5 76127,45,11485,-11440,1781,33,1451,19,116,0.065131948,35604,-33823
ZCTA5 76129,0,48,-48,1700,19.5,1200,98,271,0.159411765,72,1628
ZCTA5 76131,15471,4535,10936,47569,33,27925,4686,6180,0.129916542,12956,34613
ZCTA5 76132,12615,357,12258,26437,34.7,16409,1892,5294,0.20024965,767,25670
ZCTA5 76133,19012,96,18916,54186,33,31511,1788,11760,0.217030229,265,53921
ZCTA5 76134,9800,12556,-2756,29208,32.4,13472,1345,9233,0.316112024,35342,-6134
ZCTA5 76135,7682,8270,-588,18939,39.3,15242,124,1006,0.053117905,23541,-4602
ZCTA5 76137,21343,23044,-1701,59273,33.5,36095,6563,7226,0.121910482,74399,-15126
ZCTA5 76140,9767,2828,6939,31703,32.1,14097,469,10907,0.344036842,8069,23634
ZCTA5 76148,7965,1,7964,24578,36.4,17701,1809,1199,0.048783465,2,24576
ZCTA5 76155,3354,623,2731,6427,30.9,2424,1105,2233,0.347440485,2125,4302
ZCTA5 76164,4283,120,4163,14081,35.1,6789,8,213,0.015126767,368,13713
ZCTA5 76177,7730,3571,4159,19320,32.5,12631,1610,1613,0.083488613,10921,8399
ZCTA5 76179,23515,1410,22105,70425,34.4,49906,1952,6049,0.085892794,3637,66788
ZCTA5 76180,14909,2425,12484,36974,37.4,25629,1751,3037,0.0821388,6538,30436
ZCTA5 76182,11294,5454,5840,30911,42.5,25802,1049,1106,0.035780143,14659,16252
ZCTA5 76201,11076,11518,-442,28415,23.6,20137,1871,3608,0.126975189,35577,-7162
ZCTA5 76203,0,7090,-7090,1178,18.2,463,293,262,0.222410866,22695,-21517
ZCTA5 76205,7612,20042,-12430,20365,29.1,13365,800,3194,0.156837712,64378,-44013
ZCTA5 76207,6254,15197,-8943,15961,39.7,12240,242,1169,0.073241025,52084,-36123
ZCTA5 76208,8281,10693,-2412,26598,33.1,19172,848,2857,0.107414091,36263,-9665
ZCTA5 76209,10316,7659,2657,26660,31.2,19423,462,2551,0.095686422,23914,2746
ZCTA5 76210,15670,8534,7136,44367,38.5,33377,1845,3529,0.0795411,24514,19853
ZCTA5 76225,1271,8147,-6876,3193,44.4,3081,0,13,0.004071406,23243,-20050
ZCTA5 76226,11659,10531,1128,34829,40.7,29851,1471,1110,0.031869993,36710,-1881
ZCTA5 76227,15459,0,15459,43088,35.1,31758,480,5936,0.137764575,0,43088
ZCTA5 76228,488,5324,-4836,1210,45.6,1130,0,9,0.007438017,14482,-13272
ZCTA5 76230,3972,15825,-11853,9921,42.6,9259,0,90,0.009071666,46850,-36929
ZCTA5 76233,1257,1570,-313,3535,40.6,3101,28,13,0.003677511,4044,-509
ZCTA5 76234,6671,9667,-2996,19147,38.5,16066,101,241,0.012586828,29133,-9986
ZCTA5 76238,124,1938,-1814,332,52.5,282,0,0,0,5840,-5508
ZCTA5 76239,483,2713,-2230,1080,50.2,1050,0,18,0.016666667,7692,-6612
ZCTA5 76240,11487,429,11058,29209,37.4,24147,290,1164,0.039850731,1235,27974
ZCTA5 76241,4,11981,-11977,9,-,9,0,0,0,37165,-37156
ZCTA5 76244,23997,16905,7092,74884,34.5,55910,5900,6242,0.08335559,49294,25590
ZCTA5 76245,808,5669,-4861,1731,58.5,1530,85,0,0,18047,-16316
ZCTA5 76247,5496,9018,-3522,16511,37.8,12570,92,1226,0.074253528,30853,-14342
ZCTA5 76248,14267,5496,8771,40553,42.6,34474,2385,1022,0.025201588,15502,25051
ZCTA5 76249,3256,8862,-5606,9235,36.8,8177,98,227,0.024580401,26356,-17121
ZCTA5 76250,418,296,122,1026,49.3,1018,0,0,0,866,160
ZCTA5 76251,241,979,-738,700,42.4,676,0,12,0.017142857,2932,-2232
ZCTA5 76252,935,9213,-8278,2424,45.6,2372,25,0,0,30816,-28392
ZCTA5 76253,105,10517,-10412,348,39.3,312,0,0,0,30891,-30543
ZCTA5 76255,2174,422,1752,5514,43.6,4877,0,8,0.001450852,1185,4329
ZCTA5 76258,2650,13725,-11075,7056,45.8,5401,12,293,0.041524943,39360,-32304
ZCTA5 76259,2078,6251,-4173,5469,36.8,4614,94,364,0.066556957,17486,-12017
ZCTA5 76261,90,5504,-5414,244,37.5,231,0,0,0,19440,-19196
ZCTA5 76262,14188,16316,-2128,40159,36.5,30670,2501,1154,0.028735775,47815,-7656
ZCTA5 76263,4,2751,-2747,14,75.5,14,0,0,0,9975,-9961
ZCTA5 76264,539,10113,-9574,1203,47,1015,43,0,0,22252,-21049
ZCTA5 76265,609,7284,-6675,1529,42.8,1439,0,0,0,18629,-17100
ZCTA5 76266,6339,3982,2357,17658,42.6,15417,273,704,0.039868615,9309,8349
ZCTA5 76267,13,350,-337,49,26.3,49,0,0,0,968,-919
ZCTA5 76268,49,57,-8,131,35.6,131,0,0,0,86,45
ZCTA5 76270,682,3614,-2932,1697,52.6,1556,0,13,0.007660577,10861,-9164
ZCTA5 76271,652,3698,-3046,1873,43.7,1814,8,0,0,9488,-7615
ZCTA5 76272,1788,683,1105,4799,49.4,4485,4,6,0.00125026,1911,2888
ZCTA5 76273,3814,2541,1273,9922,39.7,8917,186,102,0.010280185,5683,4239
ZCTA5 76301,6060,10467,-4407,15062,34.5,9103,57,3380,0.224405789,28291,-13229
ZCTA5 76302,4893,5323,-430,11423,35.6,8603,515,1180,0.103300359,14556,-3133
ZCTA5 76305,1923,12119,-10196,4639,46.6,3758,196,99,0.021340806,35787,-31148
ZCTA5 76306,5634,25686,-20052,14781,34.3,10343,202,2129,0.144036263,71418,-56637
ZCTA5 76308,8327,5293,3034,20028,32.2,15707,372,1874,0.093569003,15878,4150
ZCTA5 76309,5617,568,5049,14082,37.1,10602,367,915,0.064976566,1377,12705
ZCTA5 76310,7514,4640,2874,19279,38,15604,741,879,0.045593651,13113,6166
ZCTA5 76311,636,131,505,8037,20.9,5596,311,1122,0.13960433,383,7654
ZCTA5 76351,790,15144,-14354,1895,38.4,1779,0,9,0.00474934,41981,-40086
ZCTA5 76354,4823,6617,-1794,11825,43.7,10576,56,270,0.022832981,29698,-17873
ZCTA5 76357,191,24231,-24040,466,48.4,449,0,0,0,71277,-70811
ZCTA5 76360,1205,513,692,2805,45.4,2457,12,50,0.017825312,1412,1393
ZCTA5 76363,105,8066,-7961,294,44.6,169,4,81,0.275510204,21563,-21269
ZCTA5 76364,89,4832,-4743,217,39.9,214,2,0,0,16648,-16431
ZCTA5 76365,1822,10870,-9048,4491,44.3,4147,44,28,0.006234692,30607,-26116
ZCTA5 76366,804,5257,-4453,2036,38.7,1896,0,0,0,13123,-11087
ZCTA5 76367,3918,152,3766,13471,40.2,10943,10,1500,0.111350308,400,13071
ZCTA5 76370,158,9945,-9787,447,41.6,383,0,0,0,24074,-23627
ZCTA5 76371,562,2874,-2312,1568,41.1,1121,0,66,0.042091837,8481,-6913
ZCTA5 76372,397,3234,-2837,1051,34.8,972,0,5,0.004757374,8376,-7325
ZCTA5 76373,61,309,-248,185,52.4,178,0,0,0,740,-555
ZCTA5 76374,1607,183,1424,3595,39.3,3256,35,14,0.003894298,502,3093
ZCTA5 76377,206,342,-136,399,58.2,379,0,0,0,853,-454
ZCTA5 76379,186,424,-238,580,30.2,487,0,22,0.037931034,1035,-455
ZCTA5 76380,1518,96,1422,3517,47.1,3009,0,144,0.040943986,155,3362
ZCTA5 76384,4354,6501,-2147,12304,36.8,8684,413,989,0.080380364,16001,-3697
ZCTA5 76388,88,489,-401,234,49.5,187,0,0,0,1519,-1285
ZCTA5 76389,511,254,257,1528,41.6,1452,0,0,0,809,719
ZCTA5 76401,10806,533,10273,29724,29.1,25717,418,527,0.017729781,1314,28410
ZCTA5 76402,0,3057,-3057,606,19.8,466,22,77,0.127062706,8030,-7424
ZCTA5 76424,3081,8589,-5508,8552,39.3,7179,85,294,0.034377923,21746,-13194
ZCTA5 76426,3864,273,3591,11350,41.4,9900,23,330,0.02907489,803,10547
ZCTA5 76427,348,10651,-10303,1018,32.7,983,10,2,0.001964637,26984,-25966
ZCTA5 76429,78,8698,-8620,106,67,106,0,0,0,24410,-24304
ZCTA5 76430,944,6718,-5774,2340,45.5,2168,1,7,0.002991453,16447,-14107
ZCTA5 76431,1577,13905,-12328,4376,37.2,4199,0,57,0.013025594,37560,-33184
ZCTA5 76432,430,610,-180,1086,52.5,1022,9,0,0,1477,-391
ZCTA5 76433,691,4869,-4178,1934,52.1,1758,0,0,0,12971,-11037
ZCTA5 76435,188,113,75,451,53,364,0,0,0,319,132
ZCTA5 76436,54,6767,-6713,114,46.5,114,0,0,0,17353,-17239
ZCTA5 76437,2005,7321,-5316,5593,37.5,5239,12,56,0.010012516,20317,-14724
ZCTA5 76439,0,1823,-1823,0,-,0,0,0,#DIV/0!,4677,-4677
ZCTA5 76442,2825,499,2326,7697,45,6159,44,51,0.006625958,1222,6475
ZCTA5 76443,809,237,572,2019,41.1,1893,0,0,0,871,1148
ZCTA5 76444,1366,10180,-8814,3477,41.9,2889,11,10,0.002876043,26756,-23279
ZCTA5 76445,73,395,-322,229,29.6,206,0,0,0,881,-652
ZCTA5 76446,3113,1260,1853,8876,39.3,7339,1,1,0.000112663,3228,5648
ZCTA5 76448,2058,2223,-165,4991,51.9,4506,41,173,0.034662392,5424,-433
ZCTA5 76449,1029,5521,-4492,2339,57.3,2232,19,0,0,15453,-13114
ZCTA5 76450,5399,1095,4304,13090,42,11989,10,205,0.01566081,2583,10507
ZCTA5 76452,53,5666,-5613,111,56.5,111,0,0,0,16240,-16129
ZCTA5 76453,680,9984,-9304,1515,58.6,1477,0,0,0,40192,-38677
ZCTA5 76454,664,12800,-12136,1856,43.5,1621,0,22,0.011853448,28379,-26523
ZCTA5 76455,332,6469,-6137,847,44.9,682,0,0,0,17055,-16208
ZCTA5 76457,1478,4297,-2819,4194,40.1,3812,9,6,0.001430615,10889,-6695
ZCTA5 76458,2003,4739,-2736,5930,39.3,5217,0,366,0.061720067,11736,-5806
ZCTA5 76459,52,5918,-5866,166,40.9,164,0,0,0,13826,-13660
ZCTA5 76460,144,9920,-9776,391,47.1,391,0,0,0,23804,-23413
ZCTA5 76462,1557,8810,-7253,4914,39,4578,9,0,0,30378,-25464
ZCTA5 76463,204,3457,-3253,575,51.4,493,0,0,0,10895,-10320
ZCTA5 76464,197,3999,-3802,381,59.9,361,5,0,0,11008,-10627
ZCTA5 76466,99,1164,-1065,523,24.5,450,0,0,0,2646,-2123
ZCTA5 76469,40,1328,-1288,86,65,86,0,0,0,4139,-4053
ZCTA5 76470,1379,9990,-8611,3432,35.8,2918,27,109,0.031759907,28399,-24967
ZCTA5 76471,646,891,-245,1500,51.4,1288,0,39,0.026,2059,-559
ZCTA5 76472,474,4170,-3696,1305,50.5,1249,0,0,0,11722,-10417
ZCTA5 76474,104,689,-585,286,51.7,216,0,0,0,1697,-1411
ZCTA5 76475,391,19179,-18788,1031,37.7,984,0,0,0,55364,-54333
ZCTA5 76476,1166,17881,-16715,3406,39.8,3169,21,21,0.00616559,49208,-45802
ZCTA5 76481,70,443,-373,233,16.9,233,0,0,0,1027,-794
ZCTA5 76483,383,34,349,868,48.1,824,0,5,0.005760369,86,782
ZCTA5 76484,281,1661,-1380,699,54.2,612,0,30,0.042918455,4566,-3867
ZCTA5 76486,431,350,81,1018,43.5,947,40,0,0,1019,-1
ZCTA5 76487,931,2389,-1458,2833,35.9,2565,0,35,0.012354395,6720,-3887
ZCTA5 76490,31,957,-926,54,41.8,54,0,0,0,2861,-2807
ZCTA5 76491,185,2203,-2018,482,34.8,424,0,0,0,6875,-6393
ZCTA5 76501,6595,631,5964,17357,36.8,11375,88,3118,0.179639339,1473,15884
ZCTA5 76502,16488,28,16460,45515,34.6,34961,862,4026,0.088454356,83,45432
ZCTA5 76504,9722,4127,5595,23916,32.6,15154,324,4647,0.194305068,14398,9518
ZCTA5 76511,872,1343,-471,2497,39.7,1858,0,254,0.101722066,3373,-876
ZCTA5 76513,14535,605,13930,42610,32.6,31678,1053,2387,0.056019714,1607,41003
ZCTA5 76518,522,616,-94,1536,40,1225,15,160,0.104166667,1504,32
ZCTA5 76519,127,60,67,250,59.9,250,0,0,0,67,183
ZCTA5 76520,2815,194,2621,7692,38,5846,84,954,0.124024961,657,7035
ZCTA5 76522,14682,1829,12853,40050,33.5,25320,851,6534,0.163146067,4399,35651
ZCTA5 76523,111,662,-551,397,43.4,340,0,13,0.032745592,1596,-1199
ZCTA5 76524,1292,15237,-13945,3813,45.2,2858,101,81,0.021243116,42032,-38219
ZCTA5 76525,461,9756,-9295,1160,41.9,1050,5,0,0,24884,-23724
ZCTA5 76527,1583,4973,-3390,4262,39.2,3592,0,39,0.009150634,14365,-10103
ZCTA5 76528,6762,100,6662,19355,39.3,15871,229,781,0.04035133,174,19181
ZCTA5 76530,966,756,210,2277,47,1867,0,123,0.054018445,2256,21
ZCTA5 76531,1461,3330,-1869,4516,44.6,4113,0,10,0.002214349,11159,-6643
ZCTA5 76534,1108,2945,-1837,2953,45.2,2749,3,75,0.0253979,8263,-5310
ZCTA5 76537,3474,0,3474,10273,32.5,7658,422,439,0.042733379,0,10273
ZCTA5 76538,471,45,426,1119,50.8,956,0,10,0.00893655,103,1016
ZCTA5 76539,3189,1418,1771,8665,46.1,6704,62,767,0.088517023,3784,4881
ZCTA5 76541,7908,2367,5541,18521,31.6,9594,458,5194,0.280438421,5692,12829
ZCTA5 76542,18486,3250,15236,50527,31.9,18254,3097,19792,0.391711362,8059,42468
ZCTA5 76543,12893,912,11981,33350,29.3,13368,1176,13374,0.40101949,2553,30797
ZCTA5 76544,3291,78,3213,24872,21.7,15815,904,4662,0.187439691,200,24672
ZCTA5 76548,11250,104,11146,31759,33.4,17049,1242,9166,0.288611102,265,31494
ZCTA5 76549,18619,192,18427,53138,28.6,21114,1534,21003,0.395253867,548,52590
ZCTA5 76550,5097,17,5080,13789,41,11841,176,234,0.016970049,54,13735
ZCTA5 76554,840,192,648,2360,32.7,1809,84,28,0.011864407,490,1870
ZCTA5 76556,716,785,-69,1863,36.8,1539,0,245,0.13150832,1918,-55
ZCTA5 76557,2089,67,2022,6063,39.4,4986,133,242,0.039914234,156,5907
ZCTA5 76559,2369,159,2210,6260,33.6,4886,57,983,0.157028754,463,5797
ZCTA5 76561,442,267,175,1259,42.2,1107,4,10,0.007942812,716,543
ZCTA5 76565,52,6374,-6322,115,44.8,115,0,0,0,17577,-17462
ZCTA5 76566,125,458,-333,345,43.7,335,0,0,0,1195,-850
ZCTA5 76567,3717,700,3017,8790,44.3,7295,59,762,0.08668942,1868,6922
ZCTA5 76569,894,1732,-838,3174,38.7,2528,35,50,0.015752993,4247,-1073
ZCTA5 76570,904,65,839,2661,36.8,2238,0,159,0.059751973,139,2522
ZCTA5 76571,3394,152,3242,9384,44.4,8398,85,8,0.000852515,570,8814
ZCTA5 76573,12,292,-280,32,66.4,32,0,0,0,703,-671
ZCTA5 76574,7438,97,7341,19126,41.5,13491,178,1082,0.056572205,332,18794
ZCTA5 76577,1255,154,1101,3120,38.5,2686,0,150,0.048076923,268,2852
ZCTA5 76578,544,186,358,1453,42.3,1089,0,31,0.021335169,400,1053
ZCTA5 76579,2086,3709,-1623,7068,31.3,6013,0,130,0.018392756,9222,-2154
ZCTA5 76596,0,0,0,1271,39.1,686,0,256,0.201416208,0,1271
ZCTA5 76597,0,2454,-2454,3304,41.2,1524,17,994,0.300847458,8556,-5252
ZCTA5 76598,0,3610,-3610,570,38.2,312,6,174,0.305263158,8316,-7746
ZCTA5 76599,0,449,-449,1681,38.6,810,4,348,0.207019631,1288,393
ZCTA5 76621,366,153,213,1025,35.4,1006,3,2,0.00195122,289,736
ZCTA5 76622,546,10568,-10022,1734,36.1,1672,0,48,0.027681661,27475,-25741
ZCTA5 76623,69,27,42,223,38.9,181,0,0,0,74,149
ZCTA5 76624,876,147,729,2522,45.3,2129,0,29,0.01149881,357,2165
ZCTA5 76626,491,2649,-2158,1309,37.3,1192,0,11,0.008403361,7958,-6649
ZCTA5 76627,572,1121,-549,1499,43.5,1414,0,6,0.004002668,2663,-1164
ZCTA5 76628,33,626,-593,110,40.5,78,0,4,0.036363636,1652,-1542
ZCTA5 76629,758,175,583,1781,48.5,1329,0,283,0.158899495,454,1327
ZCTA5 76630,664,2033,-1369,1683,45,1631,0,0,0,5316,-3633
ZCTA5 76631,170,1435,-1265,636,34.4,436,3,130,0.204402516,5391,-4755
ZCTA5 76632,534,3409,-2875,1627,43.8,940,0,314,0.192993239,9762,-8135
ZCTA5 76633,1989,3388,-1399,6286,41.2,5713,79,149,0.023703468,9825,-3539
ZCTA5 76634,2838,1023,1815,7207,49.2,6442,36,105,0.014569169,4452,2755
ZCTA5 76635,498,478,20,1498,31.1,1131,0,200,0.133511348,1436,62
ZCTA5 76636,540,62,478,1507,40.3,1388,29,0,0,268,1239
ZCTA5 76637,181,1612,-1431,369,47.4,350,0,6,0.016260163,4631,-4262
ZCTA5 76638,1066,8493,-7427,3095,42.3,2943,2,112,0.036187399,26128,-23033
ZCTA5 76639,676,506,170,1638,46.5,1250,6,126,0.076923077,1125,513
ZCTA5 76640,1136,2013,-877,3140,34.9,2891,0,10,0.003184713,4936,-1796
ZCTA5 76641,602,2083,-1481,1768,45.2,1511,0,47,0.02658371,5731,-3963
ZCTA5 76642,2105,130,1975,5917,43.7,4071,124,1005,0.169849586,267,5650
ZCTA5 76643,5655,16149,-10494,15707,36.4,12844,535,942,0.05997326,39183,-23476
ZCTA5 76645,3859,0,3859,10762,36.7,7250,142,1335,0.124047575,0,10762
ZCTA5 76648,997,595,402,2554,48.9,2175,34,141,0.055207518,1618,936
ZCTA5 76649,276,11702,-11426,596,57.8,565,0,1,0.001677852,41281,-40685
ZCTA5 76650,48,13218,-13170,160,35.9,152,0,0,0,45082,-44922
ZCTA5 76651,1467,11573,-10106,3984,38.5,2777,7,529,0.132781124,43155,-39171
ZCTA5 76652,449,71,378,1169,50.1,1086,0,0,0,93,1076
ZCTA5 76653,533,15721,-15188,1409,42.7,1254,0,100,0.070972321,56056,-54647
ZCTA5 76654,82,14298,-14216,184,38.5,183,0,1,0.005434783,63268,-63084
ZCTA5 76655,2946,281,2665,8616,40.1,7676,89,210,0.024373259,655,7961
ZCTA5 76656,860,2138,-1278,2671,37.7,2284,0,152,0.056907525,6525,-3854
ZCTA5 76657,4013,718,3295,11723,37.8,10110,41,257,0.021922716,1863,9860
ZCTA5 76660,200,726,-526,663,26.5,482,0,43,0.064856712,1784,-1121
ZCTA5 76661,2145,315,1830,7388,38.6,3565,215,3099,0.419463996,962,6426
ZCTA5 76664,1280,432,848,4015,35.4,3010,6,780,0.194271482,1027,2988
ZCTA5 76665,1117,1820,-703,2838,47.3,2472,19,72,0.025369979,5192,-2354
ZCTA5 76666,66,0,66,171,42.8,156,0,0,0,0,171
ZCTA5 76667,3701,3400,301,10385,38.5,6265,98,2373,0.228502648,11679,-1294
ZCTA5 76670,538,3705,-3167,1815,36.3,1320,0,203,0.11184573,9329,-7514
ZCTA5 76671,647,4691,-4044,1635,55.6,1405,3,9,0.005504587,13391,-11756
ZCTA5 76673,377,3677,-3300,1253,36.5,898,0,108,0.086193136,12306,-11053
ZCTA5 76676,104,241,-137,260,41.8,239,1,0,0,873,-613
ZCTA5 76678,43,215,-172,77,63.3,77,0,0,0,483,-406
ZCTA5 76679,330,1619,-1289,1067,38.2,954,0,0,0,5462,-4395
ZCTA5 76680,34,5008,-4974,165,45.1,127,0,0,0,14151,-13986
ZCTA5 76681,211,1100,-889,550,34.5,435,0,64,0.116363636,4506,-3956
ZCTA5 76682,1077,256,821,3182,35.4,2862,15,101,0.031741043,604,2578
ZCTA5 76685,28,2227,-2199,43,79.1,0,0,34,0.790697674,7434,-7391
ZCTA5 76686,104,47,57,222,53.9,179,0,36,0.162162162,98,124
ZCTA5 76687,827,4085,-3258,1915,55.7,1800,0,36,0.018798956,13400,-11485
ZCTA5 76689,1446,2760,-1314,3878,38.3,3344,0,55,0.014182568,8216,-4338
ZCTA5 76690,413,7240,-6827,1200,33.5,993,0,10,0.008333333,27462,-26262
ZCTA5 76691,2427,50,2377,6357,43.3,5362,7,211,0.033191757,199,6158
ZCTA5 76692,3839,102,3737,9508,52.1,8810,77,204,0.021455616,271,9237
ZCTA5 76693,808,9275,-8467,2170,43.3,1602,0,341,0.157142857,28572,-26402
ZCTA5 76701,759,11648,-10889,1953,32.3,1458,21,329,0.168458781,36406,-34453
ZCTA5 76704,3287,1985,1302,7791,27.9,2080,0,5324,0.683352586,7724,67
ZCTA5 76705,11109,1033,10076,31902,34.7,20605,470,6044,0.189455207,2548,29354
ZCTA5 76706,14079,7082,6997,39488,23.5,27521,903,5744,0.145461912,20411,19077
ZCTA5 76707,5808,131,5677,16430,29.8,8470,106,4699,0.286001217,330,16100
ZCTA5 76708,9508,283,9225,26155,35.5,17787,628,4291,0.164060409,743,25412
ZCTA5 76710,10705,1139,9566,23385,39.2,16448,262,4162,0.177977336,3994,19391
ZCTA5 76711,3894,1942,1952,10237,32,5924,44,1285,0.125525056,7625,2612
ZCTA5 76712,10264,3844,6420,27310,37.4,22715,831,1837,0.067264738,10847,16463
ZCTA5 76798,0,167,-167,2966,19.1,2344,268,186,0.062710722,345,2621
ZCTA5 76801,9477,881,8596,25081,38.8,20444,77,1080,0.043060484,2362,22719
ZCTA5 76802,2141,1831,310,5727,39.7,4871,139,153,0.026715558,5199,528
ZCTA5 76820,61,39,22,119,71.5,119,0,0,0,117,2
ZCTA5 76821,1759,21580,-19821,4430,45.4,3782,0,173,0.039051919,59519,-55089
ZCTA5 76823,993,7175,-6182,2698,46,2333,7,127,0.047071905,20047,-17349
ZCTA5 76824,0,6820,-6820,0,-,0,0,0,#DIV/0!,15635,-15635
ZCTA5 76825,2610,1113,1497,6539,40.9,5108,71,75,0.011469644,3270,3269
ZCTA5 76827,283,314,-31,601,64,572,0,0,0,797,-196
ZCTA5 76828,99,56,43,202,64.8,188,0,0,0,233,-31
ZCTA5 76831,0,35,-35,0,-,0,0,0,#DIV/0!,80,-80
ZCTA5 76832,194,10,184,678,39.7,581,0,13,0.019174041,10,668
ZCTA5 76834,2103,30,2073,4995,46.5,4123,16,52,0.01041041,102,4893
ZCTA5 76836,2,231,-229,5,64.5,5,0,0,0,1003,-998
ZCTA5 76837,417,684,-267,2001,45.2,1708,17,49,0.024487756,1867,134
ZCTA5 76841,12,7554,-7542,175,11.9,175,0,0,0,19855,-19680
ZCTA5 76842,89,0,89,170,75,170,0,0,0,64,106
ZCTA5 76844,1227,603,624,3243,47.3,2667,8,17,0.00524206,1284,1959
ZCTA5 76845,101,828,-727,263,49.3,256,0,0,0,2410,-2147
ZCTA5 76848,39,10725,-10686,78,76.2,61,0,0,0,30263,-30185
ZCTA5 76849,1465,16510,-15045,3641,45.5,2924,0,41,0.011260643,46248,-42607
ZCTA5 76852,136,379,-243,304,56.5,229,0,0,0,910,-606
ZCTA5 76853,538,1731,-1193,1492,49.8,1313,58,6,0.004021448,4486,-2994
ZCTA5 76854,110,271,-161,288,54.3,267,0,0,0,848,-560
ZCTA5 76856,1307,132,1175,3570,44.2,3013,32,1,0.000280112,353,3217
ZCTA5 76857,926,3771,-2845,1984,47.3,1913,0,0,0,10348,-8364
ZCTA5 76858,112,1560,-1448,264,55.7,205,0,0,0,4059,-3795
ZCTA5 76859,934,15560,-14626,1773,59.1,1369,0,1,0.000564016,43310,-41537
ZCTA5 76861,654,4115,-3461,2053,34.2,1714,0,5,0.00243546,12837,-10784
ZCTA5 76862,83,1816,-1733,184,64.1,176,0,2,0.010869565,5639,-5455
ZCTA5 76864,314,3876,-3562,812,57.8,721,1,5,0.006157635,11326,-10514
ZCTA5 76865,86,713,-627,199,61,196,0,0,0,910,-711
ZCTA5 76866,208,14978,-14770,838,53.6,679,0,14,0.016706444,54100,-53262
ZCTA5 76869,41,1231,-1190,218,4,215,0,0,0,3384,-3166
ZCTA5 76870,20,17203,-17183,72,56.3,68,0,0,0,39744,-39672
ZCTA5 76871,230,13089,-12859,704,44.5,594,0,0,0,37215,-36511
ZCTA5 76872,287,8908,-8621,611,58.2,569,8,0,0,33239,-32628
ZCTA5 76873,50,11249,-11199,148,56.6,118,29,0,0,28318,-28170
ZCTA5 76874,0,16104,-16104,0,-,0,0,0,#DIV/0!,41789,-41789
ZCTA5 76875,249,7492,-7243,489,54,471,0,0,0,23641,-23152
ZCTA5 76877,1467,680,787,4303,39.7,3459,0,90,0.02091564,1216,3087
ZCTA5 76878,607,17098,-16491,1642,49.1,1266,46,154,0.093788063,37759,-36117
ZCTA5 76880,0,13743,-13743,0,-,0,0,0,#DIV/0!,32145,-32145
ZCTA5 76882,96,12311,-12215,257,50.8,255,0,0,0,31813,-31556
ZCTA5 76884,18,5058,-5040,55,63.2,54,0,0,0,14620,-14565
ZCTA5 76885,52,5793,-5741,97,50.9,97,0,0,0,17109,-17012
ZCTA5 76887,53,10840,-10787,63,60.2,63,0,0,0,36057,-35994
ZCTA5 76888,75,6552,-6477,136,55.2,135,0,0,0,21321,-21185
ZCTA5 76890,357,16766,-16409,884,51.7,867,0,2,0.002262443,50158,-49274
ZCTA5 76901,12181,5016,7165,32419,34.5,26578,100,827,0.025509732,17728,14691
ZCTA5 76902,0,4250,-4250,0,-,0,0,0,#DIV/0!,13917,-13917
ZCTA5 76903,11805,2168,9637,30312,39.2,21539,61,1650,0.054433888,6603,23709
ZCTA5 76904,14828,14169,659,36132,34.4,28027,1039,1130,0.031274217,45046,-8914
ZCTA5 76905,4606,18854,-14248,13052,31.8,10104,121,544,0.041679436,55936,-42884
ZCTA5 76908,0,13896,-13896,2319,21.1,1243,324,431,0.185855972,28647,-26328
ZCTA5 76909,0,17486,-17486,555,19.8,395,13,64,0.115315315,39047,-38492
ZCTA5 76930,33,3129,-3096,72,57,63,0,0,0,7843,-7771
ZCTA5 76932,1055,15631,-14576,3349,30.3,1697,62,85,0.025380711,36367,-33018
ZCTA5 76933,492,16139,-15647,1365,37.6,1146,0,32,0.023443223,45726,-44361
ZCTA5 76934,295,911,-616,947,31.1,806,0,26,0.027455121,7146,-6199
ZCTA5 76935,666,205,461,1916,41.1,1666,8,103,0.053757829,681,1235
ZCTA5 76936,883,373,510,2547,38.8,1599,0,30,0.011778563,8609,-6062
ZCTA5 76937,37,10742,-10705,66,54.7,66,0,0,0,36131,-36065
ZCTA5 76939,0,9688,-9688,0,-,0,0,0,#DIV/0!,25054,-25054
ZCTA5 76940,0,9933,-9933,15,53.3,13,0,2,0.133333333,27870,-27855
ZCTA5 76941,599,22672,-22073,1410,38.4,951,0,86,0.060992908,51367,-49957
ZCTA5 76943,1274,8966,-7692,2867,52.3,1319,0,46,0.016044646,32900,-30033
ZCTA5 76945,780,0,780,1715,47.1,1577,0,2,0.001166181,253,1462
ZCTA5 76950,1128,9261,-8133,3473,35.2,1888,0,4,0.001151742,31353,-27880
ZCTA5 76951,397,17965,-17568,1391,32.3,1070,13,2,0.001437815,57534,-56143
ZCTA5 76953,35,17863,-17828,67,59.7,67,0,0,0,49568,-49501
ZCTA5 76955,89,5430,-5341,278,31.3,278,0,0,0,14490,-14212
ZCTA5 76957,46,17578,-17532,185,7.8,185,0,0,0,48874,-48689
ZCTA5 76958,91,18554,-18463,238,35.4,197,0,0,0,55461,-55223
ZCTA5 77002,5971,17193,-11222,18892,34.6,8101,900,6526,0.345437222,51095,-32203
ZCTA5 77003,5140,1733,3407,9992,33.1,4945,349,2661,0.26631305,7562,2430
ZCTA5 77004,14740,9279,5461,34197,33.1,11312,2444,16786,0.490861772,28410,5787
ZCTA5 77005,9973,14147,-4174,28310,36.1,21036,3882,755,0.026669022,44109,-15799
ZCTA5 77006,13345,3576,9769,22678,33.8,16699,2304,1431,0.063100803,10721,11957
ZCTA5 77007,21209,2716,18493,40653,33.7,28710,4654,2308,0.056773178,6878,33775
ZCTA5 77008,17500,1514,15986,37097,34.6,29832,1938,1096,0.029544168,3779,33318
ZCTA5 77009,14745,13982,763,37654,37.8,20257,1185,1969,0.052291921,40949,-3295
ZCTA5 77010,536,7529,-6993,802,59.4,769,0,33,0.041147132,21791,-20989
ZCTA5 77011,6152,7838,-1686,17060,36.7,8184,262,320,0.018757327,24087,-7027
ZCTA5 77012,5942,4364,1578,17932,33.4,6646,21,1130,0.063015838,13121,4811
ZCTA5 77013,5978,1483,4495,19296,32.9,9423,132,3416,0.177031509,4358,14938
ZCTA5 77014,11862,3540,8322,37471,31.3,7453,3746,16947,0.452269755,13425,24046
ZCTA5 77015,18110,2043,16067,58276,29.7,28475,881,9119,0.156479511,5497,52779
ZCTA5 77016,9790,270,9520,30252,37,7509,220,17649,0.583399445,672,29580
ZCTA5 77017,10440,9708,732,33627,31.5,16927,1075,1769,0.052606536,28841,4786
ZCTA5 77018,11641,0,11641,28403,38.2,20486,914,2383,0.083899588,0,28403
ZCTA5 77019,11326,4719,6607,22475,35.9,15732,2091,1893,0.084226919,11683,10792
ZCTA5 77020,8885,0,8885,26252,34.8,7578,226,5594,0.213088527,0,26252
ZCTA5 77021,10542,215,10327,26287,34.1,5456,657,17628,0.670597634,792,25495
ZCTA5 77022,9097,187,8910,26476,33.5,13856,187,4351,0.164337513,432,26044
ZCTA5 77023,10306,892,9414,27676,34.3,12825,422,1000,0.036132389,2711,24965
ZCTA5 77024,15846,160,15686,37694,42.4,27699,5647,908,0.024088714,469,37225
ZCTA5 77025,13601,1629,11972,29539,37.3,16069,4935,4095,0.138630285,4561,24978
ZCTA5 77026,7898,149,7749,21412,36.1,4768,171,10703,0.499859892,501,20911
ZCTA5 77027,10887,177,10710,19386,34,13590,2542,1469,0.075776333,491,18895
ZCTA5 77028,6288,179,6109,19506,32,4013,0,12659,0.648979801,494,19012
ZCTA5 77029,5461,94,5367,16223,38,8124,0,3247,0.200147938,237,15986
ZCTA5 77030,5358,203,5155,11787,34.2,7133,3214,672,0.057011962,553,11234
ZCTA5 77031,5959,2356,3603,16710,33.5,7327,597,3148,0.188390186,6954,9756
ZCTA5 77032,4336,966,3370,13887,27.7,5485,67,5123,0.368906171,2989,10898
ZCTA5 77033,9253,281,8972,28669,32.7,8295,95,17012,0.593393561,652,28017
ZCTA5 77034,12243,585,11658,38875,31.3,21802,1929,3744,0.096308682,1877,36998
ZCTA5 77035,13788,1798,11990,35335,35,14317,638,10308,0.291722089,5314,30021
ZCTA5 77036,25658,3137,22521,68797,31.9,20085,8452,9156,0.133087199,9642,59155
ZCTA5 77037,5149,10362,-5213,18106,33.2,11820,35,289,0.01596156,30318,-12212
ZCTA5 77038,8897,3246,5651,32275,29.3,15359,2639,6161,0.190890782,9297,22978
ZCTA5 77039,7931,94,7837,27501,31.1,17923,236,2732,0.099341842,373,27128
ZCTA5 77040,18537,1390,17147,50192,34.5,26368,4359,7657,0.152554192,4355,45837
ZCTA5 77041,10984,126,10858,33053,39.6,17254,5128,3054,0.092397059,426,32627
ZCTA5 77042,18836,1639,17197,40861,33.4,16957,2764,12099,0.296101417,5618,35243
ZCTA5 77043,9804,1796,8008,25122,35.2,16597,1873,1997,0.079492079,3685,21437
ZCTA5 77044,15712,5790,9922,53753,32.1,24801,662,17213,0.320223987,16609,37144
ZCTA5 77045,10053,1057,8996,32627,33.4,11379,547,13585,0.416372943,3158,29469
ZCTA5 77046,751,148,603,1002,59.1,650,95,183,0.182634731,589,413
ZCTA5 77047,11891,1372,10519,33199,32.7,7151,852,19846,0.59778909,3626,29573
ZCTA5 77048,6561,632,5929,19413,32.2,3444,392,14049,0.723690311,1469,17944
ZCTA5 77049,11422,7527,3895,39514,29.4,19033,1234,7443,0.188363618,23351,16163
ZCTA5 77050,1663,8405,-6742,5745,32.8,1358,0,1423,0.247693647,20213,-14468
ZCTA5 77051,6570,1333,5237,19077,30.8,2470,316,14700,0.770561409,3152,15925
ZCTA5 77053,9175,1915,7260,30642,33.8,10901,179,12387,0.40424907,6131,24511
ZCTA5 77054,14448,137,14311,23699,31.8,6642,5452,8722,0.368032406,366,23333
ZCTA5 77055,15758,2980,12778,43780,34.7,20123,2282,1961,0.044792143,9521,34259
ZCTA5 77056,11805,554,11251,22062,40.1,14692,3711,1977,0.089611096,1542,20520
ZCTA5 77057,20858,2040,18818,44056,33.7,24970,4112,4014,0.091111313,6100,37956
ZCTA5 77058,9265,120,9145,17651,36.1,12250,1564,1403,0.079485582,409,17242
ZCTA5 77059,6239,909,5330,18020,43.9,12403,2722,707,0.039234184,2521,15499
ZCTA5 77060,14720,1848,12872,47349,27.1,25294,605,8595,0.181524425,5022,42327
ZCTA5 77061,9147,325,8822,25485,32.4,9133,1708,5904,0.231665686,597,24888
ZCTA5 77062,9442,5849,3593,24761,40.4,17194,3249,2418,0.097653568,14779,9982
ZCTA5 77063,19672,4796,14876,39855,33.8,18713,4696,9305,0.233471334,14777,25078
ZCTA5 77064,15654,233,15421,49305,33.6,20338,7876,8175,0.165804685,1185,48120
ZCTA5 77065,15937,965,14972,40140,35.4,20757,3311,9040,0.225211759,2725,37415
ZCTA5 77066,11855,3873,7982,40053,33.2,13928,6503,9080,0.226699623,11639,28414
ZCTA5 77067,10005,947,9058,33420,31.2,14345,1663,10145,0.303560742,3036,30384
ZCTA5 77068,3747,9015,-5268,11031,37.3,5170,735,2819,0.255552534,27088,-16057
ZCTA5 77069,8313,10763,-2450,19054,39.8,10225,954,4368,0.229243204,28204,-9150
ZCTA5 77070,21474,14787,6687,58462,34.7,31838,5755,10848,0.18555643,38632,19830
ZCTA5 77071,9903,14843,-4940,27221,37.3,7127,1782,13477,0.495095698,36439,-9218
ZCTA5 77072,18997,11424,7573,63585,33.7,15494,13719,15152,0.238295195,32473,31112
ZCTA5 77073,13288,12958,330,38857,31.8,16786,231,12338,0.317523226,39738,-881
ZCTA5 77074,12941,4859,8082,39088,31.6,18842,3730,6059,0.15500921,14539,24549
ZCTA5 77075,12287,1278,11009,42736,32.1,20580,2833,4962,0.116108199,4280,38456
ZCTA5 77076,9801,11653,-1852,33171,28.8,22510,101,1488,0.044858461,30893,2278
ZCTA5 77077,29031,135,28896,63168,35.2,29309,7911,18070,0.286062563,689,62479
ZCTA5 77078,4625,20370,-15745,13738,35.6,4422,0,6932,0.50458582,62071,-48333
ZCTA5 77079,13372,6208,7164,34633,35.4,23059,3088,4410,0.127335201,20691,13942
ZCTA5 77080,15248,15654,-406,45391,32.4,16671,1795,1587,0.034962878,49605,-4214
ZCTA5 77081,18515,9786,8729,51374,28.6,23438,3070,7603,0.147993148,36724,14650
ZCTA5 77082,21398,17179,4219,52827,35.6,17202,7822,19426,0.367728624,59742,-6915
ZCTA5 77083,23129,24928,-1799,77663,34.4,22034,18235,22456,0.289146698,90752,-13089
ZCTA5 77084,34699,11770,22929,107864,33.2,47439,12343,17171,0.159191204,44808,63056
ZCTA5 77085,5500,236,5264,17101,38,7013,334,4634,0.270978305,700,16401
ZCTA5 77086,8660,121,8539,30071,32.1,13088,3062,4989,0.165907353,415,29656
ZCTA5 77087,11344,10157,1187,36710,32,18209,82,5192,0.141432852,36096,614
ZCTA5 77088,17164,2836,14328,54601,34,18300,1936,20782,0.38061574,11260,43341
ZCTA5 77089,18118,10082,8036,59042,34.8,27291,11133,8737,0.147979404,31827,27215
ZCTA5 77090,16174,12289,3885,39478,30,13194,622,19681,0.498530827,42904,-3426
ZCTA5 77091,11113,15198,-4085,30008,35,12004,231,12960,0.431884831,64876,-34868
ZCTA5 77092,14368,2458,11910,35822,35.1,19460,521,4180,0.116688069,8087,27735
ZCTA5 77093,13476,121,13355,47417,31.8,28746,300,5472,0.115401649,276,47141
ZCTA5 77094,3977,127,3850,11139,42.8,5973,2816,612,0.054942095,512,10627
ZCTA5 77095,24622,170,24452,71138,38.2,37634,8566,11259,0.158269842,531,70607
ZCTA5 77096,12819,16618,-3799,32744,36.8,18344,3075,5677,0.173375275,51229,-18485
ZCTA5 77098,8541,11421,-2880,15414,36,10838,2154,555,0.036006228,36600,-21186
ZCTA5 77099,16046,2834,13212,50113,32.2,16278,6353,17635,0.351904695,12520,37593
ZCTA5 77204,0,237,-237,4459,20.6,2123,895,1024,0.229647903,823,3636
ZCTA5 77301,10473,3590,6883,33409,31.7,21521,487,5141,0.153880691,12238,21171
ZCTA5 77302,6394,1185,5209,19165,38.1,15668,176,619,0.032298461,4180,14985
ZCTA5 77303,7595,108,7487,22502,33.7,16813,263,1133,0.05035108,436,22066
ZCTA5 77304,14903,405,14498,36700,33.4,29413,1378,3343,0.091089918,2005,34695
ZCTA5 77306,5069,81,4988,16650,32.9,14763,101,334,0.02006006,152,16498
ZCTA5 77316,9754,10,9744,29191,41.7,27281,171,251,0.008598541,22,29169
ZCTA5 77318,6994,127,6867,18348,51.1,15752,209,197,0.010736865,322,18026
ZCTA5 77320,9813,4304,5509,38572,39.5,24979,337,10017,0.259696153,17151,21421
ZCTA5 77326,63,149,-86,82,74.8,82,0,0,0,623,-541
ZCTA5 77327,9334,921,8413,29710,31.7,19550,25,1882,0.063345675,3583,26127
ZCTA5 77328,5891,7822,-1931,18297,36.6,15242,231,546,0.029840958,29612,-11315
ZCTA5 77331,2930,21254,-18324,7114,53.2,5826,0,887,0.124683722,73032,-65918
ZCTA5 77334,23,8888,-8865,23,-,23,0,0,0,35169,-35146
ZCTA5 77335,906,14470,-13564,2799,40.4,2181,0,167,0.059664166,59525,-56726
ZCTA5 77336,4142,2648,1494,12249,37.9,10703,18,457,0.037309168,9255,2994
ZCTA5 77338,16315,2193,14122,46780,32.6,19914,1425,17552,0.375203078,9541,37239
ZCTA5 77339,17063,19776,-2713,42652,39.8,33374,1533,1713,0.040162243,70528,-27876
ZCTA5 77340,11979,3893,8086,32826,30.5,22866,493,6852,0.208736977,11245,21581
ZCTA5 77341,0,949,-949,0,-,0,0,0,#DIV/0!,4576,-4576
ZCTA5 77342,0,3684,-3684,0,-,0,0,0,#DIV/0!,15469,-15469
ZCTA5 77345,9209,10295,-1086,27274,41.1,23836,748,924,0.033878419,40729,-13455
ZCTA5 77346,22385,1980,20405,67587,36.2,41784,2397,13000,0.192344682,5779,61808
ZCTA5 77350,40,4766,-4726,119,49.5,44,0,16,0.134453782,18225,-18106
ZCTA5 77351,11726,119,11607,34047,44.5,27594,364,3190,0.093694011,415,33632
ZCTA5 77354,12789,14821,-2032,38505,38.1,28967,1025,1980,0.051421893,56581,-18076
ZCTA5 77355,10032,86,9946,31164,39.9,25775,102,465,0.014921063,219,30945
ZCTA5 77356,12040,9646,2394,28689,46.5,25833,443,1244,0.043361567,37441,-8752
ZCTA5 77357,9258,77,9181,29992,30.9,21692,44,815,0.027173913,308,29684
ZCTA5 77358,1963,69,1894,5324,37.4,4597,23,581,0.109128475,148,5176
ZCTA5 77359,82,282,-200,142,81.4,59,0,83,0.584507042,1069,-927
ZCTA5 77360,2350,1376,974,5805,45.6,5465,0,13,0.002239449,5090,715
ZCTA5 77362,2156,502,1654,6361,39,5177,195,648,0.101870775,1955,4406
ZCTA5 77363,1227,1552,-325,3042,45.8,2673,9,143,0.047008547,5696,-2654
ZCTA5 77364,1048,17741,-16693,2272,61.2,1774,44,254,0.111795775,64987,-62715
ZCTA5 77365,12145,1644,10501,36802,36,30499,861,372,0.010108146,2957,33845
ZCTA5 77367,176,125,51,264,60.4,262,0,0,0,297,-33
ZCTA5 77368,0,8732,-8732,0,-,0,0,0,#DIV/0!,25594,-25594
ZCTA5 77369,215,1871,-1656,478,56.5,478,0,0,0,4925,-4447
ZCTA5 77371,2154,1947,207,7291,37.6,5619,0,496,0.068029077,5117,2174
ZCTA5 77372,4157,50,4107,14103,34.4,12967,31,111,0.007870666,85,14018
ZCTA5 77373,21156,99,21057,63296,33.5,37546,1036,12481,0.197184656,268,63028
ZCTA5 77374,199,834,-635,449,52.2,382,0,0,0,1541,-1092
ZCTA5 77375,22022,7987,14035,62970,34,42001,3551,8832,0.140257265,24313,38657
ZCTA5 77376,309,4967,-4658,561,48.1,530,0,4,0.007130125,13137,-12576
ZCTA5 77377,12618,3852,8766,38689,38.6,28528,3144,2880,0.074439763,11564,27125
ZCTA5 77378,5538,22268,-16730,17549,36,12445,65,1636,0.093224685,65178,-47629
ZCTA5 77379,27746,192,27554,82125,37.3,52612,8392,9318,0.113461187,708,81417
ZCTA5 77380,13980,342,13638,29095,36,20914,2140,2791,0.095927135,814,28281
ZCTA5 77381,13441,2008,11433,36080,44,30822,1259,783,0.021701774,6289,29791
ZCTA5 77382,13149,5414,7735,41233,40.6,30902,3372,1678,0.040695559,19553,21680
ZCTA5 77384,9135,136,8999,21259,40,16043,1583,1425,0.067030434,255,21004
ZCTA5 77385,8464,1296,7168,24771,34.1,17637,1587,1792,0.072342659,3504,21267
ZCTA5 77386,20228,5257,14971,64460,33.7,48298,3435,5583,0.086611852,14483,49977
ZCTA5 77388,17511,7624,9887,53498,34.9,33307,4611,8417,0.157332984,21352,32146
ZCTA5 77389,13448,95,13353,41982,33.5,30249,1764,2908,0.069267781,241,41741
ZCTA5 77396,19482,309,19173,61720,33.2,26700,1866,17650,0.285968892,742,60978
ZCTA5 77401,6256,9076,-2820,17362,46,12258,3564,461,0.026552241,21472,-4110
ZCTA5 77406,19349,8612,10737,58998,38.1,37467,6651,7195,0.121953287,27412,31586
ZCTA5 77407,20776,8814,11962,73084,33.4,20167,23449,21377,0.292499042,23288,49796
ZCTA5 77412,0,3869,-3869,0,-,0,0,0,#DIV/0!,11565,-11565
ZCTA5 77414,9279,1052,8227,24345,35.5,14001,308,3199,0.131402752,2114,22231
ZCTA5 77415,110,367,-257,390,30.8,162,0,228,0.584615385,864,-474
ZCTA5 77417,780,8564,-7784,2892,35.3,1469,0,299,0.103388658,17556,-14664
ZCTA5 77418,3814,7471,-3657,10220,42.3,7628,99,1161,0.113600783,22731,-12511
ZCTA5 77419,294,67,227,823,34.1,545,0,0,0,107,716
ZCTA5 77420,835,1580,-745,2365,37.2,1813,0,397,0.167864693,4103,-1738
ZCTA5 77422,4955,742,4213,14042,46.1,10979,50,1414,0.100697906,2060,11982
ZCTA5 77423,4177,2910,1267,14470,33,8012,148,2144,0.148168625,7142,7328
ZCTA5 77426,788,12626,-11838,2019,47.9,1482,0,509,0.252105002,42080,-40061
ZCTA5 77428,0,15567,-15567,0,-,0,0,0,#DIV/0!,47490,-47490
ZCTA5 77429,29886,2981,26905,88375,37.1,60254,8480,8715,0.098613861,9175,79200
ZCTA5 77430,665,2620,-1955,1780,43.1,1684,0,1,0.000561798,6484,-4704
ZCTA5 77431,241,4929,-4688,333,88.2,0,0,333,1,16820,-16487
ZCTA5 77432,0,4090,-4090,0,-,0,0,0,#DIV/0!,10012,-10012
ZCTA5 77433,30506,3014,27492,103070,33,58912,11153,16223,0.157397885,7971,95099
ZCTA5 77434,1256,525,731,4128,30.2,2023,0,823,0.199370155,1622,2506
ZCTA5 77435,1484,1748,-264,3727,42.9,3053,0,240,0.064394956,4687,-960
ZCTA5 77436,0,4835,-4835,0,-,0,0,0,#DIV/0!,15783,-15783
ZCTA5 77437,6580,6867,-287,18529,35.8,14652,13,1279,0.069026931,16771,1758
ZCTA5 77440,51,1074,-1023,131,52.8,96,0,0,0,3684,-3553
ZCTA5 77441,7108,527,6581,22665,38.5,15986,2657,537,0.023692919,2445,20220
ZCTA5 77442,252,2725,-2473,1343,16.6,530,0,317,0.236038719,5959,-4616
ZCTA5 77443,62,1012,-950,132,-,132,0,0,0,2799,-2667
ZCTA5 77444,309,22845,-22536,785,34.8,597,0,0,0,70407,-69622
ZCTA5 77445,5398,97,5301,14595,30.1,6281,55,4806,0.329290853,260,14335
ZCTA5 77446,650,934,-284,5121,20.2,150,12,4862,0.949423941,2818,2303
ZCTA5 77447,5964,331,5633,18145,34.2,11521,367,1264,0.069661064,783,17362
ZCTA5 77448,72,18566,-18494,148,35.2,141,0,7,0.047297297,54864,-54716
ZCTA5 77449,37043,11427,25616,119994,33.2,56345,5926,26150,0.217927563,33133,86861
ZCTA5 77450,24737,22018,2719,72197,37.9,48650,8598,5254,0.072773107,63255,8942
ZCTA5 77451,193,3653,-3460,588,34.2,166,0,332,0.56462585,8737,-8149
ZCTA5 77453,50,153,-103,168,11.4,168,0,0,0,420,-252
ZCTA5 77454,0,288,-288,0,-,0,0,0,#DIV/0!,865,-865
ZCTA5 77455,679,547,132,2014,32.7,1804,0,88,0.043694141,935,1079
ZCTA5 77456,366,115,251,1063,49.6,602,0,45,0.04233302,247,816
ZCTA5 77457,257,5296,-5039,471,62.5,447,0,0,0,12177,-11706
ZCTA5 77458,36,39,-3,58,25.2,36,0,0,0,112,-54
ZCTA5 77459,24974,17433,7541,77722,38,34134,18044,18238,0.234656854,53229,24493
ZCTA5 77460,33,3534,-3501,177,30.3,177,0,0,0,5642,-5465
ZCTA5 77461,3878,7967,-4089,11824,36.3,8362,117,260,0.021989175,21032,-9208
ZCTA5 77464,164,9062,-8898,366,31.9,291,0,5,0.013661202,19873,-19507
ZCTA5 77465,2638,21082,-18444,7227,43.9,5755,263,18,0.00249066,41709,-34482
ZCTA5 77466,190,9374,-9184,360,57.6,299,0,0,0,30532,-30172
ZCTA5 77467,0,0,0,0,-,0,0,0,#DIV/0!,554,-554
ZCTA5 77468,0,8576,-8576,0,-,0,0,0,#DIV/0!,23514,-23514
ZCTA5 77469,19346,440,18906,57228,35.9,27236,8444,13074,0.228454603,1717,55511
ZCTA5 77470,178,3999,-3821,458,39.8,381,0,11,0.024017467,11178,-10720
ZCTA5 77471,14862,2939,11923,41723,32.4,24252,2407,5290,0.126788582,5973,35750
ZCTA5 77473,13,11173,-11160,38,31.5,0,0,38,1,30999,-30961
ZCTA5 77474,5607,5571,36,14048,39.2,10669,0,964,0.068621868,21677,-7629
ZCTA5 77475,331,2135,-1804,699,64.9,633,0,26,0.037195994,6477,-5778
ZCTA5 77476,99,5364,-5265,281,58.2,227,0,51,0.181494662,12482,-12201
ZCTA5 77477,12850,12723,127,33844,33.9,11379,8263,9231,0.272751448,28461,5383
ZCTA5 77478,8777,9586,-809,23276,47.6,11238,8524,1001,0.043005671,20939,2337
ZCTA5 77479,28515,12400,16115,90084,40.4,35863,41370,7141,0.079270459,28228,61856
ZCTA5 77480,2851,3377,-526,8243,38.7,6855,100,563,0.068300376,8312,-69
ZCTA5 77481,116,11983,-11867,152,84.2,48,4,89,0.585526316,24716,-24564
ZCTA5 77482,498,4555,-4057,1307,43,715,12,167,0.127773527,14307,-13000
ZCTA5 77483,133,3133,-3000,334,26.5,281,0,0,0,9486,-9152
ZCTA5 77484,4524,7064,-2540,12914,34.8,9073,43,1407,0.108951525,17824,-4910
ZCTA5 77485,1464,7131,-5667,3933,37.6,2638,39,419,0.106534452,16882,-12949
ZCTA5 77486,2682,2872,-190,7227,40.8,5008,0,911,0.126055071,6841,386
ZCTA5 77488,5241,4369,872,14721,38.8,9230,164,3351,0.227633992,12882,1839
ZCTA5 77489,12720,4174,8546,38593,35.6,6310,1531,25304,0.655662944,12457,26136
ZCTA5 77493,14876,5429,9447,48117,33.2,28496,5052,5678,0.118004032,16911,31206
ZCTA5 77494,40280,18727,21553,129165,36.9,71182,26066,10223,0.079146828,48246,80919
ZCTA5 77498,16423,315,16108,52947,34.5,21999,14330,10028,0.189396944,901,52046
ZCTA5 77502,10845,13157,-2312,37665,29.3,25610,107,596,0.015823709,43452,-5787
ZCTA5 77503,8005,24206,-16201,24582,30.7,17154,52,730,0.029696526,54917,-30335
ZCTA5 77504,9064,10808,-1744,25748,32.2,18148,643,1495,0.058062762,26939,-1191
ZCTA5 77505,7848,5203,2645,22548,36,17796,736,316,0.014014547,14158,8390
ZCTA5 77506,10434,15536,-5102,37141,28.4,27875,14,493,0.013273741,40290,-3149
ZCTA5 77507,240,13975,-13735,403,30.1,282,3,53,0.131513648,34391,-33988
ZCTA5 77510,5214,10980,-5766,13124,45.9,11441,23,121,0.00921975,27119,-13995
ZCTA5 77511,16869,7715,9154,49600,33.9,37932,923,2024,0.040806452,14340,35260
ZCTA5 77514,2106,7140,-5034,5818,39.1,4217,79,705,0.121175662,17170,-11352
ZCTA5 77515,11596,18127,-6531,33491,39.4,25299,740,3163,0.094443283,52384,-18893
ZCTA5 77517,2126,5649,-3523,6118,42.6,5776,0,0,0,13570,-7452
ZCTA5 77518,3544,4260,-716,10567,31.6,8074,335,279,0.026402953,8060,2507
ZCTA5 77519,232,10528,-10296,596,55.1,596,0,0,0,22718,-22122
ZCTA5 77520,12833,17525,-4692,36054,35.3,22934,365,3759,0.104260276,45105,-9051
ZCTA5 77521,21895,19935,1960,63309,33,37046,1154,12536,0.198012921,39850,23459
ZCTA5 77523,8554,7162,1392,26370,33.2,20792,209,2371,0.08991278,22124,4246
ZCTA5 77530,9052,100,8952,30880,30,19551,525,2559,0.082869171,614,30266
ZCTA5 77531,6005,632,5373,15956,31.2,9906,42,1928,0.120832289,1714,14242
ZCTA5 77532,10710,72,10638,30108,37.1,22572,230,3422,0.1136575,168,29940
ZCTA5 77533,379,377,2,1135,40.5,1079,0,43,0.037885463,1108,27
ZCTA5 77534,902,261,641,3125,34.4,2563,9,22,0.00704,698,2427
ZCTA5 77535,10551,1185,9366,37418,35.3,29293,286,3497,0.093457694,3574,33844
ZCTA5 77536,11485,559,10926,33291,37.4,27101,393,736,0.022108077,1434,31857
ZCTA5 77538,276,2451,-2175,864,41.6,716,0,72,0.083333333,7426,-6562
ZCTA5 77539,16961,31,16930,45901,35.7,32527,1363,5085,0.1107819,31,45870
ZCTA5 77541,6523,99,6424,17989,33.5,11507,27,2022,0.112402023,223,17766
ZCTA5 77545,8199,75,8124,25755,35.7,5178,529,14157,0.549679674,175,25580
ZCTA5 77546,18608,2585,16023,54405,38.5,43346,3660,2691,0.049462366,8598,45807
ZCTA5 77547,2671,14777,-12106,9702,30.3,6378,0,567,0.058441558,48064,-38362
ZCTA5 77550,10940,0,10940,22421,41.9,14088,712,4741,0.211453548,204,22217
ZCTA5 77551,9311,419,8892,23686,37.7,16120,434,3600,0.151988516,1240,22446
ZCTA5 77554,4212,17,4195,9001,52.1,7967,433,241,0.026774803,30,8971
ZCTA5 77555,0,15115,-15115,3,42.5,1,0,1,0.333333333,53307,-53304
ZCTA5 77560,339,76,263,708,38.8,443,7,163,0.230225989,158,550
ZCTA5 77561,8,4245,-4237,27,29.4,27,0,0,0,13545,-13518
ZCTA5 77562,3565,330,3235,10292,36.6,8513,16,424,0.041197046,897,9395
ZCTA5 77563,4162,16,4146,10223,41,7322,29,1514,0.148097427,76,10147
ZCTA5 77564,634,608,26,1737,39.8,1664,0,0,0,2072,-335
ZCTA5 77565,2948,590,2358,6555,48.3,5446,108,324,0.049427918,1767,4788
ZCTA5 77566,11295,257,11038,30327,34.9,24637,764,1422,0.046888911,642,29685
ZCTA5 77568,7287,89,7198,19819,37.2,10473,753,5655,0.285332257,179,19640
ZCTA5 77571,13157,760,12397,37298,37.2,26882,425,3179,0.085232452,1870,35428
ZCTA5 77573,34240,742,33498,95111,36.3,74702,5389,6726,0.070717372,2048,93063
ZCTA5 77575,5602,135,5467,15796,37,9877,79,2501,0.158331223,232,15564
ZCTA5 77577,480,391,89,1303,42.7,1110,8,64,0.049117421,873,430
ZCTA5 77578,8103,55,8048,23444,37.3,11969,2474,5435,0.231829039,89,23355
ZCTA5 77580,0,227,-227,0,-,0,0,0,#DIV/0!,607,-607
ZCTA5 77581,17078,60,17018,50733,35.7,34017,3224,6188,0.121971892,130,50603
ZCTA5 77582,174,248,-74,374,49.1,374,0,0,0,475,-101
ZCTA5 77583,10883,598,10285,41232,36.7,19392,2090,12772,0.30975941,1325,39907
ZCTA5 77584,29822,2512,27310,89358,35.4,43536,16293,20083,0.224747644,6535,82823
ZCTA5 77585,422,368,54,1152,32.6,1152,0,0,0,1206,-54
ZCTA5 77586,9040,227,8813,23364,40.3,19962,651,1035,0.044298921,646,22718
ZCTA5 77587,4880,892,3988,16381,29.7,10231,255,154,0.009401135,2009,14372
ZCTA5 77590,12764,1181,11583,33272,35.7,20575,257,6396,0.19223371,2877,30395
ZCTA5 77591,5687,2934,2753,14961,33.9,5791,292,7167,0.479045518,8522,6439
ZCTA5 77597,174,136,38,408,48,362,0,46,0.112745098,330,78
ZCTA5 77598,12214,265,11949,27184,31.6,17188,1628,4039,0.148580047,716,26468
ZCTA5 77611,3375,4834,-1459,9829,36.5,8790,154,38,0.00386611,10762,-933
ZCTA5 77612,3591,374,3217,9490,39.6,8766,0,63,0.006638567,923,8567
ZCTA5 77613,385,1854,-1469,896,47.4,661,4,202,0.225446429,5030,-4134
ZCTA5 77614,247,271,-24,519,57.6,504,0,0,0,802,-283
ZCTA5 77615,133,141,-8,365,47.1,365,0,0,0,284,81
ZCTA5 77616,84,932,-848,269,38,269,0,0,0,2465,-2196
ZCTA5 77617,32,22,10,46,67.1,35,0,11,0.239130435,38,8
ZCTA5 77619,5964,309,5655,17078,39.7,12295,973,1248,0.073076473,861,16217
ZCTA5 77622,509,484,25,1685,28.6,1619,0,0,0,1290,395
ZCTA5 77623,290,2093,-1803,689,54.8,685,0,0,0,5292,-4603
ZCTA5 77624,238,3188,-2950,658,61.5,545,0,0,0,8487,-7829
ZCTA5 77625,3014,670,2344,7773,40.3,6819,9,459,0.05905056,1910,5863
ZCTA5 77627,8654,1865,6789,21896,37.2,19039,411,737,0.033659116,4641,17255
ZCTA5 77629,336,286,50,782,50.7,620,0,162,0.207161125,791,-9
ZCTA5 77630,10432,103,10329,29480,36.7,20739,125,6264,0.212483039,224,29256
ZCTA5 77632,8034,89,7945,21657,40.1,18959,329,963,0.044465993,224,21433
ZCTA5 77640,6716,522,6194,17579,36.8,5536,413,10085,0.573695887,1627,15952
ZCTA5 77642,13526,5364,8162,37881,32.7,14018,3224,13748,0.362926005,14381,23500
ZCTA5 77650,1116,622,494,2094,64.8,1918,0,176,0.084049666,2117,-23
ZCTA5 77651,4900,176,4724,13534,38.8,11815,376,191,0.014112605,760,12774
ZCTA5 77655,163,122,41,307,58.6,271,0,9,0.029315961,268,39
ZCTA5 77656,6102,306,5796,16795,41.6,13269,88,2633,0.156772849,1053,15742
ZCTA5 77657,7951,797,7154,21551,38.8,20459,80,79,0.003665723,3158,18393
ZCTA5 77659,1901,1401,500,6230,33.5,5602,99,234,0.037560193,3836,2394
ZCTA5 77660,419,7367,-6948,1342,51.5,1321,0,0,0,19935,-18593
ZCTA5 77661,139,0,139,363,36,283,0,34,0.093663912,91,272
ZCTA5 77662,9543,203,9340,25789,40.5,24411,97,117,0.004536818,535,25254
ZCTA5 77663,386,568,-182,854,42,854,0,0,0,1607,-753
ZCTA5 77664,912,41,871,2368,46.8,2046,36,120,0.050675676,132,2236
ZCTA5 77665,2008,3336,-1328,6499,39.9,5198,48,65,0.010001539,10744,-4245
ZCTA5 77701,4610,142,4468,12930,36.5,4037,338,6064,0.468986852,407,12523
ZCTA5 77702,1470,34,1436,3368,38.2,1454,3,1093,0.324524941,44,3324
ZCTA5 77703,4333,1686,2647,12069,31.5,1938,31,7809,0.64702958,5049,7020
ZCTA5 77705,10760,5158,5602,40947,36.8,18415,974,18903,0.461645542,16191,24756
ZCTA5 77706,12857,454,12403,29195,38.6,19339,1227,6482,0.222024319,1362,27833
ZCTA5 77707,6293,35,6258,18214,34.1,7407,1107,6902,0.378939277,69,18145
ZCTA5 77708,5256,16,5240,12979,37.4,3137,95,9039,0.696432699,30,12949
ZCTA5 77713,5620,247,5373,14136,35.4,8155,541,3043,0.215265988,741,13395
ZCTA5 77801,5879,1695,4184,14585,23.7,9800,709,2548,0.174700034,5352,9233
ZCTA5 77802,10993,2012,8981,24571,36.7,19792,565,2498,0.101664564,5246,19325
ZCTA5 77803,9635,355,9280,33233,30.7,20230,30,8022,0.241386574,733,32500
ZCTA5 77807,4332,584,3748,12677,33.9,8037,589,2136,0.168494123,1746,10931
ZCTA5 77808,5531,1175,4356,14684,41.8,12761,96,745,0.050735494,3310,11374
ZCTA5 77830,1125,380,745,3122,40.6,2836,23,178,0.057014734,1124,1998
ZCTA5 77831,1134,454,680,3137,50.3,2753,0,270,0.086069493,1587,1550
ZCTA5 77833,10945,240,10705,28417,40.5,21107,469,4571,0.160854418,619,27798
ZCTA5 77835,1318,6335,-5017,3589,44,3230,4,145,0.040401226,19628,-16039
ZCTA5 77836,4696,175,4521,11584,44.3,9240,0,1109,0.095735497,458,11126
ZCTA5 77837,596,8,588,1580,40.9,740,22,768,0.486075949,25,1555
ZCTA5 77840,19972,453,19519,50047,22.6,33407,4918,5746,0.114812077,1113,48934
ZCTA5 77843,0,34,-34,7965,19.4,5873,862,480,0.060263653,107,7858
ZCTA5 77845,27033,176,26857,72886,31.7,58562,5858,3483,0.047786955,350,72536
ZCTA5 77852,0,21,-21,0,-,0,0,0,#DIV/0!,48,-48
ZCTA5 77853,471,453,18,1091,54.8,642,0,309,0.283226398,1167,-76
ZCTA5 77855,21,0,21,34,70.7,34,0,0,0,0,34
ZCTA5 77856,1608,305,1303,4526,38.9,4013,36,276,0.060980999,926,3600
ZCTA5 77857,401,204,197,903,52.3,771,14,94,0.104097453,472,431
ZCTA5 77859,2839,104,2735,7368,36.7,4514,0,1949,0.264522258,332,7036
ZCTA5 77861,841,219,622,2171,47.4,1986,0,23,0.010594196,625,1546
ZCTA5 77863,29,920,-891,359,11.8,0,0,359,1,2609,-2250
ZCTA5 77864,2535,7903,-5368,7158,38.7,5040,162,1035,0.144593462,21324,-14166
ZCTA5 77865,704,1091,-387,2274,36,2069,131,2,0.000879507,3054,-780
ZCTA5 77866,0,3661,-3661,0,-,0,0,0,#DIV/0!,10193,-10193
ZCTA5 77867,97,9085,-8988,302,41.1,169,0,133,0.440397351,28706,-28404
ZCTA5 77868,5467,173,5294,18302,37.7,10578,83,3902,0.213200743,392,17910
ZCTA5 77871,1188,1234,-46,2757,54.7,2454,0,116,0.042074719,2483,274
ZCTA5 77872,755,247,508,2416,30.3,2175,0,4,0.001655629,673,1743
ZCTA5 77873,515,1371,-856,1270,47.1,1155,0,21,0.016535433,3856,-2586
ZCTA5 77875,12,188,-176,12,-,12,0,0,0,423,-411
ZCTA5 77876,55,859,-804,167,46.1,167,0,0,0,2321,-2154
ZCTA5 77878,236,787,-551,564,47.9,326,0,68,0.120567376,2486,-1922
ZCTA5 77879,2197,23,2174,5162,44.1,3730,0,868,0.168151879,69,5093
ZCTA5 77880,905,831,74,1816,54.9,1066,0,736,0.405286344,2336,-520
ZCTA5 77882,14,290,-276,36,-,36,0,0,0,855,-819
ZCTA5 77901,14916,1908,13008,40742,31.2,28136,375,3464,0.085022827,5881,34861
ZCTA5 77904,11118,33,11085,29064,38.7,22411,709,1188,0.04087531,97,28967
ZCTA5 77905,6307,446,5861,16570,42.3,13774,9,407,0.024562462,1076,15494
ZCTA5 77950,73,7,66,132,66.3,110,0,9,0.068181818,24,108
ZCTA5 77951,564,48,516,1361,41.9,1187,0,89,0.065393093,109,1252
ZCTA5 77954,3348,1044,2304,10801,41.5,6034,11,1300,0.120359226,2645,8156
ZCTA5 77957,3070,761,2309,8710,39.9,6811,64,1064,0.122158439,2097,6613
ZCTA5 77960,37,515,-478,37,-,37,0,0,0,1279,-1242
ZCTA5 77961,133,162,-29,165,44.6,165,0,0,0,423,-258
ZCTA5 77962,1124,1198,-74,3262,37.5,2718,23,52,0.01594114,2345,917
ZCTA5 77963,1888,3917,-2029,5188,41.6,4097,11,327,0.063030069,9449,-4261
ZCTA5 77964,3165,3707,-542,7850,42.6,6108,64,743,0.094649682,11831,-3981
ZCTA5 77968,1117,2554,-1437,3057,37.6,2944,0,12,0.003925417,7498,-4441
ZCTA5 77969,60,0,60,157,52.1,151,0,0,0,0,157
ZCTA5 77970,111,11304,-11193,377,34.6,331,0,0,0,28325,-27948
ZCTA5 77971,297,10349,-10052,1137,34.4,1086,0,0,0,34568,-33431
ZCTA5 77973,11,5090,-5079,30,55.5,30,0,0,0,16698,-16668
ZCTA5 77974,190,19359,-19169,562,36,513,0,0,0,43583,-43021
ZCTA5 77975,646,6945,-6299,1540,50,1321,0,21,0.013636364,18314,-16774
ZCTA5 77976,19,442,-423,41,65.4,41,0,0,0,1559,-1518
ZCTA5 77977,273,6481,-6208,467,47.7,285,0,120,0.256959315,19322,-18855
ZCTA5 77978,188,4171,-3983,495,33.7,392,2,11,0.022222222,11054,-10559
ZCTA5 77979,6237,2828,3409,16577,37.7,12200,821,520,0.031368764,6724,9853
ZCTA5 77982,433,3426,-2993,1084,56.1,908,0,1,0.000922509,9019,-7935
ZCTA5 77983,877,2421,-1544,2251,33.9,1775,87,0,0,7097,-4846
ZCTA5 77984,1625,81,1544,4134,47.7,3673,8,95,0.022980164,174,3960
ZCTA5 77986,9,361,-352,18,-,18,0,0,0,876,-858
ZCTA5 77987,79,1174,-1095,230,33.1,217,0,0,0,3074,-2844
ZCTA5 77988,44,563,-519,100,52.9,100,0,0,0,1317,-1217
ZCTA5 77990,331,178,153,913,52.9,816,10,25,0.027382256,391,522
ZCTA5 77991,90,63,27,492,15.3,220,6,0,0,220,272
ZCTA5 77993,42,4,38,233,40.4,233,0,0,0,10,223
ZCTA5 77994,132,77,55,376,32.5,342,0,0,0,175,201
ZCTA5 77995,3887,28,3859,11065,38.9,7397,0,573,0.051784907,81,10984
ZCTA5 78001,0,1559,-1559,0,-,0,0,0,#DIV/0!,3758,-3758
ZCTA5 78002,2447,83,2364,8776,32.3,5524,48,78,0.008887876,188,8588
ZCTA5 78003,3679,185,3494,9325,49.7,8012,11,69,0.007399464,554,8771
ZCTA5 78004,177,74,103,391,59.9,365,0,0,0,196,195
ZCTA5 78005,828,23,805,1942,30.4,1913,0,0,0,82,1860
ZCTA5 78006,14831,1001,13830,39830,42.2,34120,512,162,0.004067286,2556,37274
ZCTA5 78007,42,21,21,204,29.5,155,0,0,0,93,111
ZCTA5 78008,121,257,-136,284,55.1,209,19,0,0,548,-264
ZCTA5 78009,2653,838,1815,7901,41.6,5663,112,230,0.029110239,2153,5748
ZCTA5 78010,1535,20,1515,3948,48.8,2556,50,4,0.001013171,43,3905
ZCTA5 78011,578,709,-131,1639,34.1,1187,0,0,0,1577,62
ZCTA5 78012,109,527,-418,250,45.6,138,0,0,0,1374,-1124
ZCTA5 78013,2156,33,2123,5333,47.3,4345,0,3,0.000562535,72,5261
ZCTA5 78014,1531,1396,135,5230,34.9,3453,9,104,0.019885277,3288,1942
ZCTA5 78015,7364,196,7168,20928,38.1,17425,342,254,0.01213685,489,20439
ZCTA5 78016,3508,154,3354,10156,42.2,8306,134,140,0.013784955,395,9761
ZCTA5 78017,941,475,466,5340,26.8,4034,49,479,0.089700375,1248,4092
ZCTA5 78019,420,5,415,1802,38.9,1139,0,43,0.023862375,36,1766
ZCTA5 78021,3,45,-42,66,3.7,66,0,0,0,186,-120
ZCTA5 78022,1576,248,1328,4636,42.9,4431,53,39,0.008412425,659,3977
ZCTA5 78023,9465,1244,8221,28750,41.2,21625,1298,542,0.018852174,3595,25155
ZCTA5 78024,514,310,204,1222,56.5,1084,56,75,0.061374795,1081,141
ZCTA5 78025,2143,527,1616,5217,43.7,4240,35,89,0.017059613,1495,3722
ZCTA5 78026,2520,31,2489,6634,38.3,5725,113,18,0.002713295,73,6561
ZCTA5 78027,169,3680,-3511,445,55,339,0,0,0,11226,-10781
ZCTA5 78028,16905,779,16126,40081,47.3,32617,260,587,0.014645343,2116,37965
ZCTA5 78029,0,1929,-1929,0,-,0,0,0,#DIV/0!,6002,-6002
ZCTA5 78039,875,1,874,2730,42.9,2100,0,0,0,3,2727
ZCTA5 78040,11316,863,10453,37136,29.4,23755,32,179,0.004820121,2307,34829
ZCTA5 78041,14740,0,14740,46751,31.1,31588,350,346,0.007400911,0,46751
ZCTA5 78043,12728,1230,11498,45703,28.6,29996,256,153,0.003347701,3635,42068
ZCTA5 78044,134,32,102,350,43.9,235,0,0,0,64,286
ZCTA5 78045,19986,4186,15800,67730,32,46532,564,446,0.00658497,13163,54567
ZCTA5 78046,16935,5915,11020,68418,26.1,49556,120,37,0.000540793,17183,51235
ZCTA5 78050,173,2541,-2368,471,38.2,269,0,10,0.021231423,7158,-6687
ZCTA5 78052,1998,186,1812,6000,44.4,5067,0,0,0,593,5407
ZCTA5 78055,754,536,218,1899,52.5,1567,0,116,0.061084781,1445,454
ZCTA5 78056,862,29,833,2250,50.9,1794,76,90,0.04,40,2210
ZCTA5 78057,496,321,175,560,44.6,518,0,6,0.010714286,967,-407
ZCTA5 78058,387,856,-469,827,63.9,757,8,0,0,2426,-1599
ZCTA5 78059,1996,2395,-399,5699,45.8,4215,62,36,0.006316898,7304,-1605
ZCTA5 78061,2588,116,2472,10781,33.3,6965,148,268,0.024858547,311,10470
ZCTA5 78062,0,521,-521,0,-,0,0,0,#DIV/0!,1479,-1479
ZCTA5 78063,3749,3,3746,9282,51,7930,70,25,0.002693385,6,9276
ZCTA5 78064,5190,765,4425,16049,34.5,12098,72,57,0.003551623,2267,13782
ZCTA5 78065,3583,1616,1967,10824,38.4,7683,51,111,0.010254989,6205,4619
ZCTA5 78066,245,820,-575,582,65.7,582,0,0,0,2376,-1794
ZCTA5 78067,186,406,-220,679,51.7,455,0,0,0,1120,-441
ZCTA5 78069,1897,898,999,6542,30.8,4914,9,31,0.004738612,2902,3640
ZCTA5 78070,6718,4151,2567,17300,50.1,14966,33,319,0.018439306,13582,3718
ZCTA5 78071,1008,1722,-714,3730,36.7,3277,0,218,0.05844504,5104,-1374
ZCTA5 78072,122,3175,-3053,488,36.8,415,0,0,0,8188,-7700
ZCTA5 78073,2770,465,2305,10297,31.3,7026,52,24,0.002330776,1218,9079
ZCTA5 78074,44,231,-187,83,75.2,83,0,0,0,678,-595
ZCTA5 78075,94,45,49,199,21,199,0,0,0,120,79
ZCTA5 78076,4191,651,3540,13224,29.1,9046,189,0,0,1891,11333
ZCTA5 78101,3188,484,2704,9082,40.6,6598,0,108,0.011891654,1301,7781
ZCTA5 78102,7087,429,6658,27271,35.2,19769,71,2237,0.082028528,1232,26039
ZCTA5 78104,31,1275,-1244,96,27,90,0,0,0,3371,-3275
ZCTA5 78107,220,48,172,397,58.2,341,0,0,0,76,321
ZCTA5 78108,13889,74,13815,44734,34.7,27458,1502,7374,0.16484106,208,44526
ZCTA5 78109,16409,95,16314,48745,33,25040,1428,10504,0.215488768,300,48445
ZCTA5 78111,0,191,-191,0,-,0,0,0,#DIV/0!,613,-613
ZCTA5 78112,3151,98,3053,10087,34,6282,47,75,0.007435313,283,9804
ZCTA5 78113,1095,398,697,2759,42.9,2390,0,0,0,1223,1536
ZCTA5 78114,8002,1984,6018,22948,40.1,18385,209,439,0.019130207,6047,16901
ZCTA5 78116,116,2899,-2783,234,69.5,227,6,0,0,6398,-6164
ZCTA5 78117,301,5514,-5213,676,40.8,549,0,0,0,18083,-17407
ZCTA5 78118,1241,3407,-2166,4280,39.9,3098,4,215,0.050233645,10833,-6553
ZCTA5 78119,1822,24,1798,7068,35.1,5138,82,623,0.088143746,7282,-214
ZCTA5 78121,4755,7373,-2618,13730,39.8,11654,28,260,0.018936635,17612,-3882
ZCTA5 78122,157,3866,-3709,250,64.4,126,0,101,0.404,9078,-8828
ZCTA5 78123,1028,3030,-2002,2528,47.2,1789,98,98,0.038765823,8326,-5798
ZCTA5 78124,2574,5694,-3120,7286,43,4990,62,313,0.0429591,15800,-8514
ZCTA5 78125,10,8439,-8429,17,75.4,14,0,0,0,20008,-19991
ZCTA5 78130,32258,7724,24534,84510,34.8,69634,533,1455,0.017216897,18265,66245
ZCTA5 78132,12813,6423,6390,36475,41.7,31262,602,1079,0.029581905,17178,19297
ZCTA5 78133,8912,12675,-3763,20835,49.9,18403,177,409,0.01963043,31849,-11014
ZCTA5 78140,1240,12983,-11743,3601,29.6,2266,0,76,0.021105249,32937,-29336
ZCTA5 78141,347,16118,-15771,853,51.9,771,0,7,0.008206331,40330,-39477
ZCTA5 78142,34,1313,-1279,99,50.4,99,0,0,0,3361,-3262
ZCTA5 78143,55,502,-447,219,42.7,129,0,0,0,1234,-1015
ZCTA5 78144,18,59,-41,18,-,18,0,0,0,134,-116
ZCTA5 78145,26,1174,-1148,85,30.5,84,0,0,0,2853,-2768
ZCTA5 78146,211,144,67,797,28.8,483,0,19,0.023839398,431,366
ZCTA5 78147,546,349,197,1691,29.3,1480,0,0,0,818,873
ZCTA5 78148,8170,509,7661,22580,33.3,14779,776,2803,0.124136404,1284,21296
ZCTA5 78150,0,2993,-2993,0,-,0,0,0,#DIV/0!,7974,-7974
ZCTA5 78151,612,438,174,1495,30.9,1147,0,0,0,998,497
ZCTA5 78152,926,2267,-1341,2380,44.6,2047,0,37,0.015546218,8268,-5888
ZCTA5 78154,14512,98,14414,39718,37.8,25500,1402,6113,0.153910066,232,39486
ZCTA5 78155,18594,70,18524,51656,37.8,34642,500,2681,0.051901038,159,51497
ZCTA5 78159,306,47,259,860,24,568,0,0,0,110,750
ZCTA5 78160,1775,984,791,5246,42.4,4680,35,7,0.00133435,2333,2913
ZCTA5 78161,196,1604,-1408,621,33.2,320,0,0,0,3760,-3139
ZCTA5 78162,132,884,-752,341,36.4,226,0,0,0,2268,-1927
ZCTA5 78163,5141,405,4736,14531,46.6,12790,555,74,0.005092561,986,13545
ZCTA5 78164,1390,88,1302,3592,48.3,2719,0,88,0.024498886,269,3323
ZCTA5 78201,17249,294,16955,45767,37.7,29126,220,1249,0.027290406,602,45165
ZCTA5 78202,4245,546,3699,10390,38.2,4870,53,1747,0.168142445,1330,9060
ZCTA5 78203,2285,188,2097,6034,34.7,3272,42,649,0.107557176,495,5539
ZCTA5 78204,4727,421,4306,11832,34.8,6665,55,154,0.013015551,913,10919
ZCTA5 78205,1118,210,908,1521,48.8,1209,14,12,0.007889546,461,1060
ZCTA5 78207,16488,98,16390,51062,32.7,33728,160,2416,0.047315029,229,50833
ZCTA5 78208,1817,60,1757,4175,33,1809,0,603,0.144431138,105,4070
ZCTA5 78209,19257,1704,17553,42474,36.6,34019,977,1520,0.035786599,4127,38347
ZCTA5 78210,12187,51,12136,34005,36,20457,198,1094,0.032171739,116,33889
ZCTA5 78211,9702,75,9627,30556,37.6,19146,39,323,0.010570755,180,30376
ZCTA5 78212,11670,75,11595,27020,37.9,17715,246,782,0.028941525,196,26824
ZCTA5 78213,16940,67,16873,42767,35.5,26837,941,1276,0.029836089,103,42664
ZCTA5 78214,8174,284,7890,23077,35,15544,60,74,0.003206656,754,22323
ZCTA5 78215,2121,393,1728,3151,31.8,2459,138,79,0.025071406,1123,2028
ZCTA5 78216,19294,178,19116,43073,34.2,27552,667,2405,0.055835442,380,42693
ZCTA5 78217,14597,643,13954,33130,35.2,19973,753,3735,0.1127377,1749,31381
ZCTA5 78218,13630,758,12872,36334,33.8,19767,1126,6531,0.179748995,2015,34319
ZCTA5 78219,5524,334,5190,16304,33,7000,303,4803,0.294590285,833,15471
ZCTA5 78220,5635,95,5540,15808,34.1,6702,165,5449,0.344698887,195,15613
ZCTA5 78221,13185,5620,7565,41964,33.6,29234,348,490,0.011676675,15497,26467
ZCTA5 78222,7884,1415,6469,23652,35.6,13716,187,3804,0.160832065,3560,20092
ZCTA5 78223,19398,4897,14501,54438,34.5,35030,672,3100,0.056945516,13001,41437
ZCTA5 78224,6231,49,6182,20306,30,14644,242,197,0.009701566,108,20198
ZCTA5 78225,5173,221,4952,14115,37.4,9477,22,150,0.010626993,529,13586
ZCTA5 78226,2324,1425,899,7109,33.2,5386,0,142,0.01997468,4034,3075
ZCTA5 78227,15192,452,14740,46350,32.5,29876,383,2238,0.04828479,1222,45128
ZCTA5 78228,19593,87,19506,56781,35.6,35062,514,1334,0.023493774,237,56544
ZCTA5 78229,16492,174,16318,34633,29.7,19211,4582,3855,0.111310022,290,34343
ZCTA5 78230,19217,1296,17921,42892,38.3,27993,1801,2221,0.051781218,3313,39579
ZCTA5 78231,3841,7372,-3531,10109,40.2,7431,373,432,0.042734197,26920,-16811
ZCTA5 78232,15202,8066,7136,36825,38.5,28432,832,2383,0.064711473,21690,15135
ZCTA5 78233,17579,8242,9337,46281,34.8,29966,1406,5228,0.112962123,23095,23186
ZCTA5 78234,945,11788,-10843,4655,20.6,3114,174,678,0.145649839,29315,-24660
ZCTA5 78235,1156,9721,-8565,2362,27.5,1449,172,189,0.080016935,24033,-21671
ZCTA5 78236,470,545,-75,8521,21.3,5919,321,1091,0.128036615,2749,5772
ZCTA5 78237,12450,0,12450,38772,34.1,25558,109,835,0.02153616,397,38375
ZCTA5 78238,10306,9338,968,25737,34.3,15316,1207,1260,0.048956755,28634,-2897
ZCTA5 78239,9892,7139,2753,30482,36.6,17996,969,5158,0.169214618,20391,10091
ZCTA5 78240,24089,12159,11930,56810,31.7,33220,5549,5757,0.101337793,32807,24003
ZCTA5 78242,10105,6648,3457,34084,28.3,21843,116,1052,0.030864922,19181,14903
ZCTA5 78243,0,13424,-13424,383,21.9,202,17,132,0.34464752,34289,-33906
ZCTA5 78244,11958,229,11729,36233,33.9,16157,372,10593,0.292357795,657,35576
ZCTA5 78245,28417,5183,23234,90956,30.2,55746,2052,10581,0.116330973,15006,75950
ZCTA5 78247,18466,335,18131,50588,36.6,35005,1373,2813,0.055606073,1000,49588
ZCTA5 78248,5717,191,5526,13840,42.7,11244,309,82,0.005924855,436,13404
ZCTA5 78249,21969,10589,11380,59035,27.9,37599,4501,3762,0.063724909,33787,25248
ZCTA5 78250,19931,81,19850,60101,34.4,38985,1994,2697,0.044874461,237,59864
ZCTA5 78251,21540,1495,20045,61970,31.8,40368,1583,5115,0.082539939,4134,57836
ZCTA5 78252,4121,66,4055,14832,32.9,9293,323,1187,0.080029666,194,14638
ZCTA5 78253,19330,811,18519,59752,32.7,36225,3068,6008,0.100548936,2118,57634
ZCTA5 78254,22486,4012,18474,74490,31.8,49153,1627,4376,0.05874614,13368,61122
ZCTA5 78255,6020,121,5899,17545,39.8,12149,1518,433,0.024679396,333,17212
ZCTA5 78256,4799,330,4469,11554,26.8,7167,975,371,0.032110092,1030,10524
ZCTA5 78257,4881,106,4775,9201,36.9,6356,602,560,0.06086295,286,8915
ZCTA5 78258,18077,172,17905,47072,37.6,33710,3563,1764,0.037474507,503,46569
ZCTA5 78259,9940,131,9809,25691,40.1,17088,1699,1636,0.063679888,337,25354
ZCTA5 78260,11365,417,10948,34038,39.9,24699,2385,1814,0.053293378,1253,32785
ZCTA5 78261,8515,2310,6205,23992,36.6,15824,864,2277,0.094906636,6183,17809
ZCTA5 78263,1877,48,1829,4806,48.8,3387,0,474,0.098626717,134,4672
ZCTA5 78264,3926,92,3834,12899,36,8659,25,359,0.027831615,323,12576
ZCTA5 78266,2706,785,1921,6962,48.5,4406,178,977,0.140333238,2185,4777
ZCTA5 78330,216,35,181,597,37.4,539,37,0,0,85,512
ZCTA5 78332,8913,62,8851,27274,35.2,24725,29,167,0.006123048,187,27087
ZCTA5 78336,4533,3289,1244,12365,40.8,9115,171,520,0.042054185,8927,3438
ZCTA5 78338,0,738,-738,0,-,0,0,0,#DIV/0!,1777,-1777
ZCTA5 78339,135,0,135,348,51.3,348,0,0,0,0,348
ZCTA5 78340,189,11038,-10849,383,58,288,0,7,0.018276762,29950,-29567
ZCTA5 78341,383,15932,-15549,1365,26.7,1320,0,0,0,40731,-39366
ZCTA5 78342,74,11249,-11175,226,53.9,169,0,0,0,34502,-34276
ZCTA5 78343,1632,6802,-5170,4594,41.2,3166,0,326,0.070962125,20079,-15485
ZCTA5 78344,139,2651,-2512,415,48.1,359,0,0,0,7403,-6988
ZCTA5 78347,24,1795,-1771,24,-,24,0,0,0,6860,-6836
ZCTA5 78349,161,0,161,768,28.6,370,0,0,0,0,768
ZCTA5 78351,183,2882,-2699,705,20.6,407,0,16,0.022695035,11939,-11234
ZCTA5 78352,51,68,-17,290,24,290,0,0,0,355,-65
ZCTA5 78353,175,332,-157,320,66.4,198,0,0,0,928,-608
ZCTA5 78355,2345,217,2128,7102,36.8,4979,0,127,0.017882287,498,6604
ZCTA5 78357,878,93,785,2819,31.5,2276,0,1,0.000354736,298,2521
ZCTA5 78358,493,1301,-808,987,68.5,694,259,0,0,3989,-3002
ZCTA5 78359,634,41,593,2231,29.4,1714,0,4,0.001792918,165,2066
ZCTA5 78360,0,82,-82,0,-,0,0,0,#DIV/0!,240,-240
ZCTA5 78361,1423,170,1253,4864,26.4,4034,0,14,0.002878289,411,4453
ZCTA5 78362,3805,362,3443,10789,38,9284,58,285,0.026415794,954,9835
ZCTA5 78363,10901,1526,9375,29415,28.1,20108,476,959,0.032602414,7305,22110
ZCTA5 78368,3534,3235,299,8586,45,7244,19,48,0.005590496,7559,1027
ZCTA5 78369,77,5,72,189,43.9,170,0,0,0,11,178
ZCTA5 78370,1635,104,1531,4857,39.4,3986,0,0,0,183,4674
ZCTA5 78371,49,3605,-3556,108,41.3,52,0,0,0,12775,-12667
ZCTA5 78372,1577,1629,-52,5261,31,4964,0,0,0,5067,194
ZCTA5 78373,1552,202,1350,3271,57.1,3180,0,0,0,454,2817
ZCTA5 78374,6811,2184,4627,19737,33.5,16524,395,419,0.021229164,8586,11151
ZCTA5 78375,1067,612,455,3015,31.5,2547,7,7,0.002321725,2061,954
ZCTA5 78376,93,286,-193,273,49.8,247,0,0,0,547,-274
ZCTA5 78377,946,1044,-98,3272,39.8,2222,3,423,0.129278729,2685,587
ZCTA5 78379,649,1544,-895,1578,50,1147,16,0,0,4886,-3308
ZCTA5 78380,8442,54,8388,24014,39,18099,91,87,0.003622887,87,23927
ZCTA5 78382,8306,37,8269,18702,50.1,16956,84,39,0.002085338,51,18651
ZCTA5 78383,1715,418,1297,5057,43.7,4168,12,151,0.029859601,957,4100
ZCTA5 78384,1481,3100,-1619,5264,37.8,4559,0,102,0.0193769,13656,-8392
ZCTA5 78385,48,174,-126,169,30.2,143,1,0,0,714,-545
ZCTA5 78387,3247,460,2787,9791,34,7801,26,95,0.009702788,832,8959
ZCTA5 78389,694,743,-49,1888,42.5,1823,0,6,0.003177966,3163,-1275
ZCTA5 78390,1895,69,1826,5737,35.5,3946,0,22,0.003834757,190,5547
ZCTA5 78391,50,850,-800,156,33.7,106,0,0,0,2391,-2235
ZCTA5 78393,686,3747,-3061,2194,39.1,1826,1,12,0.005469462,10473,-8279
ZCTA5 78401,1573,8555,-6982,4660,47.4,3230,36,486,0.104291845,21142,-16482
ZCTA5 78402,116,6344,-6228,233,37.9,181,0,21,0.090128755,17836,-17603
ZCTA5 78404,6009,11239,-5230,15650,41.1,12065,290,408,0.026070288,33652,-18002
ZCTA5 78405,5216,8007,-2791,14194,37.3,9330,6,496,0.034944343,24372,-10178
ZCTA5 78406,370,998,-628,2328,29.4,1542,0,248,0.10652921,4333,-2005
ZCTA5 78407,625,16536,-15911,2033,38.6,819,0,295,0.145105755,55584,-53551
ZCTA5 78408,3953,526,3427,10294,34.4,7079,53,1019,0.098989703,2326,7968
ZCTA5 78409,854,676,178,2312,37.7,1711,0,0,0,2172,140
ZCTA5 78410,9418,28339,-18921,27623,33.2,21544,35,504,0.018245665,77242,-49619
ZCTA5 78411,9118,12938,-3820,24194,40.6,18431,316,760,0.031412747,39402,-15208
ZCTA5 78412,15606,55,15551,41071,29.5,29948,1687,1525,0.037130822,2915,38156
ZCTA5 78413,14357,0,14357,36989,35.5,27538,848,1492,0.040336316,73,36916
ZCTA5 78414,17224,2797,14427,46133,34.3,31039,2488,1076,0.023323868,8415,37718
ZCTA5 78415,14095,20096,-6001,41583,34.3,29415,342,1233,0.02965154,58320,-16737
ZCTA5 78416,5329,15380,-10051,15030,36.4,9291,41,1661,0.110512309,41111,-26081
ZCTA5 78417,1392,10368,-8976,4400,39,2687,11,148,0.033636364,38132,-33732
ZCTA5 78418,12068,12862,-794,30015,41.3,23329,1263,923,0.030751291,48055,-18040
ZCTA5 78419,176,10253,-10077,544,25.2,339,14,147,0.270220588,30123,-29579
ZCTA5 78501,21666,8086,13580,60855,36.2,35999,806,587,0.00964588,26219,34636
ZCTA5 78503,6254,6156,98,20444,32.1,10216,132,147,0.007190374,19674,770
ZCTA5 78504,18738,6782,11956,60740,30.6,38026,2993,754,0.012413566,18623,42117
ZCTA5 78516,10016,34906,-24890,33963,30.4,26311,2,0,0,115538,-81575
ZCTA5 78520,18844,14080,4764,60592,32.5,43909,145,175,0.00288817,54984,5608
ZCTA5 78521,26194,0,26194,88791,30.5,65212,153,43,0.000484283,0,88791
ZCTA5 78526,16374,8264,8110,58713,29.1,40985,751,416,0.007085313,18129,40584
ZCTA5 78535,253,13639,-13386,713,40.6,688,0,7,0.009817672,35741,-35028
ZCTA5 78536,134,14527,-14393,353,36.5,212,0,0,0,35586,-35233
ZCTA5 78537,13667,10315,3352,51216,25.9,31201,98,29,0.000566229,26669,24547
ZCTA5 78538,2840,2528,312,10557,31.9,6824,0,0,0,7137,3420
ZCTA5 78539,13310,13052,258,36531,33.3,21853,1929,889,0.024335496,42836,-6305
ZCTA5 78540,0,16082,-16082,0,-,0,0,0,#DIV/0!,47631,-47631
ZCTA5 78541,14304,18240,-3936,45675,28.3,34283,91,355,0.007772304,44739,936
ZCTA5 78542,21034,24855,-3821,84606,26.3,53150,84,673,0.007954519,70239,14367
ZCTA5 78543,2566,17428,-14862,8421,32.5,5627,0,96,0.011400071,35483,-27062
ZCTA5 78545,205,21457,-21252,407,46.1,366,0,0,0,64040,-63633
ZCTA5 78547,185,14433,-14248,257,57.4,156,0,0,0,40210,-39953
ZCTA5 78548,456,12868,-12412,1412,33.5,884,0,0,0,33945,-32533
ZCTA5 78549,295,3225,-2930,1109,22.8,812,0,0,0,9860,-8751
ZCTA5 78550,18778,757,18021,54486,31.6,43060,708,1094,0.020078552,1952,52534
ZCTA5 78552,13416,17635,-4219,41382,33.7,32077,827,402,0.009714369,48700,-7318
ZCTA5 78557,3746,12594,-8848,13939,28.9,5510,0,2,0.000143482,30292,-16353
ZCTA5 78558,187,13187,-13000,430,60.1,414,0,0,0,42662,-42232
ZCTA5 78559,4185,5305,-1120,12819,34.4,9689,0,15,0.001170138,14322,-1503
ZCTA5 78560,1359,107,1252,4417,28.5,3404,54,0,0,420,3997
ZCTA5 78561,213,99,114,694,42.9,534,0,0,0,248,446
ZCTA5 78562,513,10806,-10293,2950,34,1656,0,9,0.003050847,26730,-23780
ZCTA5 78563,55,12373,-12318,102,61.5,27,0,0,0,31175,-31073
ZCTA5 78564,13,5780,-5767,42,27.2,42,0,0,0,15307,-15265
ZCTA5 78565,52,12582,-12530,61,74.3,61,0,0,0,33131,-33070
ZCTA5 78566,6934,11101,-4167,24551,32.2,16946,0,379,0.015437253,24660,-109
ZCTA5 78567,100,175,-75,318,29.3,271,0,0,0,340,-22
ZCTA5 78569,1247,75,1172,4370,40.4,3495,0,0,0,183,4187
ZCTA5 78570,9137,1854,7283,33221,30.6,21045,6,35,0.00105355,4969,28252
ZCTA5 78572,24561,889,23672,76645,37.3,47247,1468,397,0.005179725,2354,74291
ZCTA5 78573,11363,9903,1460,42523,26.7,25475,195,53,0.001246384,27061,15462
ZCTA5 78574,16238,426,15812,63660,26.9,41360,27,192,0.003016023,1096,62564
ZCTA5 78575,1665,1566,99,5077,38.7,3742,60,0,0,4791,286
ZCTA5 78576,3048,4050,-1002,12748,19.6,6556,105,6,0.000470662,11577,1171
ZCTA5 78577,23279,7958,15321,79128,29.3,58057,146,300,0.003791325,22341,56787
ZCTA5 78578,4038,5811,-1773,10551,44.7,9605,85,24,0.002274666,18096,-7545
ZCTA5 78579,902,8738,-7836,3176,37,1163,0,0,0,20999,-17823
ZCTA5 78580,3305,11563,-8258,13429,30.9,10364,0,129,0.009606076,28854,-15425
ZCTA5 78582,12139,11688,451,44583,27.9,31340,5,44,0.000986923,28476,16107
ZCTA5 78583,2035,9272,-7237,5952,45,3828,41,0,0,20558,-14606
ZCTA5 78584,5253,1418,3835,18128,29.5,13079,0,40,0.002206531,3542,14586
ZCTA5 78585,0,1080,-1080,0,-,0,0,0,#DIV/0!,2792,-2792
ZCTA5 78586,14410,1913,12497,48726,30.8,33842,38,56,0.001149284,5211,43515
ZCTA5 78588,48,12711,-12663,121,52.5,62,0,0,0,28745,-28624
ZCTA5 78589,10970,7078,3892,39881,29.1,29946,0,40,0.001002984,18070,21811
ZCTA5 78590,127,11903,-11776,622,27.7,549,0,0,0,29987,-29365
ZCTA5 78591,146,18497,-18351,274,44.2,223,0,0,0,44097,-43823
ZCTA5 78592,173,6895,-6722,618,40.5,474,0,0,0,18244,-17626
ZCTA5 78593,1407,3400,-1993,4857,30.6,3722,0,0,0,10057,-5200
ZCTA5 78594,516,13723,-13207,1446,40.2,1165,0,0,0,39455,-38009
ZCTA5 78595,1999,16285,-14286,7272,27.6,5664,0,0,0,43780,-36508
ZCTA5 78596,11323,14128,-2805,36852,32.5,23722,51,395,0.01071855,36007,845
ZCTA5 78597,1118,9903,-8785,2138,58.5,1734,53,103,0.048175865,28058,-25920
ZCTA5 78598,70,10290,-10220,132,62.9,132,0,0,0,28605,-28473
ZCTA5 78599,8519,51,8468,34580,26.4,21618,155,185,0.005349913,113,34467
ZCTA5 78602,11077,6668,4409,32646,41.2,23272,410,1890,0.05789377,19891,12755
ZCTA5 78605,2588,895,1693,6955,39.4,5535,39,20,0.002875629,2014,4941
ZCTA5 78606,2621,19884,-17263,6890,46.2,5305,12,0,0,56044,-49154
ZCTA5 78607,67,1311,-1244,186,58,186,0,0,0,3389,-3203
ZCTA5 78608,114,1750,-1636,325,60.3,325,0,0,0,5124,-4799
ZCTA5 78609,841,362,479,1966,61,1861,7,0,0,961,1005
ZCTA5 78610,14937,10365,4572,41681,35.4,32768,440,1756,0.042129507,29660,12021
ZCTA5 78611,4728,6623,-1895,12938,44.4,11594,173,385,0.029757304,10345,2593
ZCTA5 78612,5655,13160,-7505,20508,30.9,9096,200,1515,0.07387361,19156,1352
ZCTA5 78613,32007,12065,19942,86066,36.1,65284,8339,3127,0.036332582,30436,55630
ZCTA5 78614,184,11933,-11749,426,43.9,314,0,66,0.154929577,27903,-27477
ZCTA5 78615,523,11951,-11428,1674,30.1,1038,55,0,0,21003,-19329
ZCTA5 78616,2462,8139,-5677,8551,33.1,5115,0,177,0.020699333,20790,-12239
ZCTA5 78617,7662,11652,-3990,28690,32.8,10488,205,2107,0.073440223,21754,6936
ZCTA5 78618,129,15127,-14998,264,65.8,257,0,0,0,34778,-34514
ZCTA5 78619,2159,14572,-12413,6274,44.3,5856,0,4,0.000637552,32167,-25893
ZCTA5 78620,6538,8466,-1928,18564,42,16928,247,35,0.00188537,17919,645
ZCTA5 78621,8103,10680,-2577,24919,36.6,15013,163,3172,0.127292427,24808,111
ZCTA5 78622,134,7818,-7684,326,41.5,312,0,0,0,17674,-17348
ZCTA5 78623,564,3132,-2568,1132,61.9,1030,10,0,0,11105,-9973
ZCTA5 78624,9794,11307,-1513,23084,49.4,19973,95,42,0.001819442,18305,4779
ZCTA5 78626,12337,19395,-7058,37235,34.1,26159,916,3252,0.087337183,62878,-25643
ZCTA5 78628,14334,14886,-552,39391,40.2,33289,1092,822,0.020867711,34437,4954
ZCTA5 78629,4518,12790,-8272,12011,35.4,7855,90,971,0.080842561,39459,-27448
ZCTA5 78631,1018,9214,-8196,3020,40.5,2842,0,0,0,19438,-16418
ZCTA5 78632,559,6528,-5969,1350,42.8,1239,40,0,0,16314,-14964
ZCTA5 78633,12911,7832,5079,26507,67.4,24486,466,245,0.009242842,16142,10365
ZCTA5 78634,13271,12781,490,38529,36.2,27403,408,3653,0.0948117,31405,7124
ZCTA5 78635,104,14415,-14311,205,21.9,205,0,0,0,34006,-33801
ZCTA5 78636,1613,13309,-11696,3338,53,2813,87,2,0.000599161,30256,-26918
ZCTA5 78638,769,16733,-15964,1978,39.9,1460,0,66,0.033367037,50553,-48575
ZCTA5 78639,3291,3824,-533,7999,54.3,7080,20,86,0.010751344,8294,-295
ZCTA5 78640,21074,16066,5008,63902,32.7,44282,512,2881,0.045084661,33217,30685
ZCTA5 78641,26921,8683,18238,81311,36,59939,4609,5135,0.063152587,21414,59897
ZCTA5 78642,6010,16496,-10486,18347,36,15163,136,395,0.021529405,45565,-27218
ZCTA5 78643,2714,10244,-7530,6584,52.2,5960,42,24,0.0036452,25770,-19186
ZCTA5 78644,6381,3485,2896,20119,39.2,14753,363,990,0.049207217,9170,10949
ZCTA5 78645,6099,5795,304,14360,52.3,13083,60,241,0.01678273,17157,-2797
ZCTA5 78648,2980,9167,-6187,7803,40.2,4824,40,502,0.06433423,17552,-9749
ZCTA5 78650,781,3851,-3070,2539,34.9,1649,2,0,0,10217,-7678
ZCTA5 78652,1632,10904,-9272,5014,39.9,4228,48,137,0.027323494,39428,-34414
ZCTA5 78653,8868,10900,-2032,30955,31.1,15176,313,5867,0.189533193,31421,-466
ZCTA5 78654,7242,6983,259,18833,46.4,15987,45,286,0.015186109,12582,6251
ZCTA5 78655,1336,13489,-12153,3696,46.8,2673,23,173,0.046807359,24897,-21201
ZCTA5 78656,883,7800,-6917,2624,30.7,1896,0,43,0.016387195,25792,-23168
ZCTA5 78657,3018,11297,-8279,6810,58.8,5558,53,18,0.002643172,30920,-24110
ZCTA5 78658,35,0,35,72,64.1,72,0,0,0,0,72
ZCTA5 78659,1151,0,1151,2855,54.3,2559,30,0,0,0,2855
ZCTA5 78660,37699,0,37699,110569,34.9,59327,9633,17089,0.154555074,0,110569
ZCTA5 78661,104,0,104,336,38.1,272,0,47,0.139880952,0,336
ZCTA5 78662,1074,10594,-9520,2552,46.4,2552,0,0,0,23765,-21213
ZCTA5 78663,291,11682,-11391,696,55.8,655,0,0,0,27077,-26381
ZCTA5 78664,22089,10791,11298,60152,34.6,39076,3267,8392,0.139513233,22936,37216
ZCTA5 78665,21317,11159,10158,59935,35.6,38344,5246,5884,0.098173021,26005,33930
ZCTA5 78666,31811,7320,24491,83858,26.3,61904,1720,5233,0.06240311,17326,66532
ZCTA5 78669,4097,67,4030,10730,46.3,9611,288,82,0.007642125,5953,4777
ZCTA5 78670,64,16119,-16055,169,50.4,137,0,10,0.059171598,37782,-37613
ZCTA5 78671,334,7443,-7109,703,59.6,665,0,0,0,18429,-17726
ZCTA5 78672,455,0,455,825,70.3,811,0,0,0,259,566
ZCTA5 78674,47,341,-294,169,31.1,169,0,0,0,668,-499
ZCTA5 78675,92,3460,-3368,209,57.3,209,0,0,0,8859,-8650
ZCTA5 78676,6473,1962,4511,15241,48.8,13364,96,0,0,4219,11022
ZCTA5 78677,0,52,-52,7,-,7,0,0,0,87,-80
ZCTA5 78681,19661,3771,15890,57451,38.6,41369,6982,2808,0.048876434,8977,48474
ZCTA5 78701,6096,84,6012,9560,39.3,7688,648,363,0.037970711,152,9408
ZCTA5 78702,11093,63,11030,24830,34.7,15674,507,3729,0.150181232,213,24617
ZCTA5 78703,10865,303,10562,22111,38.2,19371,1505,228,0.01031161,666,21445
ZCTA5 78704,26619,188,26431,49854,33.2,40007,1704,2252,0.045171902,559,49295
ZCTA5 78705,8910,15,8895,32506,21,21210,4761,3049,0.093798068,23,32483
ZCTA5 78712,0,3481,-3481,206,21.2,134,36,26,0.126213592,8924,-8718
ZCTA5 78717,12736,30,12706,34087,35.6,18077,9853,2231,0.065450172,64,34023
ZCTA5 78719,588,3116,-2528,1856,42.9,688,0,99,0.053340517,8468,-6612
ZCTA5 78721,4130,242,3888,10728,34.3,5793,186,2125,0.198079791,570,10158
ZCTA5 78722,3048,157,2891,5938,35.9,4506,180,530,0.089255642,308,5630
ZCTA5 78723,14496,9684,4812,36114,35.4,21338,1547,5104,0.141330232,23160,12954
ZCTA5 78724,7611,1022,6589,25936,30.5,7706,156,5717,0.220427205,2249,23687
ZCTA5 78725,3503,1041,2462,9082,36.6,3718,256,1015,0.111759524,2744,6338
ZCTA5 78726,5769,1375,4394,13414,34.3,9660,2030,185,0.013791561,3125,10289
ZCTA5 78727,13304,493,12811,29991,36.3,18306,5773,2532,0.084425328,1211,28780
ZCTA5 78728,12665,1486,11179,25359,35.4,14271,2976,4156,0.163886589,4103,21256
ZCTA5 78729,14329,630,13699,30907,35.2,21547,3914,1896,0.061345326,1639,29268
ZCTA5 78730,3997,68,3929,9455,44.2,7170,892,112,0.011845584,130,9325
ZCTA5 78731,13148,352,12796,26506,40.4,22080,2368,289,0.010903192,681,25825
ZCTA5 78732,7102,234,6868,19653,39,15900,1899,842,0.042843332,819,18834
ZCTA5 78733,3076,1336,1740,9500,42.7,6951,1567,100,0.010526316,2692,6808
ZCTA5 78734,9164,25,9139,21625,49.1,18858,553,431,0.019930636,78,21547
ZCTA5 78735,8644,463,8181,19152,37.8,15653,1540,421,0.021982038,1092,18060
ZCTA5 78736,3854,245,3609,9481,40.3,8849,88,63,0.006644869,496,8985
ZCTA5 78737,7610,432,7178,24783,38.1,18923,944,356,0.014364685,739,24044
ZCTA5 78738,10467,241,10226,26806,42,20636,3762,841,0.031373573,633,26173
ZCTA5 78739,6574,934,5640,19898,39.1,14810,2602,469,0.023570208,2922,16976
ZCTA5 78741,21432,2827,18605,46147,29.6,27297,2018,5124,0.11103647,7301,38846
ZCTA5 78742,307,63,244,1099,25.7,481,0,120,0.109190173,147,952
ZCTA5 78744,17126,6025,11101,48524,31.8,26623,1036,4494,0.092613964,15000,33524
ZCTA5 78745,28447,1439,27008,62277,37.1,49274,1820,2456,0.03943671,3216,59061
ZCTA5 78746,10661,1031,9630,28017,42.3,24106,2402,379,0.013527501,2168,25849
ZCTA5 78747,7143,169,6974,20698,36,13056,664,813,0.039279157,469,20229
ZCTA5 78748,22407,172,22235,53501,35.4,40507,2454,3276,0.0612325,391,53110
ZCTA5 78749,15372,1548,13824,35933,41.6,26861,3732,1194,0.033228509,4066,31867
ZCTA5 78750,11634,0,11634,29559,39.6,20227,3532,1838,0.062180723,0,29559
ZCTA5 78751,8550,36,8514,15856,29.9,11617,1396,466,0.029389506,78,15778
ZCTA5 78752,9755,26,9729,21178,32.4,10089,1079,3007,0.141986968,26,21152
ZCTA5 78753,22306,90,22216,58805,32,31488,5059,8866,0.150769492,202,58603
ZCTA5 78754,10990,150,10840,29690,33.7,14937,4048,3954,0.133176154,643,29047
ZCTA5 78756,4389,287,4102,9314,35,7564,376,446,0.047884904,733,8581
ZCTA5 78757,11082,18,11064,25547,37.7,18860,835,790,0.030923396,32,25515
ZCTA5 78758,22641,553,22088,50717,32.1,29648,3219,4413,0.087012244,1255,49462
ZCTA5 78759,21605,299,21306,44978,38,32378,5963,1252,0.027835831,715,44263
ZCTA5 78801,7092,539,6553,21435,32.5,17841,271,282,0.013156053,1158,20277
ZCTA5 78802,0,268,-268,0,-,0,0,0,#DIV/0!,649,-649
ZCTA5 78827,382,6873,-6491,919,45.2,603,1,1,0.001088139,16280,-15361
ZCTA5 78828,64,34,30,97,66.1,97,0,0,0,48,49
ZCTA5 78829,272,164,108,1090,24.5,647,0,0,0,214,876
ZCTA5 78830,197,2932,-2735,521,49.3,376,12,0,0,6969,-6448
ZCTA5 78832,1039,15690,-14651,3199,47.6,3011,0,0,0,39911,-36712
ZCTA5 78833,367,12736,-12369,1346,49.8,1340,0,2,0.001485884,31275,-29929
ZCTA5 78834,2293,16795,-14502,7316,36.1,4288,127,18,0.002460361,48089,-40773
ZCTA5 78836,30,173,-143,84,42.7,73,0,0,0,345,-261
ZCTA5 78837,88,0,88,159,68,159,0,0,0,74,85
ZCTA5 78838,60,931,-871,91,70,91,0,0,0,1957,-1866
ZCTA5 78839,2830,4123,-1293,7796,33.7,6090,34,0,0,10734,-2938
ZCTA5 78840,15985,1541,14444,46970,32.1,36812,316,517,0.011007026,4216,42754
ZCTA5 78841,0,390,-390,0,-,0,0,0,#DIV/0!,746,-746
ZCTA5 78842,0,6715,-6715,0,-,0,0,0,#DIV/0!,19824,-19824
ZCTA5 78843,15,4546,-4531,527,22.9,447,0,62,0.117647059,9303,-8776
ZCTA5 78850,287,410,-123,1181,38.9,1011,0,0,0,1023,158
ZCTA5 78851,45,12458,-12413,45,-,45,0,0,0,34427,-34382
ZCTA5 78852,17349,13327,4022,56746,29.6,38408,54,256,0.004511331,32272,24474
ZCTA5 78860,0,19389,-19389,0,-,0,0,0,#DIV/0!,47005,-47005
ZCTA5 78861,4448,17871,-13423,13272,35.7,10128,18,746,0.056208559,44605,-31333
ZCTA5 78870,280,6485,-6205,968,37.9,890,0,0,0,18633,-17665
ZCTA5 78871,9,1259,-1250,25,42.2,25,0,0,0,3309,-3284
ZCTA5 78872,292,36,256,1014,21.8,659,0,44,0.043392505,68,946
ZCTA5 78873,470,3956,-3486,1324,45.5,1210,0,37,0.027945619,11517,-10193
ZCTA5 78877,341,1197,-856,1023,49.5,469,0,0,0,2497,-1474
ZCTA5 78879,70,807,-737,271,45.2,271,0,0,0,1770,-1499
ZCTA5 78880,475,15979,-15504,1159,40.9,1143,0,1,0.000862813,38043,-36884
ZCTA5 78881,592,17974,-17382,1549,49.6,1368,0,0,0,44440,-42891
ZCTA5 78883,135,2111,-1976,308,59.5,282,0,0,0,4996,-4688
ZCTA5 78884,461,1192,-731,1233,44.9,1132,0,3,0.00243309,3430,-2197
ZCTA5 78885,38,1902,-1864,101,52,101,0,0,0,5673,-5572
ZCTA5 78886,138,0,138,534,27.8,534,0,0,0,0,534
ZCTA5 78931,83,318,-235,184,71,184,0,0,0,695,-511
ZCTA5 78932,181,24,157,529,55.6,406,0,0,0,73,456
ZCTA5 78933,597,238,359,1357,51.5,1216,120,0,0,746,611
ZCTA5 78934,2234,3198,-964,6626,46.5,4886,143,636,0.095985512,9016,-2390
ZCTA5 78935,388,7463,-7075,753,60.4,651,0,24,0.03187251,20593,-19840
ZCTA5 78938,88,10819,-10731,193,55.8,193,0,0,0,34371,-34178
ZCTA5 78940,821,8927,-8106,2164,56.4,1978,0,171,0.079020333,28018,-25854
ZCTA5 78941,1073,3874,-2801,3076,47.6,2553,11,20,0.006501951,10933,-7857
ZCTA5 78942,3245,988,2257,9627,40.8,7327,151,1202,0.124857173,2530,7097
ZCTA5 78943,191,293,-102,415,50.8,84,0,172,0.414457831,750,-335
ZCTA5 78944,295,171,124,751,58.2,634,0,74,0.098535286,323,428
ZCTA5 78945,4019,2827,1192,10570,47.9,9484,71,467,0.044181646,7443,3127
ZCTA5 78946,381,5709,-5328,955,53.4,535,0,420,0.439790576,17442,-16487
ZCTA5 78947,1683,4236,-2553,4589,41.2,4314,57,58,0.012638919,12054,-7465
ZCTA5 78948,262,41,221,735,41.5,496,0,156,0.212244898,189,546
ZCTA5 78949,184,336,-152,604,49.3,604,0,0,0,1095,-491
ZCTA5 78950,871,296,575,2166,49.3,1908,0,190,0.087719298,980,1186
ZCTA5 78951,0,16038,-16038,0,-,0,0,0,#DIV/0!,48154,-48154
ZCTA5 78953,508,20522,-20014,930,47.9,909,0,21,0.022580645,54493,-53563
ZCTA5 78954,506,3242,-2736,1245,52.1,1197,7,24,0.019277108,10445,-9200
ZCTA5 78956,1784,1465,319,5436,42.4,4400,39,605,0.11129507,4286,1150
ZCTA5 78957,3747,1044,2703,9685,39.7,7537,71,1115,0.115126484,3126,6559
ZCTA5 78959,674,1064,-390,1584,47,811,6,127,0.080176768,2837,-1253
ZCTA5 78962,1756,1523,233,4801,46.1,3537,0,620,0.129139763,4349,452
ZCTA5 78963,215,342,-127,750,38.9,661,0,54,0.072,1020,-270
ZCTA5 79001,54,117,-63,162,41.6,159,0,0,0,283,-121
ZCTA5 79002,24,586,-562,50,59.7,50,0,0,0,1545,-1495
ZCTA5 79003,75,1613,-1538,241,47.3,235,6,0,0,4147,-3906
ZCTA5 79005,604,187,417,1671,31.2,1109,20,11,0.006582885,452,1219
ZCTA5 79007,4520,338,4182,13915,36.1,10689,82,395,0.028386633,692,13223
ZCTA5 79008,0,825,-825,0,-,0,0,0,#DIV/0!,2294,-2294
ZCTA5 79009,562,5863,-5301,1825,37.9,1256,0,12,0.006575342,16301,-14476
ZCTA5 79010,61,322,-261,693,14.4,593,0,100,0.144300144,851,-158
ZCTA5 79011,88,1208,-1120,200,53.8,178,0,0,0,2755,-2555
ZCTA5 79012,0,32,-32,0,-,0,0,0,#DIV/0!,88,-88
ZCTA5 79013,981,101,880,3043,30.8,1922,372,381,0.125205389,313,2730
ZCTA5 79014,1337,2761,-1424,3285,38.5,2518,0,56,0.017047184,7157,-3872
ZCTA5 79015,7923,160,7763,22493,33.5,18955,262,460,0.020450807,474,22019
ZCTA5 79016,0,106,-106,359,19.5,239,7,60,0.167130919,280,79
ZCTA5 79018,136,339,-203,361,34.5,339,8,0,0,996,-635
ZCTA5 79019,680,267,413,1914,40.3,1792,3,13,0.006792059,604,1310
ZCTA5 79021,32,626,-594,102,30.3,91,0,0,0,1633,-1531
ZCTA5 79022,3415,191,3224,11076,33.2,8631,27,427,0.038551824,472,10604
ZCTA5 79024,135,1089,-954,338,40.9,307,0,0,0,3016,-2678
ZCTA5 79025,4,178,-174,12,-,12,0,0,0,457,-445
ZCTA5 79027,1534,245,1289,4667,35.1,3393,92,45,0.009642168,579,4088
ZCTA5 79029,4942,622,4320,15875,29.4,10948,561,466,0.029354331,1505,14370
ZCTA5 79031,460,38,422,1217,40.1,922,0,56,0.04601479,84,1133
ZCTA5 79032,44,348,-304,112,34.4,76,0,0,0,903,-791
ZCTA5 79033,22,113,-91,25,53.8,25,0,0,0,316,-291
ZCTA5 79034,181,489,-308,478,35.6,457,0,9,0.018828452,1132,-654
ZCTA5 79035,1906,232,1674,5434,38.6,4189,0,70,0.012881855,569,4865
ZCTA5 79036,1781,65,1716,5035,41.8,4559,12,61,0.012115194,261,4774
ZCTA5 79039,308,11,297,762,46.7,732,7,8,0.010498688,33,729
ZCTA5 79040,642,188,454,2232,32.6,1766,0,1,0.000448029,557,1675
ZCTA5 79041,1102,122,980,2821,47.6,1963,0,203,0.071960298,306,2515
ZCTA5 79042,440,131,309,1203,30.8,1172,2,6,0.004987531,329,874
ZCTA5 79043,500,6581,-6081,1650,29.5,1168,0,41,0.024848485,18444,-16794
ZCTA5 79044,259,79,180,514,33.6,503,0,0,0,224,290
ZCTA5 79045,6031,31,6000,18634,31.8,14152,176,158,0.008479124,101,18533
ZCTA5 79046,222,97,125,692,37.1,536,17,13,0.018786127,254,438
ZCTA5 79051,0,1362,-1362,0,-,0,0,0,#DIV/0!,3752,-3752
ZCTA5 79052,498,1939,-1441,1334,35.2,1081,0,58,0.043478261,4569,-3235
ZCTA5 79053,11,60,-49,27,16.8,27,0,0,0,140,-113
ZCTA5 79054,190,85,105,605,33.4,560,13,0,0,230,375
ZCTA5 79056,37,129,-92,74,39.3,70,0,0,0,291,-217
ZCTA5 79057,480,182,298,1316,36.6,1214,0,0,0,546,770
ZCTA5 79058,0,1913,-1913,0,-,0,0,0,#DIV/0!,5369,-5369
ZCTA5 79059,264,2279,-2015,562,48.8,543,0,0,0,5872,-5310
ZCTA5 79061,101,648,-547,281,54,264,8,0,0,1509,-1228
ZCTA5 79062,97,542,-445,348,23.7,331,0,0,0,1229,-881
ZCTA5 79063,248,67,181,692,43.5,643,6,0,0,139,553
ZCTA5 79064,788,803,-15,2442,38.2,1965,0,27,0.011056511,2096,346
ZCTA5 79065,7219,1640,5579,19538,36.1,15419,231,1082,0.055379261,4335,15203
ZCTA5 79066,6,399,-393,16,-,16,0,0,0,916,-900
ZCTA5 79068,1261,2011,-750,3253,41.8,2900,7,50,0.015370427,4949,-1696
ZCTA5 79070,3489,9400,-5911,9812,32.5,7495,48,82,0.008357114,27228,-17416
ZCTA5 79072,8396,121,8275,25831,31.4,18687,128,1219,0.047191359,293,25538
ZCTA5 79073,4,361,-357,16,14.7,15,0,0,0,750,-734
ZCTA5 79078,50,319,-269,126,34.4,104,0,2,0.015873016,582,-456
ZCTA5 79079,1011,418,593,2509,36.8,1992,0,51,0.020326823,881,1628
ZCTA5 79080,159,99,60,396,49.1,368,3,1,0.002525253,285,111
ZCTA5 79081,1166,97,1069,3276,34.6,2853,6,9,0.002747253,225,3051
ZCTA5 79082,82,103,-21,184,57.3,145,0,11,0.059782609,288,-104
ZCTA5 79083,714,185,529,2118,32.7,1728,11,4,0.001888574,547,1571
ZCTA5 79084,530,358,172,1441,41.1,1147,55,1,0.000693963,531,910
ZCTA5 79085,0,1098,-1098,0,-,0,0,0,#DIV/0!,3769,-3769
ZCTA5 79086,1105,2701,-1596,3023,39.3,2514,25,0,0,5535,-2512
ZCTA5 79087,286,79,207,732,45.5,651,0,0,0,167,565
ZCTA5 79088,1793,7019,-5226,5213,37.2,3948,45,506,0.09706503,21489,-16276
ZCTA5 79091,17,228,-211,72,11.8,72,0,0,0,548,-476
ZCTA5 79092,481,274,207,1339,42.2,1202,14,4,0.002987304,617,722
ZCTA5 79093,39,116,-77,114,53.2,60,0,0,0,269,-155
ZCTA5 79094,8,293,-285,12,61.5,8,0,0,0,793,-781
ZCTA5 79095,976,413,563,2710,40.2,1939,0,275,0.101476015,1088,1622
ZCTA5 79096,714,457,257,1988,40.1,1835,0,43,0.021629779,6816,-4828
ZCTA5 79097,413,263,150,1072,40.5,1057,0,0,0,543,529
ZCTA5 79098,177,110,67,389,60.1,368,1,0,0,263,126
ZCTA5 79101,1195,30,1165,2335,50.2,2068,0,114,0.04882227,61,2274
ZCTA5 79102,4206,4424,-218,9898,34.3,7631,846,284,0.028692665,11573,-1675
ZCTA5 79103,3731,361,3370,10758,30.4,8692,247,521,0.048429076,1150,9608
ZCTA5 79104,2288,2803,-515,6705,34.4,5170,79,264,0.039373602,11921,-5216
ZCTA5 79106,11800,6539,5261,27668,33.3,21206,903,1501,0.054250398,14405,13263
ZCTA5 79107,10960,9994,966,39829,32.6,21773,4063,8961,0.224986819,20050,19779
ZCTA5 79108,4350,7380,-3030,10549,40.6,9347,10,210,0.0199071,16647,-6098
ZCTA5 79109,18539,15067,3472,43167,37.9,35005,395,2590,0.059999537,37874,5293
ZCTA5 79110,6949,12081,-5132,19235,31.3,16029,345,670,0.034832337,26005,-6770
ZCTA5 79111,457,4974,-4517,2046,28,1622,3,148,0.072336266,14096,-12050
ZCTA5 79118,9883,14805,-4922,25963,37.4,20887,968,541,0.020837345,35041,-9078
ZCTA5 79119,8402,11077,-2675,20387,36.4,18589,428,265,0.012998479,28735,-8348
ZCTA5 79121,2511,10539,-8028,5388,47.6,4530,112,161,0.029881218,30470,-25082
ZCTA5 79124,4189,63,4126,10847,43.1,9963,348,47,0.004332995,2990,7857
ZCTA5 79201,2091,0,2091,6817,33.4,5072,5,594,0.087135103,324,6493
ZCTA5 79220,62,7655,-7593,184,36.8,122,0,0,0,19199,-19015
ZCTA5 79223,19,12965,-12946,81,40.3,81,0,0,0,37085,-37004
ZCTA5 79225,283,12282,-11999,880,35.4,752,13,13,0.014772727,28703,-27823
ZCTA5 79226,968,18350,-17382,2677,36.1,2355,6,221,0.082555099,46227,-43550
ZCTA5 79227,495,10866,-10371,1131,55.4,846,9,1,0.000884173,27350,-26219
ZCTA5 79229,123,13271,-13148,281,49.4,247,0,15,0.053380783,38367,-38086
ZCTA5 79230,36,6418,-6382,151,34.2,44,0,0,0,18687,-18536
ZCTA5 79231,0,9146,-9146,0,-,0,0,0,#DIV/0!,26492,-26492
ZCTA5 79233,40,9227,-9187,98,39.5,70,0,20,0.204081633,26683,-26585
ZCTA5 79234,30,1382,-1352,80,50.2,65,0,0,0,4454,-4374
ZCTA5 79235,1151,1964,-813,3257,34.7,2570,8,234,0.071845256,6195,-2938
ZCTA5 79236,75,489,-414,200,35.7,171,1,2,0.01,1200,-1000
ZCTA5 79237,204,312,-108,463,59.1,451,2,0,0,824,-361
ZCTA5 79239,63,461,-398,124,74.4,120,0,0,0,1205,-1081
ZCTA5 79240,26,146,-120,131,31.8,60,0,0,0,238,-107
ZCTA5 79241,688,341,347,2025,44.1,1806,5,25,0.012345679,1002,1023
ZCTA5 79243,9,15,-6,19,58.5,19,0,0,0,29,-10
ZCTA5 79244,293,0,293,861,30,708,0,15,0.017421603,0,861
ZCTA5 79245,895,1466,-571,2304,42.7,1586,5,127,0.055121528,4368,-2064
ZCTA5 79247,20,11832,-11812,35,55.3,25,0,0,0,29029,-28994
ZCTA5 79248,610,5673,-5063,1455,34.8,1048,0,111,0.07628866,15094,-13639
ZCTA5 79250,466,10386,-9920,1188,45,990,0,8,0.006734007,25438,-24250
ZCTA5 79251,17,12400,-12383,41,64.5,27,0,0,0,30786,-30745
ZCTA5 79252,979,4424,-3445,2768,44.5,2233,77,33,0.011921965,12068,-9300
ZCTA5 79255,213,10648,-10435,472,49.1,380,0,31,0.065677966,29522,-29050
ZCTA5 79256,115,4217,-4102,288,61.7,268,0,0,0,10973,-10685
ZCTA5 79257,346,537,-191,820,47.1,722,0,0,0,1504,-684
ZCTA5 79258,31,466,-435,74,81.3,74,0,0,0,1015,-941
ZCTA5 79259,14,5,9,49,76.9,49,0,0,0,7,42
ZCTA5 79261,122,477,-355,313,43.4,237,0,16,0.051118211,1263,-950
ZCTA5 79311,1402,481,921,3767,37.8,3388,0,76,0.020175206,1218,2549
ZCTA5 79312,319,36,283,1235,37.5,991,54,85,0.068825911,76,1159
ZCTA5 79313,574,424,150,1457,40,1039,8,21,0.014413178,1022,435
ZCTA5 79314,39,57,-18,132,30.2,111,0,0,0,163,-31
ZCTA5 79316,3655,154,3501,10180,36,7888,2,245,0.024066798,329,9851
ZCTA5 79322,671,38,633,1802,43.1,1196,3,61,0.033851276,99,1703
ZCTA5 79323,2475,101,2374,7003,28.9,4923,0,103,0.014707982,370,6633
ZCTA5 79324,12,364,-352,36,19.8,36,0,0,0,987,-951
ZCTA5 79325,596,0,596,2218,26.2,1891,23,8,0.003606853,315,1903
ZCTA5 79326,3,659,-656,34,18.4,34,0,0,0,1669,-1635
ZCTA5 79329,1227,353,874,3086,40.8,2626,0,51,0.016526248,679,2407
ZCTA5 79330,41,294,-253,73,73.4,73,0,0,0,857,-784
ZCTA5 79331,3998,30,3968,11726,33.6,7337,17,1041,0.088777077,63,11663
ZCTA5 79336,5917,149,5768,15785,33.7,12258,61,651,0.041241685,286,15499
ZCTA5 79339,2373,32,2341,6694,35.4,5517,11,251,0.037496265,61,6633
ZCTA5 79342,121,586,-465,332,49.6,239,0,0,0,1423,-1091
ZCTA5 79343,567,132,435,1695,37.2,1451,12,41,0.024188791,328,1367
ZCTA5 79344,0,4058,-4058,0,-,0,0,0,#DIV/0!,10055,-10055
ZCTA5 79345,304,3849,-3545,1166,27.5,691,0,0,0,9620,-8454
ZCTA5 79346,811,1507,-696,2062,36.6,1456,0,126,0.061105723,4903,-2841
ZCTA5 79347,1941,764,1177,6933,33.4,6003,35,26,0.00375018,1473,5460
ZCTA5 79350,218,184,34,508,49.4,465,0,0,0,470,38
ZCTA5 79351,498,365,133,1268,37.2,983,10,12,0.009463722,1140,128
ZCTA5 79353,8,57,-49,24,33.3,21,0,0,0,311,-287
ZCTA5 79355,624,243,381,1613,41.2,1201,49,0,0,1920,-307
ZCTA5 79356,1649,617,1032,5602,43.2,4053,89,421,0.075151732,2601,3001
ZCTA5 79357,757,141,616,1944,40.5,1613,14,115,0.059156379,343,1601
ZCTA5 79358,445,2447,-2002,1365,32.9,1132,0,0,0,5832,-4467
ZCTA5 79359,1238,818,420,3500,35.2,2668,0,404,0.115428571,1681,1819
ZCTA5 79360,5013,127,4886,16584,27.4,14806,203,72,0.004341534,338,16246
ZCTA5 79363,2137,823,1314,5827,38.9,4791,9,54,0.009267204,1763,4064
ZCTA5 79364,2785,201,2584,7638,36.4,6061,0,363,0.04752553,544,7094
ZCTA5 79366,457,189,268,1107,49.1,902,9,8,0.007226739,460,647
ZCTA5 79367,231,37,194,638,29.5,492,0,0,0,64,574
ZCTA5 79369,38,5024,-4986,65,67.9,59,0,0,0,12515,-12450
ZCTA5 79370,525,36,489,1236,48.1,1020,56,16,0.012944984,82,1154
ZCTA5 79371,630,56,574,1600,33.9,1318,24,17,0.010625,154,1446
ZCTA5 79372,504,1874,-1370,1400,34.8,1039,16,9,0.006428571,4292,-2892
ZCTA5 79373,1080,473,607,2816,38.4,2134,5,35,0.012428977,1164,1652
ZCTA5 79376,19,346,-327,95,7.3,95,0,0,0,859,-764
ZCTA5 79377,78,330,-252,242,35.5,219,0,0,0,800,-558
ZCTA5 79378,74,5473,-5399,257,36.6,164,0,0,0,14873,-14616
ZCTA5 79379,181,880,-699,605,42.1,350,2,31,0.051239669,2058,-1453
ZCTA5 79380,23,87,-64,73,43.9,42,0,0,0,187,-114
ZCTA5 79381,504,3075,-2571,1425,34.8,1111,6,9,0.006315789,7478,-6053
ZCTA5 79382,3115,322,2793,9355,31.5,7455,0,298,0.031854623,881,8474
ZCTA5 79383,22,60,-38,49,31.1,41,0,0,0,106,-57
ZCTA5 79401,3782,1243,2539,9045,23.4,6175,215,1048,0.115865119,3463,5582
ZCTA5 79402,0,96,-96,0,-,0,0,0,#DIV/0!,180,-180
ZCTA5 79403,5783,36,5747,16001,35.2,8795,205,4245,0.265295919,57,15944
ZCTA5 79404,3375,68,3307,9312,40.3,5471,46,1840,0.197594502,184,9128
ZCTA5 79406,0,366,-366,7341,19.2,5669,362,584,0.079553194,688,6653
ZCTA5 79407,9340,612,8728,21211,30.3,16508,832,1040,0.049031163,1082,20129
ZCTA5 79410,4345,1117,3228,10570,27.1,7466,428,863,0.081646168,3024,7546
ZCTA5 79411,3076,377,2699,6623,30.3,4664,0,541,0.081685037,958,5665
ZCTA5 79412,5732,93,5639,15719,33,10026,50,1634,0.103950633,214,15505
ZCTA5 79413,8756,2086,6670,23265,31,17240,320,1221,0.05248227,5483,17782
ZCTA5 79414,8436,38,8398,18081,28.1,12497,341,1413,0.078148333,63,18018
ZCTA5 79415,6285,949,5336,17048,26.6,10586,932,1892,0.11098076,2399,14649
ZCTA5 79416,13587,476,13111,34864,27.9,25892,939,2802,0.080369436,1498,33366
ZCTA5 79423,15931,300,15631,41950,35.7,33402,930,1604,0.038235995,498,41452
ZCTA5 79424,20086,2659,17427,49721,37.1,41767,1613,844,0.016974719,7528,42193
ZCTA5 79501,1193,275,918,2686,46.5,2057,22,133,0.049516009,651,2035
ZCTA5 79502,414,4324,-3910,1208,35.3,1099,0,13,0.010761589,11561,-10353
ZCTA5 79503,79,148,-69,128,46.5,120,4,0,0,515,-387
ZCTA5 79504,1103,499,604,3147,49.2,2863,0,48,0.015252622,1042,2105
ZCTA5 79505,81,595,-514,288,31.6,270,0,1,0.003472222,1495,-1207
ZCTA5 79506,288,515,-227,544,60.6,494,0,0,0,1382,-838
ZCTA5 79508,445,556,-111,1061,45.8,1032,0,20,0.018850141,1300,-239
ZCTA5 79510,2906,117,2789,7673,39.7,7024,52,89,0.011599114,221,7452
ZCTA5 79511,415,4045,-3630,1165,34.9,1086,0,33,0.02832618,8910,-7745
ZCTA5 79512,1964,160,1804,7758,32.8,5884,0,583,0.075148234,290,7468
ZCTA5 79517,66,2768,-2702,139,53.6,138,1,0,0,7157,-7018
ZCTA5 79518,22,10923,-10901,64,47,54,0,0,0,30143,-30079
ZCTA5 79519,48,51,-3,67,49.9,67,0,0,0,127,-60
ZCTA5 79520,986,132,854,2393,37,1778,1,86,0.035938153,269,2124
ZCTA5 79521,1238,95,1143,3412,41.6,2844,0,190,0.055685815,175,3237
ZCTA5 79525,1068,822,246,2481,43.4,2333,0,17,0.006852076,1531,950
ZCTA5 79526,360,1500,-1140,868,51.8,801,0,0,0,3603,-2735
ZCTA5 79527,103,433,-330,233,47.9,223,0,0,0,755,-522
ZCTA5 79528,214,2524,-2310,584,46.2,524,0,5,0.008561644,8995,-8411
ZCTA5 79529,470,0,470,1164,46.3,988,55,57,0.048969072,0,1164
ZCTA5 79530,220,3948,-3728,476,53.1,439,0,2,0.004201681,9179,-8703
ZCTA5 79532,233,0,233,852,36.9,825,0,2,0.002347418,657,195
ZCTA5 79533,218,25,193,457,49.3,424,0,1,0.002188184,91,366
ZCTA5 79534,73,659,-586,161,48.6,145,0,0,0,1172,-1011
ZCTA5 79535,70,320,-250,155,65,153,0,0,0,680,-525
ZCTA5 79536,1937,513,1424,5703,35.2,5336,7,19,0.00333158,899,4804
ZCTA5 79537,21,36,-15,55,44.3,23,0,0,0,106,-51
ZCTA5 79538,66,41,25,181,55.9,137,0,0,0,41,140
ZCTA5 79539,82,1822,-1740,230,44.8,185,0,0,0,4151,-3921
ZCTA5 79540,21,35,-14,54,51.4,54,0,0,0,71,-17
ZCTA5 79541,453,354,99,1077,48.1,1077,0,0,0,913,164
ZCTA5 79543,490,36,454,1295,33.1,1189,0,28,0.021621622,73,1222
ZCTA5 79544,170,136,34,546,38.2,377,0,54,0.098901099,306,240
ZCTA5 79545,742,15,727,1855,34.7,1671,0,13,0.007008086,33,1822
ZCTA5 79546,696,52,644,1639,41.7,1202,8,49,0.029896278,71,1568
ZCTA5 79547,345,1807,-1462,757,45.9,594,2,51,0.067371202,3738,-2981
ZCTA5 79548,62,197,-135,135,42.9,135,0,0,0,427,-292
ZCTA5 79549,5500,12053,-6553,15814,35.5,12334,95,724,0.045782218,28844,-13030
ZCTA5 79553,1322,3069,-1747,3256,34.1,2687,0,107,0.032862408,7779,-4523
ZCTA5 79556,4698,160,4538,12687,36.4,10049,63,708,0.055805155,271,12416
ZCTA5 79560,54,5955,-5901,138,47.4,138,0,0,0,14286,-14148
ZCTA5 79561,252,2235,-1983,626,48.4,522,12,50,0.079872204,4896,-4270
ZCTA5 79562,1450,518,932,4150,38.9,3432,12,0,0,1193,2957
ZCTA5 79563,424,50,374,1149,40.7,861,8,31,0.026979983,141,1008
ZCTA5 79565,75,916,-841,349,22.9,309,0,0,0,2223,-1874
ZCTA5 79566,72,290,-218,188,32.9,188,0,0,0,766,-578
ZCTA5 79567,1101,1761,-660,3112,33.7,2536,9,94,0.030205656,4020,-908
ZCTA5 79601,7748,8,7740,27033,30.3,17869,918,3633,0.1343913,8,27025
ZCTA5 79602,9454,121,9333,26933,36.3,19764,738,2153,0.079939108,169,26764
ZCTA5 79603,8755,112,8643,23956,34.8,14902,251,2467,0.102980464,277,23679
ZCTA5 79605,11493,472,11021,28611,33.7,20441,297,2858,0.09989165,1270,27341
ZCTA5 79606,11330,85,11245,26810,33.5,21835,992,1309,0.048825065,125,26685
ZCTA5 79607,883,9339,-8456,3888,21.9,2664,102,568,0.146090535,22488,-18600
ZCTA5 79699,0,4497,-4497,121,19.7,80,0,22,0.181818182,11115,-10994
ZCTA5 79701,10769,697,10072,30348,29.4,18471,38,3661,0.120633979,1474,28874
ZCTA5 79703,8071,18,8053,22257,32.5,14737,473,1549,0.069596082,18,22239
ZCTA5 79705,16635,2362,14273,40134,32.4,28072,219,3774,0.094034983,5243,34891
ZCTA5 79706,10450,809,9641,31088,32.2,26657,256,814,0.026183736,1934,29154
ZCTA5 79707,14786,5186,9600,36167,32.3,29116,2024,824,0.0227832,13593,22574
ZCTA5 79713,272,711,-439,853,38,734,8,0,0,1782,-929
ZCTA5 79714,6263,1643,4620,18184,32.6,13549,85,394,0.0216674,3757,14427
ZCTA5 79718,194,270,-76,659,56.5,653,0,0,0,531,128
ZCTA5 79719,135,687,-552,321,46.1,284,0,0,0,1518,-1197
ZCTA5 79720,11564,444,11120,32431,37.2,24833,285,1836,0.0566125,1072,31359
ZCTA5 79721,0,1828,-1828,603,40.9,489,13,24,0.039800995,5034,-4431
ZCTA5 79730,47,41,6,180,10,32,0,0,0,143,37
ZCTA5 79731,1557,437,1120,4473,36,2196,147,58,0.012966689,1025,3448
ZCTA5 79733,123,1618,-1495,401,27.2,187,0,16,0.039900249,3810,-3409
ZCTA5 79734,946,71,875,1918,58.9,1786,0,36,0.018769552,106,1812
ZCTA5 79735,4359,257,4102,13267,36.4,10089,90,592,0.044621994,544,12723
ZCTA5 79738,71,228,-157,213,43.4,192,0,0,0,480,-267
ZCTA5 79739,372,1078,-706,1052,35.8,665,0,0,0,2610,-1558
ZCTA5 79741,113,367,-254,295,42.3,291,0,0,0,732,-437
ZCTA5 79742,230,90,140,584,28.5,460,32,37,0.063356164,228,356
ZCTA5 79743,96,2360,-2264,253,37.2,229,0,0,0,5155,-4902
ZCTA5 79744,489,9628,-9139,1531,30.7,852,49,0,0,23616,-22085
ZCTA5 79745,2334,5957,-3623,6559,36.8,4830,0,133,0.020277481,14768,-8209
ZCTA5 79748,72,11542,-11470,310,24.8,209,0,0,0,29783,-29473
ZCTA5 79749,168,3962,-3794,553,33.1,505,0,0,0,9526,-8973
ZCTA5 79752,828,4833,-4005,2014,39.1,649,0,95,0.047169811,10443,-8429
ZCTA5 79754,33,6186,-6153,83,31.2,82,1,0,0,14891,-14808
ZCTA5 79755,37,5209,-5172,69,34.7,61,0,0,0,14828,-14759
ZCTA5 79756,3533,5475,-1942,9477,36.3,7651,253,378,0.03988604,14335,-4858
ZCTA5 79758,823,0,823,2286,35,2286,0,0,0,0,2286
ZCTA5 79759,0,454,-454,0,-,0,0,0,#DIV/0!,952,-952
ZCTA5 79761,12448,839,11609,31566,29.6,19078,275,2344,0.074257112,2328,29238
ZCTA5 79762,15322,273,15049,40728,31,29177,629,2703,0.066367118,677,40051
ZCTA5 79763,12967,2343,10624,35900,31.9,22733,316,1177,0.032785515,5296,30604
ZCTA5 79764,9088,720,8368,25871,32.1,17798,0,644,0.024892737,2044,23827
ZCTA5 79765,7788,5850,1938,20155,30.4,13903,957,950,0.047134706,16166,3989
ZCTA5 79766,3165,183,2982,10755,29.4,5805,58,97,0.009019061,455,10300
ZCTA5 79769,0,4378,-4378,0,-,0,0,0,#DIV/0!,9513,-9513
ZCTA5 79770,0,0,0,0,-,0,0,0,#DIV/0!,0,0
ZCTA5 79772,3868,1195,2673,13843,36.5,9188,174,322,0.023260854,2766,11077
ZCTA5 79776,0,3774,-3774,0,-,0,0,0,#DIV/0!,10644,-10644
ZCTA5 79777,55,2447,-2392,152,31.5,137,0,4,0.026315789,7122,-6970
ZCTA5 79778,537,5342,-4805,1223,42,683,17,31,0.025347506,15353,-14130
ZCTA5 79780,11,534,-523,11,-,11,0,0,0,1396,-1385
ZCTA5 79781,57,4886,-4829,89,51.4,85,0,0,0,12651,-12562
ZCTA5 79782,1608,329,1279,4782,31.6,3896,0,28,0.005855291,829,3953
ZCTA5 79783,94,2814,-2720,228,45.4,217,0,0,0,7979,-7751
ZCTA5 79785,13,3432,-3419,87,45.9,75,0,0,0,9520,-9433
ZCTA5 79788,330,0,330,825,26.9,620,0,6,0.007272727,0,825
ZCTA5 79789,389,2414,-2025,1070,29.8,935,58,13,0.012149533,6527,-5457
ZCTA5 79821,1716,2187,-471,6645,36.2,4145,9,117,0.017607223,7495,-850
ZCTA5 79830,3887,74,3813,7948,44.4,6329,358,21,0.002642174,149,7799
ZCTA5 79832,0,1040,-1040,0,-,0,0,0,#DIV/0!,2467,-2467
ZCTA5 79834,163,66,97,236,30.8,211,12,6,0.025423729,238,-2
ZCTA5 79835,4001,1550,2451,12231,36.3,5872,188,16,0.001308151,3467,8764
ZCTA5 79836,2405,46,2359,8042,27.5,5355,0,19,0.002362596,84,7958
ZCTA5 79837,84,317,-233,175,39.1,138,0,0,0,783,-608
ZCTA5 79838,1992,352,1640,5687,37.2,3345,134,10,0.001758396,966,4721
ZCTA5 79839,454,62,392,1174,33.8,784,0,11,0.009369676,132,1042
ZCTA5 79842,289,2343,-2054,453,55.5,436,0,0,0,6856,-6403
ZCTA5 79843,1064,991,73,2461,49.2,1963,19,0,0,2510,-49
ZCTA5 79845,1104,98,1006,3824,34.9,2398,67,0,0,264,3560
ZCTA5 79846,27,4432,-4405,43,-,43,0,0,0,13250,-13207
ZCTA5 79847,30,1585,-1555,95,28.4,85,0,0,0,4403,-4308
ZCTA5 79848,381,26,355,934,51.7,821,0,14,0.014989293,67,867
ZCTA5 79849,3840,411,3429,13183,30.1,6481,22,0,0,908,12275
ZCTA5 79851,136,13,123,1573,30.8,358,25,30,0.019071837,99,1474
ZCTA5 79852,307,134,173,628,61.5,494,0,0,0,332,296
ZCTA5 79853,880,2810,-1930,2858,39.3,1261,0,0,0,5679,-2821
ZCTA5 79854,64,14926,-14862,103,66.9,52,0,0,0,35605,-35502
ZCTA5 79855,617,0,617,2134,43,1513,19,3,0.001405811,447,1687
ZCTA5 79901,3516,7776,-4260,8518,46.7,4067,5,299,0.035102137,19502,-10984
ZCTA5 79902,8724,12405,-3681,19984,38.5,11705,393,474,0.023718975,31896,-11912
ZCTA5 79903,6125,121,6004,15849,41.1,8570,0,111,0.007003596,241,15608
ZCTA5 79904,11609,5,11604,32148,30.6,18066,527,2000,0.062212268,5,32143
ZCTA5 79905,7866,0,7866,21953,33.8,10232,26,73,0.003325286,0,21953
ZCTA5 79906,1569,543,1026,5839,22.3,3549,202,958,0.16406919,1619,4220
ZCTA5 79907,16389,299,16090,50696,35.1,28293,150,258,0.005089159,710,49986
ZCTA5 79908,1098,189,909,4753,16.8,2914,41,461,0.096991374,333,4420
ZCTA5 79911,2854,5,2849,7668,35.5,5400,276,103,0.013432447,15,7653
ZCTA5 79912,29596,0,29596,78470,33.7,46209,2249,1581,0.020147827,0,78470
ZCTA5 79915,13119,64,13055,36505,40.5,19848,294,256,0.007012738,169,36336
ZCTA5 79916,0,11,-11,4526,22.7,2593,144,853,0.188466637,11,4515
ZCTA5 79918,0,23,-23,656,21.7,268,13,240,0.365853659,59,597
ZCTA5 79920,0,7823,-7823,7,21.3,6,0,0,0,20339,-20332
ZCTA5 79922,2686,6797,-4111,7210,45.7,4905,150,69,0.009570042,14946,-7736
ZCTA5 79924,20922,0,20922,59420,33.8,31608,894,5209,0.087664086,27,59393
ZCTA5 79925,14788,0,14788,38947,35.4,24878,307,1057,0.027139446,0,38947
ZCTA5 79927,12952,612,12340,42140,35,23192,100,145,0.003440911,1542,40598
ZCTA5 79928,21374,128,21246,76392,28.4,49618,281,1728,0.02262017,362,76030
ZCTA5 79930,10479,0,10479,26787,33.4,17090,196,557,0.020793669,0,26787
ZCTA5 79932,9682,262,9420,28594,33.5,18385,205,338,0.011820662,781,27813
ZCTA5 79934,9565,2783,6782,26916,29.3,15057,947,2978,0.110640511,6464,20452
ZCTA5 79935,6466,169,6297,19073,37.5,12123,315,319,0.016725214,523,18550
ZCTA5 79936,35736,193,35543,107579,34.1,67835,1356,3412,0.031716227,384,107195
ZCTA5 79938,26423,224,26199,91575,28.5,59934,772,3547,0.038733279,542,91033
ZCTA5 80002,9168,530,8638,19724,36.7,16763,328,123,0.006236058,1285,18439
ZCTA5 80003,14298,62,14236,36790,36.3,28938,1325,877,0.023837999,127,36663
ZCTA5 80004,14691,56,14635,35608,42.7,31650,386,288,0.00808807,154,35454
ZCTA5 80005,11210,17,11193,28909,43.2,26705,417,208,0.007194991,36,28873
ZCTA5 80007,6074,171,5903,17132,39.1,15076,895,10,0.000583703,541,16591
ZCTA5 80010,13913,85,13828,43026,32,18881,2713,7008,0.16287826,191,42835
ZCTA5 80011,17454,457,16997,52248,32.1,24485,3044,9803,0.187624407,1161,51087
ZCTA5 80012,18865,13,18852,51796,33.4,23457,3254,12156,0.234689937,23,51773
ZCTA5 80013,25850,793,25057,75525,35.9,47640,5082,10225,0.135385634,1985,73540
ZCTA5 80014,18468,92,18376,39149,40.5,26246,3087,5464,0.139569338,187,38962
ZCTA5 80015,24088,48,24040,71786,38.2,50292,5557,6280,0.087482239,183,71603
ZCTA5 80016,21874,3991,17883,63013,39.2,45592,6536,4124,0.065446813,9990,53023
ZCTA5 80017,14037,22,14015,40001,32.4,18379,2031,8700,0.217494563,40,39961
ZCTA5 80018,4701,59,4642,14513,34.7,8476,937,2314,0.159443258,114,14399
ZCTA5 80019,1390,293,1097,4162,30.6,1155,233,1646,0.395482941,785,3377
ZCTA5 80020,20733,3312,17421,53210,38.4,44066,3155,481,0.009039654,9556,43654
ZCTA5 80021,15839,262,15577,35337,36.3,29791,1521,273,0.007725613,695,34642
ZCTA5 80022,17427,42,17385,57154,32.4,39898,1023,2907,0.050862582,116,57038
ZCTA5 80023,9321,82,9239,24889,40.9,20278,2504,472,0.018964201,195,24694
ZCTA5 80024,18,125,-107,52,42.3,45,0,0,0,306,-254
ZCTA5 80025,15,344,-329,37,62.1,27,0,0,0,719,-682
ZCTA5 80026,13439,387,13052,32607,39.7,27517,1261,203,0.006225657,853,31754
ZCTA5 80027,13086,115,12971,34423,40.1,28033,3163,323,0.009383261,231,34192
ZCTA5 80030,6634,1124,5510,16805,36.1,12357,381,399,0.023742934,2573,14232
ZCTA5 80031,14219,15,14204,36835,39.9,28084,2233,552,0.014985747,43,36792
ZCTA5 80033,12488,221,12267,27499,42.6,23832,393,223,0.008109386,477,27022
ZCTA5 80045,698,0,698,1455,30.9,880,256,43,0.029553265,0,1455
ZCTA5 80101,208,155,53,459,52.3,450,0,0,0,400,59
ZCTA5 80102,2169,3136,-967,6443,38.7,5772,32,39,0.006053081,7813,-1370
ZCTA5 80103,871,665,206,2751,36.8,2081,6,44,0.015994184,1632,1119
ZCTA5 80104,12645,184,12461,33991,38.3,30180,526,191,0.005619134,519,33472
ZCTA5 80105,620,233,387,1493,52.7,1353,11,0,0,698,795
ZCTA5 80106,1857,6433,-4576,4787,50.7,4316,202,142,0.029663672,14553,-9766
ZCTA5 80107,4843,260,4583,13981,43,12627,148,22,0.001573564,776,13205
ZCTA5 80108,10760,166,10594,31545,41.1,27268,1093,660,0.020922492,375,31170
ZCTA5 80109,8945,27,8918,27187,35.1,24231,753,123,0.004524221,69,27118
ZCTA5 80110,9839,103,9736,23787,35.8,17653,605,1263,0.053096229,235,23552
ZCTA5 80111,12677,1222,11455,32122,40.4,25449,4088,408,0.012701575,2861,29261
ZCTA5 80112,14946,27,14919,35144,35.7,25749,3716,1424,0.040519008,46,35098
ZCTA5 80113,10333,41,10292,22548,38,19593,270,571,0.025323754,106,22442
ZCTA5 80116,1749,1419,330,4749,53.7,4475,14,0,0,3737,1012
ZCTA5 80117,928,106,822,2549,45.9,2118,11,24,0.009415457,197,2352
ZCTA5 80118,2270,382,1888,6141,54.3,5737,28,7,0.001139879,834,5307
ZCTA5 80120,13342,64,13278,29840,41.5,26063,610,764,0.025603217,205,29635
ZCTA5 80121,7134,4713,2421,17918,47.9,16526,235,178,0.009934144,11935,5983
ZCTA5 80122,12632,115,12517,32145,43.6,28609,983,388,0.012070306,210,31935
ZCTA5 80123,19186,98,19088,46816,40.2,40026,2667,504,0.01076555,266,46550
ZCTA5 80124,9286,327,8959,22071,39.2,17456,2384,729,0.033029768,652,21419
ZCTA5 80125,4073,2128,1945,11458,40.5,9981,311,33,0.002880084,4668,6790
ZCTA5 80126,15812,65,15747,44148,41.7,38797,2477,403,0.009128386,165,43983
ZCTA5 80127,16950,7548,9402,44417,44.5,38948,1030,326,0.007339532,19424,24993
ZCTA5 80128,14335,131,14204,37117,39.8,32353,700,403,0.010857559,482,36635
ZCTA5 80129,11882,101,11781,30340,39.9,26260,1499,358,0.011799604,208,30132
ZCTA5 80130,9357,898,8459,26643,37.6,22139,2253,384,0.014412791,1774,24869
ZCTA5 80131,119,425,-306,265,46,198,0,10,0.037735849,1403,-1138
ZCTA5 80132,9774,182,9592,28325,43.3,25660,836,262,0.009249779,401,27924
ZCTA5 80133,1069,177,892,2519,50.6,2246,18,35,0.013894403,449,2070
ZCTA5 80134,26038,5052,20986,73165,36.9,60219,5072,1784,0.024383243,13661,59504
ZCTA5 80135,1501,464,1037,4041,51,3795,19,24,0.005939124,1054,2987
ZCTA5 80136,1903,10904,-9001,5922,38.2,4786,30,61,0.010300574,27295,-21373
ZCTA5 80137,587,10215,-9628,2409,28.6,1417,0,246,0.102117061,25785,-23376
ZCTA5 80138,11737,6925,4812,34259,40.9,30601,865,233,0.006801133,16322,17937
ZCTA5 80202,10497,37,10460,16952,33.7,13940,906,446,0.02630958,300,16652
ZCTA5 80203,15040,0,15040,20972,32.9,17473,565,1019,0.048588594,0,20972
ZCTA5 80204,15339,3874,11465,33853,32.9,22924,529,2447,0.072283106,9185,24668
ZCTA5 80205,15924,117,15807,33805,32.8,20800,657,5116,0.151338559,306,33499
ZCTA5 80206,13925,1371,12554,25046,37.5,20928,758,1146,0.045755809,3779,21267
ZCTA5 80207,8887,1687,7200,22776,37.1,12254,288,6145,0.269801545,4405,18371
ZCTA5 80209,13534,0,13534,24073,37.5,21538,553,263,0.010925103,0,24073
ZCTA5 80210,16401,346,16055,38059,35.2,31681,1340,993,0.026091069,804,37255
ZCTA5 80211,18061,7,18054,36330,33.8,28393,785,767,0.021112029,18,36312
ZCTA5 80212,9767,34,9733,19778,37.8,16631,545,210,0.010617858,53,19725
ZCTA5 80214,11707,204,11503,26122,35.7,20683,429,628,0.024041038,606,25516
ZCTA5 80215,8568,605,7963,19288,41.1,16525,597,221,0.011457901,1448,17840
ZCTA5 80216,5524,0,5524,15349,30.1,8584,114,904,0.058896345,0,15349
ZCTA5 80218,11649,13,11636,19013,35.7,16207,600,729,0.038342187,13,19000
ZCTA5 80219,22222,526,21696,67393,33.1,44053,1371,1105,0.016396362,1194,66199
ZCTA5 80220,16401,2201,14200,37116,37.6,25984,1383,3558,0.095861623,5453,31663
ZCTA5 80221,13892,126,13766,40741,34.4,29659,559,732,0.017967158,229,40512
ZCTA5 80222,11011,21,10990,24169,37,18837,710,1327,0.054905044,43,24126
ZCTA5 80223,8688,112,8576,20227,34.4,13621,858,969,0.047906264,306,19921
ZCTA5 80224,8013,39,7974,18995,35.6,12899,879,2870,0.151092393,184,18811
ZCTA5 80226,13469,0,13469,32232,36.4,25574,1277,619,0.019204517,0,32232
ZCTA5 80227,15312,6939,8373,35296,38.7,27808,1718,821,0.023260426,17722,17574
ZCTA5 80228,14797,8261,6536,35091,38.6,29739,1410,339,0.009660597,23183,11908
ZCTA5 80229,19251,472,18779,56484,32,36645,2128,645,0.011419163,1232,55252
ZCTA5 80230,4840,1203,3637,9782,45.3,7796,396,407,0.041607033,2864,6918
ZCTA5 80231,15965,142,15823,35168,34.9,22627,1804,5172,0.147065514,314,34854
ZCTA5 80232,9314,113,9201,22352,39.8,18402,1206,138,0.006173944,229,22123
ZCTA5 80233,17154,803,16351,47810,33.8,35912,1166,1414,0.029575403,2287,45523
ZCTA5 80234,11714,943,10771,28793,35.7,22735,1599,579,0.020109054,2081,26712
ZCTA5 80235,3887,656,3231,8752,35.3,6993,229,528,0.060329068,1515,7237
ZCTA5 80236,6055,31,6024,16416,37.7,11851,593,224,0.013645224,94,16322
ZCTA5 80237,11300,770,10530,22149,35.7,17623,526,1596,0.072057429,2270,19879
ZCTA5 80238,10124,10583,-459,27921,35.3,20271,2344,2457,0.087998281,24881,3040
ZCTA5 80239,13385,66,13319,46465,30.9,17953,1486,8341,0.17951146,159,46306
ZCTA5 80241,11834,203,11631,34233,35.8,26600,1915,799,0.023340052,658,33575
ZCTA5 80246,7369,67,7302,12878,33,9175,279,1455,0.112983383,179,12699
ZCTA5 80247,14878,3346,11532,29066,37.2,15203,1628,6826,0.234844836,7487,21579
ZCTA5 80249,11655,149,11506,36640,32.3,14361,2575,12041,0.328629913,347,36293
ZCTA5 80260,12251,422,11829,35291,30.4,24030,1078,636,0.018021592,1019,34272
ZCTA5 80264,0,7,-7,0,-,0,0,0,#DIV/0!,11,-11
ZCTA5 80266,0,108,-108,0,-,0,0,0,#DIV/0!,406,-406
ZCTA5 80290,192,524,-332,281,48,167,29,0,0,1057,-776
ZCTA5 80293,0,404,-404,0,-,0,0,0,#DIV/0!,719,-719
ZCTA5 80294,0,18,-18,0,-,0,0,0,#DIV/0!,62,-62
ZCTA5 80301,11750,20,11730,25058,37.2,22096,849,202,0.008061298,20,25038
ZCTA5 80302,12294,10842,1452,29593,25.4,26064,1377,391,0.013212584,28309,1284
ZCTA5 80303,11128,75,11053,24810,29.8,20723,1647,311,0.012535268,149,24661
ZCTA5 80304,11072,146,10926,25332,41.9,21659,832,80,0.003158061,426,24906
ZCTA5 80305,6744,102,6642,16153,38.4,13759,1027,91,0.005633628,157,15996
ZCTA5 80310,0,15,-15,7664,19.3,5928,1052,104,0.013569937,15,7649
ZCTA5 80401,16535,4957,11578,42397,39.5,37842,1156,540,0.01273675,14712,27685
ZCTA5 80403,8435,399,8036,20831,42.9,19573,246,145,0.00696078,1181,19650
ZCTA5 80419,0,301,-301,0,-,0,0,0,#DIV/0!,671,-671
ZCTA5 80420,328,48,280,803,46.9,763,0,5,0.00622665,136,667
ZCTA5 80421,3373,4791,-1418,8807,48.1,8081,0,13,0.001476099,13149,-4342
ZCTA5 80422,1992,4,1988,4167,50.7,3864,0,14,0.003359731,4,4163
ZCTA5 80423,44,1198,-1154,138,59.4,138,0,0,0,3393,-3255
ZCTA5 80424,3727,70,3657,10862,34.5,9709,287,20,0.001841282,129,10733
ZCTA5 80425,73,671,-598,137,50,134,0,2,0.01459854,1862,-1725
ZCTA5 80426,46,1735,-1689,73,66.4,73,0,0,0,5031,-4958
ZCTA5 80427,375,10,365,680,43.8,545,0,36,0.052941176,15,665
ZCTA5 80428,194,61,133,509,45.4,504,0,0,0,149,360
ZCTA5 80430,55,118,-63,148,48.4,148,0,0,0,300,-152
ZCTA5 80432,159,77,82,285,53.6,275,0,10,0.035087719,224,61
ZCTA5 80433,3557,5643,-2086,8531,49,7948,93,0,0,16057,-7526
ZCTA5 80434,14,30,-16,23,68.8,23,0,0,0,148,-125
ZCTA5 80435,2584,18,2566,8004,35.2,6564,93,40,0.004997501,69,7935
ZCTA5 80436,179,117,62,403,58.1,341,0,0,0,317,86
ZCTA5 80438,372,1261,-889,635,46.2,558,14,9,0.014173228,3927,-3292
ZCTA5 80439,10271,73,10198,25255,48.7,23804,310,128,0.005068303,147,25108
ZCTA5 80440,1178,1150,28,2672,43.5,2496,83,20,0.00748503,2948,-276
ZCTA5 80442,772,1613,-841,2311,32,1930,99,100,0.043271311,5466,-3155
ZCTA5 80443,1849,183,1666,4379,48.2,3853,0,0,0,474,3905
ZCTA5 80444,548,135,413,1098,43.7,1000,0,8,0.007285974,446,652
ZCTA5 80446,1468,986,482,3612,50.3,3392,0,13,0.003599114,3103,509
ZCTA5 80447,975,287,688,2271,48.7,2002,0,0,0,999,1272
ZCTA5 80448,0,478,-478,0,-,0,0,0,#DIV/0!,1103,-1103
ZCTA5 80449,489,297,192,1092,59.4,979,0,0,0,631,461
ZCTA5 80451,305,311,-6,984,39.2,898,13,11,0.011178862,1087,-103
ZCTA5 80452,1561,29,1532,3289,47.2,3020,0,102,0.031012466,54,3235
ZCTA5 80453,108,196,-88,277,33,277,0,0,0,660,-383
ZCTA5 80454,640,5,635,1529,49.2,1328,24,0,0,5,1524
ZCTA5 80455,213,137,76,431,51.3,399,26,0,0,389,42
ZCTA5 80456,179,259,-80,307,59.1,307,0,0,0,641,-334
ZCTA5 80457,206,26,180,414,40.5,414,0,0,0,80,334
ZCTA5 80459,836,77,759,2565,38,2226,0,0,0,208,2357
ZCTA5 80461,2651,1093,1558,7191,34.9,5639,48,14,0.001946878,2658,4533
ZCTA5 80463,68,606,-538,137,58.4,137,0,0,0,1375,-1238
ZCTA5 80465,5927,14349,-8422,15679,43.8,13363,356,249,0.015881115,38477,-22798
ZCTA5 80466,1650,7218,-5568,3498,47.3,3297,34,27,0.007718696,21046,-17548
ZCTA5 80467,1004,132,872,2179,42.6,2100,9,32,0.014685636,510,1669
ZCTA5 80468,152,6882,-6730,403,62.3,384,0,0,0,17888,-17485
ZCTA5 80469,136,116,20,354,37.3,349,5,0,0,781,-427
ZCTA5 80470,1560,1038,522,4006,48.3,3915,0,0,0,3331,675
ZCTA5 80471,0,1928,-1928,0,-,0,0,0,#DIV/0!,5933,-5933
ZCTA5 80473,40,85,-45,51,33.8,51,0,0,0,163,-112
ZCTA5 80474,114,669,-555,197,48.6,197,0,0,0,1659,-1462
ZCTA5 80475,9,182,-173,9,-,9,0,0,0,520,-511
ZCTA5 80476,87,14,73,199,45.8,190,5,0,0,32,167
ZCTA5 80478,520,253,267,1479,36.8,1331,11,12,0.00811359,768,711
ZCTA5 80479,0,112,-112,0,-,0,0,0,#DIV/0!,359,-359
ZCTA5 80480,523,28,495,1153,55.8,1109,0,9,0.007805724,102,1051
ZCTA5 80481,236,8690,-8454,613,47.3,402,6,0,0,26614,-26001
ZCTA5 80482,620,39,581,1260,60.7,1239,0,0,0,101,1159
ZCTA5 80483,237,1130,-893,594,46.5,484,20,0,0,2384,-1790
ZCTA5 80487,7431,75,7356,18447,41.2,16322,233,43,0.002331002,212,18235
ZCTA5 80498,3347,183,3164,8469,47.3,7571,1,0,0,633,7836
ZCTA5 80501,17570,120,17450,43615,37.4,35367,789,625,0.014329932,429,43186
ZCTA5 80503,14591,29,14562,36894,42.2,32635,1684,403,0.010923185,29,36865
ZCTA5 80504,21219,357,20862,58675,39.6,49112,1689,419,0.007141031,976,57699
ZCTA5 80510,176,39,137,462,50.5,432,0,2,0.004329004,184,278
ZCTA5 80512,853,703,150,1728,55.6,1669,0,1,0.000578704,2187,-459
ZCTA5 80513,5929,402,5527,15408,44.3,14351,91,0,0,1363,14045
ZCTA5 80514,2056,54,2002,6097,31.7,4941,319,143,0.023454158,106,5991
ZCTA5 80515,349,185,164,646,60.2,646,0,0,0,491,155
ZCTA5 80516,11227,704,10523,33291,37.3,29225,1831,18,0.000540687,1847,31444
ZCTA5 80517,5071,43,5028,10675,55.9,9868,32,100,0.009367681,130,10545
ZCTA5 80520,670,97,573,1874,39.6,1581,0,0,0,316,1558
ZCTA5 80521,14179,758,13421,37867,23.5,31791,1368,652,0.017218158,2312,35555
ZCTA5 80524,15527,392,15135,37236,36.6,31911,500,413,0.011091417,881,36355
ZCTA5 80525,23060,597,22463,54980,36.4,47220,1367,772,0.01404147,1679,53301
ZCTA5 80526,18546,502,18044,44566,31.6,38677,1240,499,0.011196877,1210,43356
ZCTA5 80528,8083,1479,6604,23352,35.5,19748,1131,259,0.011091127,3959,19393
ZCTA5 80530,1820,72,1748,5190,35,4194,340,0,0,186,5004
ZCTA5 80532,107,1558,-1451,238,58.8,238,0,0,0,3846,-3608
ZCTA5 80534,6699,419,6280,18424,35.2,15704,839,123,0.006676075,1084,17340
ZCTA5 80535,1092,244,848,2263,45.7,2171,37,0,0,535,1728
ZCTA5 80536,892,359,533,2137,50.4,2024,0,0,0,1143,994
ZCTA5 80537,19064,2937,16127,43256,41.1,39197,303,117,0.002704827,8606,34650
ZCTA5 80538,20358,244,20114,49879,41.5,45373,539,450,0.009021833,745,49134
ZCTA5 80540,2103,171,1932,5124,48.3,4710,32,23,0.004488681,392,4732
ZCTA5 80542,1475,3082,-1607,4782,36.4,4244,76,0,0,9611,-4829
ZCTA5 80543,3065,1624,1441,8167,34.7,7156,77,11,0.001346884,4074,4093
ZCTA5 80544,16,73,-57,33,-,33,0,0,0,246,-213
ZCTA5 80545,603,28,575,1076,63,1040,0,0,0,65,1011
ZCTA5 80546,70,57,13,189,35.6,169,0,0,0,132,57
ZCTA5 80547,1991,26,1965,6289,35.3,5768,88,0,0,134,6155
ZCTA5 80549,4994,44,4950,13582,35.9,12212,50,166,0.012222059,148,13434
ZCTA5 80550,14320,430,13890,38494,38.8,34208,743,174,0.004520185,1574,36920
ZCTA5 80601,13120,132,12988,40346,34.5,30880,1072,951,0.02357111,301,40045
ZCTA5 80602,12446,18989,-6543,39215,38.2,29608,3051,466,0.011883208,52184,-12969
ZCTA5 80603,5279,35,5244,15116,35.7,12664,62,258,0.017068007,74,15042
ZCTA5 80610,1311,189,1122,3559,36.4,3165,47,6,0.001685867,469,3090
ZCTA5 80611,274,36,238,844,39.8,781,0,0,0,166,678
ZCTA5 80612,115,1343,-1228,268,59.4,244,0,0,0,3262,-2994
ZCTA5 80615,3376,412,2964,8931,43,7934,70,21,0.00235136,1136,7795
ZCTA5 80620,6318,3762,2556,20828,28.3,17080,257,321,0.015411945,9714,11114
ZCTA5 80621,4611,5702,-1091,13534,38.2,9788,42,177,0.013078173,16720,-3186
ZCTA5 80622,67,350,-283,207,36.6,207,0,0,0,1141,-934
ZCTA5 80623,339,214,125,1171,31.2,926,0,8,0.006831768,606,565
ZCTA5 80624,334,26,308,928,37.6,800,0,0,0,66,862
ZCTA5 80631,17183,664,16519,55089,27.9,42274,596,2166,0.039318194,2010,53079
ZCTA5 80634,22988,220,22768,60350,38.3,49569,792,654,0.010836785,829,59521
ZCTA5 80640,4471,331,4140,13344,36.4,10815,374,195,0.014613309,756,12588
ZCTA5 80642,1688,398,1290,5140,35.2,4152,14,99,0.0192607,1109,4031
ZCTA5 80643,1256,1810,-554,3745,38.2,3332,0,3,0.000801068,5040,-1295
ZCTA5 80644,973,2301,-1328,2686,39.6,2469,0,4,0.001489203,6329,-3643
ZCTA5 80645,1636,1111,525,5132,35.5,4181,12,34,0.006625097,2528,2604
ZCTA5 80646,0,4498,-4498,0,-,0,0,0,#DIV/0!,10886,-10886
ZCTA5 80648,415,686,-271,1306,41.4,1045,0,2,0.001531394,1871,-565
ZCTA5 80649,197,655,-458,429,61.2,408,0,0,0,1912,-1483
ZCTA5 80650,633,1773,-1140,1843,41,1597,10,0,0,4818,-2975
ZCTA5 80651,1437,6,1431,4145,42.4,3394,5,32,0.007720145,26,4119
ZCTA5 80652,101,6605,-6504,207,32.9,207,0,0,0,19614,-19407
ZCTA5 80653,307,2328,-2021,802,41.6,752,0,4,0.004987531,4466,-3664
ZCTA5 80654,956,2192,-1236,2961,40.7,2338,0,2,0.000675447,6623,-3662
ZCTA5 80701,6104,495,5609,16547,34.9,10806,60,901,0.054450958,1676,14871
ZCTA5 80705,356,286,70,1017,31.5,867,2,0,0,961,56
ZCTA5 80720,1028,530,498,2485,39,2243,10,61,0.024547284,1660,825
ZCTA5 80721,120,1154,-1034,477,22.6,324,0,0,0,3529,-3052
ZCTA5 80722,149,98,51,485,36,449,0,0,0,200,285
ZCTA5 80723,2581,334,2247,6838,35.1,6205,0,0,0,1028,5810
ZCTA5 80726,179,3958,-3779,389,52.5,365,0,0,0,11815,-11426
ZCTA5 80727,264,1198,-934,532,37.6,487,0,0,0,3499,-2967
ZCTA5 80728,384,504,-120,1128,44,870,23,0,0,1184,-56
ZCTA5 80729,197,5,192,429,57.3,412,0,0,0,11,418
ZCTA5 80731,582,1718,-1136,1328,44.5,1237,7,0,0,5372,-4044
ZCTA5 80732,4,12421,-12417,16,13,16,0,0,0,38361,-38345
ZCTA5 80733,226,9508,-9282,580,46.7,542,0,0,0,26378,-25798
ZCTA5 80734,1119,8337,-7218,2956,37.7,2554,10,0,0,21957,-19001
ZCTA5 80735,145,4911,-4766,316,41.6,313,0,0,0,15379,-15063
ZCTA5 80736,218,156,62,530,41.8,492,0,0,0,355,175
ZCTA5 80737,702,1038,-336,1699,42.4,1528,8,15,0.008828723,2630,-931
ZCTA5 80740,35,183,-148,71,58.8,70,0,0,0,561,-490
ZCTA5 80741,388,1580,-1192,1020,33.4,931,45,0,0,3849,-2829
ZCTA5 80742,129,264,-135,251,54.8,244,0,2,0.007968127,696,-445
ZCTA5 80743,477,19,458,1194,37,1140,0,31,0.025963149,79,1115
ZCTA5 80744,182,247,-65,461,51.9,375,3,0,0,771,-310
ZCTA5 80745,32,363,-331,68,55,68,0,0,0,1187,-1119
ZCTA5 80746,20,144,-124,45,23.8,45,0,0,0,301,-256
ZCTA5 80747,180,348,-168,454,43.7,433,7,3,0.00660793,788,-334
ZCTA5 80749,133,255,-122,294,39,202,9,0,0,911,-617
ZCTA5 80750,77,3,74,230,41.5,195,0,0,0,7,223
ZCTA5 80751,6421,592,5829,17718,37.7,14669,70,193,0.010892877,1996,15722
ZCTA5 80754,58,170,-112,151,46.8,143,2,0,0,515,-364
ZCTA5 80755,38,123,-85,103,60.7,103,0,0,0,333,-230
ZCTA5 80757,102,9646,-9544,187,54.5,180,7,0,0,35179,-34992
ZCTA5 80758,1375,5778,-4403,3412,42.5,3049,5,5,0.001465416,18402,-14990
ZCTA5 80759,1736,367,1369,4845,32.2,3998,0,125,0.025799794,1142,3703
ZCTA5 80801,54,426,-372,90,59.8,90,0,0,0,1343,-1253
ZCTA5 80802,48,2357,-2309,162,40.9,130,0,0,0,6817,-6655
ZCTA5 80804,154,21,133,300,41.5,295,0,0,0,46,254
ZCTA5 80805,149,672,-523,394,39.6,307,3,0,0,2403,-2009
ZCTA5 80807,1890,87,1803,4376,37,3706,3,3,0.000685558,194,4182
ZCTA5 80808,2441,338,2103,6550,39.8,5616,19,172,0.026259542,1018,5532
ZCTA5 80809,436,253,183,947,54.1,906,0,0,0,603,344
ZCTA5 80810,462,408,54,1116,43.2,974,3,2,0.001792115,1128,-12
ZCTA5 80812,114,145,-31,288,41,278,1,0,0,513,-225
ZCTA5 80813,742,1670,-928,1528,43.3,1400,0,18,0.011780105,4951,-3423
ZCTA5 80814,1801,0,1801,3554,54.4,3139,44,13,0.00365785,929,2625
ZCTA5 80815,360,168,192,770,53.1,758,0,0,0,393,377
ZCTA5 80816,2998,54,2944,6614,55.2,6333,88,18,0.0027215,72,6542
ZCTA5 80817,10827,210,10617,31450,30.7,22320,848,3439,0.109348172,516,30934
ZCTA5 80818,150,43,107,471,32.8,462,0,0,0,119,352
ZCTA5 80819,393,141,252,831,34.8,757,16,11,0.013237064,284,547
ZCTA5 80820,304,2935,-2631,709,58.8,689,0,0,0,6179,-5470
ZCTA5 80821,539,90,449,1270,35.6,1216,0,12,0.009448819,164,1106
ZCTA5 80822,114,25,89,223,63.2,223,0,0,0,33,190
ZCTA5 80823,86,14161,-14075,215,47.5,214,0,0,0,34022,-33807
ZCTA5 80824,152,107,45,380,45.8,279,0,0,0,181,199
ZCTA5 80825,162,784,-622,375,36.7,348,0,3,0.008,2228,-1853
ZCTA5 80826,0,337,-337,1595,36.8,1117,6,429,0.268965517,762,833
ZCTA5 80827,322,424,-102,611,64.9,551,0,0,0,1123,-512
ZCTA5 80828,846,316,530,1878,45.1,1786,16,8,0.004259851,680,1198
ZCTA5 80829,2573,118,2455,5620,42.3,5148,149,36,0.006405694,354,5266
ZCTA5 80830,46,2276,-2230,101,56.3,101,0,0,0,5475,-5374
ZCTA5 80831,9679,65,9614,30879,38.2,25839,419,1421,0.04601833,176,30703
ZCTA5 80832,353,493,-140,851,41.6,801,0,4,0.004700353,1188,-337
ZCTA5 80833,457,1581,-1124,921,59.9,910,0,0,0,3741,-2820
ZCTA5 80834,130,484,-354,295,44.4,271,0,0,0,1140,-845
ZCTA5 80835,304,965,-661,755,40.1,665,0,19,0.025165563,2248,-1493
ZCTA5 80836,387,729,-342,1110,34.7,905,0,3,0.002702703,2205,-1095
ZCTA5 80840,643,424,219,6170,20.9,5079,248,454,0.073581848,990,5180
ZCTA5 80860,232,50,182,439,52.8,391,0,0,0,139,300
ZCTA5 80861,83,270,-187,216,45,214,0,0,0,658,-442
ZCTA5 80862,21,2479,-2458,34,62.3,34,0,0,0,6002,-5968
ZCTA5 80863,5023,225,4798,13165,47,11723,95,141,0.010710216,541,12624
ZCTA5 80864,565,315,250,1305,49.9,1142,24,17,0.01302682,716,589
ZCTA5 80902,3300,71,3229,11756,23,8343,135,2250,0.19139163,180,11576
ZCTA5 80903,7427,68,7359,16844,33.5,13021,369,1158,0.068748516,163,16681
ZCTA5 80904,10552,374,10178,21162,47,17720,271,332,0.015688498,731,20431
ZCTA5 80905,8039,467,7572,16717,35.9,12787,396,1153,0.068971705,1309,15408
ZCTA5 80906,15068,439,14629,38046,38.6,30516,1200,1453,0.038190611,1010,37036
ZCTA5 80907,12512,259,12253,28549,37.2,23909,469,726,0.025429963,574,27975
ZCTA5 80908,7111,238,6873,20622,39.3,17745,457,789,0.038260111,472,20150
ZCTA5 80909,16460,15,16445,37821,35.9,28695,496,1932,0.051082732,19,37802
ZCTA5 80910,12705,16,12689,31827,29.9,17540,637,4177,0.13124077,16,31811
ZCTA5 80911,12224,320,11904,36496,34.7,26677,920,2384,0.065322227,859,35637
ZCTA5 80913,0,13175,-13175,5667,21.6,3465,202,717,0.126521969,38688,-33021
ZCTA5 80914,0,7640,-7640,384,21.7,266,8,30,0.078125,23277,-22893
ZCTA5 80915,8438,406,8032,22382,33.5,14994,603,1877,0.083862032,909,21473
ZCTA5 80916,14249,1029,13220,41087,28.8,20783,1353,6790,0.165259084,2907,38180
ZCTA5 80917,13096,917,12179,31614,33.8,24278,899,1896,0.059973429,2103,29511
ZCTA5 80918,19196,356,18840,48404,35.3,38881,997,2142,0.044252541,878,47526
ZCTA5 80919,11375,8013,3362,27788,42.1,23431,607,797,0.028681445,22342,5446
ZCTA5 80920,13880,5973,7907,38988,36.3,33043,1884,914,0.023443111,15431,23557
ZCTA5 80921,8755,2679,6076,22725,44.8,18977,1347,505,0.022222222,6950,15775
ZCTA5 80922,10496,640,9856,29623,32.4,21549,761,1380,0.046585423,1435,28188
ZCTA5 80923,11670,698,10972,32050,34.4,25003,1291,1467,0.045772231,1542,30508
ZCTA5 80924,4339,388,3951,13607,32.6,10933,711,361,0.026530462,1370,12237
ZCTA5 80925,4261,400,3861,14084,29.6,9026,307,1766,0.125390514,1016,13068
ZCTA5 80926,708,334,374,2029,44,1627,9,0,0,922,1107
ZCTA5 80927,1638,1443,195,5231,34.9,3754,165,167,0.031925062,4272,959
ZCTA5 80928,277,708,-431,831,41.8,756,5,0,0,1907,-1076
ZCTA5 80929,29,554,-525,39,88.1,39,0,0,0,1278,-1239
ZCTA5 80930,557,131,426,1691,28.5,1293,117,195,0.115316381,279,1412
ZCTA5 80938,188,201,-13,565,32.1,229,0,103,0.182300885,487,78
ZCTA5 80939,0,6386,-6386,0,-,0,0,0,#DIV/0!,24040,-24040
ZCTA5 80951,1649,46,1603,5357,26,3020,21,975,0.182004853,163,5194
ZCTA5 81001,12628,184,12444,30678,36.4,21726,226,724,0.023599974,276,30402
ZCTA5 81003,5774,2207,3567,14889,38.3,10352,139,547,0.036738532,5965,8924
ZCTA5 81004,11169,1098,10071,26641,37.2,20318,171,719,0.026988476,3157,23484
ZCTA5 81005,12975,1133,11842,32106,41.4,25034,271,432,0.013455429,3727,28379
ZCTA5 81006,4406,12675,-8269,11361,45.3,9118,196,54,0.004753103,35978,-24617
ZCTA5 81007,11507,58,11449,32991,39.5,28759,347,405,0.012276075,132,32859
ZCTA5 81008,4844,3315,1529,11239,39.6,8991,165,223,0.019841623,9984,1255
ZCTA5 81019,721,267,454,1943,36.8,1822,0,0,0,565,1378
ZCTA5 81020,489,16221,-15732,984,54.9,780,0,0,0,48067,-47083
ZCTA5 81021,3,7448,-7445,8,72.5,8,0,0,0,20078,-20070
ZCTA5 81022,518,783,-265,1452,40.2,1451,0,0,0,3245,-1793
ZCTA5 81023,642,218,424,1356,59.8,1265,0,0,0,626,730
ZCTA5 81024,145,10068,-9923,244,62.3,205,0,0,0,28550,-28306
ZCTA5 81025,378,650,-272,783,52.2,731,0,0,0,1486,-703
ZCTA5 81027,63,1574,-1511,136,41.7,119,0,0,0,4626,-4490
ZCTA5 81029,133,170,-37,363,40.4,341,0,0,0,487,-124
ZCTA5 81030,67,70,-3,131,59.8,118,0,0,0,179,-48
ZCTA5 81033,56,1998,-1942,306,29.3,119,0,0,0,5793,-5487
ZCTA5 81036,463,3484,-3021,1074,44.4,1040,0,7,0.006517691,9429,-8355
ZCTA5 81039,748,15,733,1602,51.9,1545,0,0,0,28,1574
ZCTA5 81040,125,2377,-2252,201,65.1,201,0,0,0,7680,-7479
ZCTA5 81041,242,222,20,618,38.4,523,11,0,0,568,50
ZCTA5 81043,24,0,24,56,39.3,48,0,0,0,0,56
ZCTA5 81044,67,3309,-3242,148,41,146,0,0,0,8648,-8500
ZCTA5 81045,37,1421,-1384,94,39.4,94,0,0,0,4413,-4319
ZCTA5 81046,0,68,-68,0,-,0,0,0,#DIV/0!,102,-102
ZCTA5 81047,617,15048,-14431,1617,47.5,1467,2,0,0,45749,-44132
ZCTA5 81049,96,9198,-9102,165,60.1,161,0,0,0,29581,-29416
ZCTA5 81050,4281,10907,-6626,9925,39.5,7680,99,192,0.019345088,23288,-13363
ZCTA5 81052,3340,7388,-4048,9073,36.5,7245,43,105,0.011572798,16187,-7114
ZCTA5 81054,1482,16020,-14538,5138,40.7,3768,60,296,0.057609965,39232,-34094
ZCTA5 81055,703,12023,-11320,1663,64.2,1504,0,2,0.001202646,27743,-26080
ZCTA5 81057,131,13604,-13473,322,45.5,306,0,0,0,31289,-30967
ZCTA5 81058,428,18227,-17799,1242,42.3,930,38,43,0.034621578,52411,-51169
ZCTA5 81059,19,3530,-3511,34,62.3,34,0,0,0,7904,-7870
ZCTA5 81062,337,9657,-9320,1641,34.5,1368,0,120,0.073126143,26384,-24743
ZCTA5 81063,760,8681,-7921,3260,38.6,2487,4,142,0.043558282,20524,-17264
ZCTA5 81064,112,5465,-5353,250,39,230,0,0,0,15210,-14960
ZCTA5 81067,1878,2152,-274,5444,38.8,4549,51,4,0.000734754,5546,-102
ZCTA5 81069,885,72,813,2215,51.8,2075,0,0,0,205,2010
ZCTA5 81071,84,246,-162,244,28.4,236,0,0,0,507,-263
ZCTA5 81073,774,546,228,1726,41.6,1575,50,22,0.012746234,1360,366
ZCTA5 81076,187,2900,-2713,745,41.5,526,0,3,0.004026846,7718,-6973
ZCTA5 81077,309,84,225,617,39.5,550,10,0,0,218,399
ZCTA5 81081,89,63,26,157,43.1,153,0,0,0,182,-25
ZCTA5 81082,5121,130,4991,11818,44.5,9085,96,93,0.007869352,270,11548
ZCTA5 81084,40,616,-576,67,64.3,52,0,0,0,1610,-1543
ZCTA5 81087,69,613,-544,169,35.8,155,0,0,0,1308,-1139
ZCTA5 81089,1862,52,1810,4759,50.2,4143,4,4,0.000840513,138,4621
ZCTA5 81090,468,304,164,949,55.5,862,0,0,0,856,93
ZCTA5 81091,378,10575,-10197,969,40.9,552,0,56,0.057791538,23806,-22837
ZCTA5 81092,301,12534,-12233,803,42,720,2,0,0,31089,-30286
ZCTA5 81101,5902,186,5716,15110,32.4,10877,187,339,0.022435473,403,14707
ZCTA5 81120,1061,953,108,2204,47.3,1588,0,28,0.012704174,2580,-376
ZCTA5 81121,160,632,-472,362,52.6,208,0,0,0,1499,-1137
ZCTA5 81122,3432,126,3306,8896,41.4,8159,15,4,0.00044964,369,8527
ZCTA5 81123,346,95,251,820,44.5,591,32,0,0,288,532
ZCTA5 81124,59,13,46,164,48.8,83,2,0,0,34,130
ZCTA5 81125,1459,56,1403,3573,38.3,2734,0,78,0.021830395,127,3446
ZCTA5 81126,74,335,-261,387,31.9,83,0,0,0,671,-284
ZCTA5 81128,30,555,-525,45,63.2,45,0,0,0,1479,-1434
ZCTA5 81129,7,575,-568,7,-,7,0,0,0,1080,-1073
ZCTA5 81130,369,105,264,745,51.4,696,13,12,0.016107383,224,521
ZCTA5 81131,604,7778,-7174,1042,65.8,983,0,0,0,19739,-18697
ZCTA5 81132,1513,589,924,3338,41.7,2843,0,3,0.000898742,1204,2134
ZCTA5 81133,422,1404,-982,1072,54.6,873,7,0,0,3135,-2063
ZCTA5 81136,112,581,-469,328,22.8,319,0,8,0.024390244,1018,-690
ZCTA5 81137,2250,115,2135,5662,41,4069,20,37,0.006534793,221,5441
ZCTA5 81138,24,98,-74,37,64.5,12,0,0,0,105,-68
ZCTA5 81140,797,71,726,1969,36.9,1573,16,9,0.004570848,207,1762
ZCTA5 81141,409,10800,-10391,1049,37.9,790,0,0,0,25865,-24816
ZCTA5 81143,340,0,340,769,54.2,750,0,0,0,1175,-406
ZCTA5 81144,2551,625,1926,6881,38.9,5055,7,14,0.002034588,1751,5130
ZCTA5 81146,336,374,-38,1039,40,895,4,0,0,750,289
ZCTA5 81147,5437,555,4882,12599,49.4,10230,125,41,0.003254227,1354,11245
ZCTA5 81148,137,76,61,313,36.3,185,1,0,0,124,189
ZCTA5 81149,418,812,-394,939,53.7,762,75,0,0,1807,-868
ZCTA5 81151,662,862,-200,1777,36.6,1299,0,0,0,1882,-105
ZCTA5 81152,492,572,-80,1089,48.8,812,1,0,0,1499,-410
ZCTA5 81154,474,541,-67,1105,51.9,1039,5,0,0,1046,59
ZCTA5 81155,140,14110,-13970,239,66.6,225,0,0,0,37545,-37306
ZCTA5 81201,4119,969,3150,9054,45.1,8284,170,0,0,2281,6773
ZCTA5 81210,184,2730,-2546,283,64.9,283,0,0,0,5986,-5703
ZCTA5 81211,3280,223,3057,8156,50.9,7494,12,278,0.034085336,552,7604
ZCTA5 81212,11622,5213,6409,31899,44.5,28665,231,1223,0.03833976,14019,17880
ZCTA5 81220,64,2451,-2387,139,62.7,139,0,0,0,5339,-5200
ZCTA5 81221,140,2797,-2657,414,37.5,400,0,0,0,6846,-6432
ZCTA5 81222,210,7537,-7327,425,58.1,425,0,0,0,17560,-17135
ZCTA5 81223,951,74,877,1822,64.5,1791,8,0,0,106,1716
ZCTA5 81224,1564,295,1269,3468,41.6,3297,20,1,0.000288351,705,2763
ZCTA5 81225,488,365,123,1052,40.5,1029,0,0,0,850,202
ZCTA5 81226,2510,1555,955,9266,42.7,7406,91,941,0.101554069,4104,5162
ZCTA5 81227,0,101,-101,0,-,0,0,0,#DIV/0!,266,-266
ZCTA5 81228,0,754,-754,0,-,0,0,0,#DIV/0!,1964,-1964
ZCTA5 81230,4189,265,3924,10676,28.1,9671,0,134,0.012551517,649,10027
ZCTA5 81232,23,809,-786,45,-,45,0,0,0,1905,-1860
ZCTA5 81233,434,45,389,1006,39.5,874,0,20,0.019880716,76,930
ZCTA5 81235,414,662,-248,800,56.3,708,2,9,0.01125,1614,-814
ZCTA5 81236,626,335,291,1096,66.3,1096,0,0,0,1074,22
ZCTA5 81237,48,91,-43,115,56.2,115,0,0,0,282,-167
ZCTA5 81239,116,10947,-10831,161,68.7,161,0,0,0,42318,-42157
ZCTA5 81240,1434,2587,-1153,3749,41.8,3554,16,0,0,9850,-6101
ZCTA5 81241,101,5075,-4974,196,59.4,192,0,0,0,21106,-20910
ZCTA5 81242,522,286,236,1146,45.4,1022,6,0,0,928,218
ZCTA5 81243,38,197,-159,65,60.6,65,0,0,0,510,-445
ZCTA5 81244,219,15043,-14824,513,47.9,482,0,0,0,45310,-44797
ZCTA5 81248,74,212,-138,184,37.4,184,0,0,0,765,-581
ZCTA5 81251,144,5286,-5142,226,59.7,226,0,0,0,15624,-15398
ZCTA5 81252,1831,19097,-17266,3931,58.4,3681,40,81,0.020605444,61642,-57711
ZCTA5 81253,198,1292,-1094,405,61.7,405,0,0,0,3621,-3216
ZCTA5 81301,12202,24,12178,29385,40.9,25562,290,132,0.004492088,96,29289
ZCTA5 81303,3595,11360,-7765,9587,41.1,7934,113,130,0.013560029,41538,-31951
ZCTA5 81320,207,1352,-1145,503,44.9,425,0,0,0,3600,-3097
ZCTA5 81321,5775,340,5435,15050,42.8,12034,162,93,0.006179402,1206,13844
ZCTA5 81323,2182,99,2083,4854,48.4,4293,0,155,0.031932427,243,4611
ZCTA5 81324,767,58,709,1506,60.7,1325,0,0,0,101,1405
ZCTA5 81325,71,5339,-5268,109,64.8,109,0,0,0,18748,-18639
ZCTA5 81326,1045,477,568,2783,45.6,2377,34,0,0,1302,1481
ZCTA5 81327,200,263,-63,357,56.8,345,0,0,0,642,-285
ZCTA5 81328,1710,234,1476,3750,52.5,3551,0,0,0,587,3163
ZCTA5 81330,75,2981,-2906,116,68.3,100,7,9,0.077586207,9399,-9283
ZCTA5 81331,66,80,-14,117,60.1,117,0,0,0,220,-103
ZCTA5 81332,217,5274,-5057,377,54.5,302,0,0,0,17620,-17243
ZCTA5 81334,428,363,65,1633,19,41,4,0,0,953,680
ZCTA5 81335,33,112,-79,55,-,55,0,0,0,282,-227
ZCTA5 81401,9486,268,9218,23497,46.3,20991,247,38,0.001617228,662,22835
ZCTA5 81403,4557,2072,2485,11254,48,9583,53,57,0.005064866,6099,5155
ZCTA5 81410,783,9238,-8455,1769,53.9,1644,15,0,0,33462,-31693
ZCTA5 81411,20,116,-96,35,54.3,35,0,0,0,395,-360
ZCTA5 81413,2265,242,2023,5802,48.5,5415,31,28,0.004825922,849,4953
ZCTA5 81415,783,7109,-6326,1687,58.1,1652,0,0,0,23606,-21919
ZCTA5 81416,5041,14714,-9673,14258,44.4,12593,219,205,0.014377893,44210,-29952
ZCTA5 81418,526,2433,-1907,1505,48,1376,0,118,0.078405316,10093,-8588
ZCTA5 81419,1324,12527,-11203,3064,54.4,3009,0,0,0,48555,-45491
ZCTA5 81422,217,7694,-7477,483,49.8,478,0,0,0,27697,-27214
ZCTA5 81423,699,4106,-3407,1675,49.6,1668,0,0,0,17043,-15368
ZCTA5 81424,509,244,265,1034,59.2,996,1,24,0.023210832,647,387
ZCTA5 81425,1880,11642,-9762,5497,38.9,4654,0,11,0.002001092,29574,-24077
ZCTA5 81426,71,1509,-1438,198,37.1,198,0,0,0,4500,-4302
ZCTA5 81427,526,2780,-2254,1247,49.5,1196,0,44,0.035284683,9389,-8142
ZCTA5 81428,1623,175,1448,3522,51.3,3276,23,67,0.019023282,518,3004
ZCTA5 81429,36,481,-445,115,76.1,114,0,0,0,1099,-984
ZCTA5 81430,326,365,-39,714,52.9,699,0,0,0,905,-191
ZCTA5 81431,156,5036,-4880,425,48.7,399,0,0,0,15800,-15375
ZCTA5 81432,1403,442,961,3010,54.6,2764,8,39,0.012956811,1298,1712
ZCTA5 81433,307,1029,-722,649,44.4,599,0,0,0,3646,-2997
ZCTA5 81434,86,11137,-11051,153,54.7,153,0,0,0,37616,-37463
ZCTA5 81435,2492,9377,-6885,5508,38,4981,64,19,0.003449528,30625,-25117
ZCTA5 81501,10534,3027,7507,23803,35.3,21485,107,173,0.007267991,7743,16060
ZCTA5 81503,6066,203,5863,15941,38.6,14368,133,72,0.004516655,570,15371
ZCTA5 81504,11942,11712,230,31094,37.7,26180,231,415,0.013346626,42771,-11677
ZCTA5 81505,4962,126,4836,12009,39.8,10602,210,151,0.012573903,365,11644
ZCTA5 81506,5076,255,4821,11504,54.2,10485,326,36,0.003129346,873,10631
ZCTA5 81507,6471,9550,-3079,15911,50.7,14566,295,52,0.003268179,36991,-21080
ZCTA5 81520,5258,3802,1456,14023,33.2,13061,296,28,0.00199672,10766,3257
ZCTA5 81521,5865,12589,-6724,15859,41.6,14102,127,168,0.010593354,37343,-21484
ZCTA5 81522,52,205,-153,104,69,104,0,0,0,559,-455
ZCTA5 81523,442,8680,-8238,668,60.5,668,0,0,0,24296,-23628
ZCTA5 81524,784,349,435,2577,32.5,2329,0,0,0,1153,1424
ZCTA5 81525,498,171,327,1406,44.1,1406,0,0,0,527,879
ZCTA5 81526,2193,64,2129,5065,54.1,4554,6,8,0.001579467,168,4897
ZCTA5 81527,688,13758,-13070,1678,51.3,1598,38,4,0.00238379,44246,-42568
ZCTA5 81601,5945,6408,-463,16485,39.4,12925,315,130,0.007885957,24104,-7619
ZCTA5 81610,100,97,3,290,27.4,290,0,0,0,316,-26
ZCTA5 81611,4218,9034,-4816,10497,40.4,9083,407,12,0.001143184,27133,-16636
ZCTA5 81612,31,81,-50,91,-,31,0,0,0,227,-136
ZCTA5 81615,1503,10749,-9246,3089,62.4,2586,0,11,0.003561023,41480,-38391
ZCTA5 81620,4037,247,3790,11131,35.1,8235,572,306,0.027490791,742,10389
ZCTA5 81621,2357,446,1911,6122,46,5605,17,13,0.002123489,1242,4880
ZCTA5 81623,6024,11867,-5843,16520,41.4,14152,106,46,0.002784504,36832,-20312
ZCTA5 81624,493,150,343,1458,41.1,1360,8,40,0.027434842,369,1089
ZCTA5 81625,4935,103,4832,12740,37.5,11013,22,83,0.006514914,409,12331
ZCTA5 81630,415,3977,-3562,1156,35.4,1061,0,0,0,13707,-12551
ZCTA5 81631,2616,10456,-7840,8271,35.7,7147,0,7,0.000846331,35188,-26917
ZCTA5 81632,3641,8900,-5259,10493,37.5,7977,171,171,0.016296579,29848,-19355
ZCTA5 81633,0,7603,-7603,0,-,0,0,0,#DIV/0!,23534,-23534
ZCTA5 81635,2698,8937,-6239,7084,33.8,5493,33,61,0.008610954,27650,-20566
ZCTA5 81637,2875,13855,-10980,9307,35.5,6814,0,0,0,51364,-42057
ZCTA5 81638,34,8675,-8641,67,45.7,67,0,0,0,32998,-32931
ZCTA5 81639,1041,5871,-4830,2696,42.7,2387,22,0,0,20823,-18127
ZCTA5 81640,27,6174,-6147,123,26.9,110,0,0,0,16933,-16810
ZCTA5 81641,1578,2254,-676,3903,39.3,3534,6,1,0.000256213,4705,-802
ZCTA5 81642,12,8661,-8649,12,-,12,0,0,0,17212,-17200
ZCTA5 81643,204,10481,-10277,368,61.2,367,0,0,0,21742,-21374
ZCTA5 81645,379,7289,-6910,1098,35.7,959,0,0,0,25163,-24065
ZCTA5 81646,82,9240,-9158,192,43.6,192,0,0,0,22672,-22480
ZCTA5 81647,2371,13788,-11417,6605,39,5447,39,0,0,33006,-26401
ZCTA5 81648,899,13234,-12335,2530,36.3,2142,0,19,0.007509881,31472,-28942
ZCTA5 81649,99,8006,-7907,281,36.2,260,0,0,0,21623,-21342
ZCTA5 81650,4586,8492,-3906,14323,32.3,11455,54,50,0.003490889,24131,-9808
ZCTA5 81652,1972,5888,-3916,6038,35.8,5167,10,53,0.008777741,10950,-4912
ZCTA5 81653,0,530,-530,0,-,0,0,0,#DIV/0!,1656,-1656
ZCTA5 81654,518,1,517,1458,46.9,1424,0,0,0,72,1386
ZCTA5 81655,147,10192,-10045,307,41.4,307,0,0,0,24785,-24478
ZCTA5 81656,158,9812,-9654,299,64,241,0,0,0,31980,-31681
ZCTA5 81657,2327,10240,-7913,5164,49.6,4951,47,7,0.001355538,24754,-19590
ZCTA5 82001,16085,18824,-2739,37286,35.1,31481,372,1146,0.030735397,66107,-28821
ZCTA5 82005,0,16730,-16730,641,21.2,452,33,83,0.129485179,53633,-52992
ZCTA5 82007,8736,13730,-4994,22436,32.9,18818,248,393,0.017516491,47858,-25422
ZCTA5 82009,14092,15385,-1293,34509,44.7,30861,475,772,0.022370976,41120,-6611
ZCTA5 82050,127,13965,-13838,298,51.8,288,0,0,0,38764,-38466
ZCTA5 82051,4,7844,-7840,12,44.5,12,0,0,0,21695,-21683
ZCTA5 82052,38,7578,-7540,77,69.8,77,0,0,0,29143,-29066
ZCTA5 82053,502,16,486,1112,54.3,913,0,0,0,24,1088
ZCTA5 82054,270,0,270,938,33.3,868,0,0,0,0,938
ZCTA5 82055,170,313,-143,344,64.4,338,0,0,0,869,-525
ZCTA5 82058,16,7912,-7896,16,-,16,0,0,0,23966,-23950
ZCTA5 82059,124,11,113,279,57.4,261,0,0,0,20,259
ZCTA5 82060,149,227,-78,528,20.7,528,0,0,0,732,-204
ZCTA5 82061,0,94,-94,0,-,0,0,0,#DIV/0!,241,-241
ZCTA5 82063,47,456,-409,81,64.3,81,0,0,0,1327,-1246
ZCTA5 82070,8405,127,8278,19405,29.4,17023,488,137,0.007060036,406,18999
ZCTA5 82072,7111,155,6956,16874,26.5,14583,907,200,0.011852554,424,16450
ZCTA5 82073,12,1628,-1616,38,42.2,38,0,0,0,4752,-4714
ZCTA5 82081,28,253,-225,77,39.8,77,0,0,0,800,-723
ZCTA5 82082,738,1231,-493,1819,45.5,1630,0,0,0,4059,-2240
ZCTA5 82083,130,78,52,326,40,308,6,0,0,252,74
ZCTA5 82084,42,293,-251,78,59.9,78,0,0,0,784,-706
ZCTA5 82190,219,2424,-2205,1057,39.3,951,48,41,0.038789026,7926,-6869
ZCTA5 82201,2941,68,2873,6793,49.1,6080,60,40,0.005888415,173,6620
ZCTA5 82210,156,712,-556,271,63.1,267,3,0,0,1911,-1640
ZCTA5 82212,263,1102,-839,729,47.8,525,0,0,0,3885,-3156
ZCTA5 82213,188,2132,-1944,315,67.6,308,0,0,0,7723,-7408
ZCTA5 82214,515,721,-206,1157,50.1,1062,0,3,0.002592913,2134,-977
ZCTA5 82215,70,14224,-14154,217,34.8,217,0,0,0,44361,-44144
ZCTA5 82217,32,231,-199,52,53,52,0,0,0,685,-633
ZCTA5 82218,6,544,-538,16,-,16,0,0,0,1920,-1904
ZCTA5 82219,10,474,-464,24,64.6,24,0,0,0,1474,-1450
ZCTA5 82221,244,254,-10,506,30.5,494,0,2,0.003952569,875,-369
ZCTA5 82222,62,513,-451,159,38.6,159,0,0,0,1662,-1503
ZCTA5 82223,373,56,317,786,49.6,778,0,0,0,194,592
ZCTA5 82224,2,122,-120,2,-,2,0,0,0,315,-313
ZCTA5 82225,745,101,644,1878,44.5,1711,0,13,0.006922258,283,1595
ZCTA5 82227,118,2277,-2159,259,63.8,253,0,0,0,7227,-6968
ZCTA5 82229,0,865,-865,0,-,0,0,0,#DIV/0!,2749,-2749
ZCTA5 82240,3764,88,3676,9853,43.9,8878,109,69,0.007002943,175,9678
ZCTA5 82242,27,3378,-3351,72,28.4,72,0,0,0,11259,-11187
ZCTA5 82243,45,93,-48,199,20.8,199,0,0,0,209,-10
ZCTA5 82244,205,3455,-3250,440,43,394,0,17,0.038636364,11248,-10808
ZCTA5 82301,3296,164,3132,8513,37.2,7172,93,151,0.017737578,514,7999
ZCTA5 82310,12,1514,-1502,24,-,24,0,0,0,5164,-5140
ZCTA5 82321,243,1103,-860,602,44.8,549,0,2,0.003322259,3565,-2963
ZCTA5 82322,72,6707,-6635,169,57.9,162,0,0,0,19990,-19821
ZCTA5 82323,84,12408,-12324,355,14.7,174,0,0,0,35179,-34824
ZCTA5 82324,78,13146,-13068,197,35.1,193,0,0,0,37487,-37290
ZCTA5 82325,391,19206,-18815,726,63.8,714,0,0,0,55837,-55111
ZCTA5 82327,304,11071,-10767,794,26.9,794,0,0,0,31232,-30438
ZCTA5 82329,172,8290,-8118,383,58.8,349,0,0,0,26078,-25695
ZCTA5 82331,1082,4662,-3580,2389,49.1,2233,7,1,0.000418585,13518,-11129
ZCTA5 82332,23,1303,-1280,34,66.8,34,0,0,0,4476,-4442
ZCTA5 82334,226,428,-202,602,39.6,582,8,6,0.009966777,1089,-487
ZCTA5 82335,0,638,-638,0,-,0,0,0,#DIV/0!,1896,-1896
ZCTA5 82336,81,0,81,243,55.9,164,0,0,0,0,243
ZCTA5 82401,2997,50,2947,6990,42,5898,28,1,0.000143062,157,6833
ZCTA5 82410,780,211,569,2080,49.5,1986,3,0,0,612,1468
ZCTA5 82411,202,564,-362,580,38.3,524,0,0,0,1359,-779
ZCTA5 82412,180,203,-23,525,39.9,509,0,0,0,669,-144
ZCTA5 82414,6881,128,6753,16038,44.9,15144,33,62,0.003865819,389,15649
ZCTA5 82420,233,577,-344,774,31.3,668,16,39,0.050387597,1883,-1109
ZCTA5 82421,130,488,-358,258,62.9,256,1,0,0,1247,-989
ZCTA5 82422,0,1609,-1609,0,-,0,0,0,#DIV/0!,3806,-3806
ZCTA5 82423,84,988,-904,233,38.6,203,0,0,0,2834,-2601
ZCTA5 82426,1138,42,1096,3239,38.2,2739,13,0,0,89,3150
ZCTA5 82428,72,135,-63,143,57.6,119,0,0,0,313,-170
ZCTA5 82430,29,144,-115,48,52.5,45,0,0,0,644,-596
ZCTA5 82431,1086,3773,-2687,3221,37.7,2980,35,15,0.004656939,9436,-6215
ZCTA5 82432,147,91,56,262,55,199,0,0,0,133,129
ZCTA5 82433,525,510,15,1162,55,908,1,112,0.096385542,2444,-1282
ZCTA5 82434,28,878,-850,61,65.4,61,0,0,0,2746,-2685
ZCTA5 82435,4919,397,4522,11800,42.1,10921,63,13,0.001101695,2026,9774
ZCTA5 82440,101,435,-334,225,63.6,180,0,0,0,1301,-1076
ZCTA5 82441,92,164,-72,179,45.2,174,0,4,0.022346369,523,-344
ZCTA5 82442,436,43,393,923,55.8,902,3,0,0,127,796
ZCTA5 82443,2048,735,1313,4617,45.5,4362,0,0,0,1958,2659
ZCTA5 82450,80,9985,-9905,133,68.6,133,0,0,0,33064,-32931
ZCTA5 82501,6946,11878,-4932,18853,37.2,14096,149,105,0.005569405,47558,-28705
ZCTA5 82510,245,9950,-9705,1092,29,68,0,3,0.002747253,32910,-31818
ZCTA5 82512,158,431,-273,300,50.5,227,0,0,0,1120,-820
ZCTA5 82513,791,85,706,1380,63.3,1354,0,4,0.002898551,233,1147
ZCTA5 82514,418,431,-13,1629,29.5,66,3,1,0.000613874,1450,179
ZCTA5 82515,160,59,101,436,52.7,409,0,0,0,230,206
ZCTA5 82516,135,1835,-1700,353,48.3,227,0,0,0,5594,-5241
ZCTA5 82520,4846,64,4782,13329,39.2,9963,15,85,0.006377073,226,13103
ZCTA5 82523,324,1621,-1297,918,42.8,746,0,0,0,6376,-5458
ZCTA5 82601,11183,292,10891,27638,36.5,25279,130,219,0.007923873,691,26947
ZCTA5 82604,10494,1058,9436,27155,37,25035,86,139,0.005118763,3333,23822
ZCTA5 82609,8359,96,8263,18207,39.8,16928,105,160,0.008787829,375,17832
ZCTA5 82620,111,980,-869,243,60.6,243,0,0,0,3122,-2879
ZCTA5 82630,0,323,-323,0,-,0,0,0,#DIV/0!,1021,-1021
ZCTA5 82633,4042,376,3666,9478,43.5,9094,40,30,0.003165225,1127,8351
ZCTA5 82635,43,576,-533,94,51.3,94,0,0,0,3405,-3311
ZCTA5 82636,1491,329,1162,3999,31.8,3547,58,78,0.019504876,872,3127
ZCTA5 82637,1599,146,1453,4229,38.6,3991,0,0,0,442,3787
ZCTA5 82638,17,222,-205,110,41.4,110,0,0,0,591,-481
ZCTA5 82639,273,82,191,749,40.4,731,0,0,0,224,525
ZCTA5 82640,77,327,-250,129,-,129,0,0,0,1112,-983
ZCTA5 82642,27,51,-24,42,61.8,42,0,0,0,176,-134
ZCTA5 82643,106,1063,-957,193,48.7,190,0,0,0,3459,-3266
ZCTA5 82644,766,190,576,1590,41.7,1590,0,0,0,555,1035
ZCTA5 82646,13,636,-623,27,-,27,0,0,0,2596,-2569
ZCTA5 82648,35,589,-554,87,29.5,87,0,0,0,1625,-1538
ZCTA5 82649,425,1114,-689,1075,40.2,963,8,0,0,3729,-2654
ZCTA5 82701,1985,1757,228,5307,41.8,4711,17,9,0.001695873,5727,-420
ZCTA5 82710,98,242,-144,253,43.6,242,0,0,0,770,-517
ZCTA5 82711,10,6422,-6412,10,-,10,0,0,0,23463,-23453
ZCTA5 82712,140,294,-154,348,46.1,348,0,0,0,807,-459
ZCTA5 82714,0,2215,-2215,0,-,0,0,0,#DIV/0!,8058,-8058
ZCTA5 82716,6783,1032,5751,17450,36.7,15744,18,48,0.002750716,2663,14787
ZCTA5 82718,8789,2644,6145,25335,33.1,22699,0,74,0.00292086,10477,14858
ZCTA5 82720,301,115,186,723,51.8,650,0,0,0,303,420
ZCTA5 82721,1067,173,894,3247,35.3,3096,15,0,0,556,2691
ZCTA5 82723,71,10125,-10054,145,70.4,145,0,0,0,37454,-37309
ZCTA5 82725,102,409,-307,168,59,168,0,0,0,1282,-1114
ZCTA5 82727,679,8985,-8306,1618,48.3,1575,0,0,0,30139,-28521
ZCTA5 82729,1135,1944,-809,2527,51.8,2396,9,0,0,8148,-5621
ZCTA5 82730,801,121,680,1607,49.5,1466,35,16,0.009956441,478,1129
ZCTA5 82731,85,128,-43,220,30.9,220,0,0,0,393,-173
ZCTA5 82732,738,2845,-2107,1894,38.8,1713,25,12,0.006335797,8593,-6699
ZCTA5 82801,10771,61,10710,25342,42.1,23445,309,144,0.005682267,179,25163
ZCTA5 82831,104,170,-66,263,35.9,261,0,0,0,539,-276
ZCTA5 82832,510,110,400,1250,43.8,1250,0,0,0,235,1015
ZCTA5 82833,139,1136,-997,180,64.9,180,0,0,0,3712,-3532
ZCTA5 82834,3398,339,3059,7458,45.6,6852,47,61,0.008179136,1045,6413
ZCTA5 82835,144,160,-16,385,31.6,379,0,0,0,481,-96
ZCTA5 82836,380,106,274,1050,42.8,1044,0,0,0,215,835
ZCTA5 82837,13,68,-55,24,26.7,24,0,0,0,195,-171
ZCTA5 82838,235,21,214,548,63.3,509,0,0,0,27,521
ZCTA5 82839,535,6656,-6121,1477,36.5,1441,0,0,0,19726,-18249
ZCTA5 82842,233,6796,-6563,435,61.2,435,0,0,0,20796,-20361
ZCTA5 82844,20,255,-235,32,77.5,32,0,0,0,749,-717
ZCTA5 82845,26,244,-218,55,-,55,0,0,0,849,-794
ZCTA5 82901,10225,442,9783,28180,35.1,24355,368,525,0.018630234,1251,26929
ZCTA5 82922,169,418,-249,309,67.1,278,0,0,0,1436,-1127
ZCTA5 82923,276,408,-132,442,74.2,442,0,0,0,799,-357
ZCTA5 82925,162,76,86,387,59.8,387,0,0,0,260,127
ZCTA5 82929,18,140,-122,42,26.8,19,0,0,0,396,-354
ZCTA5 82930,5629,75,5554,14816,36,13382,37,98,0.006614471,252,14564
ZCTA5 82932,301,29,272,705,44.2,672,0,0,0,122,583
ZCTA5 82933,200,8,192,573,40.3,573,0,0,0,16,557
ZCTA5 82934,56,71,-15,127,36.1,105,0,0,0,221,-94
ZCTA5 82935,4494,74,4420,12403,39.8,10897,97,0,0,194,12209
ZCTA5 82936,6,83,-77,10,-,10,0,0,0,204,-194
ZCTA5 82937,1171,98,1073,3302,35.6,3193,0,0,0,268,3034
ZCTA5 82938,99,4904,-4805,227,60.7,227,0,0,0,14726,-14499
ZCTA5 82939,583,2615,-2032,1294,55,1176,0,0,0,6899,-5605
ZCTA5 82941,1781,195,1586,5048,36.2,4887,0,1,0.000198098,490,4558
ZCTA5 82942,45,68,-23,66,31.4,66,0,0,0,248,-182
ZCTA5 82943,76,2521,-2445,147,49.5,86,22,0,0,5545,-5398
ZCTA5 82944,114,74,40,597,17.1,597,0,0,0,185,412
ZCTA5 82945,62,8,54,150,44.7,114,0,0,0,53,97
ZCTA5 83001,7296,82,7214,17984,37.5,14872,306,138,0.007673488,246,17738
ZCTA5 83011,104,1248,-1144,335,59.2,222,0,0,0,4097,-3762
ZCTA5 83012,41,447,-406,115,24.3,115,0,0,0,1493,-1378
ZCTA5 83013,65,349,-284,240,64.3,233,2,2,0.008333333,1126,-886
ZCTA5 83014,1225,94,1131,2648,54.4,2573,17,0,0,283,2365
ZCTA5 83025,435,198,237,773,54.8,717,0,0,0,445,328
ZCTA5 83101,1439,627,812,3037,39.8,2908,20,3,0.000987817,1822,1215
ZCTA5 83110,1750,307,1443,4973,39.5,4604,8,0,0,953,4020
ZCTA5 83111,189,23,166,606,25.3,584,0,0,0,35,571
ZCTA5 83112,186,1327,-1141,851,18.3,851,0,0,0,4024,-3173
ZCTA5 83113,833,59,774,2370,45.5,2210,0,0,0,109,2261
ZCTA5 83114,272,138,134,806,36,781,2,0,0,311,495
ZCTA5 83115,116,416,-300,274,60.8,274,0,0,0,1075,-801
ZCTA5 83116,328,210,118,784,47,714,0,0,0,522,262
ZCTA5 83118,339,764,-425,620,49.6,620,0,0,0,2293,-1673
ZCTA5 83119,78,305,-227,205,73.7,205,0,0,0,679,-474
ZCTA5 83120,136,1041,-905,400,45.5,400,0,0,0,2951,-2551
ZCTA5 83121,0,142,-142,0,-,0,0,0,#DIV/0!,245,-245
ZCTA5 83122,184,121,63,914,25,914,0,0,0,299,615
ZCTA5 83123,265,77,188,597,54.1,564,16,0,0,149,448
ZCTA5 83124,51,1751,-1700,112,56.5,109,1,0,0,6606,-6494
ZCTA5 83126,178,56,122,612,40.5,584,0,0,0,227,385
ZCTA5 83127,1515,283,1232,3677,52.2,3500,10,5,0.001359804,660,3017
ZCTA5 83128,502,13995,-13493,1283,38.1,1213,16,6,0.004676539,40945,-39662
ZCTA5 83201,13995,71,13924,38683,32.2,33371,1239,357,0.00922886,136,38547
ZCTA5 83202,8313,72,8241,22609,35.4,18636,268,27,0.001194215,124,22485
ZCTA5 83203,13,570,-557,13,-,0,0,0,0,1730,-1717
ZCTA5 83204,7722,238,7484,19125,37.8,16436,103,205,0.010718954,548,18577
ZCTA5 83209,217,256,-39,926,20.9,791,25,60,0.064794816,754,172
ZCTA5 83210,1362,144,1218,4298,24.3,2434,3,0,0,422,3876
ZCTA5 83211,2154,6330,-4176,6165,35.7,4642,0,0,0,19356,-13191
ZCTA5 83212,126,77,49,379,23.5,376,0,0,0,147,232
ZCTA5 83213,450,341,109,1320,44.7,1189,0,0,0,1006,314
ZCTA5 83214,233,207,26,679,32.3,542,2,0,0,587,92
ZCTA5 83215,28,371,-343,48,57.9,46,0,0,0,2801,-2753
ZCTA5 83217,320,11967,-11647,894,37.3,839,0,0,0,34251,-33357
ZCTA5 83218,151,3968,-3817,441,36.9,409,0,0,0,9373,-8932
ZCTA5 83220,44,1974,-1930,69,70.2,69,0,0,0,4391,-4322
ZCTA5 83221,9076,8236,840,28184,33.6,23420,177,61,0.002164349,25083,3101
ZCTA5 83223,84,4783,-4699,201,46.6,201,0,0,0,13934,-13733
ZCTA5 83226,832,18592,-17760,1979,56.9,1821,1,0,0,50193,-48214
ZCTA5 83227,23,12305,-12282,41,61.5,38,0,3,0.073170732,49581,-49540
ZCTA5 83228,314,3259,-2945,1095,25.2,1035,0,0,0,6805,-5710
ZCTA5 83232,130,9617,-9487,399,30.7,377,0,0,0,20136,-19737
ZCTA5 83233,95,11431,-11336,218,47,131,0,0,0,23984,-23766
ZCTA5 83234,482,14114,-13632,1362,40.4,1216,4,0,0,40644,-39282
ZCTA5 83235,92,15074,-14982,363,27.8,281,0,0,0,31605,-31242
ZCTA5 83236,884,11933,-11049,2195,40,1947,25,0,0,41937,-39742
ZCTA5 83237,381,16830,-16449,1287,26.4,1128,7,0,0,37734,-36447
ZCTA5 83238,36,7286,-7250,80,62.7,80,0,0,0,25850,-25770
ZCTA5 83239,187,14780,-14593,649,35.5,616,3,14,0.021571649,33255,-32606
ZCTA5 83241,775,14940,-14165,2377,38.7,2131,4,0,0,38677,-36300
ZCTA5 83243,16,20688,-20672,16,-,16,0,0,0,46427,-46411
ZCTA5 83244,177,12318,-12141,398,32.8,396,0,0,0,32219,-31821
ZCTA5 83245,844,9308,-8464,2417,42.6,2346,0,9,0.003723624,23058,-20641
ZCTA5 83246,359,14781,-14422,897,53.9,759,0,0,0,36929,-36032
ZCTA5 83250,664,8003,-7339,1982,42.4,1875,0,0,0,18939,-16957
ZCTA5 83251,518,16796,-16278,1464,48.5,1253,0,1,0.00068306,44117,-42653
ZCTA5 83252,1736,7565,-5829,4482,40.8,4277,0,3,0.000669344,28880,-24398
ZCTA5 83253,22,26812,-26790,41,63.1,34,0,0,0,70382,-70341
ZCTA5 83254,1335,14342,-13007,3772,35.7,3587,9,0,0,55440,-51668
ZCTA5 83255,382,1615,-1233,1023,48.5,1007,0,0,0,4826,-3803
ZCTA5 83261,207,13080,-12873,740,29,677,0,0,0,50189,-49449
ZCTA5 83262,308,12881,-12573,932,39.3,930,1,0,0,46422,-45490
ZCTA5 83263,3218,8707,-5489,9666,36.7,8888,12,0,0,29244,-19578
ZCTA5 83271,106,15858,-15752,287,44.7,257,0,0,0,55037,-54750
ZCTA5 83272,84,12647,-12563,225,45.5,211,6,0,0,39618,-39393
ZCTA5 83274,3310,8652,-5342,9965,35.2,8653,15,0,0,29522,-19557
ZCTA5 83276,1392,16921,-15529,3817,35.7,3700,14,0,0,38664,-34847
ZCTA5 83277,61,2758,-2697,176,43.3,168,0,0,0,8089,-7913
ZCTA5 83278,197,12838,-12641,337,67.7,337,0,0,0,34791,-34454
ZCTA5 83281,3,10199,-10196,22,5.8,22,0,0,0,26833,-26811
ZCTA5 83283,54,14605,-14551,251,21.9,251,0,0,0,42565,-42314
ZCTA5 83285,7,10739,-10732,21,71.6,18,0,3,0.142857143,28567,-28546
ZCTA5 83286,434,2890,-2456,1338,31.3,1302,0,0,0,5312,-3974
ZCTA5 83287,117,5702,-5585,242,68.4,242,0,0,0,18176,-17934
ZCTA5 83301,22622,5654,16968,60434,34.9,52053,1323,544,0.009001555,15916,44518
ZCTA5 83302,83,13341,-13258,268,24.5,267,1,0,0,39954,-39686
ZCTA5 83311,244,2392,-2148,827,31.6,733,0,0,0,6463,-5636
ZCTA5 83312,46,5886,-5840,116,64.3,116,0,0,0,12478,-12362
ZCTA5 83313,1249,9280,-8031,4127,42.4,3035,147,0,0,21892,-17765
ZCTA5 83314,375,11778,-11403,982,34.7,922,0,0,0,26488,-25506
ZCTA5 83316,3969,692,3277,10552,38.3,8405,100,12,0.001137225,3064,7488
ZCTA5 83318,6215,18060,-11845,18821,32.3,15230,74,12,0.000637586,51310,-32489
ZCTA5 83320,342,3208,-2866,1538,29.8,905,0,0,0,8004,-6466
ZCTA5 83321,197,4836,-4639,423,57.7,341,0,0,0,15252,-14829
ZCTA5 83322,33,3803,-3770,77,36.9,77,0,0,0,18562,-18485
ZCTA5 83323,591,6932,-6341,1549,37.4,1416,0,3,0.001936733,34579,-33030
ZCTA5 83324,197,199,-2,688,33,635,0,0,0,773,-85
ZCTA5 83325,233,1000,-767,700,32.8,541,11,0,0,2533,-1833
ZCTA5 83327,267,10720,-10453,901,42.1,834,0,0,0,31722,-30821
ZCTA5 83328,2011,5712,-3701,5827,36,5512,0,27,0.004633602,16772,-10945
ZCTA5 83330,2355,10076,-7721,6549,42.1,5792,6,0,0,32540,-25991
ZCTA5 83332,1196,93,1103,2541,51.9,2300,9,2,0.000787092,376,2165
ZCTA5 83333,4333,14248,-9915,11220,43.6,9881,21,61,0.00543672,49644,-38424
ZCTA5 83334,886,11067,-10181,2633,35,2250,0,0,0,35655,-33022
ZCTA5 83335,632,486,146,1841,32.7,1454,0,0,0,1455,386
ZCTA5 83336,2015,1125,890,6083,35.4,5378,0,0,0,5213,870
ZCTA5 83337,17,348,-331,22,68.5,22,0,0,0,796,-774
ZCTA5 83338,6947,1068,5879,21402,32.7,17476,175,19,0.000887767,2890,18512
ZCTA5 83340,2234,660,1574,5359,50.2,4862,51,36,0.006717671,1674,3685
ZCTA5 83341,2498,1325,1173,8215,35,6816,0,14,0.0017042,4352,3863
ZCTA5 83342,436,2469,-2033,1352,44,1261,0,0,0,6432,-5080
ZCTA5 83344,369,18113,-17744,1294,32.2,1139,11,0,0,46312,-45018
ZCTA5 83346,412,15314,-14902,1441,35.3,1275,14,5,0.003469813,36605,-35164
ZCTA5 83347,1141,11726,-10585,3296,35.4,2872,0,0,0,32979,-29683
ZCTA5 83348,32,20044,-20012,282,26.3,282,0,0,0,60566,-60284
ZCTA5 83349,420,18197,-17777,1257,35.3,1091,2,0,0,42426,-41169
ZCTA5 83350,4261,14825,-10564,12333,35,9437,33,12,0.000972999,32701,-20368
ZCTA5 83352,1210,16681,-15471,3264,37.5,2554,24,0,0,45911,-42647
ZCTA5 83353,503,14119,-13616,1267,57.5,1129,5,31,0.024467245,35388,-34121
ZCTA5 83354,10,15830,-15820,10,-,10,0,0,0,39927,-39917
ZCTA5 83355,1517,12880,-11363,5393,31.6,3893,29,1,0.000185426,37591,-32198
ZCTA5 83401,14702,7191,7511,46215,30.1,40960,218,307,0.006642865,24373,21842
ZCTA5 83402,10529,12256,-1727,27238,34,22583,268,108,0.003965049,33594,-6356
ZCTA5 83404,8948,6939,2009,25349,36.8,22808,399,7,0.000276145,15524,9825
ZCTA5 83406,6279,17679,-11400,19297,34.4,17530,187,98,0.00507851,44416,-25119
ZCTA5 83414,227,25050,-24823,442,70.3,442,0,0,0,70715,-70273
ZCTA5 83420,865,14824,-13959,2353,44.6,2186,0,0,0,37559,-35206
ZCTA5 83421,169,13648,-13479,381,35.1,381,0,0,0,39117,-38736
ZCTA5 83422,1106,16722,-15616,3553,40.7,2846,0,0,0,51208,-47655
ZCTA5 83423,249,14025,-13776,756,33.8,486,0,5,0.006613757,29985,-29229
ZCTA5 83424,28,12011,-11983,106,12.2,106,0,0,0,37030,-36924
ZCTA5 83425,162,8206,-8044,621,25.5,573,0,0,0,16276,-15655
ZCTA5 83427,730,17379,-16649,2479,29.1,2341,19,0,0,34643,-32164
ZCTA5 83428,237,7011,-6774,567,53.5,562,0,0,0,16995,-16428
ZCTA5 83429,380,18474,-18094,763,68.6,752,0,0,0,47559,-46796
ZCTA5 83431,320,15006,-14686,998,37.4,713,0,0,0,37663,-36665
ZCTA5 83433,28,1574,-1546,50,72.6,50,0,0,0,5393,-5343
ZCTA5 83434,622,12501,-11879,1812,45.6,1731,0,0,0,28843,-27031
ZCTA5 83435,210,11235,-11025,599,32.5,419,0,1,0.001669449,22248,-21649
ZCTA5 83436,228,9126,-8898,797,32.4,785,0,5,0.006273526,21855,-21058
ZCTA5 83438,64,16779,-16715,305,28.5,277,0,0,0,36464,-36159
ZCTA5 83440,10436,4676,5760,47535,23.1,43446,771,183,0.003849795,10567,36968
ZCTA5 83442,7050,1046,6004,23609,30.3,21379,76,16,0.000677708,2057,21552
ZCTA5 83443,368,348,20,940,34.1,882,0,0,0,1184,-244
ZCTA5 83444,412,4755,-4343,1031,39.8,792,13,0,0,11129,-10098
ZCTA5 83445,2245,10173,-7928,7704,36,7061,23,44,0.005711319,22805,-15101
ZCTA5 83446,20,21128,-21108,26,67.5,25,0,0,0,56005,-55979
ZCTA5 83448,772,20646,-19874,3206,29.1,2896,9,67,0.020898316,51665,-48459
ZCTA5 83449,92,17822,-17730,216,58,209,0,0,0,44975,-44759
ZCTA5 83450,324,6216,-5892,1118,29.4,908,0,5,0.004472272,17229,-16111
ZCTA5 83451,327,13143,-12816,1000,31.9,985,0,0,0,38664,-37664
ZCTA5 83452,849,11904,-11055,2093,48.7,1999,0,0,0,35237,-33144
ZCTA5 83454,77,12434,-12357,259,40.1,230,0,0,0,39680,-39421
ZCTA5 83455,2216,7717,-5501,5738,36.4,4933,0,0,0,26357,-20619
ZCTA5 83460,0,7042,-7042,44,19.4,36,0,0,0,20856,-20812
ZCTA5 83462,198,20089,-19891,376,61.4,369,7,0,0,60607,-60231
ZCTA5 83463,29,14130,-14101,40,71,40,0,0,0,37146,-37106
ZCTA5 83464,110,8833,-8723,294,43.3,279,0,0,0,31685,-31391
ZCTA5 83465,31,9206,-9175,88,50.6,44,5,0,0,26935,-26847
ZCTA5 83466,111,4242,-4131,129,71.2,129,0,0,0,12218,-12089
ZCTA5 83467,2776,9096,-6320,6724,51.1,6284,0,2,0.000297442,24406,-17682
ZCTA5 83468,71,2940,-2869,158,44,158,0,0,0,8430,-8272
ZCTA5 83469,0,24275,-24275,22,39.5,16,0,0,0,64923,-64901
ZCTA5 83501,14818,0,14818,36308,40,33897,368,37,0.001019059,807,35501
ZCTA5 83520,64,6689,-6625,249,45.6,239,0,0,0,20120,-19871
ZCTA5 83522,688,285,403,2629,33.7,2443,2,13,0.004944846,847,1782
ZCTA5 83523,358,1787,-1429,851,53,751,15,0,0,4543,-3692
ZCTA5 83524,410,267,143,934,53.6,766,0,0,0,755,179
ZCTA5 83525,142,10747,-10605,247,68.7,239,0,0,0,38374,-38127
ZCTA5 83526,109,1155,-1046,312,41.8,288,0,0,0,2158,-1846
ZCTA5 83530,2238,567,1671,5511,42.4,5155,13,4,0.000725821,939,4572
ZCTA5 83533,76,13563,-13487,244,35.3,244,0,0,0,50845,-50601
ZCTA5 83535,444,100,344,1067,48.4,969,0,8,0.007497657,265,802
ZCTA5 83536,1845,9880,-8035,4562,51.9,3793,83,0,0,25922,-21360
ZCTA5 83537,418,747,-329,1050,47.2,973,1,0,0,1545,-495
ZCTA5 83539,848,202,646,2176,55.6,1990,9,2,0.000919118,584,1592
ZCTA5 83540,835,410,425,2690,35,725,25,3,0.001115242,832,1858
ZCTA5 83541,488,9311,-8823,1026,59.6,982,0,0,0,30959,-29933
ZCTA5 83542,74,155,-81,152,63.4,152,0,0,0,537,-385
ZCTA5 83543,260,804,-544,726,38.8,606,0,37,0.050964187,2584,-1858
ZCTA5 83544,2375,13655,-11280,6395,48.3,5749,54,28,0.004378421,43669,-37274
ZCTA5 83545,187,10250,-10063,385,61.4,368,0,0,0,35236,-34851
ZCTA5 83546,208,9095,-8887,481,51.6,467,0,0,0,28565,-28084
ZCTA5 83547,160,11,149,340,65.5,323,0,0,0,23,317
ZCTA5 83548,44,643,-599,124,35.5,114,0,0,0,1510,-1386
ZCTA5 83549,288,34,254,604,58.1,589,2,0,0,87,517
ZCTA5 83552,393,4971,-4578,800,62.5,790,0,0,0,10319,-9519
ZCTA5 83553,544,20229,-19685,1010,60.6,968,0,0,0,57929,-56919
ZCTA5 83554,155,2588,-2433,261,73.5,251,0,3,0.011494253,4290,-4029
ZCTA5 83555,169,218,-49,366,55.8,350,0,2,0.005464481,573,-207
ZCTA5 83602,7,1257,-1250,7,-,7,0,0,0,2459,-2452
ZCTA5 83604,226,6725,-6499,468,40.5,452,0,0,0,23788,-23320
ZCTA5 83605,12489,5852,6637,38420,31.2,25233,192,191,0.004971369,21902,16518
ZCTA5 83607,10712,17462,-6750,34024,34.3,26948,604,8,0.000235128,28281,5743
ZCTA5 83610,372,92,280,1044,45.3,1002,0,0,0,185,859
ZCTA5 83611,853,8583,-7730,2452,60.2,2310,2,7,0.002854812,31613,-29161
ZCTA5 83612,855,1666,-811,2068,57.2,1957,0,0,0,5292,-3224
ZCTA5 83615,325,2918,-2593,1342,58,1308,5,0,0,9336,-7994
ZCTA5 83616,12248,1868,10380,32605,45.3,29109,536,189,0.005796657,4582,28023
ZCTA5 83617,6378,340,6038,16551,45.1,14083,54,18,0.001087548,732,15819
ZCTA5 83619,3258,116,3142,7940,39.5,6745,151,0,0,225,7715
ZCTA5 83622,948,1759,-811,2083,56.5,1971,16,16,0.007681229,5442,-3359
ZCTA5 83623,530,360,170,1453,45.4,1280,0,3,0.002064694,611,842
ZCTA5 83624,575,2155,-1580,1554,42,1313,1,8,0.005148005,6081,-4527
ZCTA5 83626,420,27352,-26932,1227,44.2,910,9,0,0,74083,-72856
ZCTA5 83627,230,17550,-17320,493,56.1,388,3,0,0,48079,-47586
ZCTA5 83628,1676,10113,-8437,4875,35.7,3537,25,0,0,22150,-17275
ZCTA5 83629,836,264,572,2091,47.3,1885,36,0,0,624,1467
ZCTA5 83631,552,8771,-8219,1144,53.5,1018,0,2,0.001748252,17583,-16439
ZCTA5 83632,162,19103,-18941,493,50.9,396,0,0,0,45284,-44791
ZCTA5 83633,239,16646,-16407,655,49.6,524,0,0,0,28645,-27990
ZCTA5 83634,9016,1574,7442,34507,32.8,30894,309,223,0.006462457,2901,31606
ZCTA5 83636,104,11766,-11662,579,41.8,528,15,0,0,40239,-39660
ZCTA5 83637,130,9283,-9153,267,57.3,238,0,0,0,25225,-24958
ZCTA5 83638,2477,15740,-13263,7463,43.8,7352,1,2,0.000267989,39254,-31791
ZCTA5 83639,1153,11648,-10495,3177,40.6,2498,0,36,0.011331445,37693,-34516
ZCTA5 83641,1232,4243,-3011,3998,34.4,3491,0,21,0.005252626,10181,-6183
ZCTA5 83642,19115,6758,12357,51088,38.8,45507,1152,164,0.003210147,21857,29231
ZCTA5 83643,41,4379,-4338,104,64.7,104,0,0,0,8977,-8873
ZCTA5 83644,4616,11347,-6731,14345,32.8,11984,136,13,0.000906239,35560,-21215
ZCTA5 83645,280,7877,-7597,810,45.7,796,0,0,0,22568,-21758
ZCTA5 83646,24139,3892,20247,71501,36.3,61968,1488,1294,0.018097649,10595,60906
ZCTA5 83647,8752,5124,3628,22508,34.2,17885,626,558,0.024791185,13551,8957
ZCTA5 83648,748,435,313,2863,21.9,1981,171,184,0.06426825,1663,1200
ZCTA5 83650,174,180,-6,538,53.4,407,0,4,0.007434944,394,144
ZCTA5 83651,13180,1067,12113,36139,35.2,27809,351,78,0.002158333,2734,33405
ZCTA5 83654,642,1028,-386,1658,50.6,1615,0,6,0.003618818,2429,-771
ZCTA5 83655,1917,6,1911,5300,40.8,4834,18,0,0,11,5289
ZCTA5 83656,195,113,82,757,26.1,446,0,0,0,258,499
ZCTA5 83657,55,1913,-1858,263,16.7,263,0,0,0,5179,-4916
ZCTA5 83660,2057,1257,800,5973,35.9,5101,28,9,0.001506781,3396,2577
ZCTA5 83661,3687,9407,-5720,10321,41.8,8439,2,48,0.004650712,21860,-11539
ZCTA5 83666,31,677,-646,56,64.3,56,0,0,0,3504,-3448
ZCTA5 83669,4523,1392,3131,12957,41,11819,125,45,0.003473026,4443,8514
ZCTA5 83670,224,980,-756,617,59.7,617,0,0,0,2208,-1591
ZCTA5 83672,3450,375,3075,8552,44.1,7111,22,9,0.001052385,706,7846
ZCTA5 83676,1827,6120,-4293,5460,39.7,3905,13,0,0,19157,-13697
ZCTA5 83677,55,873,-818,305,49.1,305,0,0,0,5217,-4912
ZCTA5 83686,18375,147,18228,53952,35,45483,196,239,0.004429864,500,53452
ZCTA5 83687,12317,1802,10515,35266,33.9,29013,181,694,0.019679011,6179,29087
ZCTA5 83702,11329,605,10724,22966,40.2,20463,381,258,0.011233998,1120,21846
ZCTA5 83703,7624,145,7479,17963,38.1,16580,347,94,0.005232979,279,17684
ZCTA5 83704,16506,314,16192,40580,37.4,34989,1130,528,0.013011336,615,39965
ZCTA5 83705,12249,4082,8167,29021,35,24768,372,622,0.021432756,9304,19717
ZCTA5 83706,14663,3188,11475,34660,31.1,29913,1719,359,0.010357761,7450,27210
ZCTA5 83709,20640,170,20470,56541,37.3,49030,1553,1386,0.024513185,467,56074
ZCTA5 83712,4147,561,3586,8837,46.1,7997,235,136,0.015389838,1490,7347
ZCTA5 83713,11355,5760,5595,29839,38.9,25102,985,641,0.021481953,19128,10711
ZCTA5 83714,10670,0,10670,25050,44.4,23316,190,152,0.006067864,3228,21822
ZCTA5 83716,7687,156,7531,20243,40.4,16064,2025,212,0.010472756,321,19922
ZCTA5 83720,0,515,-515,0,-,0,0,0,#DIV/0!,1368,-1368
ZCTA5 83725,0,353,-353,0,-,0,0,0,#DIV/0!,911,-911
ZCTA5 83801,2620,996,1624,7243,46.1,6448,32,0,0,5319,1924
ZCTA5 83802,15,12182,-12167,132,28.9,109,0,0,0,22152,-22020
ZCTA5 83803,381,3588,-3207,693,60.3,631,62,0,0,9250,-8557
ZCTA5 83804,734,2286,-1552,1488,63.6,1367,0,0,0,5346,-3858
ZCTA5 83805,3047,521,2526,8609,41.9,7945,91,20,0.00232315,1292,7317
ZCTA5 83806,78,526,-448,202,51.3,199,0,0,0,1453,-1251
ZCTA5 83808,46,13,33,166,41.8,166,0,0,0,32,134
ZCTA5 83809,147,220,-73,338,60.9,338,0,0,0,928,-590
ZCTA5 83810,669,6522,-5853,1635,55.8,1514,0,0,0,23074,-21439
ZCTA5 83811,709,3670,-2961,1480,54.2,1417,0,0,0,6441,-4961
ZCTA5 83812,15,1972,-1957,22,72,22,0,0,0,4328,-4306
ZCTA5 83813,313,589,-276,967,37.5,949,0,0,0,1100,-133
ZCTA5 83814,11604,1071,10533,26851,42.7,24553,231,30,0.001117277,1993,24858
ZCTA5 83815,15027,192,14835,36987,39.9,33125,504,179,0.004839538,594,36393
ZCTA5 83821,107,352,-245,224,62.7,206,9,0,0,1066,-842
ZCTA5 83822,917,7568,-6651,2146,55.7,1982,3,0,0,22442,-20296
ZCTA5 83823,639,1040,-401,1561,45.4,1471,0,0,0,2877,-1316
ZCTA5 83824,117,1419,-1302,411,35.8,258,0,0,0,3886,-3475
ZCTA5 83825,95,444,-349,212,60,197,0,0,0,907,-695
ZCTA5 83826,36,10,26,36,-,36,0,0,0,37,-1
ZCTA5 83827,70,1569,-1499,131,58.9,129,0,0,0,6102,-5971
ZCTA5 83830,144,14432,-14288,313,71.1,313,0,0,0,34735,-34422
ZCTA5 83832,657,540,117,1842,37.1,1729,10,1,0.000542888,1177,665
ZCTA5 83833,772,913,-141,1547,61.5,1497,0,1,0.000646412,2004,-457
ZCTA5 83834,62,220,-158,160,49.9,159,0,0,0,494,-334
ZCTA5 83835,9101,7163,1938,22868,47,21651,92,114,0.004985132,21091,1777
ZCTA5 83836,433,3252,-2819,850,64,810,0,0,0,9423,-8573
ZCTA5 83837,1305,714,591,3203,38.1,2945,0,50,0.015610365,1954,1249
ZCTA5 83839,507,671,-164,1049,59.1,985,0,0,0,1084,-35
ZCTA5 83840,270,5113,-4843,711,37.7,682,0,0,0,19495,-18784
ZCTA5 83841,222,5982,-5760,702,43.9,702,0,0,0,14867,-14165
ZCTA5 83842,58,4447,-4389,140,64.5,135,0,0,0,13556,-13416
ZCTA5 83843,11385,62,11323,25951,29.4,22971,667,383,0.014758583,275,25676
ZCTA5 83844,22,3227,-3205,2319,19.5,2049,107,27,0.01164295,7904,-5585
ZCTA5 83845,876,2509,-1633,2101,47.7,1967,8,0,0,4692,-2591
ZCTA5 83846,357,13935,-13578,789,42.7,743,2,2,0.002534854,30789,-30000
ZCTA5 83847,533,24091,-23558,1209,51.9,994,69,7,0.005789909,54766,-53557
ZCTA5 83848,74,16239,-16165,138,59.9,138,0,0,0,56347,-56209
ZCTA5 83849,895,77,818,2219,41.6,2060,0,17,0.007661109,574,1645
ZCTA5 83850,933,882,51,2442,48.8,2183,0,5,0.002047502,3196,-754
ZCTA5 83851,640,25095,-24455,1940,41.6,1174,3,58,0.029896907,55753,-53813
ZCTA5 83852,562,17087,-16525,1204,45.3,1008,0,84,0.069767442,41628,-40424
ZCTA5 83854,16984,15712,1272,48382,35.1,43979,301,104,0.00214956,32911,15471
ZCTA5 83855,810,16424,-15614,1903,36.7,1676,32,4,0.002101944,49356,-47453
ZCTA5 83856,2828,4655,-1827,7005,48.1,6441,38,0,0,14199,-7194
ZCTA5 83857,403,8590,-8187,1348,36.9,1295,0,53,0.039317507,18769,-17421
ZCTA5 83858,6249,15765,-9516,17825,40.9,16319,120,25,0.001402525,32490,-14665
ZCTA5 83860,2695,13416,-10721,7398,50.9,6986,11,24,0.00324412,27786,-20388
ZCTA5 83861,2647,16583,-13936,6685,48.5,6292,8,19,0.002842184,42825,-36140
ZCTA5 83864,7533,0,7533,18462,45,17006,174,28,0.001516629,0,18462
ZCTA5 83866,117,0,117,245,51.3,245,0,0,0,0,245
ZCTA5 83867,221,0,221,588,58.8,556,0,0,0,0,588
ZCTA5 83868,321,15170,-14849,656,55.5,610,0,0,0,38967,-38311
ZCTA5 83869,1825,3875,-2050,5317,44.1,4802,73,6,0.001128456,11453,-6136
ZCTA5 83870,126,1591,-1465,396,33,300,0,0,0,4719,-4323
ZCTA5 83871,862,8337,-7475,2286,44.1,2152,33,0,0,20951,-18665
ZCTA5 83872,235,7821,-7586,642,50.3,620,0,11,0.017133956,17492,-16850
ZCTA5 83873,722,12849,-12127,1689,44.2,1539,4,25,0.014801658,33817,-32128
ZCTA5 83874,34,9150,-9116,55,69.9,55,0,0,0,25476,-25421
ZCTA5 83876,679,10996,-10317,1690,52.6,928,6,1,0.000591716,28844,-27154
ZCTA5 84001,199,14946,-14747,684,27.7,676,0,4,0.005847953,38099,-37415
ZCTA5 84002,105,13447,-13342,268,35.2,259,0,0,0,44304,-44036
ZCTA5 84003,14430,7966,6464,52442,27.2,46471,789,440,0.008390222,22764,29678
ZCTA5 84004,2780,7624,-4844,10209,34.1,9632,90,0,0,18764,-8555
ZCTA5 84005,9731,7804,1927,42222,20.8,38335,172,176,0.004168443,19400,22822
ZCTA5 84006,336,11271,-10935,1042,31.7,876,1,3,0.002879079,24205,-23163
ZCTA5 84007,139,6448,-6309,414,24.4,406,0,0,0,15561,-15147
ZCTA5 84008,0,9311,-9311,0,-,0,0,0,#DIV/0!,35314,-35314
ZCTA5 84009,10682,5110,5572,37791,32,32381,1412,165,0.004366119,17611,20180
ZCTA5 84010,15337,6608,8729,47550,31.8,43246,574,148,0.003112513,16448,31102
ZCTA5 84013,211,366,-155,927,24.3,926,0,0,0,1753,-826
ZCTA5 84014,5688,17,5671,16711,38.2,15219,292,183,0.010950871,38,16673
ZCTA5 84015,21039,221,20818,68865,30.7,58586,1587,994,0.014434038,387,68478
ZCTA5 84017,1487,19,1468,5089,35.1,4161,0,69,0.013558656,33,5056
ZCTA5 84018,74,301,-227,287,15.8,287,0,0,0,921,-634
ZCTA5 84020,14910,1018,13892,49978,33.1,42463,2127,1060,0.021209332,2765,47213
ZCTA5 84021,1157,1522,-365,3591,36.4,3310,0,10,0.00278474,4858,-1267
ZCTA5 84022,224,66,158,536,44.9,434,0,34,0.063432836,172,364
ZCTA5 84023,59,98,-39,121,51.3,121,0,0,0,183,-62
ZCTA5 84024,14,337,-323,52,33.7,52,0,0,0,1075,-1023
ZCTA5 84025,6758,3659,3099,24093,30.7,21922,697,182,0.007554061,9384,14709
ZCTA5 84026,277,160,117,825,30.2,228,0,0,0,725,100
ZCTA5 84027,221,95,126,690,48.4,677,0,0,0,167,523
ZCTA5 84028,121,184,-63,473,36.1,402,0,0,0,311,162
ZCTA5 84029,3528,1117,2411,12733,29.5,12170,141,27,0.002120474,2980,9753
ZCTA5 84031,71,175,-104,153,44.3,153,0,0,0,546,-393
ZCTA5 84032,7204,2339,4865,24238,31.6,21973,603,142,0.005858569,4916,19322
ZCTA5 84033,335,1273,-938,1073,36.3,1038,0,0,0,4189,-3116
ZCTA5 84034,49,2366,-2317,144,40.5,20,0,0,0,7419,-7275
ZCTA5 84035,256,961,-705,476,45.3,476,0,0,0,2744,-2268
ZCTA5 84036,2590,1475,1115,8317,35.9,7212,37,26,0.003126127,4556,3761
ZCTA5 84037,10945,417,10528,39257,32.3,36526,254,199,0.00506916,1224,38033
ZCTA5 84038,183,2435,-2252,587,43.3,542,1,0,0,10683,-10096
ZCTA5 84039,191,0,191,507,39.8,395,0,0,0,0,507
ZCTA5 84040,8424,16482,-8058,26384,35.7,23302,544,289,0.010953608,40950,-14566
ZCTA5 84041,17664,12,17652,54953,29.8,46613,1002,1157,0.021054356,25,54928
ZCTA5 84042,3000,13614,-10614,11346,29.5,10214,245,35,0.003084788,38731,-27385
ZCTA5 84043,19629,177,19452,74101,26.2,67098,1328,435,0.005870366,6320,67781
ZCTA5 84044,8906,18,8888,29128,33.2,20075,309,318,0.01091733,75,29053
ZCTA5 84045,8721,24,8697,36720,21.7,32652,342,132,0.003594771,102,36618
ZCTA5 84046,138,324,-186,420,38.1,382,0,0,0,1028,-608
ZCTA5 84047,15321,214,15107,36275,32.6,26917,1517,966,0.02662991,541,35734
ZCTA5 84049,2238,557,1681,6490,40.9,6298,13,0,0,1924,4566
ZCTA5 84050,3430,714,2716,11875,31.6,11260,28,82,0.006905263,5738,6137
ZCTA5 84051,158,639,-481,528,28.6,506,0,0,0,1937,-1409
ZCTA5 84052,383,520,-137,1267,34.2,978,19,5,0.00394633,1420,-153
ZCTA5 84053,207,268,-61,695,36.6,640,0,0,0,513,182
ZCTA5 84054,7206,2013,5193,21443,30.8,18024,907,53,0.002471669,5581,15862
ZCTA5 84055,435,0,435,1571,35.7,1541,2,13,0.008274984,0,1571
ZCTA5 84056,998,65,933,3566,22.9,2820,113,216,0.06057207,139,3427
ZCTA5 84057,11920,488,11432,38600,27.3,32762,544,235,0.006088083,1631,36969
ZCTA5 84058,10263,518,9745,33714,24.8,28303,725,280,0.008305155,1976,31738
ZCTA5 84059,4377,422,3955,13921,24.6,12100,275,242,0.017383809,1280,12641
ZCTA5 84060,3029,2013,1016,8757,41.1,7509,277,78,0.00890716,7366,1391
ZCTA5 84061,159,539,-380,359,54.9,359,0,0,0,2233,-1874
ZCTA5 84062,13789,481,13308,47203,27.9,41996,647,178,0.003770947,1725,45478
ZCTA5 84063,97,237,-140,234,48.7,155,1,0,0,362,-128
ZCTA5 84064,193,26,167,976,28.2,861,0,0,0,26,950
ZCTA5 84065,14448,451,13997,49075,33.8,44103,878,334,0.006805909,1309,47766
ZCTA5 84066,4176,3401,775,13441,31.3,11160,141,18,0.001339186,10401,3040
ZCTA5 84067,12912,518,12394,39076,32.5,32713,653,260,0.0066537,2094,36982
ZCTA5 84069,178,420,-242,507,40.9,479,0,0,0,1772,-1265
ZCTA5 84070,10741,1011,9730,30091,31.5,23821,1019,296,0.009836828,3893,26198
ZCTA5 84071,612,2845,-2233,2168,37.5,2093,31,0,0,11966,-9798
ZCTA5 84072,156,2446,-2290,394,44.3,387,0,0,0,6031,-5637
ZCTA5 84073,104,4408,-4304,316,35.3,309,0,0,0,15357,-15041
ZCTA5 84074,16301,24,16277,53932,32.1,46441,311,590,0.010939702,24,53908
ZCTA5 84075,8480,542,7938,31552,29.1,28455,338,633,0.02006212,2611,28941
ZCTA5 84076,92,474,-382,464,33.5,273,0,0,0,1659,-1195
ZCTA5 84078,9369,9797,-428,29877,31.4,26660,163,188,0.006292466,21620,8257
ZCTA5 84080,98,8653,-8555,244,43,226,0,0,0,16633,-16389
ZCTA5 84081,14098,8359,5739,50596,29.3,37430,1398,808,0.015969642,18873,31723
ZCTA5 84082,280,0,280,849,43.4,839,0,0,0,79,770
ZCTA5 84083,386,12845,-12459,1161,30,720,5,0,0,34520,-33359
ZCTA5 84084,10516,2484,8032,32514,34.1,23160,688,387,0.011902565,6521,25993
ZCTA5 84085,92,659,-567,309,36.8,116,0,0,0,1810,-1501
ZCTA5 84086,164,883,-719,471,42.3,452,0,0,0,2296,-1825
ZCTA5 84087,4861,4340,521,16133,34.4,14124,106,316,0.019587182,11307,4826
ZCTA5 84088,12432,6998,5434,39229,33.8,30579,1076,398,0.010145556,16781,22448
ZCTA5 84092,9087,1632,7455,28197,42.2,25963,736,185,0.006560982,4052,24145
ZCTA5 84093,7720,2220,5500,24429,39.5,22113,805,403,0.016496787,4638,19791
ZCTA5 84094,9366,10236,-870,28755,34.9,24401,1371,132,0.004590506,25026,3729
ZCTA5 84095,12578,4126,8452,37835,36.9,32598,1905,197,0.005206819,9421,28414
ZCTA5 84096,18672,254,18418,65702,29,57198,1481,425,0.006468601,716,64986
ZCTA5 84097,6703,325,6378,22131,29.1,19895,360,108,0.004880033,490,21641
ZCTA5 84098,6304,748,5556,19276,43.7,17518,394,100,0.005187798,1686,17590
ZCTA5 84101,3888,2376,1512,6422,35.8,4622,375,498,0.077545936,5105,1317
ZCTA5 84102,9818,1584,8234,18995,28.9,15329,1239,387,0.020373783,4218,14777
ZCTA5 84103,11720,2256,9464,22888,36.8,19982,820,388,0.016952115,5105,17783
ZCTA5 84104,7713,5722,1991,24809,31,11641,940,1138,0.04587045,10925,13884
ZCTA5 84105,9775,374,9401,23117,35.2,19947,747,324,0.014015659,731,22386
ZCTA5 84106,14994,215,14779,35714,33.9,30399,1241,884,0.024752198,477,35237
ZCTA5 84107,15655,30,15625,36498,34.7,28770,1563,1054,0.028878295,56,36442
ZCTA5 84108,7549,3318,4231,21736,34.4,19004,1124,259,0.011915716,6490,15246
ZCTA5 84109,9011,9663,-652,25856,36.2,23378,980,240,0.009282178,25950,-94
ZCTA5 84111,6854,6649,205,12410,33,8780,938,593,0.047784045,15665,-3255
ZCTA5 84112,236,7216,-6980,2393,21.3,1740,431,31,0.01295445,16567,-14174
ZCTA5 84113,0,10518,-10518,206,20.4,140,15,11,0.053398058,24045,-23839
ZCTA5 84114,0,10878,-10878,0,-,0,0,0,#DIV/0!,26364,-26364
ZCTA5 84115,11684,60,11624,27997,33.8,18084,2633,2238,0.079937136,114,27883
ZCTA5 84116,12109,4347,7762,35111,30.7,16247,3023,1260,0.03588619,14464,20647
ZCTA5 84117,10306,6076,4230,24437,41.1,21569,611,509,0.020829071,13950,10487
ZCTA5 84118,11518,3219,8299,41424,30.3,23697,967,1176,0.02838934,6764,34660
ZCTA5 84119,15966,192,15774,51636,29.7,27362,2275,2217,0.042935162,303,51333
ZCTA5 84120,13829,859,12970,52362,30.3,29814,2973,1139,0.021752416,2540,49822
ZCTA5 84121,15503,70,15433,40151,40.9,36498,1003,245,0.006101965,136,40015
ZCTA5 84123,13798,231,13567,37662,33.8,28359,2217,590,0.015665658,920,36742
ZCTA5 84124,8361,75,8286,23552,38.5,20333,879,74,0.003141984,222,23330
ZCTA5 84128,8429,833,7596,32062,30.6,17138,1188,321,0.010011852,1875,30187
ZCTA5 84129,11854,20,11834,38388,34.8,26834,3299,581,0.015134938,58,38330
ZCTA5 84138,0,261,-261,0,-,0,0,0,#DIV/0!,513,-513
ZCTA5 84150,0,2785,-2785,0,-,0,0,0,#DIV/0!,7539,-7539
ZCTA5 84180,0,967,-967,0,-,0,0,0,#DIV/0!,1848,-1848
ZCTA5 84301,262,13819,-13557,760,35.8,694,14,0,0,33602,-32842
ZCTA5 84302,8578,0,8578,26242,33.5,23639,176,160,0.006097096,0,26242
ZCTA5 84304,29,454,-425,106,18.4,106,0,0,0,917,-811
ZCTA5 84305,265,173,92,681,36.3,680,0,0,0,350,331
ZCTA5 84306,124,373,-249,321,40.1,321,0,0,0,1424,-1103
ZCTA5 84307,367,2841,-2474,1186,34.6,1088,2,4,0.003372681,10648,-9462
ZCTA5 84308,93,1355,-1262,282,35,265,0,0,0,6190,-5908
ZCTA5 84309,144,2035,-1891,435,49.4,423,0,0,0,8182,-7747
ZCTA5 84310,1735,386,1349,5327,38.8,5181,63,83,0.015581002,1595,3732
ZCTA5 84311,227,494,-267,951,26.2,843,0,2,0.002103049,2311,-1360
ZCTA5 84312,1579,227,1352,4928,30.3,4467,45,0,0,902,4026
ZCTA5 84313,13,1490,-1477,38,63.3,29,0,9,0.236842105,5138,-5100
ZCTA5 84314,348,726,-378,1218,27.7,1197,5,6,0.004926108,2974,-1756
ZCTA5 84315,2801,617,2184,9326,38.1,8829,22,0,0,3041,6285
ZCTA5 84316,101,719,-618,339,36.7,324,0,0,0,2806,-2467
ZCTA5 84317,1036,1290,-254,2682,52.6,2610,9,0,0,4662,-1980
ZCTA5 84318,1435,485,950,5206,26.5,5032,0,5,0.00096043,1765,3441
ZCTA5 84319,2758,256,2502,9745,28.2,8425,76,0,0,1112,8633
ZCTA5 84320,765,507,258,2602,32.1,2454,0,0,0,2410,192
ZCTA5 84321,15261,261,15000,48518,24.2,42082,1206,410,0.008450472,979,47539
ZCTA5 84322,0,372,-372,0,-,0,0,0,#DIV/0!,1412,-1412
ZCTA5 84324,297,352,-55,1075,34.3,1020,1,22,0.020465116,1479,-404
ZCTA5 84325,663,271,392,2166,38.1,2052,0,16,0.007386888,1298,868
ZCTA5 84326,715,373,342,2089,35.4,1810,14,0,0,1792,297
ZCTA5 84327,247,777,-530,925,32.3,884,0,5,0.005405405,3817,-2892
ZCTA5 84328,468,8602,-8134,1517,41.1,1491,1,0,0,23069,-21552
ZCTA5 84329,44,3557,-3513,112,29.7,112,0,0,0,10512,-10400
ZCTA5 84330,134,181,-47,359,40.9,344,0,0,0,553,-194
ZCTA5 84331,91,211,-120,269,33.8,253,0,1,0.003717472,741,-472
ZCTA5 84332,2548,180,2368,8199,34.8,7509,52,7,0.000853763,794,7405
ZCTA5 84333,924,1274,-350,3025,35.5,2914,0,14,0.004628099,3171,-146
ZCTA5 84334,64,541,-477,338,16.6,338,0,0,0,975,-637
ZCTA5 84335,4209,3,4206,15615,25.7,14472,119,0,0,16,15599
ZCTA5 84336,74,126,-52,299,36.9,299,0,0,0,298,1
ZCTA5 84337,4611,1451,3160,14401,32.5,13148,238,103,0.007152281,4495,9906
ZCTA5 84338,174,232,-58,561,29.8,545,1,0,0,494,67
ZCTA5 84339,1562,5080,-3518,5865,26.1,5463,13,27,0.004603581,12886,-7021
ZCTA5 84340,1093,1140,-47,3380,36.5,3215,28,0,0,4028,-648
ZCTA5 84341,8246,157,8089,24601,25.2,20691,970,329,0.01337344,380,24221
ZCTA5 84401,15301,142,15159,43463,32.1,35774,617,679,0.015622483,423,43040
ZCTA5 84403,13353,3572,9781,36746,33.5,30814,509,909,0.024737386,11166,25580
ZCTA5 84404,21856,1002,20854,64499,33.3,54544,697,505,0.007829579,3215,61284
ZCTA5 84405,11700,287,11413,34243,31.7,30522,427,287,0.008381275,733,33510
ZCTA5 84408,0,190,-190,16,24.5,12,4,0,0,473,-457
ZCTA5 84414,9607,575,9032,32336,31.7,29645,656,55,0.001700891,2192,30144
ZCTA5 84501,4782,565,4217,12928,34.7,11380,96,258,0.019956683,1119,11809
ZCTA5 84511,1332,1067,265,4506,29.6,3385,35,8,0.001775411,3858,648
ZCTA5 84512,215,131,84,789,41.7,90,0,0,0,275,514
ZCTA5 84513,491,92,399,1375,36.3,1350,0,0,0,341,1034
ZCTA5 84515,0,111,-111,0,-,0,0,0,#DIV/0!,219,-219
ZCTA5 84516,35,15068,-15033,55,67.9,55,0,0,0,43432,-43377
ZCTA5 84518,301,0,301,978,31.1,952,0,0,0,0,978
ZCTA5 84520,431,436,-5,1134,39,1083,0,0,0,2231,-1097
ZCTA5 84521,214,2571,-2357,576,46.9,538,0,0,0,7877,-7301
ZCTA5 84522,112,678,-566,375,40.6,339,0,7,0.018666667,1755,-1380
ZCTA5 84523,579,219,360,1740,39.3,1737,0,0,0,623,1117
ZCTA5 84525,324,161,163,822,40.9,798,0,0,0,534,288
ZCTA5 84526,1763,167,1596,4228,43.5,4027,0,2,0.000473037,631,3597
ZCTA5 84528,982,273,709,2835,36.5,2665,0,0,0,691,2144
ZCTA5 84529,59,1328,-1269,89,30.4,89,0,0,0,3702,-3613
ZCTA5 84530,65,2417,-2352,113,60.6,113,0,0,0,5505,-5392
ZCTA5 84531,118,222,-104,478,35.4,0,0,0,0,576,-98
ZCTA5 84532,4392,366,4026,10001,41.5,9056,147,1,1.00E-04,1239,8762
ZCTA5 84533,43,16,27,112,40.1,88,0,11,0.098214286,27,85
ZCTA5 84534,758,2018,-1260,2646,31.2,30,0,0,0,5166,-2520
ZCTA5 84535,952,3530,-2578,2968,38,2736,0,37,0.012466307,9045,-6077
ZCTA5 84536,482,290,192,1495,33.9,76,0,0,0,1401,94
ZCTA5 84537,412,299,113,1083,38.2,1060,0,0,0,940,143
ZCTA5 84539,132,551,-419,390,46.3,354,0,0,0,3056,-2666
ZCTA5 84540,22,303,-281,104,19.7,104,0,0,0,1046,-942
ZCTA5 84542,595,435,160,1439,38.9,1338,0,14,0.009728978,1580,-141
ZCTA5 84601,11051,3791,7260,33109,25.4,27206,513,425,0.012836389,9588,23521
ZCTA5 84602,82,152,-70,1748,19.1,1623,38,11,0.006292906,282,1466
ZCTA5 84604,11652,457,11195,43006,23.8,36685,1297,377,0.008766219,2019,40987
ZCTA5 84606,10178,72,10106,35960,23.2,29056,1147,391,0.010873192,201,35759
ZCTA5 84620,402,70,332,1183,37.7,1150,0,4,0.003381234,128,1055
ZCTA5 84621,42,1925,-1883,57,60.1,57,0,0,0,4708,-4651
ZCTA5 84622,460,49,411,1291,36.4,1179,0,0,0,60,1231
ZCTA5 84623,20,144,-124,151,24,39,0,0,0,462,-311
ZCTA5 84624,1959,246,1713,5739,35.3,4986,65,31,0.005401638,514,5225
ZCTA5 84626,99,9041,-8942,496,25.4,356,0,0,0,20550,-20054
ZCTA5 84627,1815,5254,-3439,6044,22.1,5491,70,70,0.011581734,11967,-5923
ZCTA5 84628,227,19439,-19212,629,47.5,594,0,0,0,58735,-58106
ZCTA5 84629,1163,11932,-10769,3309,44,3263,0,0,0,25965,-22656
ZCTA5 84630,127,12829,-12702,431,20.3,217,0,0,0,31054,-30623
ZCTA5 84631,886,16268,-15382,2927,36.1,2433,109,2,0.000683293,36143,-33216
ZCTA5 84632,372,18229,-17857,1147,39.8,1095,0,0,0,40213,-39066
ZCTA5 84633,328,17827,-17499,1003,30.2,842,2,0,0,38842,-37839
ZCTA5 84634,595,26152,-25557,3752,37.5,2359,53,66,0.017590618,57153,-53401
ZCTA5 84635,296,18983,-18687,836,29.1,615,0,0,0,43719,-42883
ZCTA5 84636,173,6039,-5866,513,37.2,500,0,0,0,15571,-15058
ZCTA5 84637,203,23131,-22928,750,22.5,612,5,0,0,62550,-61800
ZCTA5 84638,97,1351,-1254,321,38.4,264,3,0,0,4168,-3847
ZCTA5 84639,285,0,285,891,32.9,878,0,0,0,253,638
ZCTA5 84640,66,22198,-22132,216,28.2,209,2,0,0,59124,-58908
ZCTA5 84642,1181,22296,-21115,3577,34.4,3229,11,71,0.019849036,74413,-70836
ZCTA5 84643,198,6922,-6724,526,39.1,515,0,0,0,17923,-17397
ZCTA5 84644,96,17404,-17308,238,38.6,222,0,0,0,42270,-42032
ZCTA5 84645,695,19080,-18385,3064,21.5,2903,0,0,0,50058,-46994
ZCTA5 84646,552,13046,-12494,1559,36,1254,30,3,0.00192431,38494,-36935
ZCTA5 84647,1404,6599,-5195,4582,32.8,4213,37,41,0.008948058,23601,-19019
ZCTA5 84648,2253,711,1542,6952,31.8,6268,37,25,0.003596087,3238,3714
ZCTA5 84649,289,256,33,913,36.6,877,0,0,0,787,126
ZCTA5 84651,7722,725,6997,28128,27.3,25344,185,143,0.005083902,3041,25087
ZCTA5 84652,302,126,176,943,33.3,909,4,0,0,362,581
ZCTA5 84653,2803,1360,1443,10869,28.5,10010,28,51,0.004692244,5914,4955
ZCTA5 84654,941,30,911,2533,37,2362,13,7,0.002763522,89,2444
ZCTA5 84655,4016,286,3730,15303,26.3,13873,0,137,0.008952493,1293,14010
ZCTA5 84656,119,323,-204,358,36.6,355,0,0,0,1213,-855
ZCTA5 84657,164,537,-373,598,26.7,443,8,0,0,2445,-1847
ZCTA5 84660,12118,167,11951,45182,27.3,42167,89,202,0.004470807,729,44453
ZCTA5 84662,493,542,-49,1517,39.9,1412,5,4,0.002636783,1706,-189
ZCTA5 84663,9904,43,9861,35124,26.5,30619,250,140,0.003985879,192,34932
ZCTA5 84664,2993,1338,1655,11226,31.1,10577,0,80,0.007126314,4874,6352
ZCTA5 84665,180,824,-644,621,42.8,559,0,14,0.022544283,2937,-2316
ZCTA5 84667,111,446,-335,372,33.3,357,0,0,0,1975,-1603
ZCTA5 84701,2726,1862,864,8425,33.3,7928,17,103,0.012225519,11392,-2967
ZCTA5 84710,51,741,-690,424,41.1,240,0,0,0,3189,-2765
ZCTA5 84711,310,136,174,887,40.1,849,0,0,0,283,604
ZCTA5 84712,63,231,-168,124,62,124,0,0,0,716,-592
ZCTA5 84713,1242,350,892,3437,37.2,3200,0,11,0.003200466,1164,2273
ZCTA5 84714,269,719,-450,751,44.7,601,0,0,0,2870,-2119
ZCTA5 84715,170,15282,-15112,352,47.8,345,0,0,0,46531,-46179
ZCTA5 84716,167,3900,-3733,419,48.5,386,0,0,0,10989,-10570
ZCTA5 84718,124,6139,-6015,374,34.5,289,0,0,0,16755,-16381
ZCTA5 84719,30,329,-299,35,65.2,35,0,0,0,811,-776
ZCTA5 84720,7563,5276,2287,22797,27,20444,379,335,0.014694916,16015,6782
ZCTA5 84721,8058,752,7306,27319,28.7,24616,129,57,0.00208646,2291,25028
ZCTA5 84722,389,1442,-1053,927,49.3,927,0,0,0,5294,-4367
ZCTA5 84723,144,1715,-1571,532,42.5,461,0,0,0,5549,-5017
ZCTA5 84724,416,442,-26,1069,48.2,892,10,0,0,1605,-536
ZCTA5 84725,496,117,379,1563,30.6,1535,0,0,0,238,1325
ZCTA5 84726,382,3510,-3128,716,56,702,0,0,0,12955,-12239
ZCTA5 84728,20,429,-409,49,60.2,49,0,0,0,1675,-1626
ZCTA5 84729,125,558,-433,414,22,414,0,0,0,1747,-1333
ZCTA5 84730,230,426,-196,627,49.4,602,0,0,0,1464,-837
ZCTA5 84731,9,114,-105,9,-,9,0,0,0,397,-388
ZCTA5 84732,18,8287,-8269,56,60.2,56,0,0,0,15767,-15711
ZCTA5 84733,151,14108,-13957,257,51.7,184,0,0,0,29597,-29340
ZCTA5 84734,137,5674,-5537,310,34,297,0,0,0,13181,-12871
ZCTA5 84735,49,17291,-17242,160,62.3,160,0,0,0,46347,-46187
ZCTA5 84736,99,7296,-7197,305,27.2,267,0,0,0,18513,-18208
ZCTA5 84737,7255,247,7008,20896,38.7,19692,54,270,0.012921133,577,20319
ZCTA5 84738,3713,817,2896,8928,52,8183,126,20,0.002240143,3129,5799
ZCTA5 84739,183,104,79,657,32.8,576,0,0,0,207,450
ZCTA5 84740,87,239,-152,301,50.5,301,0,0,0,818,-517
ZCTA5 84741,2538,644,1894,6016,46.2,5571,84,15,0.002493351,1461,4555
ZCTA5 84742,137,136,1,330,57.4,328,0,0,0,294,36
ZCTA5 84743,85,50,35,280,51.6,280,0,0,0,140,140
ZCTA5 84744,78,97,-19,311,18.6,304,0,0,0,105,206
ZCTA5 84745,1428,17,1411,4286,34.6,3657,0,0,0,58,4228
ZCTA5 84746,438,308,130,1187,54.8,1156,0,0,0,824,363
ZCTA5 84747,389,646,-257,1064,33.3,1027,0,0,0,1628,-564
ZCTA5 84749,86,392,-306,238,41.7,238,0,0,0,834,-596
ZCTA5 84750,190,1250,-1060,591,56.2,563,0,5,0.008460237,3013,-2422
ZCTA5 84751,592,167,425,2481,25.4,2094,0,0,0,334,2147
ZCTA5 84752,283,102,181,1035,31.5,1016,0,0,0,144,891
ZCTA5 84753,0,42,-42,0,-,0,0,0,#DIV/0!,65,-65
ZCTA5 84754,1437,410,1027,4024,42,3824,30,17,0.004224652,709,3315
ZCTA5 84755,10,973,-963,31,46.8,31,0,0,0,3391,-3360
ZCTA5 84756,113,2001,-1888,279,63.3,279,0,0,0,5027,-4748
ZCTA5 84757,586,373,213,1265,57.3,1236,18,0,0,677,588
ZCTA5 84758,176,199,-23,536,31.1,523,0,0,0,444,92
ZCTA5 84759,672,6858,-6186,2273,37.6,2062,1,6,0.002639683,17573,-15300
ZCTA5 84760,333,56,277,982,35.6,934,24,0,0,132,850
ZCTA5 84761,1086,334,752,2927,43.1,2630,12,0,0,802,2125
ZCTA5 84762,63,1083,-1020,102,57.3,102,0,0,0,3286,-3184
ZCTA5 84763,120,190,-70,199,66.1,182,0,0,0,246,-47
ZCTA5 84764,89,172,-83,258,33.5,258,0,0,0,332,-74
ZCTA5 84765,2343,485,1858,7697,33.9,6885,169,48,0.006236196,1196,6501
ZCTA5 84766,66,275,-209,232,28.1,232,0,0,0,733,-501
ZCTA5 84767,227,7498,-7271,684,49.4,609,0,35,0.051169591,18008,-17324
ZCTA5 84770,16188,325,15863,44908,37.1,39393,223,181,0.004030462,1066,43842
ZCTA5 84772,97,415,-318,241,54.6,241,0,0,0,979,-738
ZCTA5 84773,78,193,-115,160,33.9,160,0,0,0,416,-256
ZCTA5 84774,506,1743,-1237,1818,35.8,1555,4,8,0.00440044,3713,-1895
ZCTA5 84775,195,482,-287,376,59,376,0,0,0,1157,-781
ZCTA5 84776,187,40,147,463,56.4,463,0,0,0,57,406
ZCTA5 84779,264,936,-672,806,48,746,0,0,0,2118,-1312
ZCTA5 84780,9155,2401,6754,27762,36.3,24195,347,56,0.002017146,6453,21309
ZCTA5 84781,116,256,-140,351,35.8,351,0,0,0,515,-164
ZCTA5 84782,235,503,-268,470,57.4,356,0,0,0,1264,-794
ZCTA5 84783,444,233,211,1042,62.5,1042,0,0,0,545,497
ZCTA5 84784,168,158,10,1069,24.9,1000,0,0,0,394,675
ZCTA5 84790,17191,75,17116,50503,38.1,44713,704,549,0.010870641,258,50245
ZCTA5 85003,4282,978,3304,8105,38.3,5882,107,949,0.117088217,3024,5081
ZCTA5 85004,4052,604,3448,9071,27.8,5974,790,611,0.067357513,1633,7438
ZCTA5 85006,9286,164,9122,24777,31.3,14546,369,1867,0.075352141,354,24423
ZCTA5 85007,5333,4394,939,14169,32.8,7824,321,1294,0.091326135,10357,3812
ZCTA5 85008,22582,0,22582,59734,30.6,36149,823,6434,0.107710851,0,59734
ZCTA5 85009,14167,30,14137,51713,30,29279,409,1935,0.037418057,105,51608
ZCTA5 85012,4183,253,3930,7861,39.4,6243,286,251,0.03192978,592,7269
ZCTA5 85013,10003,23,9980,20163,38.9,13986,898,968,0.048008729,37,20126
ZCTA5 85014,12757,427,12330,26120,36,17667,1119,1344,0.051454824,992,25128
ZCTA5 85015,15938,352,15586,41848,31.8,22035,1808,6302,0.150592621,972,40876
ZCTA5 85016,18082,206,17876,36320,37.6,26660,1609,1666,0.045870044,580,35740
ZCTA5 85017,11948,52,11896,41195,26.3,23504,1431,2591,0.062895983,107,41088
ZCTA5 85018,16966,583,16383,37558,38.4,29313,773,1854,0.049363651,1669,35889
ZCTA5 85019,7898,34,7864,29084,29.2,17062,832,936,0.032182643,86,28998
ZCTA5 85020,16169,7723,8446,33582,43.6,24621,521,1718,0.051158359,19887,13695
ZCTA5 85021,16273,831,15442,39611,35.4,24431,1446,4142,0.104566913,1982,37629
ZCTA5 85022,23116,241,22875,50320,38.4,38910,1407,3239,0.064368045,636,49684
ZCTA5 85023,13599,40,13559,33985,36.2,25058,1763,2312,0.068030013,80,33905
ZCTA5 85024,10054,112,9942,24947,33.8,20054,1386,547,0.021926484,197,24750
ZCTA5 85026,0,432,-432,0,-,0,0,0,#DIV/0!,1020,-1020
ZCTA5 85027,16102,240,15862,38136,34.9,28778,3071,800,0.020977554,762,37374
ZCTA5 85028,7557,245,7312,18136,48.5,15883,189,453,0.024977944,580,17556
ZCTA5 85029,18414,130,18284,47886,36.1,32845,1270,3325,0.069435743,335,47551
ZCTA5 85031,8495,181,8314,33410,28.8,21414,52,822,0.024603412,307,33103
ZCTA5 85032,28279,0,28279,69352,37.5,50877,2753,2358,0.034000461,0,69352
ZCTA5 85033,16404,131,16273,60114,27.6,29914,327,2437,0.040539641,281,59833
ZCTA5 85034,2331,44,2287,5001,30.9,2639,87,606,0.121175765,92,4909
ZCTA5 85035,15445,6,15439,54524,26.5,26816,492,5190,0.09518744,12,54512
ZCTA5 85037,14939,203,14736,52061,30.6,27635,1519,5085,0.097673883,512,51549
ZCTA5 85040,10761,442,10319,33802,30,16138,688,6599,0.195225135,1378,32424
ZCTA5 85041,17994,73,17921,62369,32.7,28697,1814,9656,0.154820504,194,62175
ZCTA5 85042,14847,48,14799,45315,33.3,22870,1719,7181,0.158468498,135,45180
ZCTA5 85043,10796,19,10777,38938,28.4,20715,536,2771,0.071164415,45,38893
ZCTA5 85044,17275,112,17163,40815,39.4,29081,2136,3611,0.088472375,385,40430
ZCTA5 85045,2609,3306,-697,6645,43.9,4886,544,150,0.022573363,7757,-1112
ZCTA5 85048,13195,330,12865,34039,40.8,23886,3314,1951,0.057316607,924,33115
ZCTA5 85050,11738,123,11615,31248,40.4,25052,2694,818,0.026177675,296,30952
ZCTA5 85051,15641,365,15276,43623,34.8,25674,2207,2998,0.068725214,1212,42411
ZCTA5 85053,11127,20,11107,28939,36,21151,985,1241,0.042883306,38,28901
ZCTA5 85054,4201,607,3594,8131,35.6,6439,1030,345,0.042430205,1717,6414
ZCTA5 85083,6476,92,6384,19744,40.7,15500,2305,413,0.020917747,129,19615
ZCTA5 85085,10265,0,10265,26505,36.6,19342,3397,709,0.02674967,37,26468
ZCTA5 85086,15500,263,15237,43083,43,37948,980,748,0.017361836,651,42432
ZCTA5 85087,3366,45,3321,8600,47.3,7634,205,107,0.01244186,194,8406
ZCTA5 85118,6303,3320,2983,12504,66.2,11647,75,144,0.011516315,9919,2585
ZCTA5 85119,10377,109,10268,23792,51.6,19867,298,375,0.015761601,115,23677
ZCTA5 85120,13622,256,13366,29062,57.4,25328,360,209,0.007191522,698,28364
ZCTA5 85121,640,256,384,2000,26.9,26,0,0,0,899,1101
ZCTA5 85122,19441,140,19301,54726,35.7,36519,703,2310,0.042210284,302,54424
ZCTA5 85123,3874,641,3233,9017,38.9,7699,0,129,0.01430631,2141,6876
ZCTA5 85128,5062,91,4971,17032,34.3,8771,57,1184,0.069516205,153,16879
ZCTA5 85131,3334,212,3122,17032,36.2,10416,200,1649,0.096817755,710,16322
ZCTA5 85132,8913,371,8542,38485,38.2,28739,244,2894,0.075198129,767,37718
ZCTA5 85135,141,580,-439,374,46.6,247,0,0,0,1396,-1022
ZCTA5 85137,908,86,822,2506,34.9,1993,41,0,0,318,2188
ZCTA5 85138,14714,230,14484,46647,36.2,28370,1331,5646,0.121036723,887,45760
ZCTA5 85139,6265,2714,3551,18596,38.4,11981,552,1479,0.079533233,7066,11530
ZCTA5 85140,14790,247,14543,45352,35.2,37365,659,1454,0.032060328,1476,43876
ZCTA5 85141,140,221,-81,314,54.9,186,0,0,0,500,-186
ZCTA5 85142,23923,12,23911,78246,36.2,61950,2055,2944,0.037624927,49,78197
ZCTA5 85143,12917,477,12440,38548,37.1,31252,760,987,0.025604441,1360,37188
ZCTA5 85145,1124,162,962,3403,36.4,2949,54,0,0,432,2971
ZCTA5 85147,1237,703,534,4221,30.8,381,0,23,0.005448946,2102,2119
ZCTA5 85172,618,17,601,1849,25.2,909,0,53,0.028664143,187,1662
ZCTA5 85173,1284,109,1175,2679,53.7,1772,90,15,0.005599104,451,2228
ZCTA5 85191,45,277,-232,108,50.4,92,0,0,0,1008,-900
ZCTA5 85192,956,356,600,2239,53.7,1714,0,0,0,758,1481
ZCTA5 85193,1489,90,1399,5303,37.4,3987,42,62,0.011691495,236,5067
ZCTA5 85194,2966,14112,-11146,7137,57.4,6101,116,39,0.005464481,36543,-29406
ZCTA5 85201,21388,452,20936,53402,31.8,33026,1065,3624,0.067862627,1661,51741
ZCTA5 85202,16480,0,16480,38663,33.1,25754,1031,2700,0.069834208,1129,37534
ZCTA5 85203,13093,0,13093,38719,31.8,28010,868,2154,0.055631602,282,38437
ZCTA5 85204,23207,10285,12922,67614,32.7,47452,838,2558,0.037832402,27552,40062
ZCTA5 85205,18992,9433,9559,44195,49.4,37095,919,1015,0.022966399,27447,16748
ZCTA5 85206,15656,2121,13535,35163,45.9,28002,397,1780,0.050621392,6215,28948
ZCTA5 85207,18678,54,18624,49699,44.5,43517,1164,756,0.015211574,210,49489
ZCTA5 85208,14686,11464,3222,36837,44,29250,859,698,0.01894834,26275,10562
ZCTA5 85209,17164,9048,8116,39726,46.1,33442,1221,915,0.023032775,26771,12955
ZCTA5 85210,15326,284,15042,40292,30.8,25380,762,3289,0.081629108,612,39680
ZCTA5 85212,13299,5182,8117,43326,33.4,33535,1657,1799,0.041522411,17341,25985
ZCTA5 85213,13172,400,12772,37247,38.1,30839,643,1141,0.03063334,1113,36134
ZCTA5 85215,7409,1074,6335,16013,56.5,14106,434,224,0.013988634,2763,13250
ZCTA5 85224,20077,66,20011,49065,36.3,32729,4631,2394,0.048792418,253,48812
ZCTA5 85225,27448,128,27320,73301,34.3,49663,4135,5419,0.07392805,441,72860
ZCTA5 85226,16284,572,15712,41988,36.5,30075,4101,2279,0.054277413,1473,40515
ZCTA5 85233,14552,185,14367,37651,37.4,28353,2881,1659,0.044062575,610,37041
ZCTA5 85234,17100,192,16908,50328,35.7,41306,1479,1370,0.027221427,536,49792
ZCTA5 85236,0,604,-604,0,-,0,0,0,#DIV/0!,1621,-1621
ZCTA5 85248,17310,8501,8809,36274,58.1,27590,4456,1272,0.035066439,23541,12733
ZCTA5 85249,15533,52,15481,43863,43.3,32948,4679,1580,0.036021248,117,43746
ZCTA5 85250,8212,15,8197,15937,46.7,13490,516,367,0.023028173,15,15922
ZCTA5 85251,21337,68,21269,40017,37.4,32906,1330,677,0.01691781,89,39928
ZCTA5 85253,7462,210,7252,17212,53.3,14363,818,182,0.010574018,490,16722
ZCTA5 85254,18581,134,18447,44752,45.8,35425,5079,586,0.013094387,255,44497
ZCTA5 85255,17959,58,17901,41888,51.3,36917,2121,691,0.016496371,93,41795
ZCTA5 85256,1380,503,877,5014,27.4,301,0,1,0.000199442,1142,3872
ZCTA5 85257,14674,127,14547,30647,35.5,25748,1044,868,0.028322511,324,30323
ZCTA5 85258,12331,694,11637,25343,52.4,21464,1531,725,0.028607505,1692,23651
ZCTA5 85259,9650,1328,8322,22402,50.9,18055,1916,571,0.025488796,4339,18063
ZCTA5 85260,17996,1395,16601,38320,45,32713,2539,1097,0.028627349,3906,34414
ZCTA5 85262,6010,377,5633,12701,61,12111,23,294,0.023147784,773,11928
ZCTA5 85263,1674,602,1072,3083,69.2,3046,15,0,0,2003,1080
ZCTA5 85264,370,1032,-662,1374,33.9,436,0,0,0,3668,-2294
ZCTA5 85266,5247,152,5095,12145,61.2,10839,709,138,0.011362701,299,11846
ZCTA5 85268,11048,5,11043,23810,59.7,22052,424,504,0.021167577,18,23792
ZCTA5 85281,26312,25,26287,66878,24.8,41152,7870,4325,0.064669996,49,66829
ZCTA5 85282,23101,48,23053,52066,33.1,33483,2486,5147,0.098855299,75,51991
ZCTA5 85283,19006,10,18996,46375,34.7,27083,3862,3377,0.072819407,10,46365
ZCTA5 85284,7070,77,6993,19067,41.9,14766,1479,512,0.026852677,130,18937
ZCTA5 85286,16256,7776,8480,46755,35.9,29676,7917,2401,0.051352796,18568,28187
ZCTA5 85295,17654,3451,14203,51813,32.3,39244,3676,2174,0.041958582,12795,39018
ZCTA5 85296,16227,431,15796,49252,35.3,38920,2003,2790,0.056647446,845,48407
ZCTA5 85297,10276,699,9577,34349,33,25498,2301,1268,0.036915194,2712,31637
ZCTA5 85298,13223,3939,9284,40894,39,33824,2558,884,0.021616863,14041,26853
ZCTA5 85301,22028,16567,5461,67736,28.5,35719,1101,7200,0.106295028,45048,22688
ZCTA5 85302,14502,0,14502,40946,35.2,26365,2107,3525,0.086088995,273,40673
ZCTA5 85303,10001,73,9928,34617,30.3,18324,1493,2897,0.083687206,193,34424
ZCTA5 85304,9494,51,9443,28587,38.4,20594,1115,1276,0.044635674,134,28453
ZCTA5 85305,4631,9,4622,14485,32.5,9259,895,851,0.058750431,28,14457
ZCTA5 85306,8985,10,8975,23598,38,19292,675,533,0.02258666,20,23578
ZCTA5 85307,4005,179,3826,11665,28.9,7386,335,1089,0.093356194,382,11283
ZCTA5 85308,24944,115,24829,63827,41.5,51235,3191,1692,0.026509158,250,63577
ZCTA5 85309,0,708,-708,955,21.3,479,36,254,0.265968586,1968,-1013
ZCTA5 85310,6758,74,6684,19664,40.1,16097,842,524,0.026647681,215,19449
ZCTA5 85320,249,68,181,723,43.3,610,0,0,0,138,585
ZCTA5 85321,1607,501,1106,3745,51.4,2281,26,0,0,1097,2648
ZCTA5 85322,186,33,153,443,47.1,322,5,1,0.002257336,77,366
ZCTA5 85323,13468,24,13444,44512,29.8,23833,711,5393,0.121158339,66,44446
ZCTA5 85324,1233,6315,-5082,2485,59.5,2303,0,0,0,18610,-16125
ZCTA5 85325,655,92,563,1215,75.1,1149,8,0,0,218,997
ZCTA5 85326,19376,23,19353,71621,32.4,46083,1278,4167,0.05818126,53,71568
ZCTA5 85328,117,548,-431,142,64.3,142,0,0,0,1448,-1306
ZCTA5 85329,809,20,789,2817,38.1,1673,0,0,0,48,2769
ZCTA5 85331,12124,9985,2139,30647,50.2,28152,774,256,0.008353183,25271,5376
ZCTA5 85332,810,11019,-10209,1758,69.4,1659,0,0,0,31257,-29499
ZCTA5 85333,236,6102,-5866,501,52.7,339,0,0,0,16870,-16369
ZCTA5 85334,558,12964,-12406,959,45.1,737,0,0,0,34172,-33213
ZCTA5 85335,11300,1636,9664,35410,32.3,19754,471,2642,0.074611692,5393,30017
ZCTA5 85336,3085,1264,1821,10318,27.8,7712,0,0,0,3126,7192
ZCTA5 85337,799,633,166,2507,33.8,1063,0,76,0.030315118,2590,-83
ZCTA5 85338,19110,11995,7115,57464,36.4,38152,1607,2932,0.051023249,36842,20622
ZCTA5 85339,14482,2195,12287,50260,30.8,22063,2373,9267,0.184381218,6966,43294
ZCTA5 85340,11398,41,11357,35643,37.3,23508,1199,2237,0.062761271,125,35518
ZCTA5 85341,16,733,-717,41,59.6,41,0,0,0,1979,-1938
ZCTA5 85342,854,299,555,1753,57.7,1646,6,15,0.00855676,912,841
ZCTA5 85343,30,48,-18,91,38,91,0,0,0,89,2
ZCTA5 85344,4304,48,4256,9369,43.8,4620,59,31,0.003308784,79,9290
ZCTA5 85345,22323,615,21708,59631,37.2,40496,1988,3119,0.052305009,2068,57563
ZCTA5 85346,1341,4281,-2940,2312,68.3,2211,79,18,0.007785467,14341,-12029
ZCTA5 85347,180,4,176,653,33,191,0,0,0,7,646
ZCTA5 85348,1261,44,1217,2156,75.3,2097,0,0,0,67,2089
ZCTA5 85349,6027,0,6027,25772,31.2,15361,23,442,0.017150396,0,25772
ZCTA5 85350,5730,91,5639,18838,30.7,11847,8,434,0.023038539,293,18545
ZCTA5 85351,17400,430,16970,28095,72.4,26084,272,525,0.018686599,1088,27007
ZCTA5 85352,156,0,156,407,31.4,238,0,0,0,0,407
ZCTA5 85353,11274,581,10693,42058,27.9,22548,477,4253,0.10112226,1421,40637
ZCTA5 85354,2432,14593,-12161,7359,40.4,6272,23,21,0.002853649,36038,-28679
ZCTA5 85355,3983,552,3431,12713,36.8,9454,468,768,0.060410603,1528,11185
ZCTA5 85356,1896,1334,562,4220,54.9,3181,16,1,0.000236967,3208,1012
ZCTA5 85357,311,115,196,442,47.4,142,6,54,0.122171946,230,212
ZCTA5 85360,36,1010,-974,57,69.5,47,0,0,0,2156,-2099
ZCTA5 85361,2319,843,1476,6970,43.6,5629,15,89,0.01276901,1551,5419
ZCTA5 85362,437,176,261,705,68.1,678,0,0,0,343,362
ZCTA5 85363,2588,64,2524,6908,39.2,4833,45,166,0.02403011,119,6789
ZCTA5 85364,26634,0,26634,72225,32.3,45411,1360,1875,0.02596054,21,72204
ZCTA5 85365,18889,115,18774,49699,34.9,34147,795,1040,0.020925974,186,49513
ZCTA5 85367,9894,407,9487,20326,65.1,16469,99,400,0.019679229,956,19370
ZCTA5 85371,131,974,-843,250,28.5,6,0,0,0,3585,-3335
ZCTA5 85373,9223,130,9093,20366,62.7,18318,288,567,0.027840519,250,20116
ZCTA5 85374,18619,1015,17604,40143,57.9,35605,408,1393,0.034700944,2340,37803
ZCTA5 85375,15811,75,15736,26479,74.6,25534,240,279,0.010536652,105,26374
ZCTA5 85377,1797,309,1488,3555,66.8,3506,26,1,0.000281294,727,2828
ZCTA5 85378,4018,999,3019,9540,42.1,6417,66,394,0.04129979,3834,5706
ZCTA5 85379,14871,165,14706,48157,34.1,35930,1492,3781,0.078514027,353,47804
ZCTA5 85381,10433,14,10419,26385,41.8,21633,649,757,0.028690544,24,26361
ZCTA5 85382,17240,8,17232,41508,43.5,33923,2400,896,0.0215862,13,41495
ZCTA5 85383,21972,98,21874,66707,39.9,52346,5627,1654,0.024794999,214,66493
ZCTA5 85387,6181,3772,2409,14518,54.9,11831,390,405,0.027896404,8768,5750
ZCTA5 85388,10011,1123,8888,33299,35,27473,1059,1531,0.045977357,3145,30154
ZCTA5 85390,4424,86,4338,9317,63.7,8664,32,17,0.001824622,164,9153
ZCTA5 85392,13267,131,13136,38772,33.1,23232,1726,2993,0.077194883,264,38508
ZCTA5 85395,12412,16,12396,36531,44,26788,1856,2298,0.062905478,30,36501
ZCTA5 85396,10599,132,10467,32413,38.8,23052,591,1090,0.033628482,295,32118
ZCTA5 85501,5181,81,5100,12903,43.2,9598,77,222,0.017205301,251,12652
ZCTA5 85530,464,2034,-1570,1514,30.4,10,0,0,0,4801,-3287
ZCTA5 85531,243,222,21,434,26.8,294,140,0,0,532,-98
ZCTA5 85532,111,61,50,312,42.3,207,0,0,0,173,139
ZCTA5 85533,1132,0,1132,3006,41,2855,0,2,0.000665336,0,3006
ZCTA5 85534,931,2577,-1646,2681,41.1,2249,6,2,0.00074599,6669,-3988
ZCTA5 85535,0,37,-37,0,-,0,0,0,#DIV/0!,99,-99
ZCTA5 85536,160,27,133,383,42.6,372,0,0,0,68,315
ZCTA5 85539,1207,32,1175,2872,45.6,1830,121,15,0.005222841,95,2777
ZCTA5 85540,1158,1289,-131,3795,28.2,3046,38,179,0.047167325,3422,373
ZCTA5 85541,10712,76,10636,22746,59.1,20439,179,136,0.005979073,199,22547
ZCTA5 85542,746,43,703,3876,24.3,62,0,0,0,58,3818
ZCTA5 85543,1435,157,1278,4073,35.3,3724,0,6,0.001473116,468,3605
ZCTA5 85544,1419,114,1305,2632,67.2,2508,0,0,0,256,2376
ZCTA5 85545,377,0,377,648,64.7,564,0,9,0.013888889,0,648
ZCTA5 85546,6231,14,6217,20189,35.1,16611,77,609,0.030164941,35,20154
ZCTA5 85550,1300,18,1282,5425,28,88,31,3,0.000552995,75,5350
ZCTA5 85551,131,542,-411,496,38.9,260,0,0,0,1243,-747
ZCTA5 85552,2069,56,2013,6601,30,5951,34,44,0.006665657,136,6465
ZCTA5 85553,883,67,816,1522,66.5,1504,0,18,0.011826544,157,1365
ZCTA5 85554,276,15,261,430,61.3,388,0,3,0.006976744,35,395
ZCTA5 85601,330,189,141,527,62.7,506,0,0,0,584,-57
ZCTA5 85602,4131,903,3228,9590,54,8332,89,33,0.003441084,3496,6094
ZCTA5 85603,3229,48,3181,6587,55.8,5395,0,70,0.010626993,89,6498
ZCTA5 85605,228,412,-184,633,34.5,535,0,5,0.007898894,1038,-405
ZCTA5 85606,361,10793,-10432,845,55.6,746,7,0,0,33146,-32301
ZCTA5 85607,5519,471,5048,17394,31,11995,148,285,0.01638496,1011,16383
ZCTA5 85608,0,146,-146,3038,36,1988,0,485,0.159644503,399,2639
ZCTA5 85609,195,6370,-6175,410,73.6,410,0,0,0,15186,-14776
ZCTA5 85610,311,301,10,817,47.7,700,0,21,0.025703794,1153,-336
ZCTA5 85611,586,571,15,1423,58,1368,23,0,0,1463,-40
ZCTA5 85613,882,125,757,5248,22.7,3705,131,880,0.167682927,281,4967
ZCTA5 85614,13132,6989,6143,23485,70.7,21719,180,338,0.014392165,17690,5795
ZCTA5 85615,3781,11646,-7865,9033,50.8,8367,54,42,0.004649618,27936,-18903
ZCTA5 85616,2271,187,2084,5216,45,3885,37,183,0.035084356,366,4850
ZCTA5 85617,554,15053,-14499,1113,57.8,958,2,5,0.004492363,37333,-36220
ZCTA5 85618,541,14186,-13645,1443,53.2,1111,0,0,0,38910,-37467
ZCTA5 85619,17,52,-35,26,63.5,26,0,0,0,188,-162
ZCTA5 85620,334,384,-50,941,29.5,463,0,0,0,5637,-4696
ZCTA5 85621,7482,922,6560,21688,37.2,13324,143,194,0.008945039,1882,19806
ZCTA5 85622,3576,429,3147,6180,73,6021,4,10,0.001618123,1077,5103
ZCTA5 85623,2304,937,1367,4927,65,3958,6,0,0,3037,1890
ZCTA5 85624,672,61,611,1339,53.5,1178,3,11,0.008215086,121,1218
ZCTA5 85625,969,389,580,1866,63.4,1708,0,1,0.000535906,1011,855
ZCTA5 85626,353,0,353,1273,31.8,957,0,0,0,573,700
ZCTA5 85627,179,6327,-6148,461,55.1,457,0,0,0,15366,-14905
ZCTA5 85629,9152,3451,5701,29319,32.8,23790,370,502,0.017122003,7169,22150
ZCTA5 85630,876,13536,-12660,1811,42,1612,0,0,0,51857,-50046
ZCTA5 85631,1609,18990,-17381,3521,52.1,2716,0,1,0.00028401,60297,-56776
ZCTA5 85632,384,12877,-12493,784,60.7,713,0,3,0.003826531,41233,-40449
ZCTA5 85633,12,110,-98,42,28.8,34,0,1,0.023809524,165,-123
ZCTA5 85634,1650,1322,328,6288,29.3,411,0,8,0.001272265,3901,2387
ZCTA5 85635,15395,449,14946,35167,39.9,25146,1457,2191,0.062302727,1364,33803
ZCTA5 85637,464,492,-28,1130,63.2,1098,0,13,0.011504425,1229,-99
ZCTA5 85638,793,6589,-5796,1667,60.9,1624,0,0,0,14989,-13322
ZCTA5 85639,104,654,-550,425,26.4,0,0,0,0,1830,-1405
ZCTA5 85640,43,232,-189,86,62.9,86,0,0,0,517,-431
ZCTA5 85641,9993,142,9851,30080,38.1,23387,698,1303,0.043317819,173,29907
ZCTA5 85643,3087,8755,-5668,8565,37.3,6544,70,147,0.017162872,20668,-12103
ZCTA5 85645,627,1283,-656,1602,56.2,1138,21,0,0,3212,-1610
ZCTA5 85646,660,19127,-18467,1274,66.5,1261,0,0,0,48587,-47313
ZCTA5 85648,6669,55,6614,21007,34.1,12979,0,0,0,150,20857
ZCTA5 85650,5929,4577,1352,14447,48.9,11158,365,622,0.043053921,10623,3824
ZCTA5 85653,6626,1782,4844,19977,34.9,16200,241,654,0.032737648,4552,15425
ZCTA5 85654,0,18245,-18245,0,-,0,0,0,#DIV/0!,47794,-47794
ZCTA5 85658,6457,9088,-2631,15494,52.6,12084,733,148,0.009552085,30045,-14551
ZCTA5 85701,2939,7715,-4776,5283,36.5,3762,187,77,0.014575052,20379,-15096
ZCTA5 85704,15821,1150,14671,34597,43.5,27872,2123,615,0.017776108,3950,30647
ZCTA5 85705,24779,1556,23223,55714,35.3,34137,1488,1786,0.032056575,4784,50930
ZCTA5 85706,18211,14342,3869,57761,27.9,29227,623,1814,0.031405273,45219,12542
ZCTA5 85707,0,13798,-13798,691,21.8,388,5,256,0.370477569,38143,-37452
ZCTA5 85708,1309,21210,-19901,3902,23.8,2477,87,330,0.084572014,50057,-46155
ZCTA5 85709,0,14174,-14174,0,-,0,0,0,#DIV/0!,39608,-39608
ZCTA5 85710,24664,8815,15849,52385,41.5,39893,1125,2793,0.053316789,27004,25381
ZCTA5 85711,17570,12103,5467,41369,36.1,26719,1527,2895,0.069979937,36534,4835
ZCTA5 85712,16437,23744,-7307,31161,42.1,23238,873,1565,0.050223035,67208,-36047
ZCTA5 85713,16496,3627,12869,45904,36.2,25936,442,1906,0.041521436,6904,39000
ZCTA5 85714,5561,20697,-15136,15828,33.8,8105,46,179,0.011309073,72269,-56441
ZCTA5 85715,8581,9816,-1235,18609,47.2,15356,350,458,0.024611747,23964,-5355
ZCTA5 85716,15729,18076,-2347,31317,38.3,23332,590,1715,0.054762589,60509,-29192
ZCTA5 85718,12747,23003,-10256,26377,52.9,20255,2135,697,0.026424537,54900,-28523
ZCTA5 85719,18548,7779,10769,47922,23,33518,3573,1639,0.034201411,19640,28282
ZCTA5 85721,0,19849,-19849,0,-,0,0,0,#DIV/0!,44392,-44392
ZCTA5 85723,0,9088,-9088,140,52.3,73,0,20,0.142857143,22382,-22242
ZCTA5 85724,0,23961,-23961,0,-,0,0,0,#DIV/0!,61813,-61813
ZCTA5 85726,0,16739,-16739,0,-,0,0,0,#DIV/0!,46004,-46004
ZCTA5 85730,15441,22396,-6955,38674,36.6,25686,1168,2547,0.065858199,58968,-20294
ZCTA5 85734,0,287,-287,5559,34.9,2123,48,890,0.160100738,688,4871
ZCTA5 85735,4060,14698,-10638,10811,45.5,6955,59,259,0.023957081,37479,-26668
ZCTA5 85736,1794,19207,-17413,4473,48.1,2700,27,91,0.020344288,52735,-48262
ZCTA5 85737,9666,11112,-1446,22331,53.5,18516,843,429,0.019210962,30088,-7757
ZCTA5 85739,8471,14704,-6233,17216,65.7,15718,156,67,0.003891729,45309,-28093
ZCTA5 85741,14053,11982,2071,34020,36.4,24495,1520,931,0.027366255,26296,7724
ZCTA5 85742,11516,10251,1265,28938,41.3,22995,902,536,0.018522358,24147,4791
ZCTA5 85743,11768,4256,7512,30655,46.2,23874,834,502,0.016375795,12619,18036
ZCTA5 85745,16314,10591,5723,37566,39.1,25534,1507,772,0.020550498,31706,5860
ZCTA5 85746,15645,9058,6587,46452,33.6,21784,318,1440,0.030999742,27593,18859
ZCTA5 85747,8791,9859,-1068,26083,35.2,19682,1004,1264,0.048460683,32262,-6179
ZCTA5 85748,8082,3446,4636,19858,39.9,16114,745,613,0.030869171,10650,9208
ZCTA5 85749,7663,7661,2,18217,54.3,15801,324,122,0.006697041,19641,-1424
ZCTA5 85750,11659,9105,2554,24440,53.8,20982,1110,415,0.01698036,23231,1209
ZCTA5 85755,7731,7003,728,17352,60,14769,693,313,0.018038266,19386,-2034
ZCTA5 85756,11200,18561,-7361,36163,35,21139,423,2433,0.06727871,51131,-14968
ZCTA5 85757,6448,14709,-8261,20440,34.6,9012,463,377,0.018444227,39926,-19486
ZCTA5 85901,7494,12146,-4652,18855,46.6,15915,106,131,0.006947759,32040,-13185
ZCTA5 85902,0,8876,-8876,5,-,5,0,0,0,27747,-27742
ZCTA5 85911,333,63,270,1432,17.6,32,42,0,0,102,1330
ZCTA5 85912,98,3395,-3297,161,59,126,0,0,0,9776,-9615
ZCTA5 85920,293,9844,-9551,562,67.3,533,0,0,0,23183,-22621
ZCTA5 85922,44,9250,-9206,60,69.6,60,0,0,0,26198,-26138
ZCTA5 85923,229,750,-521,449,62.1,449,0,0,0,2132,-1683
ZCTA5 85924,892,13439,-12547,1855,64.3,1756,38,0,0,37323,-35468
ZCTA5 85925,1447,80,1367,4487,38.4,4139,0,0,0,824,3663
ZCTA5 85926,251,2349,-2098,852,26.4,11,0,0,0,6698,-5846
ZCTA5 85927,39,170,-131,125,61.9,17,0,0,0,520,-395
ZCTA5 85928,211,54,157,565,43.2,565,0,0,0,130,435
ZCTA5 85929,3226,113,3113,7377,52.4,6053,61,38,0.005151145,224,7153
ZCTA5 85930,306,575,-269,1526,26.5,14,0,0,0,1560,-34
ZCTA5 85931,96,167,-71,235,59,220,0,6,0.025531915,622,-387
ZCTA5 85932,181,611,-430,636,47.7,374,0,0,0,1608,-972
ZCTA5 85933,1373,269,1104,2908,61.3,2556,52,1,0.000343879,816,2092
ZCTA5 85934,236,0,236,486,45.8,365,0,0,0,0,486
ZCTA5 85935,2003,5300,-3297,4429,59.2,3800,31,0,0,14146,-9717
ZCTA5 85936,928,0,928,4057,33.2,2762,0,285,0.070248952,0,4057
ZCTA5 85937,2786,54,2732,9058,33.4,7874,0,37,0.004084787,184,8874
ZCTA5 85938,873,9221,-8348,2359,41.4,1847,0,4,0.001695634,24779,-22420
ZCTA5 85939,1445,6571,-5126,3977,41,3530,0,42,0.010560724,19090,-15113
ZCTA5 85940,477,90,387,1524,55.1,1343,0,55,0.036089239,149,1375
ZCTA5 85941,2739,4479,-1740,10640,29,350,9,20,0.001879699,10809,-169
ZCTA5 85942,0,318,-318,0,-,0,0,0,#DIV/0!,731,-731
ZCTA5 86001,12703,118,12585,37157,23.4,27110,1290,587,0.015797831,223,36934
ZCTA5 86003,29,184,-155,72,54.6,0,0,0,0,414,-342
ZCTA5 86004,13863,168,13695,36337,36.4,27032,499,282,0.007760685,288,36049
ZCTA5 86005,6607,1868,4739,15921,34.7,12358,318,406,0.025500911,3901,12020
ZCTA5 86011,33,87,-54,4717,19.1,3590,69,181,0.038371847,207,4510
ZCTA5 86015,545,1570,-1025,1115,37.9,582,166,0,0,5491,-4376
ZCTA5 86016,19,35,-16,42,56.5,0,0,0,0,35,7
ZCTA5 86017,493,244,249,780,66.3,742,0,38,0.048717949,685,95
ZCTA5 86018,333,67,266,771,55.2,759,0,0,0,94,677
ZCTA5 86020,635,4486,-3851,2283,31.7,30,0,0,0,11088,-8805
ZCTA5 86021,708,138,570,4189,17.4,4189,0,0,0,309,3880
ZCTA5 86022,752,296,456,2041,36.4,1490,12,21,0.010289074,807,1234
ZCTA5 86023,453,124,329,1916,29.8,996,13,65,0.033924843,255,1661
ZCTA5 86024,485,279,206,1004,67.6,944,0,0,0,688,316
ZCTA5 86025,1686,65,1621,5253,39.4,2489,0,321,0.061107938,176,5077
ZCTA5 86028,15,2619,-2604,39,-,39,0,0,0,7363,-7324
ZCTA5 86029,27,96,-69,106,52.8,80,0,9,0.08490566,215,-109
ZCTA5 86030,278,13708,-13430,927,41.3,14,0,0,0,37047,-36120
ZCTA5 86031,646,6443,-5797,1832,34.5,34,5,2,0.001091703,19440,-17608
ZCTA5 86032,578,9780,-9202,2121,21.8,1605,2,1,0.000471476,25109,-22988
ZCTA5 86033,2584,13139,-10555,8191,30.4,265,44,21,0.00256379,36078,-27887
ZCTA5 86034,535,0,535,1519,45.2,49,0,12,0.007899934,0,1519
ZCTA5 86035,572,721,-149,1928,36,8,5,0,0,1643,285
ZCTA5 86036,88,406,-318,220,39.6,51,0,0,0,866,-646
ZCTA5 86038,39,4124,-4085,73,66.4,73,0,0,0,11982,-11909
ZCTA5 86039,537,340,197,1590,37.8,6,8,0,0,953,637
ZCTA5 86040,3777,1131,2646,10824,31.9,2968,51,207,0.019124169,2717,8107
ZCTA5 86042,628,5849,-5221,2207,36.9,70,70,7,0.003171726,15445,-13238
ZCTA5 86043,589,23,566,2609,27.6,0,0,0,0,124,2485
ZCTA5 86044,1120,3271,-2151,3149,41.6,13,13,0,0,8402,-5253
ZCTA5 86045,3300,686,2614,11756,34.4,452,0,109,0.009271861,1268,10488
ZCTA5 86046,2438,1233,1205,5826,45.3,4524,75,116,0.019910745,2561,3265
ZCTA5 86047,4118,79,4039,14388,33.7,3131,37,439,0.030511537,134,14254
ZCTA5 86052,0,3532,-3532,333,41.4,246,0,13,0.039039039,7993,-7660
ZCTA5 86053,716,5245,-4529,2498,27.6,0,0,0,0,13496,-10998
ZCTA5 86054,578,2135,-1557,1628,44.1,9,0,0,0,3292,-1664
ZCTA5 86301,11194,17538,-6344,25178,59,22207,683,36,0.00142982,44830,-19652
ZCTA5 86303,9352,11601,-2249,18452,60.8,16710,184,129,0.006991112,29114,-10662
ZCTA5 86305,8549,12920,-4371,18421,60.5,17352,59,23,0.001248575,41813,-23392
ZCTA5 86313,0,4242,-4242,260,55.8,203,0,13,0.05,11312,-11052
ZCTA5 86314,15876,15256,620,39118,43.4,32619,437,268,0.006851066,33016,6102
ZCTA5 86315,3689,690,2999,9096,51.2,8046,229,37,0.004067722,1685,7411
ZCTA5 86320,1240,10018,-8778,2972,54.4,2182,0,0,0,25822,-22850
ZCTA5 86321,878,9156,-8278,2745,23.9,2123,0,0,0,24049,-21304
ZCTA5 86322,4308,3582,726,12487,41.3,10123,90,88,0.007047329,8166,4321
ZCTA5 86323,8248,9359,-1111,18913,53.3,16521,275,77,0.004071274,24258,-5345
ZCTA5 86324,2375,12428,-10053,4419,59.7,3712,29,199,0.045032813,31178,-26759
ZCTA5 86325,2502,9574,-7072,5598,55.4,4743,26,98,0.017506252,26669,-21071
ZCTA5 86326,11417,0,11417,24896,47.8,20906,74,199,0.007993252,192,24704
ZCTA5 86327,4726,4480,246,9894,62.3,9434,0,78,0.007883566,10099,-205
ZCTA5 86329,454,1893,-1439,1545,34,1408,0,0,0,4735,-3190
ZCTA5 86331,226,1881,-1655,445,57.2,359,0,0,0,5218,-4773
ZCTA5 86332,1030,7565,-6535,2017,62,1940,0,4,0.001983143,20034,-18017
ZCTA5 86333,2635,8132,-5497,7012,48.3,5600,121,95,0.013548203,22320,-15308
ZCTA5 86334,1773,4821,-3048,4402,46.5,3983,14,0,0,14161,-9759
ZCTA5 86335,2462,1894,568,4593,61.1,3959,1,3,0.000653168,5596,-1003
ZCTA5 86336,5647,155,5492,10890,58.6,8685,273,51,0.004683196,298,10592
ZCTA5 86337,747,884,-137,1610,57.2,1449,22,0,0,2658,-1048
ZCTA5 86338,261,22,239,539,60.5,495,5,17,0.031539889,27,512
ZCTA5 86343,61,508,-447,129,55.5,107,0,0,0,1410,-1281
ZCTA5 86351,3407,78,3329,6300,65,5447,106,123,0.01952381,182,6118
ZCTA5 86401,11657,173,11484,28352,44.5,23692,550,522,0.0184114,337,28015
ZCTA5 86403,8197,138,8059,18068,49.8,15901,135,160,0.008855435,194,17874
ZCTA5 86404,8365,14,8351,17966,59.1,16211,140,0,0,28,17938
ZCTA5 86406,11683,508,11175,24050,57.3,21791,143,79,0.003284823,1410,22640
ZCTA5 86409,12832,68,12764,29109,47.8,26156,215,274,0.009412896,156,28953
ZCTA5 86411,202,43,159,518,40.3,518,0,0,0,181,337
ZCTA5 86413,4914,691,4223,11077,60.1,9609,61,200,0.01805543,1795,9282
ZCTA5 86426,6588,1470,5118,15630,56.3,12904,395,200,0.012795905,4494,11136
ZCTA5 86429,3968,12832,-8864,8391,57.5,7523,21,312,0.037182696,54480,-46089
ZCTA5 86431,189,11617,-11428,296,60.6,287,0,0,0,48613,-48317
ZCTA5 86432,1852,16399,-14547,4000,62.1,2605,0,0,0,67226,-63226
ZCTA5 86433,26,23101,-23075,43,-,17,26,0,0,62884,-62841
ZCTA5 86434,518,15224,-14706,1697,27.8,190,0,0,0,39592,-37895
ZCTA5 86435,0,18404,-18404,0,-,0,0,0,#DIV/0!,58849,-58849
ZCTA5 86436,763,11361,-10598,1089,71.2,1067,0,0,0,43653,-42564
ZCTA5 86437,23,14085,-14062,107,53.5,36,0,0,0,33754,-33647
ZCTA5 86438,338,2109,-1771,661,66.1,625,0,12,0.018154312,3835,-3174
ZCTA5 86440,3255,21919,-18664,8130,42.5,5964,121,29,0.003567036,100671,-92541
ZCTA5 86441,924,9451,-8527,1815,59.4,1752,37,0,0,29164,-27349
ZCTA5 86442,14982,5030,9952,33477,49.1,27505,531,418,0.012486185,9318,24159
ZCTA5 86443,0,3972,-3972,0,-,0,0,0,#DIV/0!,5556,-5556
ZCTA5 86444,786,6957,-6171,1517,68.2,1473,7,0,0,17668,-16151
ZCTA5 86445,129,17051,-16922,253,58.2,253,0,0,0,46779,-46526
ZCTA5 86502,300,9135,-8835,920,38.6,26,0,0,0,23171,-22251
ZCTA5 86503,3005,15300,-12295,9089,35.1,168,132,11,0.001210254,48497,-39408
ZCTA5 86504,1599,23964,-22365,6347,34.5,105,62,30,0.004726643,64613,-58266
ZCTA5 86505,1963,16808,-14845,7522,34.3,73,7,6,0.00079766,41086,-33564
ZCTA5 86506,422,1492,-1070,1437,38,16,0,0,0,2664,-1227
ZCTA5 86507,576,17071,-16495,2005,37.6,2,0,0,0,68657,-66652
ZCTA5 86508,182,10814,-10632,516,40.1,8,0,0,0,45663,-45147
ZCTA5 86510,1323,17520,-16197,3569,35.6,122,22,0,0,50269,-46700
ZCTA5 86511,951,20954,-20003,3629,34.5,33,42,0,0,42932,-39303
ZCTA5 86512,714,25295,-24581,2513,31.4,101,4,10,0.003979308,69615,-67102
ZCTA5 86514,873,21691,-20818,3367,31.6,72,24,9,0.002673003,45702,-42335
ZCTA5 86515,994,14959,-13965,3079,35.7,135,0,10,0.003247808,28254,-25175
ZCTA5 86520,706,13961,-13255,2270,29.5,0,0,0,0,39437,-37167
ZCTA5 86535,343,11136,-10793,1428,34.6,0,0,0,0,39990,-38562
ZCTA5 86538,554,12921,-12367,1491,33.8,35,19,0,0,49242,-47751
ZCTA5 86540,228,12753,-12525,1039,26.4,0,0,5,0.00481232,49048,-48009
ZCTA5 86544,356,25877,-25521,1377,35,16,7,0,0,59305,-57928
ZCTA5 86545,340,13271,-12931,1268,31.9,0,20,0,0,30553,-29285
ZCTA5 86547,266,18334,-18068,1040,33.4,0,0,0,0,35942,-34902
ZCTA5 86556,560,16366,-15806,2845,22.3,126,10,141,0.049560633,60867,-58022
ZCTA5 87001,1061,12252,-11191,3851,36.1,628,29,0,0,30225,-26374
ZCTA5 87002,7501,11804,-4303,20533,45.2,14435,279,308,0.015000244,28260,-7727
ZCTA5 87004,4693,3308,1385,11778,43.6,6711,29,107,0.009084734,12692,-914
ZCTA5 87005,67,9497,-9430,96,52,67,0,29,0.302083333,28571,-28475
ZCTA5 87006,305,19798,-19493,1539,37.5,1068,0,0,0,62303,-60764
ZCTA5 87007,309,16318,-16009,1385,33.6,46,1,1,0.000722022,43761,-42376
ZCTA5 87008,1157,25526,-24369,2409,53.5,2059,20,9,0.00373599,85940,-83531
ZCTA5 87010,615,15312,-14697,1005,59.4,977,0,0,0,40535,-39530
ZCTA5 87011,0,28793,-28793,0,-,0,0,0,#DIV/0!,49937,-49937
ZCTA5 87012,190,16459,-16269,436,35.6,169,0,0,0,47857,-47421
ZCTA5 87013,1557,11284,-9727,5648,32.1,558,0,0,0,20793,-15145
ZCTA5 87014,259,16643,-16384,499,57.4,350,0,0,0,36107,-35608
ZCTA5 87015,5929,3769,2160,14637,49.3,11692,16,95,0.006490401,8628,6009
ZCTA5 87016,1088,15764,-14676,2818,54,2244,0,7,0.002484031,44871,-42053
ZCTA5 87017,154,973,-819,618,55.8,149,0,0,0,3289,-2671
ZCTA5 87018,196,9563,-9367,932,32.6,9,0,0,0,40305,-39373
ZCTA5 87020,3430,7173,-3743,11073,36.3,7234,42,384,0.034678949,26621,-15548
ZCTA5 87021,917,9145,-8228,2837,46.2,1407,0,30,0.010574551,31569,-28732
ZCTA5 87022,217,13245,-13028,443,49.1,13,0,0,0,53994,-53551
ZCTA5 87023,182,10574,-10392,509,61.5,361,0,92,0.180746562,25894,-25385
ZCTA5 87024,615,14652,-14037,2510,32.7,89,0,7,0.002788845,45816,-43306
ZCTA5 87025,629,24110,-23481,1385,52.9,772,149,0,0,56107,-54722
ZCTA5 87026,1124,1470,-346,4259,37.2,367,0,0,0,2257,2002
ZCTA5 87027,157,12514,-12357,359,32.7,133,0,7,0.019498607,22270,-21911
ZCTA5 87028,49,13369,-13320,87,68.3,87,0,0,0,20328,-20241
ZCTA5 87029,160,0,160,260,61.8,246,0,0,0,0,260
ZCTA5 87031,14324,0,14324,45537,36.3,31555,767,791,0.01737049,623,44914
ZCTA5 87032,92,3195,-3103,92,-,0,0,0,0,8262,-8170
ZCTA5 87034,705,0,705,3223,38.1,148,0,0,0,0,3223
ZCTA5 87035,2301,33,2268,7301,37.8,5387,87,83,0.011368306,3402,3899
ZCTA5 87036,584,0,584,1731,46.4,1254,25,203,0.117273252,0,1731
ZCTA5 87037,441,2797,-2356,1771,39.4,77,0,0,0,5567,-3796
ZCTA5 87038,73,0,73,390,30.9,0,0,0,0,0,390
ZCTA5 87040,146,24399,-24253,783,36.4,0,0,0,0,101647,-100864
ZCTA5 87041,319,8486,-8167,828,38.9,350,0,5,0.006038647,21517,-20689
ZCTA5 87042,1376,3569,-2193,3433,40.8,2529,65,0,0,7889,-4456
ZCTA5 87043,1909,5506,-3597,3863,62.6,3410,59,0,0,12306,-8443
ZCTA5 87044,73,12987,-12914,120,65.2,114,0,0,0,50947,-50827
ZCTA5 87045,488,11458,-10970,1885,29.7,5,0,0,0,51350,-49465
ZCTA5 87046,74,7787,-7713,214,40.6,174,0,0,0,30990,-30776
ZCTA5 87047,1897,13354,-11457,4545,48.7,3994,31,15,0.00330033,32508,-27963
ZCTA5 87048,3673,6347,-2674,8735,56.8,7108,277,138,0.015798512,15248,-6513
ZCTA5 87049,68,7275,-7207,253,51.7,110,0,0,0,25258,-25005
ZCTA5 87051,424,13540,-13116,1887,43.9,1727,0,0,0,43786,-41899
ZCTA5 87052,548,12052,-11504,2688,31.1,19,0,0,0,42763,-40075
ZCTA5 87053,345,6956,-6611,1253,31.2,39,2,0,0,16678,-15425
ZCTA5 87056,496,16256,-15760,1182,54.7,1021,15,0,0,46590,-45408
ZCTA5 87059,4056,3410,646,9706,52.3,8207,79,0,0,9904,-198
ZCTA5 87060,0,8856,-8856,0,-,0,0,0,#DIV/0!,26790,-26790
ZCTA5 87061,132,31533,-31401,258,35,258,0,0,0,93925,-93667
ZCTA5 87062,538,9320,-8782,1702,36.7,1561,0,0,0,19535,-17833
ZCTA5 87063,110,18161,-18051,367,25.9,284,0,0,0,75961,-75594
ZCTA5 87064,55,10366,-10311,84,72.5,6,0,0,0,35014,-34930
ZCTA5 87068,1904,15229,-13325,5335,42.6,2733,70,0,0,69734,-64399
ZCTA5 87070,9,0,9,9,-,9,0,0,0,1847,-1838
ZCTA5 87072,177,6935,-6758,604,34.7,14,0,0,0,17749,-17145
ZCTA5 87083,238,14089,-13851,399,64.8,266,0,6,0.015037594,35226,-34827
ZCTA5 87101,0,6445,-6445,0,-,0,0,0,#DIV/0!,27443,-27443
ZCTA5 87102,9798,8906,892,19056,35.9,11471,229,799,0.041929051,22893,-3837
ZCTA5 87104,5856,9412,-3556,13468,41.2,9085,87,165,0.012251262,25387,-11919
ZCTA5 87105,18886,15178,3708,54138,38.6,30660,122,686,0.012671321,41903,12235
ZCTA5 87106,11909,16562,-4653,25844,32.1,18004,1109,875,0.033856988,33972,-8128
ZCTA5 87107,12334,16003,-3669,27981,44.3,18422,133,261,0.009327758,40867,-12886
ZCTA5 87108,17128,23925,-6797,36433,37.2,21472,846,2348,0.064447067,94703,-58270
ZCTA5 87109,18919,2468,16451,40249,41.7,26647,1571,1700,0.042237074,6983,33266
ZCTA5 87110,18135,14003,4132,40307,40.7,27084,950,1312,0.032550177,26961,13346
ZCTA5 87111,25998,12523,13475,57518,43.5,43468,2534,1131,0.01966341,22350,35168
ZCTA5 87112,18760,6705,12055,41818,40.3,29961,1249,1108,0.026495767,12129,29689
ZCTA5 87113,6417,12245,-5828,16879,39.7,9998,2557,215,0.012737721,37165,-20286
ZCTA5 87114,26615,10925,15690,69717,36.2,47686,1026,2497,0.035816228,30344,39373
ZCTA5 87116,1384,7117,-5733,4579,23.2,3182,251,345,0.075343962,25828,-21249
ZCTA5 87117,0,6658,-6658,24,20.7,15,0,0,0,27198,-27174
ZCTA5 87120,25860,5923,19937,66118,38.6,42822,1382,2323,0.035134154,14896,51222
ZCTA5 87121,25665,4313,21352,75378,30.4,42201,838,1841,0.024423572,6766,68612
ZCTA5 87122,6559,5544,1015,18022,46.1,13889,1202,300,0.016646321,12351,5671
ZCTA5 87123,18500,13686,4814,44162,39.4,28879,1966,1569,0.035528282,24286,19876
ZCTA5 87124,21614,9678,11936,56875,40.1,42148,1112,1809,0.031806593,20739,36136
ZCTA5 87144,16204,14097,2107,47079,37.5,33572,651,1187,0.02521294,28114,18965
ZCTA5 87151,0,14312,-14312,1640,33.6,841,0,148,0.090243902,42363,-40723
ZCTA5 87301,7428,5556,1872,22776,34.4,5716,840,327,0.014357218,16845,5931
ZCTA5 87305,601,17280,-16679,2125,33,28,0,0,0,46253,-44128
ZCTA5 87310,288,11400,-11112,1120,31.8,15,0,34,0.030357143,31650,-30530
ZCTA5 87311,1241,14013,-12772,5074,30.5,86,1,7,0.001379582,36135,-31061
ZCTA5 87312,171,0,171,417,44.5,32,0,0,0,0,417
ZCTA5 87313,1614,10726,-9112,5284,34.3,92,23,15,0.002838759,32630,-27346
ZCTA5 87315,56,7953,-7897,141,73.8,141,0,0,0,25923,-25782
ZCTA5 87316,485,6498,-6013,1630,34.1,238,0,0,0,19933,-18303
ZCTA5 87317,329,12078,-11749,1327,27.3,256,0,0,0,40483,-39156
ZCTA5 87319,735,10499,-9764,2910,31.4,122,0,0,0,40698,-37788
ZCTA5 87320,193,8605,-8412,578,43.9,5,0,0,0,32998,-32420
ZCTA5 87321,725,12356,-11631,2011,54.2,1011,0,0,0,44295,-42284
ZCTA5 87322,137,10189,-10052,630,20,167,0,0,0,35994,-35364
ZCTA5 87323,1388,5061,-3673,4159,37.8,742,5,11,0.002644867,15528,-11369
ZCTA5 87325,672,15951,-15279,2572,34.7,87,8,0,0,48292,-45720
ZCTA5 87326,591,20815,-20224,2383,33.7,152,2,0,0,67929,-65546
ZCTA5 87327,1804,14332,-12528,8445,32.3,112,36,0,0,49062,-40617
ZCTA5 87328,800,18866,-18066,2841,28.7,8,0,0,0,62965,-60124
ZCTA5 87347,117,26972,-26855,262,25.9,112,0,0,0,105603,-105341
ZCTA5 87357,327,16455,-16128,1080,30.5,58,3,5,0.00462963,63106,-62026
ZCTA5 87364,497,4360,-3863,1638,36,0,0,0,0,15265,-13627
ZCTA5 87365,22,9368,-9346,33,38.6,0,0,0,0,30369,-30336
ZCTA5 87375,1155,4625,-3470,4477,34.8,69,0,0,0,16597,-12120
ZCTA5 87401,15255,15035,220,47326,33.6,24536,392,483,0.010205807,49551,-2225
ZCTA5 87402,3509,1359,2150,9792,39.2,6395,82,97,0.009906046,3999,5793
ZCTA5 87410,5838,23257,-17419,14993,39.9,11363,229,359,0.023944507,76619,-61626
ZCTA5 87412,438,9039,-8601,1702,59.3,506,106,97,0.056991774,27486,-25784
ZCTA5 87413,5168,10530,-5362,15134,34.9,8911,40,28,0.001850139,31334,-16200
ZCTA5 87415,825,9317,-8492,2057,52.1,1977,0,2,0.00097229,27562,-25505
ZCTA5 87416,1349,6151,-4802,4581,37.5,190,24,0,0,21129,-16548
ZCTA5 87417,1473,3636,-2163,4976,27.4,1974,14,11,0.002210611,14203,-9227
ZCTA5 87418,357,8319,-7962,859,56.5,636,5,0,0,21347,-20488
ZCTA5 87419,161,7709,-7548,436,51.8,385,0,0,0,21710,-21274
ZCTA5 87420,3201,13669,-10468,11293,36.5,170,89,4,0.000354202,54255,-42962
ZCTA5 87421,513,22009,-21496,1980,42,528,30,0,0,59270,-57290
ZCTA5 87455,520,8347,-7827,1565,39.5,34,8,5,0.003194888,19895,-18330
ZCTA5 87461,451,12459,-12008,1481,37.9,0,0,0,0,23789,-22308
ZCTA5 87499,293,493,-200,1016,37.7,55,0,0,0,968,48
ZCTA5 87501,7913,181,7732,14637,56.7,12410,146,79,0.005397281,411,14226
ZCTA5 87505,15273,13934,1339,31885,51.1,25312,701,450,0.014113219,57441,-25556
ZCTA5 87506,6710,14827,-8117,15481,53.7,8938,213,176,0.011368775,58090,-42609
ZCTA5 87507,19449,7895,11554,51780,37.8,37740,670,587,0.011336423,25861,25919
ZCTA5 87508,7333,0,7333,18587,52.8,14590,200,188,0.010114596,0,18587
ZCTA5 87510,449,4116,-3667,915,47.9,570,0,0,0,10994,-10079
ZCTA5 87511,697,19776,-19079,2587,30.1,800,3,50,0.019327406,39017,-36430
ZCTA5 87512,84,16674,-16590,177,65.1,126,0,0,0,30855,-30678
ZCTA5 87513,433,14653,-14220,826,48.4,727,0,0,0,41094,-40268
ZCTA5 87514,542,25840,-25298,1816,40.6,1608,0,0,0,93117,-91301
ZCTA5 87515,82,11914,-11832,131,56.8,91,0,0,0,42873,-42742
ZCTA5 87516,28,12344,-12316,59,46.3,9,0,0,0,32176,-32117
ZCTA5 87517,216,14150,-13934,328,48.5,278,0,0,0,39064,-38736
ZCTA5 87518,0,9425,-9425,0,-,0,0,0,#DIV/0!,36935,-36935
ZCTA5 87519,281,16304,-16023,905,31,858,0,0,0,58719,-57814
ZCTA5 87520,568,8941,-8373,1372,59.6,732,0,0,0,18633,-17261
ZCTA5 87521,335,14414,-14079,808,46.8,388,12,0,0,40502,-39694
ZCTA5 87522,1276,0,1276,3301,42.6,1274,0,0,0,183,3118
ZCTA5 87523,161,0,161,185,68.7,31,0,0,0,0,185
ZCTA5 87524,118,12863,-12745,388,35.2,43,0,0,0,38066,-37678
ZCTA5 87525,22,10724,-10702,79,49.6,79,0,0,0,32339,-32260
ZCTA5 87527,250,11549,-11299,631,57.7,337,0,0,0,33836,-33205
ZCTA5 87528,753,408,345,3340,30,114,28,6,0.001796407,1122,2218
ZCTA5 87529,1921,7671,-5750,4938,53.8,4456,0,0,0,24913,-19975
ZCTA5 87530,436,6786,-6350,898,39.6,214,0,0,0,20468,-19570
ZCTA5 87531,91,14866,-14775,175,74.7,169,0,0,0,41610,-41435
ZCTA5 87532,7091,3377,3714,20115,39.1,9702,123,76,0.003778275,8462,11653
ZCTA5 87535,917,4569,-3652,1482,57.2,1340,0,0,0,10939,-9457
ZCTA5 87537,841,10354,-9513,2328,38.9,1571,0,13,0.005584192,25603,-23275
ZCTA5 87538,143,7044,-6901,251,40,226,0,0,0,19903,-19652
ZCTA5 87539,54,9962,-9908,378,36.3,355,0,0,0,28266,-27888
ZCTA5 87540,515,129,386,866,60.7,800,30,0,0,141,725
ZCTA5 87543,45,11109,-11064,45,-,0,0,0,0,21545,-21500
ZCTA5 87544,5993,8373,-2380,13453,41.4,10393,949,163,0.012116257,27127,-13674
ZCTA5 87547,2036,12627,-10591,5716,41.6,5194,94,48,0.008397481,36961,-31245
ZCTA5 87548,233,5107,-4874,376,65.4,162,4,0,0,10891,-10515
ZCTA5 87549,486,10571,-10085,1023,59.9,454,0,0,0,24494,-23471
ZCTA5 87551,109,12584,-12475,137,71.5,119,0,0,0,31737,-31600
ZCTA5 87552,915,4465,-3550,2410,42.9,1701,0,72,0.029875519,13297,-10887
ZCTA5 87553,477,8309,-7832,1527,42.2,747,2,7,0.004584152,23671,-22144
ZCTA5 87554,0,8611,-8611,0,-,0,0,0,#DIV/0!,22533,-22533
ZCTA5 87556,922,4843,-3921,2904,38.9,2653,17,3,0.001033058,13360,-10456
ZCTA5 87557,1965,5732,-3767,5413,41,3128,0,0,0,16241,-10828
ZCTA5 87558,380,13885,-13505,1071,45.9,1061,0,0,0,38362,-37291
ZCTA5 87560,563,12678,-12115,1595,46.6,876,26,45,0.028213166,32474,-30879
ZCTA5 87562,139,3955,-3816,522,34.7,522,0,0,0,10613,-10091
ZCTA5 87564,44,5838,-5794,110,47.7,78,0,0,0,15655,-15545
ZCTA5 87565,190,122,68,324,40.4,277,0,0,0,228,96
ZCTA5 87566,644,10493,-9849,3120,36.6,346,2,55,0.017628205,31479,-28359
ZCTA5 87567,344,9209,-8865,704,53.1,384,0,0,0,25834,-25130
ZCTA5 87569,282,8957,-8675,603,58.6,237,0,0,0,24910,-24307
ZCTA5 87571,4372,8664,-4292,11695,50.1,7640,39,33,0.002821719,26613,-14918
ZCTA5 87573,14,16794,-16780,14,-,14,0,0,0,52907,-52893
ZCTA5 87575,318,14035,-13717,1027,28.4,427,0,0,0,47048,-46021
ZCTA5 87577,136,8402,-8266,161,66.8,141,2,0,0,24983,-24822
ZCTA5 87578,143,13406,-13263,379,46.8,254,1,0,0,37945,-37566
ZCTA5 87579,423,12039,-11616,1059,60.2,432,167,7,0.006610009,26368,-25309
ZCTA5 87580,222,14937,-14715,269,69.7,269,0,0,0,45433,-45164
ZCTA5 87581,15,11029,-11014,25,-,25,0,0,0,35148,-35123
ZCTA5 87582,340,8852,-8512,1032,33.1,895,0,0,0,26742,-25710
ZCTA5 87583,173,11893,-11720,482,42.3,73,0,0,0,33268,-32786
ZCTA5 87701,7799,11996,-4197,18331,42.8,10105,232,260,0.014183623,35691,-17360
ZCTA5 87710,642,13,629,1436,60.8,1347,9,10,0.006963788,1470,-34
ZCTA5 87711,260,21402,-21142,956,35.6,859,0,0,0,96965,-96009
ZCTA5 87712,174,22325,-22151,300,46.8,196,0,0,0,74641,-74341
ZCTA5 87713,176,8453,-8277,250,66.4,80,0,0,0,35207,-34957
ZCTA5 87714,564,23208,-22644,1033,39.3,839,4,13,0.012584705,89001,-87968
ZCTA5 87715,225,16799,-16574,557,52.8,286,0,0,0,60759,-60202
ZCTA5 87718,272,16929,-16657,494,63.2,386,0,2,0.004048583,53014,-52520
ZCTA5 87722,436,5313,-4877,945,43.2,509,0,0,0,18654,-17709
ZCTA5 87723,177,10670,-10493,328,70.2,122,0,0,0,34293,-33965
ZCTA5 87724,22,10094,-10072,22,-,22,0,0,0,31936,-31914
ZCTA5 87728,182,12107,-11925,596,24.2,537,0,0,0,45494,-44898
ZCTA5 87729,45,9247,-9202,80,60.5,65,0,0,0,28392,-28312
ZCTA5 87730,9,12510,-12501,15,67.8,15,0,0,0,33203,-33188
ZCTA5 87731,132,11294,-11162,570,28,248,7,69,0.121052632,29590,-29020
ZCTA5 87732,434,14648,-14214,823,58.5,625,0,0,0,42937,-42114
ZCTA5 87733,31,7890,-7859,94,50.4,65,0,0,0,19731,-19637
ZCTA5 87734,107,13603,-13496,244,53.5,98,0,0,0,35485,-35241
ZCTA5 87735,43,10123,-10080,43,-,43,0,0,0,25947,-25904
ZCTA5 87736,22,16712,-16690,65,78.5,65,0,0,0,40323,-40258
ZCTA5 87740,3258,0,3258,6968,45.7,5440,0,49,0.007032147,0,6968
ZCTA5 87742,145,5233,-5088,262,68.7,185,0,0,0,14423,-14161
ZCTA5 87743,123,6396,-6273,314,44.3,111,0,0,0,19673,-19359
ZCTA5 87745,410,6947,-6537,880,66.8,553,0,0,0,29155,-28275
ZCTA5 87746,26,13176,-13150,61,50.8,44,0,0,0,40375,-40314
ZCTA5 87747,601,6238,-5637,1575,53.4,1055,0,27,0.017142857,20050,-18475
ZCTA5 87749,39,14567,-14528,92,-,92,0,0,0,40085,-39993
ZCTA5 87750,0,18277,-18277,0,-,0,0,0,#DIV/0!,70749,-70749
ZCTA5 87752,295,11253,-10958,587,63.1,355,0,0,0,23377,-22790
ZCTA5 87753,24,16716,-16692,46,-,0,0,0,0,54185,-54139
ZCTA5 87801,2918,17506,-14588,9568,38.8,6678,297,126,0.013168896,53129,-43561
ZCTA5 87820,75,9266,-9191,195,73,128,0,0,0,23708,-23513
ZCTA5 87821,336,14559,-14223,839,64.7,736,0,13,0.015494636,30946,-30107
ZCTA5 87823,94,5632,-5538,335,15.8,328,7,0,0,14508,-14173
ZCTA5 87824,48,7925,-7877,84,80.6,84,0,0,0,20546,-20462
ZCTA5 87825,780,4845,-4065,2528,48,846,0,0,0,11340,-8812
ZCTA5 87827,105,9286,-9181,172,66.1,172,0,0,0,25527,-25355
ZCTA5 87828,139,12711,-12572,789,25.9,421,0,0,0,30563,-29774
ZCTA5 87829,358,7412,-7054,770,61.2,744,0,0,0,18906,-18136
ZCTA5 87830,285,15859,-15574,863,43.6,767,0,0,0,37090,-36227
ZCTA5 87831,81,8902,-8821,219,63.1,219,0,0,0,17115,-16896
ZCTA5 87832,67,13894,-13827,146,49.1,138,0,0,0,28323,-28177
ZCTA5 87901,2708,15264,-12556,6243,43.9,4732,97,39,0.006246997,55313,-49070
ZCTA5 87930,303,15526,-15223,573,58.3,573,0,0,0,46880,-46307
ZCTA5 87931,404,12929,-12525,777,70.9,663,0,0,0,28821,-28044
ZCTA5 87933,55,0,55,201,23.9,201,0,0,0,0,201
ZCTA5 87935,1003,13128,-12125,1747,68.6,1581,0,0,0,40553,-38806
ZCTA5 87936,113,14958,-14845,160,70.8,104,0,0,0,60284,-60124
ZCTA5 87937,1044,17681,-16637,3864,30.7,2595,0,0,0,77028,-73164
ZCTA5 87939,96,442,-346,197,63.5,197,0,0,0,3840,-3643
ZCTA5 87940,133,22733,-22600,448,60.2,98,0,0,0,75211,-74763
ZCTA5 87941,253,22129,-21876,732,24.3,210,0,0,0,80801,-80069
ZCTA5 87942,441,11908,-11467,1260,53.3,1016,0,0,0,35857,-34597
ZCTA5 87943,107,9905,-9798,180,72.5,180,0,0,0,35408,-35228
ZCTA5 88001,14806,6099,8707,38524,28.2,24797,677,1296,0.033641366,18713,19811
ZCTA5 88002,374,7972,-7598,1366,23.1,849,76,302,0.221083455,24935,-23569
ZCTA5 88003,0,22563,-22563,479,19.6,390,9,8,0.016701461,65610,-65131
ZCTA5 88004,0,7969,-7969,1198,36.6,796,0,81,0.067612688,29703,-28505
ZCTA5 88005,10949,14919,-3970,28647,33.6,20919,133,665,0.0232136,61832,-33185
ZCTA5 88007,8690,10088,-1398,24233,41.4,18308,226,228,0.009408658,43902,-19669
ZCTA5 88008,4001,7897,-3896,11003,30.6,6503,117,173,0.015722985,24254,-13251
ZCTA5 88009,0,10791,-10791,46,21.5,46,0,0,0,35770,-35724
ZCTA5 88011,13486,8210,5276,30223,43.2,23716,793,817,0.027032393,26115,4108
ZCTA5 88012,10579,8509,2070,31276,30.3,20607,466,447,0.014292109,25282,5994
ZCTA5 88020,306,18579,-18273,779,50.2,569,0,0,0,83182,-82403
ZCTA5 88021,5141,16343,-11202,15413,32.5,9310,38,84,0.005449945,56370,-40957
ZCTA5 88022,266,6794,-6528,837,51.8,684,0,0,0,31086,-30249
ZCTA5 88023,898,13358,-12460,2197,38.3,1535,0,0,0,46946,-44749
ZCTA5 88024,180,11716,-11536,763,28.4,498,0,0,0,33906,-33143
ZCTA5 88025,40,8406,-8366,100,64.6,100,0,0,0,29664,-29564
ZCTA5 88026,587,10468,-9881,1700,42.2,1112,0,37,0.021764706,33052,-31352
ZCTA5 88027,245,8259,-8014,709,33.3,433,0,0,0,27334,-26625
ZCTA5 88028,110,140,-30,237,66.5,231,0,0,0,274,-37
ZCTA5 88029,385,15715,-15330,1143,31.2,878,0,0,0,59844,-58701
ZCTA5 88030,8662,15425,-6763,24139,36.8,17974,261,457,0.018932019,54406,-30267
ZCTA5 88034,10,9465,-9455,27,-,27,0,0,0,36739,-36712
ZCTA5 88038,107,14478,-14371,404,56.4,338,0,0,0,54397,-53993
ZCTA5 88039,292,14870,-14578,616,36.9,602,0,0,0,47433,-46817
ZCTA5 88040,32,17635,-17603,63,46.5,63,0,0,0,70447,-70384
ZCTA5 88041,463,13695,-13232,1426,57.6,1405,0,1,0.000701262,49808,-48382
ZCTA5 88042,200,8175,-7975,352,65,316,0,0,0,36191,-35839
ZCTA5 88043,642,16433,-15791,1732,38.2,1117,0,0,0,61836,-60104
ZCTA5 88044,912,11583,-10671,2791,37.6,1957,11,0,0,33273,-30482
ZCTA5 88045,1151,8161,-7010,3198,41.6,2463,0,31,0.009693558,24775,-21577
ZCTA5 88046,358,11564,-11206,757,47,757,0,0,0,37716,-36959
ZCTA5 88047,588,11264,-10676,1477,41.3,1015,0,0,0,34877,-33400
ZCTA5 88048,1206,8920,-7714,3116,43.5,1479,0,0,0,26457,-23341
ZCTA5 88049,376,17907,-17531,733,65.1,719,0,0,0,51439,-50706
ZCTA5 88051,52,12397,-12345,97,65,92,0,0,0,42332,-42235
ZCTA5 88052,96,12261,-12165,168,50.8,161,0,0,0,44631,-44463
ZCTA5 88053,85,10054,-9969,168,45.9,106,0,0,0,32226,-32058
ZCTA5 88055,21,8881,-8860,41,63.3,41,0,0,0,31338,-31297
ZCTA5 88056,111,19267,-19156,186,75.2,186,0,0,0,53964,-53778
ZCTA5 88061,7176,9839,-2663,17683,47.1,14438,198,188,0.01063168,29571,-11888
ZCTA5 88063,4074,6161,-2087,11522,32.8,7483,0,9,0.000781114,17034,-5512
ZCTA5 88065,284,6149,-5865,738,29.6,597,0,39,0.052845528,17659,-16921
ZCTA5 88072,619,386,233,2782,20.8,1095,0,0,0,1088,1694
ZCTA5 88081,4139,1261,2878,16310,31.4,9189,46,241,0.014776211,3679,12631
ZCTA5 88101,17171,25416,-8245,46158,31.2,28517,692,2554,0.055331687,73761,-27603
ZCTA5 88103,0,24287,-24287,0,-,0,0,0,#DIV/0!,82708,-82708
ZCTA5 88112,112,11835,-11723,277,58.9,236,0,0,0,40698,-40421
ZCTA5 88113,38,4431,-4393,195,32.9,15,0,0,0,16200,-16005
ZCTA5 88114,25,7149,-7124,48,47.9,48,0,0,0,25172,-25124
ZCTA5 88115,15,561,-546,15,76.1,15,0,0,0,1566,-1551
ZCTA5 88116,149,139,10,420,43.5,386,0,0,0,560,-140
ZCTA5 88118,141,156,-15,309,55.7,270,0,0,0,377,-68
ZCTA5 88119,549,8972,-8423,1792,26.5,835,0,48,0.026785714,25640,-23848
ZCTA5 88120,174,126,48,340,59.4,264,0,0,0,364,-24
ZCTA5 88121,59,2735,-2676,184,48.5,154,0,0,0,8171,-7987
ZCTA5 88124,365,12068,-11703,856,46.9,748,0,0,0,31582,-30726
ZCTA5 88125,21,16480,-16459,77,32.1,30,0,0,0,38719,-38642
ZCTA5 88126,7,8385,-8378,12,69.5,10,0,0,0,25523,-25511
ZCTA5 88130,6395,39,6356,17795,30.1,12421,152,439,0.024669851,57,17738
ZCTA5 88132,102,15855,-15753,295,34.4,236,6,0,0,60283,-59988
ZCTA5 88134,36,529,-493,118,50.1,118,0,0,0,1071,-953
ZCTA5 88135,523,298,225,1256,41,792,0,47,0.037420382,1193,63
ZCTA5 88136,13,18822,-18809,26,58.9,26,0,0,0,60769,-60743
ZCTA5 88201,9968,3067,6901,26634,38.2,20577,661,413,0.015506495,9003,17631
ZCTA5 88203,10641,39,10602,30045,34.1,21554,29,455,0.015143951,258,29787
ZCTA5 88210,6915,1531,5384,18785,34.1,14345,56,243,0.012935853,4000,14785
ZCTA5 88220,14453,1232,13221,39557,36.4,31063,418,649,0.016406704,2637,36920
ZCTA5 88230,1706,4304,-2598,4827,36.1,3751,0,45,0.009322561,11135,-6308
ZCTA5 88231,1226,11312,-10086,3480,33.6,2860,0,0,0,26746,-23266
ZCTA5 88232,638,15310,-14672,2547,37.2,1760,8,69,0.027090695,41210,-38663
ZCTA5 88240,13876,5503,8373,41204,29.4,27254,402,2469,0.059921367,14695,26509
ZCTA5 88242,2606,8892,-6286,7583,38.4,6128,0,25,0.003296848,22416,-14833
ZCTA5 88244,0,5749,-5749,1378,37.4,1043,0,58,0.042089985,13247,-11869
ZCTA5 88250,107,14697,-14590,298,38.7,260,0,0,0,43676,-43378
ZCTA5 88252,840,19203,-18363,2156,41.6,1915,0,48,0.022263451,56807,-54651
ZCTA5 88253,291,21594,-21303,937,36.6,808,0,8,0.008537887,64441,-63504
ZCTA5 88254,44,18655,-18611,52,55.7,52,0,0,0,48725,-48673
ZCTA5 88255,27,14455,-14428,53,-,53,0,0,0,48567,-48514
ZCTA5 88256,676,16953,-16277,2118,33.6,1766,0,0,0,49309,-47191
ZCTA5 88260,4620,16047,-11427,15314,31.2,11697,8,418,0.027295285,55129,-39815
ZCTA5 88262,4,16737,-16733,12,29.5,12,0,0,0,48103,-48091
ZCTA5 88263,62,6816,-6754,172,47.6,148,0,0,0,19823,-19651
ZCTA5 88264,0,1322,-1322,0,-,0,0,0,#DIV/0!,3202,-3202
ZCTA5 88265,70,16560,-16490,143,60.2,81,0,0,0,41746,-41603
ZCTA5 88267,584,14150,-13566,1425,39.2,944,0,20,0.014035088,42232,-40807
ZCTA5 88268,0,14902,-14902,0,-,0,0,0,#DIV/0!,42688,-42688
ZCTA5 88301,630,239,391,1364,51.9,768,0,15,0.010997067,13130,-11766
ZCTA5 88310,15049,18388,-3339,37138,39.6,28100,595,1607,0.043271043,51142,-14004
ZCTA5 88311,434,17486,-17052,1057,58.6,934,12,6,0.005676443,54274,-53217
ZCTA5 88312,1181,13719,-12538,2616,62.3,2072,0,12,0.004587156,45685,-43069
ZCTA5 88314,59,366,-307,222,-,222,0,0,0,1301,-1079
ZCTA5 88316,943,63,880,2260,45.4,2071,0,0,0,162,2098
ZCTA5 88317,778,818,-40,2060,58.4,1971,0,1,0.000485437,2301,-241
ZCTA5 88318,170,15708,-15538,314,61.2,305,0,0,0,48208,-47894
ZCTA5 88321,141,11595,-11454,441,19.8,416,0,0,0,36341,-35900
ZCTA5 88323,0,126,-126,0,-,0,0,0,#DIV/0!,277,-277
ZCTA5 88324,47,2758,-2711,100,67.9,100,0,0,0,7524,-7424
ZCTA5 88325,430,14035,-13605,1563,25.1,1179,0,0,0,45362,-43799
ZCTA5 88330,1179,461,718,4128,22.5,2794,91,460,0.111434109,1244,2884
ZCTA5 88336,171,18499,-18328,328,59.7,255,0,0,0,53841,-53513
ZCTA5 88337,827,5004,-4177,1843,54.7,1400,0,0,0,12104,-10261
ZCTA5 88338,113,16120,-16007,169,53.7,144,0,0,0,43220,-43051
ZCTA5 88339,225,10448,-10223,670,60.2,657,0,0,0,27598,-26928
ZCTA5 88340,1041,6198,-5157,4005,32.4,336,12,2,0.000499376,19302,-15297
ZCTA5 88341,270,10612,-10342,642,52.4,613,0,8,0.012461059,36915,-36273
ZCTA5 88342,0,14958,-14958,0,-,0,0,0,#DIV/0!,47077,-47077
ZCTA5 88343,13,476,-463,13,-,10,0,0,0,1191,-1178
ZCTA5 88344,27,600,-573,41,64,41,0,0,0,1268,-1227
ZCTA5 88345,3669,19186,-15517,8415,49.2,7495,93,81,0.009625668,35373,-26958
ZCTA5 88346,1017,13871,-12854,2841,37.4,1967,0,44,0.015487504,43354,-40513
ZCTA5 88347,17,17230,-17213,33,40.4,27,4,2,0.060606061,30226,-30193
ZCTA5 88348,352,20608,-20256,755,66.9,690,0,0,0,44723,-43968
ZCTA5 88349,0,20202,-20202,0,-,0,0,0,#DIV/0!,67482,-67482
ZCTA5 88350,51,7594,-7543,175,70.7,175,0,0,0,19971,-19796
ZCTA5 88351,107,12743,-12636,201,60,198,0,0,0,26746,-26545
ZCTA5 88352,1401,10105,-8704,4496,31.8,3026,49,0,0,18390,-13894
ZCTA5 88353,124,22134,-22010,383,23.8,174,0,0,0,43857,-43474
ZCTA5 88354,57,10821,-10764,112,-,112,0,0,0,27254,-27142
ZCTA5 88355,53,16201,-16148,117,-,117,0,0,0,46072,-45955
ZCTA5 88401,2563,12186,-9623,6536,41,4818,48,221,0.033812729,55782,-49246
ZCTA5 88410,60,17246,-17186,137,43.5,112,0,0,0,68524,-68387
ZCTA5 88411,37,20336,-20299,134,52.6,105,0,0,0,60054,-59920
ZCTA5 88414,33,16073,-16040,97,46.5,49,1,0,0,31828,-31731
ZCTA5 88415,999,20419,-19420,3225,40.2,2480,0,51,0.015813953,52375,-49150
ZCTA5 88416,109,8413,-8304,149,76.1,149,0,0,0,19771,-19622
ZCTA5 88417,21,9387,-9366,75,65.3,75,0,0,0,23327,-23252
ZCTA5 88418,118,10161,-10043,522,31.2,350,0,0,0,25463,-24941
ZCTA5 88419,20,1582,-1562,83,34.8,83,0,0,0,4580,-4497
ZCTA5 88421,19,19563,-19544,19,-,0,0,0,0,46217,-46198
ZCTA5 88422,38,10165,-10127,95,76.4,77,0,0,0,27437,-27342
ZCTA5 88424,19,11331,-11312,62,61.5,62,0,0,0,31024,-30962
ZCTA5 88426,453,22911,-22458,1261,57,1054,41,0,0,76797,-75536
ZCTA5 88427,42,13140,-13098,104,61.8,85,0,0,0,40237,-40133
ZCTA5 88430,76,19712,-19636,162,51.9,151,0,0,0,48438,-48276
ZCTA5 88431,43,17093,-17050,139,72.4,111,0,0,0,53218,-53079
ZCTA5 88434,107,17281,-17174,250,43.8,178,0,0,0,47599,-47349
ZCTA5 88435,888,11831,-10943,3613,40,2103,8,83,0.022972599,34306,-30693
ZCTA5 88436,34,0,34,61,63.4,61,0,0,0,0,61
ZCTA5 88439,0,0,0,0,-,0,0,0,#DIV/0!,62,-62
ZCTA5 89001,510,0,510,1378,40.6,1203,0,2,0.001451379,1358,20
ZCTA5 89002,12737,10165,2572,37287,37.4,29079,1215,1153,0.030922305,36528,759
ZCTA5 89003,514,0,514,762,59.7,631,0,47,0.06167979,2661,-1899
ZCTA5 89004,110,312,-202,299,52,286,0,0,0,1381,-1082
ZCTA5 89005,6163,0,6163,14875,51.8,13229,209,160,0.010756303,459,14416
ZCTA5 89007,235,20133,-19898,949,35.1,899,0,0,0,81952,-81003
ZCTA5 89008,479,0,479,890,49.4,770,0,29,0.03258427,839,51
ZCTA5 89010,171,7384,-7213,448,53.5,413,0,0,0,28723,-28275
ZCTA5 89011,11975,18346,-6371,31071,41.5,19286,2310,2449,0.078819478,63009,-31938
ZCTA5 89012,15372,8879,6493,38356,43.8,27143,3658,2823,0.073599958,24850,13506
ZCTA5 89013,125,2576,-2451,233,65.5,223,0,0,0,4861,-4628
ZCTA5 89014,16801,12390,4411,41429,39,25167,3814,5240,0.12648145,24477,16952
ZCTA5 89015,14698,13011,1687,39872,41.9,29340,1281,2362,0.059239567,31860,8012
ZCTA5 89017,22,0,22,35,79.4,35,0,0,0,0,35
ZCTA5 89018,255,14485,-14230,794,40.5,627,0,0,0,42408,-41614
ZCTA5 89019,1122,6298,-5176,2117,57.5,1750,155,100,0.047236656,24292,-22175
ZCTA5 89020,644,7878,-7234,1696,38.1,1058,13,0,0,26310,-24614
ZCTA5 89021,946,664,282,3214,30.8,2836,21,0,0,2121,1093
ZCTA5 89022,0,9598,-9598,0,-,0,0,0,#DIV/0!,38700,-38700
ZCTA5 89025,359,1781,-1422,867,47.1,424,0,70,0.080738178,10520,-9653
ZCTA5 89026,0,16953,-16953,0,-,0,0,0,#DIV/0!,51507,-51507
ZCTA5 89027,7172,9077,-1905,17588,54.2,13590,395,185,0.010518535,40881,-23293
ZCTA5 89029,4286,74,4212,8482,61,6977,111,366,0.0431502,345,8137
ZCTA5 89030,15547,11219,4328,53763,29.8,21364,767,9084,0.168963786,33178,20585
ZCTA5 89031,22927,4275,18652,72377,35.3,33657,5045,14758,0.203904555,9823,62554
ZCTA5 89032,15383,729,14654,47881,34.5,20004,3320,13098,0.273553184,1329,46552
ZCTA5 89034,1350,14350,-13000,2431,70.3,2282,53,44,0.018099548,47762,-45331
ZCTA5 89039,138,1777,-1639,231,71.4,231,0,0,0,7277,-7046
ZCTA5 89040,1555,2670,-1115,4382,39.1,4022,43,50,0.011410315,8692,-4310
ZCTA5 89042,328,5154,-4826,1078,31.6,1004,0,0,0,21416,-20338
ZCTA5 89043,389,4208,-3819,1219,46.6,895,0,196,0.160787531,9680,-8461
ZCTA5 89044,10165,14529,-4364,25614,46.8,15833,4838,994,0.038806902,37101,-11487
ZCTA5 89045,993,2604,-1611,2345,42.1,2272,0,12,0.005117271,11181,-8836
ZCTA5 89046,237,1737,-1500,363,66.7,330,0,0,0,3736,-3373
ZCTA5 89047,59,829,-770,195,54.2,195,0,0,0,2044,-1849
ZCTA5 89048,9938,224,9714,24277,51.4,18927,697,595,0.024508794,529,23748
ZCTA5 89049,1286,179,1107,2496,53.7,2185,0,147,0.058894231,334,2162
ZCTA5 89052,23531,15720,7811,57966,44.6,38493,8281,2742,0.047303592,31365,26601
ZCTA5 89054,94,12288,-12194,338,11,320,0,0,0,25302,-24964
ZCTA5 89060,4883,10861,-5978,11556,53.8,8460,137,41,0.00354794,20397,-8841
ZCTA5 89061,3087,73,3014,6771,60,5506,76,184,0.027174716,73,6698
ZCTA5 89070,0,11,-11,5525,35.9,1787,75,1967,0.3560181,35,5490
ZCTA5 89074,20496,249,20247,51609,40.7,37103,4336,2242,0.043442035,511,51098
ZCTA5 89081,12436,8524,3912,39820,31.7,15357,3107,10873,0.273053742,17215,22605
ZCTA5 89084,10271,458,9813,32143,34.5,15089,3738,5504,0.171234795,1430,30713
ZCTA5 89085,1375,4737,-3362,3869,36.6,2391,337,584,0.150943396,18405,-14536
ZCTA5 89086,2437,464,1973,6499,30.4,1994,406,2552,0.392675796,1239,5260
ZCTA5 89101,15669,2775,12894,43572,35,15125,1666,6370,0.146194804,7541,36031
ZCTA5 89102,15234,8907,6327,37633,36.6,14746,3818,4861,0.129168549,23642,13991
ZCTA5 89103,22333,127,22206,51966,38.5,21322,7150,7869,0.151425932,4567,47399
ZCTA5 89104,14867,0,14867,39781,36.9,18666,1733,3846,0.096679319,0,39781
ZCTA5 89106,9353,618,8735,25477,33.1,6448,1243,8491,0.333280999,1779,23698
ZCTA5 89107,13016,277,12739,37342,36.4,16974,2397,3831,0.102592255,735,36607
ZCTA5 89108,26508,937,25571,73315,36.1,36070,2767,10319,0.140748824,2807,70508
ZCTA5 89109,3259,9766,-6507,6355,47.2,2927,659,1482,0.233202203,24685,-18330
ZCTA5 89110,21368,1247,20121,67361,32.8,33195,3594,5634,0.083638901,2441,64920
ZCTA5 89113,13607,7418,6189,34227,37.5,16521,8928,3441,0.100534666,31907,2320
ZCTA5 89115,18947,15,18932,65713,27.7,23396,1822,14877,0.22639356,47,65666
ZCTA5 89117,22820,103,22717,54663,42.3,33175,6794,5640,0.103177652,312,54351
ZCTA5 89118,8737,12209,-3472,22701,40.8,10517,3929,4154,0.182987534,36891,-14190
ZCTA5 89119,22229,13550,8679,50847,35.4,18472,6027,7086,0.139359254,40217,10630
ZCTA5 89120,9254,195,9059,24418,37.5,12441,1519,1479,0.060570071,730,23688
ZCTA5 89121,24244,2244,22000,66455,39,31421,3503,7846,0.118064856,9581,56874
ZCTA5 89122,18997,11108,7889,51772,36.9,23137,6093,5524,0.106698602,32859,18913
ZCTA5 89123,23534,4461,19073,60823,40.6,33134,11547,4348,0.071486115,12140,48683
ZCTA5 89124,282,3816,-3534,616,57.2,482,45,4,0.006493506,9785,-9169
ZCTA5 89128,15000,2370,12630,37124,39.7,21106,2854,4264,0.114858313,5150,31974
ZCTA5 89129,20417,6878,13539,54770,39,36655,4189,5386,0.098338506,31768,23002
ZCTA5 89130,12473,3197,9276,34439,41.7,20175,1811,4701,0.136502221,7818,26621
ZCTA5 89131,16970,467,16503,51053,39.2,34642,2538,5016,0.098250837,1004,50049
ZCTA5 89134,11252,221,11031,23152,64,17686,2208,880,0.038009675,598,22554
ZCTA5 89135,12782,15985,-3203,29706,46.3,21141,3700,1032,0.034740456,56471,-26765
ZCTA5 89138,7082,3249,3833,19971,38.3,13937,3109,564,0.028240949,8174,11797
ZCTA5 89139,13350,366,12984,42898,34.9,16388,11513,6966,0.162385193,1253,41645
ZCTA5 89141,12596,207,12389,37596,37.7,19717,8279,2892,0.076923077,263,37333
ZCTA5 89142,10548,6,10542,34008,32.3,13506,3477,2850,0.083803811,6,34002
ZCTA5 89143,4115,319,3796,13602,31.2,9601,664,1056,0.077635642,644,12958
ZCTA5 89144,7962,22533,-14571,19796,45.9,13547,2469,1011,0.051070923,98228,-78432
ZCTA5 89145,9638,21723,-12085,24737,43.9,14522,1966,1450,0.058616647,89922,-65185
ZCTA5 89146,7635,8722,-1087,19756,39.1,9812,2706,1847,0.093490585,36609,-16853
ZCTA5 89147,21163,0,21163,56463,38.7,26278,10143,8419,0.149106495,0,56463
ZCTA5 89148,21838,388,21450,61289,35.7,29843,13423,7268,0.118585717,1046,60243
ZCTA5 89149,15731,154,15577,41668,37.5,27561,2620,4514,0.108332533,263,41405
ZCTA5 89156,9750,2141,7609,30740,33.7,14880,1378,3522,0.114573845,5946,24794
ZCTA5 89158,288,5366,-5078,406,56,284,74,0,0,19986,-19580
ZCTA5 89161,213,23139,-22926,534,54.7,503,0,0,0,79070,-78536
ZCTA5 89166,9077,16850,-7773,27060,31.4,16081,2331,2907,0.107427938,57365,-30305
ZCTA5 89169,9957,568,9389,20864,37,9712,1527,4501,0.215730445,1791,19073
ZCTA5 89178,13921,2399,11522,38928,35.4,21800,7678,3634,0.093351829,6294,32634
ZCTA5 89179,3736,7471,-3735,11880,34,6228,2663,678,0.057070707,21475,-9595
ZCTA5 89183,14375,2126,12249,41126,32.1,19243,7017,4703,0.114355882,6155,34971
ZCTA5 89191,0,344,-344,537,21.4,324,55,88,0.163873371,1068,-531
ZCTA5 89301,2652,2716,-64,7320,40.1,5826,62,660,0.090163934,7397,-77
ZCTA5 89310,107,2181,-2074,149,59.8,111,0,0,0,5156,-5007
ZCTA5 89311,78,20,58,204,58.4,204,0,0,0,53,151
ZCTA5 89314,89,973,-884,219,33.7,23,7,0,0,2552,-2333
ZCTA5 89315,14,340,-326,71,12.9,71,0,0,0,1030,-959
ZCTA5 89316,278,5017,-4739,1060,26.9,1020,18,1,0.000943396,14727,-13667
ZCTA5 89317,138,1936,-1798,453,37.1,439,0,10,0.022075055,4859,-4406
ZCTA5 89318,445,13634,-13189,876,42.8,770,0,0,0,33279,-32403
ZCTA5 89319,137,12750,-12613,211,54,211,0,0,0,40494,-40283
ZCTA5 89402,82,20378,-20296,162,72.2,162,0,0,0,83613,-83451
ZCTA5 89403,6219,4935,1284,16550,45.4,12894,249,12,0.000725076,19698,-3148
ZCTA5 89404,17,69,-52,17,-,17,0,0,0,139,-122
ZCTA5 89405,53,2095,-2042,156,19.9,156,0,0,0,5519,-5363
ZCTA5 89406,9753,32,9721,24973,40.8,19887,641,598,0.023945862,59,24914
ZCTA5 89408,8050,78,7972,22971,36.3,18648,372,549,0.0238997,181,22790
ZCTA5 89409,86,829,-743,111,55.6,111,0,0,0,1858,-1747
ZCTA5 89410,4814,53,4761,11009,53.7,9332,131,205,0.018621128,82,10927
ZCTA5 89411,413,781,-368,948,59.3,825,37,0,0,2335,-1387
ZCTA5 89412,48,14871,-14823,98,43.6,60,0,13,0.132653061,52312,-52214
ZCTA5 89413,359,7740,-7381,710,64.5,542,87,0,0,34350,-33640
ZCTA5 89414,50,13423,-13373,143,48.6,143,0,0,0,43378,-43235
ZCTA5 89415,1267,1992,-725,3165,46.9,2705,61,84,0.026540284,4833,-1668
ZCTA5 89418,92,376,-284,228,34.5,199,0,10,0.043859649,1068,-840
ZCTA5 89419,1364,17892,-16528,5407,40.1,3858,86,206,0.038098761,53219,-47812
ZCTA5 89420,6,678,-672,80,18.9,0,0,0,0,1952,-1872
ZCTA5 89421,228,17496,-17268,421,55.7,142,3,0,0,60222,-59801
ZCTA5 89422,95,8599,-8504,158,62.7,147,0,0,0,31075,-30917
ZCTA5 89423,4501,15868,-11367,10783,57.7,9879,171,10,0.000927386,55780,-44997
ZCTA5 89424,164,3863,-3699,333,38.3,30,0,18,0.054054054,14077,-13744
ZCTA5 89425,215,12429,-12214,799,39.4,781,0,0,0,48069,-47270
ZCTA5 89426,64,6462,-6398,151,63.4,149,0,2,0.013245033,25443,-25292
ZCTA5 89427,362,6460,-6098,1142,32.2,127,0,59,0.051663748,21887,-20745
ZCTA5 89428,39,23688,-23649,96,58,96,0,0,0,89783,-89687
ZCTA5 89429,3288,16200,-12912,7462,53,6703,36,79,0.010586974,53194,-45732
ZCTA5 89430,58,13632,-13574,82,60.8,82,0,0,0,48803,-48721
ZCTA5 89431,15340,15526,-186,40711,36.1,22041,1892,782,0.019208568,44129,-3418
ZCTA5 89433,7257,16430,-9173,23596,33.4,14626,121,286,0.012120698,53791,-30195
ZCTA5 89434,10698,9924,774,27478,40.6,19419,1706,660,0.024019215,35278,-7800
ZCTA5 89436,16844,19541,-2697,46321,39.6,35975,2828,649,0.014010924,78700,-32379
ZCTA5 89437,0,505,-505,0,-,0,0,0,#DIV/0!,968,-968
ZCTA5 89438,13,13928,-13915,32,-,32,0,0,0,48687,-48655
ZCTA5 89439,775,5248,-4473,1462,59.4,1349,35,0,0,19713,-18251
ZCTA5 89440,259,1299,-1040,784,55.2,761,0,1,0.00127551,3613,-2829
ZCTA5 89441,4692,1548,3144,12721,47.1,9978,144,337,0.026491628,4284,8437
ZCTA5 89442,320,13036,-12716,920,41.4,376,7,10,0.010869565,34054,-33134
ZCTA5 89444,1498,15047,-13549,3029,61.3,2672,8,48,0.015846814,45080,-42051
ZCTA5 89445,6614,14836,-8222,16522,35.9,13089,198,97,0.00587096,38642,-22120
ZCTA5 89446,0,2173,-2173,133,40.6,66,0,51,0.383458647,6849,-6716
ZCTA5 89447,3576,934,2642,8398,50,6361,27,42,0.005001191,1993,6405
ZCTA5 89448,895,7055,-6160,1875,56.7,1397,111,21,0.0112,29230,-27355
ZCTA5 89449,1415,18863,-17448,2897,49.2,2194,46,61,0.021056265,75136,-72239
ZCTA5 89450,0,10309,-10309,0,-,0,0,0,#DIV/0!,38751,-38751
ZCTA5 89451,4041,14280,-10239,9493,49.3,7776,228,80,0.008427262,51001,-41508
ZCTA5 89460,5533,659,4874,14133,47.3,11893,219,0,0,1332,12801
ZCTA5 89496,0,19492,-19492,104,23.2,68,6,6,0.057692308,61376,-61272
ZCTA5 89501,2647,15809,-13162,4097,51.4,2991,239,370,0.090309983,53655,-49558
ZCTA5 89502,18903,2316,16587,45840,34.9,26766,2333,1528,0.033333333,8634,37206
ZCTA5 89503,12692,13541,-849,30350,33.8,22857,2073,991,0.032652389,53722,-23372
ZCTA5 89506,15252,11840,3412,44476,34.7,29832,2016,1737,0.039054771,51614,-7138
ZCTA5 89508,4942,4220,722,14687,37.2,11639,283,102,0.006944917,16166,-1479
ZCTA5 89509,16834,9317,7517,36063,41.7,28225,1932,563,0.015611569,29431,6632
ZCTA5 89510,522,12786,-12264,1224,58.4,805,0,5,0.004084967,43203,-41979
ZCTA5 89511,11854,5411,6443,28807,45.2,23779,2017,363,0.012601104,18071,10736
ZCTA5 89512,11246,9297,1949,27999,31.2,15158,1913,2005,0.0716097,19556,8443
ZCTA5 89519,3793,5390,-1597,8904,51.7,7703,309,30,0.003369272,16169,-7265
ZCTA5 89521,14060,1478,12582,36301,40,28110,2994,423,0.011652572,3676,32625
ZCTA5 89523,15139,12155,2984,35738,40.6,27552,2955,847,0.023700263,38723,-2985
ZCTA5 89557,0,21551,-21551,163,18.7,108,31,24,0.147239264,70726,-70563
ZCTA5 89701,10605,9262,1343,28957,39.8,20246,978,965,0.033325275,30209,-1252
ZCTA5 89703,4777,6626,-1849,10241,53.3,9076,205,14,0.001367054,23815,-13574
ZCTA5 89704,1815,7982,-6167,4397,58.2,3975,15,8,0.001819422,22051,-17654
ZCTA5 89705,2243,7084,-4841,5203,50.2,4201,163,21,0.004036133,19215,-14012
ZCTA5 89706,8474,9859,-1385,20489,42,16413,375,153,0.007467422,27453,-6964
ZCTA5 89801,9444,7692,1752,25938,33.8,18876,526,327,0.012606986,21252,4686
ZCTA5 89815,5012,3838,1174,15918,34.3,14010,120,31,0.001947481,11555,4363
ZCTA5 89820,2207,11029,-8822,5621,37.8,5094,4,137,0.024372887,26386,-20765
ZCTA5 89821,260,9426,-9166,508,57.9,412,0,0,0,24538,-24030
ZCTA5 89822,778,3909,-3131,2177,39.3,1561,12,0,0,16855,-14678
ZCTA5 89823,156,7346,-7190,392,53.1,302,0,0,0,16614,-16222
ZCTA5 89825,329,13805,-13476,1130,28.1,468,0,0,0,39927,-38797
ZCTA5 89826,0,2727,-2727,0,-,0,0,0,#DIV/0!,7237,-7237
ZCTA5 89828,134,6081,-5947,312,19,312,0,0,0,12442,-12130
ZCTA5 89830,15,18667,-18652,34,-,34,0,0,0,50759,-50725
ZCTA5 89831,26,22120,-22094,26,-,26,0,0,0,60167,-60141
ZCTA5 89832,384,11371,-10987,1125,39.4,23,0,1,0.000888889,26182,-25057
ZCTA5 89833,51,20777,-20726,148,43.5,126,0,2,0.013513514,59083,-58935
ZCTA5 89834,23,11499,-11476,89,21.3,66,0,19,0.213483146,16325,-16236
ZCTA5 89835,476,20824,-20348,1477,45.5,1071,0,151,0.102234259,55367,-53890
ZCTA5 89883,1884,19832,-17948,4635,36.8,3414,0,0,0,57117,-52482
ZCTA5 90001,13421,19083,-5662,58245,30.7,20030,293,4799,0.082393338,45360,12885
ZCTA5 90002,13011,13871,-860,54384,28.9,17275,627,9256,0.170197117,32694,21690
ZCTA5 90003,17759,11573,6186,75190,29,16669,384,12865,0.17109988,23636,51554
ZCTA5 90004,22231,9884,12347,59621,35.5,17681,15224,2448,0.041059358,29473,30148
ZCTA5 90005,15993,2556,13437,36910,35.6,7616,12212,2180,0.059062585,8544,28366
ZCTA5 90006,18850,18804,46,57136,34.6,16801,10531,1897,0.033201484,49067,8069
ZCTA5 90007,12211,3973,8238,41270,25.2,14367,7734,4310,0.104434214,10136,31134
ZCTA5 90008,14425,14525,-100,31046,42.4,3221,1298,20459,0.658989886,33671,-2625
ZCTA5 90010,2247,1731,516,4313,34,1046,2672,239,0.055413865,3931,382
ZCTA5 90011,24603,1455,23148,109511,30.1,34228,705,6681,0.06100757,2931,106580
ZCTA5 90012,14361,10564,3797,39709,34.9,10063,13596,5465,0.137626231,22163,17546
ZCTA5 90013,7724,14385,-6661,13413,42.8,4641,1923,3799,0.283232685,34445,-21032
ZCTA5 90014,5803,9703,-3900,8547,40.7,3154,1866,1762,0.206154206,28819,-20272
ZCTA5 90015,11746,11663,83,24228,32,8189,4614,1966,0.081145782,34829,-10601
ZCTA5 90016,17387,836,16551,45884,35,16100,2070,12997,0.28325778,2254,43630
ZCTA5 90017,12996,24227,-11231,28433,32.6,9814,4396,3221,0.11328386,63446,-35013
ZCTA5 90018,16394,173,16221,51388,35.2,14335,2765,14408,0.280376742,514,50874
ZCTA5 90019,23584,10483,13101,61061,38.6,19471,10762,10822,0.177232603,33034,28027
ZCTA5 90020,16881,26930,-10049,38124,36.8,7633,16918,2624,0.068828035,90074,-51950
ZCTA5 90021,1454,15536,-14082,2724,39.6,814,173,481,0.176578561,44302,-41578
ZCTA5 90022,17266,15992,1274,65110,32.7,26918,726,376,0.005774843,47295,17815
ZCTA5 90023,11832,17679,-5847,45732,31.3,15723,435,474,0.010364734,47672,-1940
ZCTA5 90024,16359,6643,9716,50611,22.7,29098,13106,2050,0.040505029,21448,29163
ZCTA5 90025,21470,12263,9207,44608,33.9,27694,10466,1523,0.034141858,53979,-9371
ZCTA5 90026,25968,12901,13067,65921,35.6,26122,9800,2279,0.034571684,68926,-3005
ZCTA5 90027,21133,19420,1713,44678,38.2,29049,5515,1223,0.027373651,86136,-41458
ZCTA5 90028,16833,14372,2461,29887,36.1,15755,3482,2733,0.091444441,44945,-15058
ZCTA5 90029,13218,9256,3962,35037,36.4,11945,5524,1372,0.039158604,36660,-1623
ZCTA5 90031,11868,12739,-871,38533,37.2,8877,10885,743,0.019282174,60495,-21962
ZCTA5 90032,13314,18647,-5333,45298,36.5,13257,5449,971,0.021435825,55914,-10616
ZCTA5 90033,13240,18452,-5212,47495,32.3,14519,2185,840,0.017686072,58181,-10686
ZCTA5 90034,24938,8106,16832,53321,35,25577,10840,5050,0.094709402,22588,30733
ZCTA5 90035,11310,17906,-6596,26411,37.6,19345,1825,1788,0.067699065,61627,-35216
ZCTA5 90036,18990,11728,7262,37596,35.2,23600,7529,1934,0.051441643,42032,-4436
ZCTA5 90037,17772,24680,-6908,68885,32,22419,747,11413,0.165681934,85174,-16289
ZCTA5 90038,12595,17467,-4872,27995,34.6,11827,1873,1896,0.06772638,72033,-44038
ZCTA5 90039,11992,11737,255,28839,40.5,15257,5350,403,0.013974132,38300,-9461
ZCTA5 90040,3424,12239,-8815,11844,39.3,5183,177,79,0.006670044,35738,-23894
ZCTA5 90041,10001,7297,2704,28956,40,12665,7709,616,0.021273657,20384,8572
ZCTA5 90042,20844,12948,7896,59658,37.3,23500,8264,1270,0.021288008,36275,23383
ZCTA5 90043,17052,1005,16047,44272,40.4,6849,1005,25973,0.586668775,3048,41224
ZCTA5 90044,28202,11830,16372,100225,31.2,22203,649,30662,0.305931654,34693,65532
ZCTA5 90045,15666,8197,7469,41411,35.5,24341,5962,4192,0.101229142,24694,16717
ZCTA5 90046,28249,15964,12285,48749,38.4,35153,3224,2825,0.057949907,52609,-3860
ZCTA5 90047,16853,8384,8469,51494,37.1,8020,464,28625,0.555890007,23055,28439
ZCTA5 90048,11474,14743,-3269,20504,39.7,16274,1465,781,0.038090129,53943,-33439
ZCTA5 90049,16116,8774,7342,35853,39.3,29244,2546,480,0.013388001,31890,3963
ZCTA5 90052,0,11038,-11038,0,-,0,0,0,#DIV/0!,45341,-45341
ZCTA5 90056,3556,6461,-2905,7956,45.3,1233,435,5320,0.668677728,24523,-16567
ZCTA5 90057,17179,5571,11608,47604,33.9,13500,8813,2773,0.058251407,16774,30830
ZCTA5 90058,979,7105,-6126,3659,25.6,2256,3,256,0.069964471,27235,-23576
ZCTA5 90059,10162,1900,8262,41315,29.2,10681,96,9890,0.23938037,5809,35506
ZCTA5 90061,7844,6088,1756,29992,31.4,9325,194,8385,0.279574553,19358,10634
ZCTA5 90062,9796,5704,4092,34277,36.8,8467,641,9967,0.290778073,15017,19260
ZCTA5 90063,13616,13161,455,52954,33.1,14586,859,274,0.005174302,43557,9397
ZCTA5 90064,11144,7529,3615,25161,39.6,15722,5149,605,0.024045149,26279,-1118
ZCTA5 90065,16180,12001,4179,46432,37.7,18605,6628,889,0.019146278,39167,7265
ZCTA5 90066,24647,16453,8194,54913,39.3,33260,7985,2742,0.049933531,52510,2403
ZCTA5 90067,1531,13312,-11781,2483,62.5,1774,465,56,0.022553363,46912,-44429
ZCTA5 90068,11528,15540,-4012,21127,43.1,16345,1479,1219,0.057698679,65093,-43966
ZCTA5 90069,12844,8705,4139,20185,43.6,16332,1455,557,0.027594749,30846,-10661
ZCTA5 90071,10,19299,-19289,28,58.3,28,0,0,0,68715,-68687
ZCTA5 90073,0,9179,-9179,881,59.1,439,71,200,0.227014756,29549,-28668
ZCTA5 90077,2899,15776,-12877,7729,47.5,6079,581,133,0.017207918,46907,-39178
ZCTA5 90079,0,6663,-6663,0,-,0,0,0,#DIV/0!,19654,-19654
ZCTA5 90089,5,12967,-12962,3498,19.3,1818,1009,225,0.06432247,32464,-28966
ZCTA5 90094,5560,18991,-13431,11426,37,7229,1980,754,0.065989848,50113,-38687
ZCTA5 90095,0,10368,-10368,0,-,0,0,0,#DIV/0!,29698,-29698
ZCTA5 90201,23847,15215,8632,96605,30.7,56350,521,1450,0.015009575,43358,53247
ZCTA5 90210,7947,12382,-4435,19627,49.1,16406,996,374,0.019055383,34339,-14712
ZCTA5 90211,3801,6110,-2309,9202,40.7,6246,1830,186,0.020212997,15867,-6665
ZCTA5 90212,5503,5000,503,10999,46.3,8444,1280,219,0.019910901,17484,-6485
ZCTA5 90220,13704,10708,2996,51480,33,10517,550,15031,0.291977467,35720,15760
ZCTA5 90221,12531,2389,10142,50660,33,12146,600,10352,0.204342677,6698,43962
ZCTA5 90222,8511,8230,281,33729,30.5,9491,279,8519,0.252571971,20601,13128
ZCTA5 90230,13792,15339,-1547,33620,40.5,17491,5354,3183,0.094675788,59298,-25678
ZCTA5 90232,7101,17623,-10522,15342,37.6,9224,3146,769,0.050123843,80492,-65150
ZCTA5 90240,7670,9768,-2098,26590,37.7,12942,2175,861,0.032380594,27767,-1177
ZCTA5 90241,14098,11828,2270,44701,35.7,21722,3102,1074,0.024026308,42133,2568
ZCTA5 90242,12729,412,12317,43002,35.1,16686,2399,2136,0.049672108,1699,41303
ZCTA5 90245,7070,7804,-734,17243,36.8,11823,1857,805,0.046685612,24075,-6832
ZCTA5 90247,16082,0,16082,48646,37.6,9678,12333,7604,0.156312955,47,48599
ZCTA5 90248,3857,0,3857,11472,45.1,2055,3906,1951,0.170066248,0,11472
ZCTA5 90249,8869,9210,-341,25929,41.2,6922,3771,6663,0.256970959,33380,-7451
ZCTA5 90250,31962,18865,13097,96730,33.3,32802,7455,23711,0.245125607,55662,41068
ZCTA5 90254,8926,0,8926,19787,40.5,15443,1478,108,0.005458129,0,19787
ZCTA5 90255,18168,23421,-5253,72488,33,33490,364,728,0.010043042,71505,983
ZCTA5 90260,10281,990,9291,33794,35.8,13480,4107,2507,0.074184767,3048,30746
ZCTA5 90262,15026,390,14636,67210,31.3,27876,635,5208,0.077488469,622,66588
ZCTA5 90263,0,12248,-12248,1913,19.8,1063,397,210,0.109775222,32327,-30414
ZCTA5 90265,6463,7001,-538,16868,49.4,13208,872,168,0.009959687,20931,-4063
ZCTA5 90266,13422,11056,2366,35585,42.8,26601,5224,193,0.005423634,24719,10866
ZCTA5 90270,6320,4212,2108,25415,31.3,12368,195,259,0.010190832,11201,14214
ZCTA5 90272,8074,4280,3794,21282,46.6,18150,1546,95,0.004463866,9838,11444
ZCTA5 90274,8962,6196,2766,24890,51,16547,5788,744,0.029891523,17020,7870
ZCTA5 90275,15397,6183,9214,42417,49.7,22592,13151,723,0.017045053,16901,25516
ZCTA5 90277,16590,15665,925,36409,44.6,25199,4628,1072,0.02944327,54182,-17773
ZCTA5 90278,15889,284,15605,42841,38.1,27219,7691,1174,0.027403655,1014,41827
ZCTA5 90280,23824,974,22850,93207,33.3,42396,772,623,0.006684047,3623,89584
ZCTA5 90290,2003,4803,-2800,5114,45.7,4386,233,87,0.017012124,20774,-15660
ZCTA5 90291,13535,3032,10503,25685,39.4,19063,1080,1635,0.06365583,15341,10344
ZCTA5 90292,13048,1064,11984,23951,39,17222,2351,1830,0.076405996,1900,22051
ZCTA5 90293,6625,547,6078,12812,41,9385,1315,559,0.043630971,2053,10759
ZCTA5 90301,12110,137,11973,38500,37,9313,1058,11735,0.304805195,281,38219
ZCTA5 90302,10456,76,10380,29278,35.9,6260,837,12253,0.418505362,139,29139
ZCTA5 90303,6844,4742,2102,23415,34.7,5999,491,8533,0.364424514,21293,2122
ZCTA5 90304,7067,3714,3353,26103,32.8,9181,1045,1015,0.038884419,25588,515
ZCTA5 90305,5880,10950,-5070,15254,45.4,1301,213,11763,0.771141996,55355,-40101
ZCTA5 90401,4678,235,4443,7482,36.7,5603,477,526,0.070302058,890,6592
ZCTA5 90402,4906,2323,2583,12046,47.3,9754,942,102,0.008467541,9097,2949
ZCTA5 90403,13164,8,13156,24525,43.9,18288,2356,715,0.029153925,59,24466
ZCTA5 90404,10562,4920,5642,23460,38.1,13759,3236,1971,0.084015345,14691,8769
ZCTA5 90405,14247,736,13511,27367,41.7,20041,2064,894,0.032667081,1535,25832
ZCTA5 90501,14423,2619,11804,43450,37.4,12810,11709,2295,0.052819333,10632,32818
ZCTA5 90502,6342,184,6158,18110,42.7,4618,6506,1171,0.064660409,486,17624
ZCTA5 90503,17173,1833,15340,44744,41.2,17903,18280,1373,0.030685679,4665,40079
ZCTA5 90504,11662,175,11487,33022,42.5,11834,12664,1467,0.044424929,383,32639
ZCTA5 90505,14177,20805,-6628,37533,42.4,16944,14156,1040,0.027708949,66186,-28653
ZCTA5 90506,0,1573,-1573,0,-,0,0,0,#DIV/0!,6952,-6952
ZCTA5 90601,10782,1327,9455,30955,39.6,13083,2142,260,0.008399289,4864,26091
ZCTA5 90602,8032,731,7301,25907,34.3,9492,724,523,0.020187594,1496,24411
ZCTA5 90603,6490,373,6117,21236,40.5,11754,1171,124,0.005839141,1604,19632
ZCTA5 90604,11781,2507,9274,39926,35.2,17376,2798,257,0.006436908,5308,34618
ZCTA5 90605,11107,4001,7106,42600,35.2,15595,2392,475,0.011150235,18542,24058
ZCTA5 90606,8692,1035,7657,32583,36.3,10164,889,366,0.011232851,3326,29257
ZCTA5 90620,13124,579,12545,47104,37.2,21260,14032,743,0.015773607,1925,45179
ZCTA5 90621,10744,133,10611,36385,35.9,12955,13111,1471,0.040428748,282,36103
ZCTA5 90623,4944,10949,-6005,15703,44.2,5209,7520,722,0.045978475,36544,-20841
ZCTA5 90630,16118,4717,11401,50543,41.2,22410,19270,1358,0.026868211,18092,32451
ZCTA5 90631,21886,524,21362,69601,37.7,34538,8853,1600,0.022988175,2564,67037
ZCTA5 90638,14803,2888,11915,46335,43.2,21324,9974,633,0.013661379,13599,32736
ZCTA5 90639,0,75,-75,2103,19.9,1156,473,99,0.047075606,261,1842
ZCTA5 90640,19191,573,18618,62941,37.4,25535,8087,615,0.009771055,3752,59189
ZCTA5 90650,26353,228,26125,103427,35.5,32806,13934,4922,0.047589121,626,102801
ZCTA5 90660,16996,225,16771,62383,39,23124,2458,685,0.010980556,495,61888
ZCTA5 90670,5212,1326,3886,17446,38.1,5856,1439,504,0.028889144,5401,12045
ZCTA5 90680,9667,21914,-12247,30500,36.6,11845,8404,556,0.018229508,76627,-46127
ZCTA5 90701,4417,374,4043,16390,38.4,4019,6409,1143,0.069737645,1650,14740
ZCTA5 90703,15687,79,15608,49989,45.7,8623,29363,4218,0.084378563,149,49840
ZCTA5 90704,1543,660,883,3940,45.2,3294,27,6,0.001522843,3263,677
ZCTA5 90706,24018,0,24018,79070,34.7,22045,9056,10119,0.127975212,32,79038
ZCTA5 90710,9150,5142,4008,27998,39.2,10639,6283,3357,0.119901422,19384,8614
ZCTA5 90712,10247,1401,8846,31701,37.6,15101,5717,3325,0.104886281,3273,28428
ZCTA5 90713,9583,404,9179,29113,39.9,16378,4040,1505,0.051695119,1450,27663
ZCTA5 90715,6573,1612,4961,21174,37.2,6716,5274,2199,0.103853783,6739,14435
ZCTA5 90716,3659,5381,-1722,14050,32.2,3052,1507,351,0.024982206,16776,-2726
ZCTA5 90717,8255,1577,6678,21727,39.5,11223,3980,1295,0.059603259,5424,16303
ZCTA5 90720,8247,1079,7168,23660,44,16277,2674,817,0.034530854,2285,21375
ZCTA5 90723,14360,795,13565,53938,31.6,15087,1811,4165,0.077218288,3114,50824
ZCTA5 90731,23155,20850,2305,62647,37.6,35222,3829,3182,0.050792536,69896,-7249
ZCTA5 90732,8680,39,8641,21582,48.1,13534,2600,1139,0.052775461,160,21422
ZCTA5 90740,12836,18114,-5278,24721,59.4,18896,3084,549,0.022207839,51125,-26404
ZCTA5 90742,324,5434,-5110,470,57.5,403,0,0,0,27029,-26559
ZCTA5 90743,200,975,-775,487,55.6,415,42,0,0,2090,-1603
ZCTA5 90744,14995,1064,13931,57030,31.6,32793,2025,1689,0.029615992,2173,54857
ZCTA5 90745,15337,2536,12801,58327,39.5,14072,22402,4071,0.069796149,9650,48677
ZCTA5 90746,8547,49,8498,28067,44.4,3118,2705,16701,0.595040439,133,27934
ZCTA5 90747,0,15461,-15461,35,19.2,8,15,6,0.171428571,53123,-53088
ZCTA5 90755,4603,12213,-7610,11813,36,5514,2638,1260,0.106662152,37472,-25659
ZCTA5 90802,21450,4733,16717,39036,35.8,20119,3439,5794,0.148427093,11421,27615
ZCTA5 90803,17502,15322,2180,32631,45.8,24860,2650,1221,0.037418406,51208,-18577
ZCTA5 90804,14975,10462,4513,37953,33.4,18717,6277,4714,0.124206255,37204,749
ZCTA5 90805,28175,20868,7307,96840,32.7,21359,10027,18102,0.18692689,67736,29104
ZCTA5 90806,12555,21353,-8798,41571,34.1,17802,8075,6580,0.158283419,81404,-39833
ZCTA5 90807,12788,18772,-5984,32994,43.3,15934,5361,4364,0.132266473,53514,-20520
ZCTA5 90808,14195,21718,-7523,39723,43.2,26758,4792,1590,0.040027188,59051,-19328
ZCTA5 90810,9871,13455,-3584,37451,35.3,14384,8635,3028,0.080852314,41234,-3783
ZCTA5 90813,17485,17791,-306,56420,30.6,21497,6583,6504,0.11527827,54750,1670
ZCTA5 90814,8817,11846,-3029,19166,37.3,13480,1500,1763,0.091985808,44122,-24956
ZCTA5 90815,14998,6940,8058,43092,36.5,29612,4832,3140,0.072867354,22084,21008
ZCTA5 90822,0,12107,-12107,117,73,85,4,21,0.179487179,28311,-28194
ZCTA5 90831,0,6379,-6379,0,-,0,0,0,#DIV/0!,14949,-14949
ZCTA5 90840,0,8307,-8307,0,-,0,0,0,#DIV/0!,33655,-33655
ZCTA5 91001,12330,0,12330,36867,44.6,16400,1903,8717,0.236444517,0,36867
ZCTA5 91006,10464,11360,-896,32499,43,9062,18417,384,0.011815748,29710,2789
ZCTA5 91007,11708,12038,-330,33689,43.7,9787,18309,655,0.019442548,31178,2511
ZCTA5 91008,278,546,-268,774,52.5,394,302,8,0.010335917,913,-139
ZCTA5 91010,8462,429,8033,27008,41.4,11693,4013,1312,0.048578199,1193,25815
ZCTA5 91011,6447,1796,4651,20621,44.6,12348,6193,254,0.01231754,5394,15227
ZCTA5 91016,14701,2876,11825,41507,39.6,21248,6010,2015,0.048546028,6400,35107
ZCTA5 91020,3224,64,3160,7869,42,4377,1734,98,0.012453933,238,7631
ZCTA5 91024,4961,1351,3610,11253,48.3,8020,1885,467,0.041500044,2710,8543
ZCTA5 91030,10345,433,9912,26837,40.4,12686,8773,1133,0.042217834,1125,25712
ZCTA5 91040,7412,5209,2203,21289,45.1,15060,2296,577,0.027103199,13212,8077
ZCTA5 91042,9872,1814,8058,26686,44.9,19149,2292,322,0.012066252,7030,19656
ZCTA5 91046,98,17547,-17449,194,78.2,139,30,0,0,54355,-54161
ZCTA5 91101,10391,977,9414,19542,36.7,9006,4896,932,0.04769215,3632,15910
ZCTA5 91103,8480,618,7862,26909,38.5,9319,2983,4017,0.14928091,1723,25186
ZCTA5 91104,13421,467,12954,37619,40.2,17025,4246,2412,0.064116537,1230,36389
ZCTA5 91105,5463,5154,309,12888,44.9,7997,2231,462,0.0358473,10811,2077
ZCTA5 91106,10442,6504,3938,23589,36,11531,5367,1428,0.060536691,19269,4320
ZCTA5 91107,12753,2565,10188,33148,42.6,16847,7942,1658,0.050018101,7233,25915
ZCTA5 91108,4031,16178,-12147,12755,45.9,3536,8430,43,0.003371227,42613,-29858
ZCTA5 91125,0,3626,-3626,925,20,435,373,55,0.059459459,7721,-6796
ZCTA5 91201,8147,240,7907,22807,41.1,17829,1303,333,0.01460078,770,22037
ZCTA5 91202,8738,1400,7338,22757,44.3,17235,3113,589,0.025882146,4261,18496
ZCTA5 91203,6748,217,6531,16557,37,10887,2709,562,0.033943347,579,15978
ZCTA5 91204,6564,1314,5250,18738,36.8,11992,2742,548,0.029245384,3485,15253
ZCTA5 91205,13709,11556,2153,36367,40.1,26209,4568,574,0.01578354,35731,636
ZCTA5 91206,12610,15018,-2408,32570,42.7,24596,4492,694,0.021307952,41889,-9319
ZCTA5 91207,4121,12641,-8520,11488,43.1,9378,1103,92,0.008008357,55458,-43970
ZCTA5 91208,5964,2033,3931,15316,48.3,10290,1989,29,0.001893445,5112,10204
ZCTA5 91210,125,475,-350,244,42.6,235,9,0,0,1402,-1158
ZCTA5 91214,10577,3278,7299,32009,41.5,18550,8576,131,0.004092599,7846,24163
ZCTA5 91301,9059,3616,5443,25737,44.6,20473,1638,412,0.016008082,10085,15652
ZCTA5 91302,9761,1852,7909,26241,44.5,20516,2292,688,0.026218513,5042,21199
ZCTA5 91303,9887,4545,5342,29965,32.3,11398,3096,1098,0.03664275,13347,16618
ZCTA5 91304,18190,2409,15781,54264,40,24157,9263,3192,0.058823529,7153,47111
ZCTA5 91306,14463,88,14375,49260,37.3,17687,9074,1824,0.037028015,110,49150
ZCTA5 91307,8562,645,7917,25773,44.4,16869,4483,1009,0.039149498,1516,24257
ZCTA5 91311,14156,6122,8034,41188,41.6,21496,6750,2894,0.070263183,14511,26677
ZCTA5 91316,12372,837,11535,28182,44.3,22201,1981,658,0.023348236,2046,26136
ZCTA5 91320,14902,229,14673,44356,42.7,33224,5024,572,0.012895662,424,43932
ZCTA5 91321,11240,553,10687,35231,33.9,20365,2433,835,0.023700718,1098,34133
ZCTA5 91324,10045,79,9966,29328,38.3,12244,6057,1600,0.054555374,96,29232
ZCTA5 91325,12590,20,12570,35355,37.9,15622,5660,2178,0.061603734,35,35320
ZCTA5 91326,12518,1071,11447,36079,45.2,17116,11210,3009,0.083400316,3002,33077
ZCTA5 91330,0,0,0,3017,19.7,1645,504,470,0.155783891,668,2349
ZCTA5 91331,23182,310,22872,102553,34.3,45426,5300,2338,0.022797968,611,101942
ZCTA5 91335,24289,1105,23184,78205,37.5,33097,10038,2810,0.035931206,2335,75870
ZCTA5 91340,8829,89,8740,35918,35.4,17460,839,649,0.018068935,183,35735
ZCTA5 91342,24793,198,24595,92764,36.5,49251,6080,3548,0.038247596,418,92346
ZCTA5 91343,17977,29,17948,64519,35,22154,8650,2844,0.044080038,54,64465
ZCTA5 91344,17529,166,17363,54465,42.4,31456,9368,1584,0.029082897,357,54108
ZCTA5 91345,5448,981,4467,18752,39.2,7062,2059,235,0.012531997,2736,16016
ZCTA5 91350,12914,13867,-953,42252,35.9,25695,5522,1985,0.046980025,38655,3597
ZCTA5 91351,10380,20511,-10131,33131,36.8,20542,1857,1256,0.037910114,72231,-39100
ZCTA5 91352,12040,20894,-8854,45900,36.6,22538,2521,949,0.020675381,70599,-24699
ZCTA5 91354,10766,147,10619,33461,38.7,20474,5946,1626,0.048593885,581,32880
ZCTA5 91355,12052,3529,8523,31469,40.7,21357,3709,856,0.027201373,12160,19309
ZCTA5 91356,11803,419,11384,29968,44.1,21956,1700,1881,0.062766951,912,29056
ZCTA5 91360,15260,920,14340,42984,42.9,32296,3202,825,0.019193188,2256,40728
ZCTA5 91361,8005,3138,4867,19454,51.4,16041,1543,307,0.015780816,9625,9829
ZCTA5 91362,13859,151,13708,36587,46.3,28010,3695,737,0.020143767,364,36223
ZCTA5 91364,10254,19873,-9619,28264,42.1,19954,2661,1911,0.067612511,74389,-46125
ZCTA5 91367,17953,15299,2654,44931,40.2,30690,5835,3165,0.070441343,49372,-4441
ZCTA5 91371,0,9156,-9156,0,-,0,0,0,#DIV/0!,39396,-39396
ZCTA5 91377,5018,799,4219,13561,42.9,10195,2407,120,0.008848905,2169,11392
ZCTA5 91381,6590,19,6571,20193,40.1,9909,5176,1073,0.053137226,30,20163
ZCTA5 91384,6982,12470,-5488,28693,35,16399,2467,1525,0.053148852,32021,-3328
ZCTA5 91387,13789,27,13762,45295,35.5,25973,4790,3052,0.067380506,50,45245
ZCTA5 91390,6288,5829,459,19772,44.2,14263,959,473,0.023922719,18496,1276
ZCTA5 91401,14596,11389,3207,38974,36.5,22272,1957,2175,0.055806435,35446,3528
ZCTA5 91402,20133,800,19333,68076,34.7,14593,10150,1993,0.029276103,1943,66133
ZCTA5 91403,11867,98,11769,26061,39.1,19289,2044,1407,0.053988719,292,25769
ZCTA5 91405,18374,1862,16512,55751,34.3,21666,4482,2714,0.048680741,6503,49248
ZCTA5 91406,18686,33,18653,54404,35.5,21652,3994,2646,0.04863613,85,54319
ZCTA5 91411,9037,800,8237,23902,36,12828,1904,1748,0.073131955,1882,22020
ZCTA5 91423,14925,1468,13457,31901,39.3,24497,1980,1273,0.039904705,3677,28224
ZCTA5 91436,6011,158,5853,16970,45,14339,655,299,0.017619328,280,16690
ZCTA5 91501,7834,387,7447,19493,41.5,14965,1363,484,0.024829426,1186,18307
ZCTA5 91502,5530,88,5442,12044,34.7,7345,2058,445,0.036947858,218,11826
ZCTA5 91504,10151,125,10026,27592,40.4,18239,3045,1203,0.043599594,373,27219
ZCTA5 91505,13042,204,12838,32884,38.4,21450,3654,928,0.028220411,859,32025
ZCTA5 91506,8125,1421,6704,19449,42,12877,2716,361,0.018561366,6173,13276
ZCTA5 91601,17086,5386,11700,34786,34.5,21358,3028,2976,0.085551659,24715,10071
ZCTA5 91602,10124,15209,-5085,20465,39.5,13220,2199,1457,0.071194723,46810,-26345
ZCTA5 91604,14350,13029,1321,32680,40.3,24933,2650,1329,0.040667075,34804,-2124
ZCTA5 91605,16304,3999,12305,52661,35.9,26283,3966,1333,0.02531285,11053,41608
ZCTA5 91606,15255,1452,13803,43381,37.6,25449,1828,2053,0.047324866,6211,37170
ZCTA5 91607,13384,687,12697,30921,37.6,20505,2236,2208,0.071407781,2698,28223
ZCTA5 91608,8,7354,-7346,16,-,16,0,0,0,28525,-28509
ZCTA5 91701,12845,9747,3098,39019,42.6,22482,4541,2083,0.053384249,29609,9410
ZCTA5 91702,16175,2769,13406,61684,31.5,28492,8084,1728,0.028013747,9657,52027
ZCTA5 91706,17857,220,17637,73652,36,23147,16078,824,0.011187748,322,73330
ZCTA5 91708,4096,2484,1612,14179,34.2,4757,4252,1796,0.126666196,9489,4690
ZCTA5 91709,24961,38,24923,78333,39,30195,30195,3422,0.043685292,58,78275
ZCTA5 91710,22214,352,21862,82192,38.2,37175,10875,4537,0.055200019,1615,80577
ZCTA5 91711,12452,1982,10470,36841,41.6,21353,5592,2082,0.056513124,6730,30111
ZCTA5 91722,10321,364,9957,35714,37.2,16403,5306,1021,0.028588229,702,35012
ZCTA5 91723,6250,0,6250,18398,37.1,10077,1860,713,0.038754212,0,18398
ZCTA5 91724,8987,122,8865,29309,39,13348,4320,1465,0.049984646,402,28907
ZCTA5 91730,24460,4975,19485,69787,34.3,31060,9928,8208,0.117615029,18039,51748
ZCTA5 91731,7928,5193,2735,28244,35.5,8035,8000,65,0.002301374,16666,11578
ZCTA5 91732,15260,33,15227,59749,36.8,16008,18155,414,0.006928986,33,59716
ZCTA5 91733,10786,17,10769,43978,35.7,12065,10008,280,0.00636682,49,43929
ZCTA5 91737,7760,10831,-3071,23790,41.5,13609,3116,1580,0.06641446,38661,-14871
ZCTA5 91739,11336,3814,7522,41427,35.1,19595,8168,4741,0.114442272,11443,29984
ZCTA5 91740,8449,11216,-2767,27379,37.5,15683,2995,634,0.023156434,39577,-12198
ZCTA5 91741,8856,11092,-2236,26460,42.7,17237,3443,496,0.018745276,47823,-21363
ZCTA5 91744,18303,2905,15398,81156,35.5,27184,11033,1167,0.014379713,11600,69556
ZCTA5 91745,16309,193,16116,54853,43.5,16714,22255,517,0.009425191,594,54259
ZCTA5 91746,6981,1129,5852,29525,39.2,9651,3149,753,0.02550381,2829,26696
ZCTA5 91748,13720,3327,10393,45205,42,6255,27834,572,0.012653468,7627,37578
ZCTA5 91750,12191,179,12012,33406,45,21268,3233,1522,0.045560678,712,32694
ZCTA5 91752,9157,2659,6498,35641,34.5,16471,3434,1709,0.047950394,10960,24681
ZCTA5 91754,11689,2780,8909,33931,42.8,5291,20564,421,0.012407533,12401,21530
ZCTA5 91755,8604,3746,4858,27197,44.9,3112,19222,258,0.00948634,15403,11794
ZCTA5 91759,175,1342,-1167,367,52.5,301,0,11,0.029972752,4063,-3696
ZCTA5 91761,17624,587,17037,60342,33.8,26301,4448,3354,0.055583176,1653,58689
ZCTA5 91762,18012,108,17904,61690,32.7,26578,4492,2720,0.044091425,453,61237
ZCTA5 91763,9896,457,9439,37821,32.4,16706,3708,1807,0.04777769,1193,36628
ZCTA5 91764,16291,8148,8143,56317,31.3,20062,3369,3860,0.068540583,30791,25526
ZCTA5 91765,15119,1806,13313,46270,44,11216,27634,2086,0.045083207,6826,39444
ZCTA5 91766,19134,10140,8994,71380,33.5,23750,9163,3883,0.054398991,35083,36297
ZCTA5 91767,14712,1039,13673,50563,35.2,18151,5055,3434,0.067915274,4465,46098
ZCTA5 91768,8635,8397,238,36706,29.7,13062,2692,1841,0.050155288,29741,6965
ZCTA5 91770,16192,265,15927,59685,42.1,6211,38457,341,0.005713328,687,58998
ZCTA5 91773,11705,107,11598,34407,42.7,20267,5743,986,0.028656959,349,34058
ZCTA5 91775,7992,78,7914,24079,43.2,6554,12657,238,0.009884131,243,23836
ZCTA5 91776,11470,771,10699,38112,42,5423,23888,242,0.006349706,2156,35956
ZCTA5 91780,11656,398,11258,35494,42.9,7089,23317,148,0.004169719,1498,33996
ZCTA5 91784,8992,120,8872,26330,47.2,17022,3138,1008,0.038283327,200,26130
ZCTA5 91786,19456,205,19251,55405,34,27679,4894,3640,0.065698042,967,54438
ZCTA5 91789,12695,942,11753,41829,45.2,7284,27533,1100,0.026297545,2335,39494
ZCTA5 91790,12465,3060,9405,45497,37.9,15071,9844,1471,0.032331802,11057,34440
ZCTA5 91791,10674,11828,-1154,34411,42.1,10250,10012,1377,0.040016274,47667,-13256
ZCTA5 91792,9184,9659,-475,31649,39.9,6177,13876,2443,0.077190433,34551,-2902
ZCTA5 91801,20080,10778,9302,53976,40.9,10557,28434,1252,0.023195494,26828,27148
ZCTA5 91803,10002,12309,-2307,29223,42,5925,13745,558,0.019094549,38597,-9374
ZCTA5 91901,6313,10306,-3993,18367,41.8,15133,539,224,0.012195786,38448,-20081
ZCTA5 91902,6041,11099,-5058,17759,45.8,10689,2537,409,0.023030576,31980,-14221
ZCTA5 91905,562,15770,-15208,1616,54.3,817,3,19,0.011757426,39079,-37463
ZCTA5 91906,1343,17062,-15719,4547,33.8,3071,10,123,0.027050803,46351,-41804
ZCTA5 91910,25531,1617,23914,76291,38.2,41200,7499,2954,0.038720164,6570,69721
ZCTA5 91911,25756,23347,2409,88589,35.8,45680,7756,3944,0.0445202,76672,11917
ZCTA5 91913,15469,2712,12757,53725,35,21748,13427,4139,0.077040484,8640,45085
ZCTA5 91914,4744,6446,-1702,17742,37.1,8171,3924,671,0.037819862,25386,-7644
ZCTA5 91915,9713,13912,-4199,34616,33.7,14382,8841,2777,0.080223018,40627,-6011
ZCTA5 91916,671,20823,-20152,1966,54.1,1642,3,12,0.006103764,68590,-66624
ZCTA5 91917,198,5792,-5594,769,32.4,633,57,13,0.016905072,15164,-14395
ZCTA5 91931,304,3605,-3301,765,37.9,752,0,0,0,10098,-9333
ZCTA5 91932,9187,9620,-433,26375,33.4,15977,2045,1423,0.053952607,25823,552
ZCTA5 91934,271,12977,-12706,796,61,681,0,0,0,61000,-60204
ZCTA5 91935,2980,16808,-13828,9450,47.6,7984,192,86,0.009100529,61030,-51580
ZCTA5 91941,12486,7147,5339,33858,40.5,23964,2102,2219,0.065538425,21987,11871
ZCTA5 91942,16960,4649,12311,40863,36,27512,2921,2945,0.072070088,12878,27985
ZCTA5 91945,9162,215,8947,27685,35.7,13113,2420,4288,0.154885317,715,26970
ZCTA5 91948,59,1438,-1379,137,27.8,137,0,0,0,2864,-2727
ZCTA5 91950,17769,6019,11750,58349,36.2,30708,9630,2492,0.04270853,13362,44987
ZCTA5 91962,971,2487,-1516,2507,46.9,1975,26,31,0.012365377,6133,-3626
ZCTA5 91963,112,412,-300,501,42.8,384,0,0,0,1665,-1164
ZCTA5 91977,19730,2105,17625,65722,35.2,32414,5336,8869,0.134947202,8494,57228
ZCTA5 91978,3320,3662,-342,10979,37,6145,676,1665,0.151653156,16976,-5997
ZCTA5 91980,0,69,-69,0,-,0,0,0,#DIV/0!,338,-338
ZCTA5 92003,1627,3714,-2087,4299,45.9,3254,80,5,0.001163061,16222,-11923
ZCTA5 92004,1336,192,1144,2779,62.8,2253,1,1,0.000359842,443,2336
ZCTA5 92007,4289,7890,-3601,11447,40.7,8904,328,38,0.003319647,22723,-11276
ZCTA5 92008,11976,14061,-2085,27742,41.8,21884,1544,287,0.010345325,31952,-4210
ZCTA5 92009,16512,0,16512,46622,42.5,36502,4169,512,0.01098194,42,46580
ZCTA5 92010,6388,7011,-623,15976,41.5,10569,3146,304,0.019028543,15102,874
ZCTA5 92011,9474,1933,7541,24518,43.8,18648,2289,389,0.015865894,4470,20048
ZCTA5 92014,5452,64,5388,12823,50.8,10844,586,218,0.017000702,244,12579
ZCTA5 92019,15091,10329,4762,45694,39.4,34993,1346,1180,0.025823959,33314,12380
ZCTA5 92020,19997,4119,15878,60222,35.1,43551,2759,3542,0.058815715,27057,33165
ZCTA5 92021,23331,295,23036,71006,35.2,48742,3450,5058,0.071233417,931,70075
ZCTA5 92024,19480,10376,9104,50840,43.2,42071,2235,247,0.004858379,26141,24699
ZCTA5 92025,16799,1883,14916,50831,34.9,28627,2299,1179,0.023194507,4266,46565
ZCTA5 92026,18432,16422,2010,51953,37.3,33551,4232,852,0.016399438,40907,11046
ZCTA5 92027,17263,13606,3657,56878,34.5,33073,3295,1061,0.018653961,47866,9012
ZCTA5 92028,16649,19548,-2899,50661,39.7,36697,1571,701,0.013837074,60446,-9785
ZCTA5 92029,7459,6616,843,19466,44.4,14584,1563,375,0.019264358,17688,1778
ZCTA5 92036,1360,726,634,2981,55.8,2405,2,97,0.032539416,1651,1330
ZCTA5 92037,16342,63,16279,37505,46.8,29234,4166,459,0.012238368,93,37412
ZCTA5 92040,15446,7355,8091,45371,39.3,37273,694,787,0.017345882,19310,26061
ZCTA5 92054,14910,7990,6920,37567,36.4,24407,1378,1576,0.041951713,22536,15031
ZCTA5 92055,0,15664,-15664,9891,21.4,6621,439,702,0.070973612,40608,-30717
ZCTA5 92056,19344,2380,16964,54045,38.1,35458,4347,1532,0.028346748,7083,46962
ZCTA5 92057,18440,2607,15833,58444,37.5,34117,5519,3513,0.060108822,6633,51811
ZCTA5 92058,14201,8004,6197,47286,25,27514,2505,3432,0.072579622,21567,25719
ZCTA5 92059,491,922,-431,1445,38.3,463,63,18,0.012456747,2567,-1122
ZCTA5 92060,99,1149,-1050,392,67.3,304,0,0,0,2814,-2422
ZCTA5 92061,647,13921,-13274,1694,53.8,1201,31,10,0.005903188,33918,-32224
ZCTA5 92064,16282,5781,10501,49005,41.6,32828,6063,990,0.02020202,12929,36076
ZCTA5 92065,12229,11733,496,36838,40.5,29234,822,315,0.008550953,27279,9559
ZCTA5 92066,177,14045,-13868,358,54.4,343,0,10,0.027932961,37558,-37200
ZCTA5 92067,2991,471,2520,9060,46.5,6929,580,0,0,1561,7499
ZCTA5 92069,14824,13521,1303,46375,35.1,29117,4986,1062,0.02290027,36343,10032
ZCTA5 92070,355,9985,-9630,869,44.9,515,3,1,0.001150748,26782,-25913
ZCTA5 92071,20678,8905,11773,59826,39.3,46048,2963,893,0.014926621,31427,28399
ZCTA5 92075,4978,4670,308,12234,46.3,9351,733,124,0.010135687,11108,1126
ZCTA5 92078,17988,14829,3159,53247,37.5,36774,5466,717,0.013465547,41383,11864
ZCTA5 92081,10420,11647,-1227,29944,37.2,21362,2048,1433,0.047855998,29358,586
ZCTA5 92082,6134,75,6059,20300,41.7,13947,581,336,0.016551724,241,20059
ZCTA5 92083,11316,21653,-10337,38875,33.1,23219,1887,1085,0.027909968,64363,-25488
ZCTA5 92084,14672,8060,6612,49759,35.1,34642,1542,1028,0.020659579,22688,27071
ZCTA5 92086,524,18588,-18064,1306,59.5,927,131,12,0.009188361,45531,-44225
ZCTA5 92091,609,20150,-19541,1331,58.2,923,236,0,0,53446,-52115
ZCTA5 92092,0,7442,-7442,0,-,0,0,0,#DIV/0!,20282,-20282
ZCTA5 92093,0,15021,-15021,0,-,0,0,0,#DIV/0!,25531,-25531
ZCTA5 92096,0,11566,-11566,0,-,0,0,0,#DIV/0!,23909,-23909
ZCTA5 92101,25702,185,25517,43096,36.6,29015,3902,3421,0.079380917,305,42791
ZCTA5 92102,14420,3080,11340,40083,34,25576,2263,3966,0.09894469,4801,35282
ZCTA5 92103,18550,13180,5370,33873,41.7,26153,2440,926,0.027337407,26762,7111
ZCTA5 92104,21951,7241,14710,45773,34.2,30144,2591,3583,0.078277587,13518,32255
ZCTA5 92105,22779,33055,-10276,73085,33.3,26637,14531,9258,0.12667442,54412,18673
ZCTA5 92106,7678,27042,-19364,20889,37.3,15782,985,646,0.030925367,70804,-49915
ZCTA5 92107,13507,2217,11290,29753,36.1,24234,1094,843,0.028333277,3493,26260
ZCTA5 92108,11847,21736,-9889,21995,33.1,14714,2548,1290,0.058649693,80726,-58731
ZCTA5 92109,21942,16440,5502,45333,33.1,37482,1971,816,0.018000132,32328,13005
ZCTA5 92110,11875,17471,-5596,30318,33.1,21601,2321,1725,0.056896893,32882,-2564
ZCTA5 92111,16870,14913,1957,49351,35.9,29643,8674,1977,0.040059979,43923,5428
ZCTA5 92113,13757,18215,-4458,51461,31,30545,1629,5020,0.097549601,40932,10529
ZCTA5 92114,18163,17086,1077,67745,36.6,21662,16240,12291,0.181430364,39567,28178
ZCTA5 92115,20892,17396,3496,61450,28.8,34976,8675,6562,0.106786005,43597,17853
ZCTA5 92116,16356,21935,-5579,31470,35.9,22040,1993,1737,0.055195424,57805,-26335
ZCTA5 92117,20681,13774,6907,55195,37.5,39076,5160,1741,0.031542712,23710,31485
ZCTA5 92118,7147,10083,-2936,19672,41.7,16209,751,767,0.038989427,34296,-14624
ZCTA5 92119,9224,7319,1905,24465,42.6,17701,2129,852,0.034825261,19075,5390
ZCTA5 92120,11544,0,11544,29172,39.8,21429,2057,1642,0.05628685,48,29124
ZCTA5 92121,1694,1014,680,4213,32.9,2305,1218,64,0.015191075,2730,1483
ZCTA5 92122,19242,629,18613,45676,31.2,25807,14030,769,0.016835975,2501,43175
ZCTA5 92123,12035,12998,-963,33035,34.9,18161,6594,2738,0.082881792,27914,5121
ZCTA5 92124,11201,10642,559,31593,32.8,20826,3888,2010,0.063621688,31425,168
ZCTA5 92126,24903,13448,11455,78097,35.5,24514,37593,3047,0.039015583,27580,50517
ZCTA5 92127,15909,10963,4946,50852,36.3,26699,16034,665,0.013077165,38889,11963
ZCTA5 92128,20465,2190,18275,50161,43.8,30695,11540,1332,0.026554495,4340,45821
ZCTA5 92129,18049,7355,10694,53742,39.9,28342,17610,1049,0.019519184,16819,36923
ZCTA5 92130,20632,13258,7374,57197,38.7,32278,18988,353,0.006171652,45714,11483
ZCTA5 92131,12550,1996,10554,36070,41.2,20288,10339,753,0.020876074,3791,32279
ZCTA5 92132,0,3206,-3206,0,-,0,0,0,#DIV/0!,13541,-13541
ZCTA5 92134,0,10675,-10675,316,22.1,121,10,113,0.357594937,26448,-26132
ZCTA5 92135,0,12580,-12580,641,21.4,372,34,89,0.138845554,35721,-35080
ZCTA5 92136,0,9337,-9337,10676,23.8,5436,1368,1986,0.186024728,23622,-12946
ZCTA5 92139,9929,15217,-5288,35364,35.8,10690,10724,4546,0.128548807,39311,-3947
ZCTA5 92140,0,13472,-13472,3249,19.7,2391,104,240,0.073868883,33792,-30543
ZCTA5 92145,0,24405,-24405,3044,21.5,1795,111,468,0.153745072,60639,-57595
ZCTA5 92147,0,5104,-5104,212,21.3,138,0,30,0.141509434,13384,-13172
ZCTA5 92154,22724,5456,17268,85024,35,44964,9440,4481,0.052702766,19494,65530
ZCTA5 92155,0,4749,-4749,340,22,202,0,30,0.088235294,12680,-12340
ZCTA5 92161,0,7328,-7328,0,-,0,0,0,#DIV/0!,21312,-21312
ZCTA5 92173,8064,5421,2643,29634,33.1,17627,443,431,0.014544105,15817,13817
ZCTA5 92179,0,962,-962,4061,42.4,2254,106,1327,0.326766806,3638,423
ZCTA5 92182,0,20595,-20595,0,-,0,0,0,#DIV/0!,61665,-61665
ZCTA5 92201,25316,10723,14593,63325,39.9,27741,1148,2508,0.039605211,27180,36145
ZCTA5 92203,12228,989,11239,32829,42.2,19937,731,541,0.016479332,1910,30919
ZCTA5 92210,2517,83,2434,4827,67.4,4417,132,145,0.030039362,241,4586
ZCTA5 92211,12946,17287,-4341,26106,63.8,21163,1237,708,0.027120202,53902,-27796
ZCTA5 92220,11617,328,11289,32523,42.5,18046,1559,2218,0.068197891,1020,31503
ZCTA5 92222,9,2713,-2704,31,59.2,31,0,0,0,6815,-6784
ZCTA5 92223,18462,47,18415,60328,35.9,35565,4425,4778,0.079200371,120,60208
ZCTA5 92225,5036,4494,542,21272,36.4,9205,457,2532,0.11902971,12582,8690
ZCTA5 92227,7597,10078,-2481,27530,30.8,17522,188,211,0.007664366,26162,1368
ZCTA5 92230,807,6897,-6090,2357,34.3,1293,42,3,0.001272804,19819,-17462
ZCTA5 92231,9005,12710,-3705,38879,33.3,21787,391,106,0.002726408,37477,1402
ZCTA5 92233,1014,15805,-14791,7454,33.6,2511,176,1224,0.164207137,40854,-33400
ZCTA5 92234,18827,13973,4854,51836,40.3,31134,3413,1292,0.024924763,33728,18108
ZCTA5 92236,15722,1346,14376,42218,37,8435,103,300,0.007105974,2866,39352
ZCTA5 92239,139,11906,-11767,301,70.6,280,0,2,0.006644518,31915,-31614
ZCTA5 92240,13962,350,13612,39173,35.9,20906,1318,2735,0.069818497,1175,37998
ZCTA5 92241,3498,10196,-6698,7319,55,5299,93,119,0.016259052,23913,-16594
ZCTA5 92242,599,11425,-10826,1256,58,1102,7,6,0.00477707,41237,-39981
ZCTA5 92243,13080,21557,-8477,49880,31.4,16098,725,1440,0.028869286,66641,-16761
ZCTA5 92249,1869,12361,-10492,8346,31,4171,72,0,0,36026,-27680
ZCTA5 92250,2031,929,1102,7798,35.6,3891,57,95,0.012182611,6007,1791
ZCTA5 92251,5907,23505,-17598,26740,31.5,14208,815,1396,0.052206432,68924,-42184
ZCTA5 92252,3597,19718,-16121,8797,40.9,7210,194,130,0.014777765,60439,-51642
ZCTA5 92253,15358,15602,-244,37814,49.7,26792,1313,715,0.018908341,51369,-13555
ZCTA5 92254,3251,19901,-16650,7478,47.1,796,0,0,0,60736,-53258
ZCTA5 92256,1515,4350,-2835,3159,49.1,2365,17,84,0.026590693,12446,-9287
ZCTA5 92257,479,21488,-21009,1018,35.2,632,18,182,0.178781925,75917,-74899
ZCTA5 92258,231,8792,-8561,627,43.1,392,0,56,0.089314195,28966,-28339
ZCTA5 92259,140,15944,-15804,221,59,151,0,0,0,42766,-42545
ZCTA5 92260,14717,8069,6648,31286,56.6,23046,1423,858,0.027424407,24060,7226
ZCTA5 92262,13062,158,12904,25888,53.7,18910,1095,2197,0.084865575,430,25458
ZCTA5 92264,11005,10449,556,19965,59.4,15690,1198,399,0.019984974,27340,-7375
ZCTA5 92266,123,16846,-16723,183,64.6,168,0,0,0,46915,-46732
ZCTA5 92267,22,13012,-12990,22,-,0,0,0,0,36994,-36972
ZCTA5 92268,279,4850,-4571,503,61.2,503,0,0,0,14199,-13696
ZCTA5 92270,8817,18873,-10056,17129,65,14414,808,286,0.01669683,47583,-30454
ZCTA5 92273,444,11122,-10678,1781,31.4,1156,0,124,0.069623807,34463,-32682
ZCTA5 92274,5746,5692,54,12843,46.1,3084,118,34,0.002647357,14716,-1873
ZCTA5 92275,629,24377,-23748,1043,57.3,623,0,48,0.046021093,66743,-65700
ZCTA5 92276,2879,10337,-7458,8052,35.5,4414,4,20,0.002483855,27132,-19080
ZCTA5 92277,9873,13005,-3132,26666,26.4,16721,923,2605,0.097689942,42712,-16046
ZCTA5 92278,0,10987,-10987,3318,21.4,2609,71,231,0.069620253,36908,-33590
ZCTA5 92280,0,6458,-6458,0,-,0,0,0,#DIV/0!,17779,-17779
ZCTA5 92281,562,6516,-5954,2548,22.4,982,11,13,0.005102041,18505,-15957
ZCTA5 92282,430,25392,-24962,1274,37.6,768,29,95,0.074568289,85275,-84001
ZCTA5 92283,531,14421,-13890,1918,30.3,636,9,21,0.010948905,41006,-39088
ZCTA5 92284,10285,239,10046,25832,40.4,19318,278,1150,0.044518427,691,25141
ZCTA5 92285,1062,15171,-14109,2699,55.7,2308,25,92,0.034086699,45695,-42996
ZCTA5 92301,8605,169,8436,37571,28.2,16674,545,6429,0.17111602,361,37210
ZCTA5 92304,0,3762,-3762,0,-,0,0,0,#DIV/0!,7784,-7784
ZCTA5 92305,149,2897,-2748,439,40.6,390,0,0,0,8867,-8428
ZCTA5 92307,13224,47,13177,40604,36.5,27903,1410,2708,0.066692937,127,40477
ZCTA5 92308,13856,3976,9880,43079,37,30535,1220,2680,0.062211286,9288,33791
ZCTA5 92309,229,0,229,593,29,357,31,0,0,1581,-988
ZCTA5 92310,2790,49,2741,9100,22.8,5558,579,1371,0.150659341,116,8984
ZCTA5 92311,11526,16458,-4932,34204,31.9,17314,711,3975,0.116214478,44778,-10574
ZCTA5 92313,4721,13296,-8575,13079,36.8,7819,525,597,0.045645692,38230,-25151
ZCTA5 92314,4399,6647,-2248,10905,42,9343,33,15,0.001375516,20528,-9623
ZCTA5 92315,2212,8544,-6332,5225,46.7,4214,109,12,0.002296651,28531,-23306
ZCTA5 92316,7550,12567,-5017,28593,35.1,12553,238,883,0.030881684,37131,-8538
ZCTA5 92317,385,12536,-12151,739,63.3,739,0,0,0,35248,-34509
ZCTA5 92320,3653,8744,-5091,10053,44.2,6636,658,200,0.019894559,28972,-18919
ZCTA5 92321,440,361,79,1010,49,860,40,0,0,848,162
ZCTA5 92322,399,20291,-19892,847,55.7,628,27,0,0,69820,-68973
ZCTA5 92324,17955,10489,7466,57931,32.4,26159,1933,5016,0.086585766,30435,27496
ZCTA5 92325,3317,9147,-5830,8347,44.2,6772,42,373,0.044686714,31174,-22827
ZCTA5 92327,379,13771,-13392,756,29,361,0,262,0.346560847,34960,-34204
ZCTA5 92328,474,18064,-17590,1049,43.1,813,14,0,0,52796,-51747
ZCTA5 92332,65,208,-143,174,44.3,129,0,0,0,583,-409
ZCTA5 92333,237,9040,-8803,462,60.6,454,0,0,0,16400,-15938
ZCTA5 92335,24921,9254,15667,97358,30.1,23350,1963,3278,0.033669549,20192,77166
ZCTA5 92336,26519,9569,16950,98896,33.4,35703,10237,11380,0.115070377,19933,78963
ZCTA5 92337,9720,10044,-324,38079,31.9,10873,2311,3755,0.098610783,26127,11952
ZCTA5 92338,0,1261,-1261,0,-,0,0,0,#DIV/0!,3071,-3071
ZCTA5 92339,506,14479,-13973,1146,37,919,0,0,0,49138,-47992
ZCTA5 92341,155,11809,-11654,339,55.6,300,0,0,0,28559,-28220
ZCTA5 92342,2467,9239,-6772,6347,42.1,4252,200,473,0.074523397,33774,-27427
ZCTA5 92344,5629,15150,-9521,20768,33.6,13598,1143,484,0.023305085,40890,-20122
ZCTA5 92345,25960,14628,11332,87994,33.1,63648,1587,3315,0.037673023,36051,51943
ZCTA5 92346,17966,10084,7882,60133,34.4,29552,5227,5671,0.094307618,23602,36531
ZCTA5 92347,303,12915,-12612,754,54.8,579,9,0,0,25994,-25240
ZCTA5 92350,54,9746,-9692,665,24.3,276,171,155,0.233082707,21389,-20724
ZCTA5 92352,2021,15408,-13387,5382,48.2,4471,80,8,0.001486436,30276,-24894
ZCTA5 92354,8515,16522,-8007,22977,37.7,10611,6271,2170,0.094442268,36277,-13300
ZCTA5 92356,2428,7637,-5209,6901,40.9,4937,133,218,0.031589625,13110,-6209
ZCTA5 92358,351,9,342,843,42.9,809,29,0,0,800,43
ZCTA5 92359,3251,7566,-4315,9587,34.4,6424,435,398,0.041514551,17074,-7487
ZCTA5 92363,2079,8779,-6700,5312,44.9,3303,51,240,0.045180723,23525,-18213
ZCTA5 92364,12,8918,-8906,12,-,12,0,0,0,31410,-31398
ZCTA5 92365,1019,7239,-6220,2485,49.7,1724,273,51,0.020523139,16187,-13702
ZCTA5 92368,289,8651,-8362,1017,32.9,578,47,24,0.02359882,20758,-19741
ZCTA5 92369,0,7865,-7865,4957,47.9,1875,246,1454,0.293322574,24065,-19108
ZCTA5 92371,5745,5857,-112,21123,33.5,16060,452,221,0.010462529,12687,8436
ZCTA5 92372,1823,7858,-6035,5701,30.1,4447,416,0,0,19469,-13768
ZCTA5 92373,12793,4995,7798,32340,39.1,21627,3274,1677,0.051855288,12100,20240
ZCTA5 92374,14568,4794,9774,45066,32.6,25163,3384,3184,0.070651933,11289,33777
ZCTA5 92376,22101,5306,16795,86826,30.3,39705,1771,9880,0.1137908,12643,74183
ZCTA5 92377,5257,2626,2631,20201,35.1,8187,530,4074,0.201673184,5897,14304
ZCTA5 92378,143,105,38,446,39.4,332,0,13,0.029147982,2960,-2514
ZCTA5 92382,1696,9058,-7362,4323,41.6,3377,138,16,0.003701133,29277,-24954
ZCTA5 92384,18,9258,-9240,27,74.2,27,0,0,0,25641,-25614
ZCTA5 92385,101,13971,-13870,176,61.5,165,0,0,0,39635,-39459
ZCTA5 92386,876,4965,-4089,1943,45.8,1786,37,101,0.051981472,13242,-11299
ZCTA5 92389,126,18934,-18808,209,69.1,161,0,0,0,59976,-59767
ZCTA5 92391,884,0,884,1996,40.6,1015,135,199,0.099699399,0,1996
ZCTA5 92392,16641,16024,617,61014,32.3,33957,3126,8659,0.141918248,40663,20351
ZCTA5 92394,9636,12183,-2547,39540,31,16902,1554,7601,0.192235711,29709,9831
ZCTA5 92395,15252,5494,9758,47416,33.6,28021,1912,5814,0.122616838,12156,35260
ZCTA5 92397,2262,5249,-2987,5215,49.4,4660,192,61,0.011697028,12490,-7275
ZCTA5 92398,646,150,496,1424,45.1,1267,130,0,0,270,1154
ZCTA5 92399,18504,483,18021,55016,35.9,42406,2114,775,0.014086811,970,54046
ZCTA5 92401,740,455,285,2085,27.9,778,130,654,0.313669065,1108,977
ZCTA5 92404,18591,3922,14669,64146,30.9,31211,1491,7513,0.117123437,9267,54879
ZCTA5 92405,9226,15699,-6473,30930,30.2,14958,972,3103,0.100323311,42206,-11276
ZCTA5 92407,17574,79,17495,68662,29.8,35777,2649,6897,0.100448574,142,68520
ZCTA5 92408,3633,3582,51,12169,35.7,5448,1874,603,0.049552141,8287,3882
ZCTA5 92410,12949,3489,9460,46615,30.3,19048,1563,5414,0.116142872,8578,38037
ZCTA5 92411,6683,434,6249,26895,29.7,9806,372,3222,0.119799219,1190,25705
ZCTA5 92415,0,500,-500,0,-,0,0,0,#DIV/0!,1129,-1129
ZCTA5 92501,6562,289,6273,21610,32.4,10364,1001,1136,0.052568255,745,20865
ZCTA5 92503,24338,3192,21146,90256,33.8,43607,6219,3436,0.038069491,6779,83477
ZCTA5 92504,15659,137,15522,58173,34.8,29745,2977,4760,0.081824902,215,57958
ZCTA5 92505,14152,13136,1016,52807,32.3,25021,6127,2650,0.050182741,31070,21737
ZCTA5 92506,14415,6791,7624,43900,38.5,28120,2401,2482,0.056537585,17496,26404
ZCTA5 92507,16875,228,16647,59767,26.1,22519,8888,4395,0.073535563,532,59235
ZCTA5 92508,9763,9506,257,36191,36.1,18944,4641,2866,0.079190959,24254,11937
ZCTA5 92509,18749,6972,11777,80036,31.8,32839,2740,2696,0.033684842,17000,63036
ZCTA5 92518,488,38,450,1103,38.7,523,132,41,0.037171351,53,1050
ZCTA5 92521,0,1592,-1592,0,-,0,0,0,#DIV/0!,4318,-4318
ZCTA5 92530,16083,13198,2885,58927,31.4,26079,2194,3144,0.05335415,32925,26002
ZCTA5 92532,7684,13358,-5674,26840,32.2,14300,3410,2357,0.087816692,37384,-10544
ZCTA5 92536,965,742,223,2401,51.7,1809,75,41,0.017076218,1718,683
ZCTA5 92539,1545,335,1210,4821,41.4,3231,163,8,0.001659407,1002,3819
ZCTA5 92543,13145,6367,6778,38769,38.7,23052,809,4273,0.110216926,15749,23020
ZCTA5 92544,16058,239,15819,52364,33.9,35522,1041,2692,0.051409365,539,51825
ZCTA5 92545,15347,106,15241,43440,41,27922,1232,3115,0.071708103,5279,38161
ZCTA5 92548,2232,5822,-3590,7665,32.4,5766,125,42,0.005479452,11029,-3364
ZCTA5 92549,1308,278,1030,2896,50.6,2148,151,92,0.031767956,525,2371
ZCTA5 92551,8171,170,8001,35421,30.2,9714,1646,6205,0.175178566,483,34938
ZCTA5 92553,19158,17,19141,73632,29.9,15672,3054,12395,0.168337136,35,73597
ZCTA5 92555,11493,583,10910,45694,34.7,16670,3295,9507,0.208057951,1454,44240
ZCTA5 92557,14516,559,13957,54225,32.3,18133,3104,9193,0.169534348,1906,52319
ZCTA5 92561,694,10039,-9345,1646,61.4,1479,14,3,0.0018226,23946,-22300
ZCTA5 92562,20226,1191,19035,63968,36.8,43104,3388,2482,0.03880065,3795,60173
ZCTA5 92563,21383,2410,18973,76795,33.9,40943,9913,6006,0.078208217,5945,70850
ZCTA5 92567,2592,3946,-1354,10480,30.6,5782,21,72,0.006870229,9543,937
ZCTA5 92570,14230,313,13917,59667,32.3,19186,1431,2600,0.043575176,602,59065
ZCTA5 92571,13351,18398,-5047,58773,29,14603,3002,5822,0.099059092,44909,13864
ZCTA5 92582,5066,4122,944,20580,30.2,9892,632,1640,0.079689018,8980,11600
ZCTA5 92583,9984,2541,7443,34103,34.8,19525,983,2253,0.066064569,10490,23613
ZCTA5 92584,15668,0,15668,54837,33.2,30230,3746,3930,0.07166694,0,54837
ZCTA5 92585,7180,21370,-14190,25238,35.5,11515,1275,2050,0.081226722,60690,-35452
ZCTA5 92586,9155,312,8843,20022,58.7,13683,495,1176,0.058735391,698,19324
ZCTA5 92587,5888,3142,2746,18432,36,13016,461,141,0.00764974,8110,10322
ZCTA5 92590,1919,2110,-191,5364,34.5,3150,289,158,0.02945563,8157,-2793
ZCTA5 92591,13382,16858,-3476,40889,36.5,25014,4511,1680,0.041086845,56865,-15976
ZCTA5 92592,24499,14927,9572,82090,37.2,52310,9606,3239,0.039456694,49598,32492
ZCTA5 92595,10286,5469,4817,34611,36.1,20762,2148,1126,0.03253301,13534,21077
ZCTA5 92596,8824,9861,-1037,35294,33.3,19645,2921,2403,0.068085227,25039,10255
ZCTA5 92602,9125,3652,5473,27425,34.8,10250,12146,88,0.003208751,9540,17885
ZCTA5 92603,7131,18961,-11830,19128,40.4,10437,7195,108,0.005646173,67380,-48252
ZCTA5 92604,10407,14937,-4530,29983,41.6,15608,10726,415,0.013841177,45924,-15941
ZCTA5 92606,9018,418,8600,25126,34,9271,11695,476,0.01894452,1253,23873
ZCTA5 92610,4229,60,4169,12524,39.6,6874,4100,51,0.004072181,202,12322
ZCTA5 92612,14122,253,13869,34640,30.1,17862,12298,1000,0.02886836,595,34045
ZCTA5 92614,11223,1146,10077,29307,33.1,14527,9234,868,0.029617498,3644,25663
ZCTA5 92617,4092,2013,2079,17960,20.8,7922,5503,1086,0.060467706,6691,11269
ZCTA5 92618,20890,14057,6833,54368,34.2,21873,26321,810,0.01489847,36587,17781
ZCTA5 92620,21158,19717,1441,60344,36.9,20504,32643,689,0.011417871,53394,6950
ZCTA5 92624,2555,4,2551,6398,49.6,5214,112,41,0.006408253,2312,4086
ZCTA5 92625,5860,8021,-2161,13102,54.2,10861,977,157,0.011982903,23188,-10086
ZCTA5 92626,19364,18239,1125,50389,36.4,31318,7290,993,0.019706682,46821,3568
ZCTA5 92627,22141,14372,7769,62575,35.7,37963,3141,596,0.009524571,35827,26748
ZCTA5 92629,11642,449,11193,26929,48.3,21955,1219,672,0.02495451,7090,19839
ZCTA5 92630,23246,3077,20169,66621,39.9,39094,11172,1862,0.027949145,8620,58001
ZCTA5 92637,11933,5664,6269,17546,74.5,12731,3822,87,0.004958395,15038,2508
ZCTA5 92646,21399,10998,10401,55939,46.9,39599,7493,587,0.010493573,30533,25406
ZCTA5 92647,21002,4035,16967,60592,36.7,36106,8613,1075,0.017741616,10235,50357
ZCTA5 92648,19726,106,19620,45612,43.7,32462,5453,366,0.008024204,264,45348
ZCTA5 92649,14696,22562,-7866,36130,44.9,26196,3995,344,0.009521174,81736,-45606
ZCTA5 92651,10976,5757,5219,24042,53.1,20753,742,115,0.004783296,18179,5863
ZCTA5 92653,10738,15198,-4460,30183,42.6,19312,4603,946,0.031342146,57125,-26942
ZCTA5 92655,2505,18752,-16247,8440,41.4,2506,3931,92,0.010900474,53268,-44828
ZCTA5 92656,19701,474,19227,53169,37.6,34568,8266,1383,0.026011398,702,52467
ZCTA5 92657,3648,13326,-9678,9342,45.9,6526,2116,20,0.002140869,49728,-40386
ZCTA5 92660,15806,10839,4967,36100,47.4,29255,3016,364,0.010083102,30980,5120
ZCTA5 92661,1652,11286,-9634,3279,46,2286,132,49,0.01494358,31312,-28033
ZCTA5 92662,1217,2996,-1779,2471,61.8,2371,49,0,0,9466,-6995
ZCTA5 92663,10552,12498,-1946,21523,44.9,18717,681,101,0.004692654,38351,-16828
ZCTA5 92672,15185,9275,5910,38872,40.3,30678,1314,1029,0.026471496,37135,1737
ZCTA5 92673,9774,12530,-2756,30972,41.4,24542,2041,607,0.019598347,54873,-23901
ZCTA5 92675,12460,21464,-9004,35319,44.8,24198,1421,321,0.009088593,63495,-28176
ZCTA5 92676,760,16763,-16003,1988,48.4,1781,50,2,0.001006036,47854,-45866
ZCTA5 92677,25361,20724,4637,64608,47.2,45923,7311,1045,0.016174468,52805,11803
ZCTA5 92678,242,13216,-12974,638,51.1,466,58,4,0.006269592,31965,-31327
ZCTA5 92679,10493,16503,-6010,31406,45.2,24569,2883,478,0.015220022,64392,-32986
ZCTA5 92683,27611,13855,13756,91267,40.8,26661,46431,1042,0.011417051,36020,55247
ZCTA5 92688,15446,14071,1375,44386,38.3,31833,5481,797,0.017956112,39436,4950
ZCTA5 92691,16400,5141,11259,48437,43.4,33186,6335,606,0.012511097,14529,33908
ZCTA5 92692,16588,8969,7619,46240,47.5,32894,7017,464,0.010034602,28990,17250
ZCTA5 92694,11292,11853,-561,34879,35.2,25590,4726,370,0.010608102,40882,-6003
ZCTA5 92697,0,7459,-7459,0,-,0,0,0,#DIV/0!,26189,-26189
ZCTA5 92701,12341,6429,5912,49008,30.2,12063,2234,344,0.007019262,15316,33692
ZCTA5 92703,13543,7134,6409,64387,32.9,14021,10522,558,0.008666346,21159,43228
ZCTA5 92704,19686,14960,4726,79641,35,23753,15405,749,0.009404704,42565,37076
ZCTA5 92705,14959,5665,9294,47851,37.9,26345,4773,856,0.017888863,19104,28747
ZCTA5 92706,10076,2240,7836,36694,36,12723,3379,597,0.01626969,6690,30004
ZCTA5 92707,14142,104,14038,60478,32.3,21084,4204,344,0.005688019,321,60157
ZCTA5 92708,18852,11371,7481,57139,43.9,26664,21290,431,0.007543009,45677,11462
ZCTA5 92780,17420,2851,14569,54840,34.5,27307,7174,1801,0.032840992,5808,49032
ZCTA5 92782,10988,5248,5740,30123,39,12784,12718,510,0.016930585,15431,14692
ZCTA5 92801,18522,10915,7607,65662,34.3,29843,11949,2891,0.04402851,29200,36462
ZCTA5 92802,11946,10009,1937,42911,33.2,22903,5532,1016,0.023676913,36300,6611
ZCTA5 92804,24586,15929,8657,86503,35.9,42753,21915,2907,0.033605771,63820,22683
ZCTA5 92805,20593,17891,2702,73736,32.4,39526,9057,1046,0.014185744,47604,26132
ZCTA5 92806,12521,12589,-68,40009,35.2,19778,5252,970,0.024244545,41153,-1144
ZCTA5 92807,12248,11552,696,36110,42.8,25139,5355,546,0.015120465,40502,-4392
ZCTA5 92808,7797,0,7797,21496,44.1,12934,5162,489,0.022748418,1919,19577
ZCTA5 92821,14822,6909,7913,41286,40.7,24028,9252,570,0.013806133,25219,16067
ZCTA5 92823,1762,6540,-4778,5626,38.2,2132,2723,0,0,23902,-18276
ZCTA5 92831,12401,10577,1824,36859,29.8,21409,6520,942,0.025556852,27913,8946
ZCTA5 92832,8203,2391,5812,25720,33.7,12766,2951,735,0.028576983,6819,18901
ZCTA5 92833,16584,2282,14302,53188,37.5,21919,18819,1233,0.023181921,5062,48126
ZCTA5 92835,9120,1547,7573,26917,41.6,17044,6112,368,0.013671657,3156,23761
ZCTA5 92840,15530,169,15361,53681,37.2,22747,19343,603,0.011233025,291,53390
ZCTA5 92841,9531,216,9315,34650,39.7,10249,17063,312,0.009004329,506,34144
ZCTA5 92843,11802,52,11750,48413,37.5,13486,21575,200,0.004131122,274,48139
ZCTA5 92844,6733,406,6327,22601,42.1,4320,13320,486,0.021503473,892,21709
ZCTA5 92845,5380,1683,3697,15240,43.9,11339,2117,113,0.007414698,4365,10875
ZCTA5 92860,7060,280,6780,26204,40.8,17902,933,1173,0.044764158,833,25371
ZCTA5 92861,1965,823,1142,5864,50.9,4479,843,24,0.004092769,5205,659
ZCTA5 92865,6813,105,6708,21384,36.3,12816,3278,327,0.015291807,396,20988
ZCTA5 92866,5626,184,5442,14966,35,10829,851,77,0.005144995,419,14547
ZCTA5 92867,12948,17,12931,44232,35.6,28504,5086,416,0.009404956,180,44052
ZCTA5 92868,7990,1313,6677,27233,33.1,15269,4043,907,0.033305181,3752,23481
ZCTA5 92869,11243,1246,9997,36174,40.9,21999,5058,398,0.011002377,3431,32743
ZCTA5 92870,16727,15515,1212,53126,37.1,32017,8859,1367,0.02573128,46811,6315
ZCTA5 92879,13758,9627,4131,48033,34.8,19700,5485,3033,0.063144088,25351,22682
ZCTA5 92880,18961,1019,17942,74933,34.3,28715,19404,4980,0.06645937,2217,72716
ZCTA5 92881,9057,580,8477,31061,39.9,18723,3631,1799,0.05791829,1119,29942
ZCTA5 92882,19622,1956,17666,70257,33.8,37145,5612,3198,0.045518596,4518,65739
ZCTA5 92883,11248,98,11150,35788,38.7,20533,3676,3273,0.091455236,205,35583
ZCTA5 92886,16777,1539,15238,50764,43.1,32928,10882,513,0.010105587,3817,46947
ZCTA5 92887,7071,17,7054,20395,46.5,13636,4351,310,0.015199804,33,20362
ZCTA5 93001,12810,333,12477,31588,40.7,25159,889,177,0.005603394,819,30769
ZCTA5 93003,20167,5532,14635,53549,41,42169,2609,970,0.01811425,15050,38499
ZCTA5 93004,11183,229,10954,31705,40,23440,1458,860,0.027125059,511,31194
ZCTA5 93010,16264,913,15351,47930,38,33377,3511,1659,0.034612977,2380,45550
ZCTA5 93012,13273,180,13093,35794,43.4,26267,4019,649,0.01813153,425,35369
ZCTA5 93013,6208,1431,4777,16515,43.6,11928,377,132,0.007992734,3799,12716
ZCTA5 93015,5531,10712,-5181,18810,35.3,13553,234,97,0.005156831,36542,-17732
ZCTA5 93021,12059,249,11810,38030,39,26280,2730,1178,0.030975546,949,37081
ZCTA5 93022,2135,4133,-1998,6140,43.2,5121,58,4,0.000651466,17586,-11446
ZCTA5 93023,8471,35,8436,21691,50.9,18774,608,62,0.002858328,85,21606
ZCTA5 93030,14801,354,14447,58019,33.5,31642,3534,1290,0.022234096,872,57147
ZCTA5 93033,16704,12991,3713,84188,30.5,46991,5539,1494,0.017745997,43596,40592
ZCTA5 93035,8850,881,7969,26224,42.4,16884,1821,546,0.020820622,1820,24404
ZCTA5 93036,13525,899,12626,46594,33.9,28605,2903,1059,0.022728248,2119,44475
ZCTA5 93040,510,90,420,1829,32.7,1309,0,38,0.020776381,357,1472
ZCTA5 93041,7287,472,6815,23210,32.7,15609,605,731,0.031495045,1472,21738
ZCTA5 93042,0,0,0,121,21.6,55,0,37,0.305785124,0,121
ZCTA5 93043,0,3422,-3422,884,23.1,451,60,174,0.196832579,12916,-12032
ZCTA5 93060,9970,2299,7671,34583,34,27110,375,185,0.005349449,6619,27964
ZCTA5 93063,19624,282,19342,56198,42.2,39668,6369,518,0.00921741,942,55256
ZCTA5 93064,0,183,-183,0,-,0,0,0,#DIV/0!,471,-471
ZCTA5 93065,25194,424,24770,72991,40.6,52429,8002,1205,0.016508885,1191,71800
ZCTA5 93066,957,4457,-3500,2741,49.7,2213,64,0,0,12947,-10206
ZCTA5 93067,208,1708,-1500,316,59.9,316,0,0,0,3506,-3190
ZCTA5 93101,12934,3119,9815,31439,32.5,20427,843,528,0.016794427,9646,21793
ZCTA5 93103,7663,361,7302,19282,38.7,12375,675,248,0.012861736,1131,18151
ZCTA5 93105,10915,2238,8677,26382,46.3,21115,1046,404,0.015313471,6886,19496
ZCTA5 93106,14,25,-11,5295,19.4,2142,2177,105,0.019830028,61,5234
ZCTA5 93108,4536,3060,1476,11097,53.9,9457,457,69,0.006217897,8884,2213
ZCTA5 93109,4569,2793,1776,11291,43.6,8950,436,303,0.026835533,9776,1515
ZCTA5 93110,6474,1084,5390,16345,43.4,11940,863,198,0.012113796,4325,12020
ZCTA5 93111,6390,1039,5351,18327,43.4,13939,873,137,0.00747531,2744,15583
ZCTA5 93117,16458,4251,12207,54915,22.9,32967,7619,1741,0.031703542,16278,38637
ZCTA5 93201,311,858,-547,1283,24,907,8,2,0.001558846,2896,-1613
ZCTA5 93202,1077,3857,-2780,4491,24.5,2208,236,40,0.008906702,15747,-11256
ZCTA5 93203,4770,338,4432,20674,25.5,12785,222,103,0.004982103,707,19967
ZCTA5 93204,3036,14453,-11417,13881,29.6,4545,202,574,0.041351488,43753,-29872
ZCTA5 93205,969,9830,-8861,2342,50.7,2000,0,0,0,30987,-28645
ZCTA5 93206,445,4887,-4442,1665,25.1,1150,0,3,0.001801802,11834,-10169
ZCTA5 93207,103,11031,-10928,264,57,225,0,0,0,31624,-31360
ZCTA5 93208,81,8493,-8412,106,26.9,81,0,0,0,33934,-33828
ZCTA5 93210,4831,158,4673,18733,33.7,9019,297,504,0.026904393,264,18469
ZCTA5 93212,4230,446,3784,23148,34.7,10987,237,3188,0.137722481,970,22178
ZCTA5 93215,12251,9909,2342,55487,31.7,25074,7472,2429,0.04377602,31570,23917
ZCTA5 93218,160,18841,-18681,726,27.7,440,0,0,0,50159,-49433
ZCTA5 93219,2487,13185,-10698,10047,28.5,5274,366,20,0.001990644,46681,-36634
ZCTA5 93220,33,8509,-8476,33,-,33,0,0,0,24364,-24331
ZCTA5 93221,4506,20767,-16261,13865,36.8,8938,684,137,0.009880995,59392,-45527
ZCTA5 93222,1018,10879,-9861,1968,56.4,1445,315,0,0,31539,-29571
ZCTA5 93223,2823,3379,-556,10485,29.7,4271,28,75,0.007153076,11099,-614
ZCTA5 93224,158,8638,-8480,470,45.1,378,0,0,0,31592,-31122
ZCTA5 93225,2027,3680,-1653,5483,44.9,5032,27,0,0,11583,-6100
ZCTA5 93226,37,11196,-11159,51,68.4,44,0,0,0,32440,-32389
ZCTA5 93227,41,7081,-7040,131,20.5,0,0,0,0,25603,-25472
ZCTA5 93230,21661,0,21661,67486,33.2,43975,2620,3463,0.051314347,0,67486
ZCTA5 93234,1786,1268,518,6485,27.9,1603,0,54,0.008326908,5300,1185
ZCTA5 93235,1262,5484,-4222,4459,33.4,1892,0,0,0,16603,-12144
ZCTA5 93237,94,6733,-6639,200,47.9,173,0,0,0,23076,-22876
ZCTA5 93238,344,4066,-3722,808,40,726,17,2,0.002475248,14319,-13511
ZCTA5 93239,478,393,85,1273,44.3,409,0,0,0,1161,112
ZCTA5 93240,2482,11450,-8968,5912,45.5,4859,70,60,0.01014885,27551,-21639
ZCTA5 93241,4293,598,3695,16543,29.3,11405,174,78,0.004714985,1549,14994
ZCTA5 93242,998,597,401,2974,30.8,2064,5,0,0,1813,1161
ZCTA5 93243,461,70,391,920,46.1,759,101,0,0,179,741
ZCTA5 93244,47,14960,-14913,102,55.5,96,0,0,0,49357,-49255
ZCTA5 93245,12059,8107,3952,37360,30.6,21583,2516,2504,0.067023555,30326,7034
ZCTA5 93246,0,1522,-1522,1246,22,801,48,250,0.200642055,3716,-2470
ZCTA5 93247,5274,13146,-7872,17182,33.7,9578,150,27,0.001571412,39704,-22522
ZCTA5 93249,526,12697,-12171,2002,25.1,1157,15,0,0,37570,-35568
ZCTA5 93250,3594,1685,1909,15318,28,9647,109,137,0.008943726,3774,11544
ZCTA5 93251,87,169,-82,281,31.9,203,0,0,0,403,-122
ZCTA5 93252,565,2866,-2301,1646,35.8,1327,28,0,0,9816,-8170
ZCTA5 93254,382,169,213,986,44.1,791,7,0,0,850,136
ZCTA5 93255,448,3864,-3416,883,62.2,784,39,0,0,14001,-13118
ZCTA5 93256,1540,247,1293,5823,29.6,3098,141,241,0.041387601,1234,4589
ZCTA5 93257,23034,2970,20064,78754,31.6,46689,3477,396,0.005028316,10276,68478
ZCTA5 93258,383,12963,-12580,1158,36.6,531,125,0,0,35882,-34724
ZCTA5 93260,86,16988,-16902,158,62.3,158,0,0,0,46070,-45912
ZCTA5 93261,552,15532,-14980,1906,34.6,1176,30,0,0,38817,-36911
ZCTA5 93262,0,8376,-8376,29,-,29,0,0,0,20927,-20898
ZCTA5 93263,5723,11717,-5994,22642,27.8,14201,113,353,0.015590496,40068,-17426
ZCTA5 93265,1346,11567,-10221,3308,44.9,2860,130,2,0.000604595,26549,-23241
ZCTA5 93266,397,468,-71,1889,24.4,937,0,0,0,948,941
ZCTA5 93267,1833,127,1706,6079,36.6,4363,14,0,0,298,5781
ZCTA5 93268,5993,606,5387,18113,31,13855,301,128,0.007066748,1631,16482
ZCTA5 93270,1530,102,1428,4806,39.1,3588,0,0,0,218,4588
ZCTA5 93271,1184,241,943,2401,51.8,2048,139,54,0.022490629,591,1810
ZCTA5 93272,1138,639,499,4598,27.1,3016,0,7,0.001522401,1400,3198
ZCTA5 93274,22146,6631,15515,78369,28.3,50397,1540,2678,0.034171675,15379,62990
ZCTA5 93276,48,1471,-1423,144,34.2,126,0,0,0,3147,-3003
ZCTA5 93277,18755,4014,14741,54649,33.6,35286,2084,1892,0.034620945,10555,44094
ZCTA5 93280,6506,830,5676,28337,30.6,14867,286,1582,0.055828069,2344,25993
ZCTA5 93283,1031,163,868,2228,59.5,2085,0,0,0,278,1950
ZCTA5 93285,1212,954,258,2087,62.1,1943,0,0,0,2528,-441
ZCTA5 93286,2874,57,2817,10500,28.6,5959,100,80,0.007619048,114,10386
ZCTA5 93287,44,0,44,93,29.4,71,0,0,0,0,93
ZCTA5 93291,18167,0,18167,61418,32.3,32454,5666,932,0.015174704,538,60880
ZCTA5 93292,13737,233,13504,43508,32.1,25537,1416,702,0.016134964,514,42994
ZCTA5 93301,5190,37,5153,14004,28.6,6993,243,2590,0.184947158,166,13838
ZCTA5 93304,15219,2438,12781,49647,29.7,23012,1138,4093,0.082442041,5355,44292
ZCTA5 93305,10842,5837,5005,37904,27.6,22627,398,2607,0.068779021,14193,23711
ZCTA5 93306,21818,261,21557,74518,32.1,45887,2447,2474,0.033200032,727,73791
ZCTA5 93307,22520,713,21807,87133,27.4,55245,2075,6052,0.069457037,2301,84832
ZCTA5 93308,19677,1524,18153,54857,35.7,41577,1352,1364,0.024864648,3575,51282
ZCTA5 93309,22310,110,22200,62804,31.5,35128,2954,6005,0.095614929,251,62553
ZCTA5 93311,15676,338,15338,48722,33,28558,7538,2846,0.058413037,903,47819
ZCTA5 93312,18220,836,17384,57625,33.6,39450,3750,1996,0.034637744,1758,55867
ZCTA5 93313,16231,2392,13839,61245,30.4,32656,6889,3859,0.063009225,4788,56457
ZCTA5 93314,10412,6590,3822,33134,35.6,25357,2558,778,0.023480413,16645,16489
ZCTA5 93401,12612,521,12091,28654,36.4,23807,1334,646,0.022544845,1518,27136
ZCTA5 93402,6237,90,6147,15692,47.9,12809,658,57,0.003632424,191,15501
ZCTA5 93405,8332,4307,4025,25081,22.8,20778,1451,266,0.010605638,11565,13516
ZCTA5 93407,5,493,-488,457,19,342,50,6,0.013129103,1070,-613
ZCTA5 93408,0,4598,-4598,32,18.8,22,0,10,0.3125,11054,-11022
ZCTA5 93409,0,954,-954,2989,42.3,755,142,1276,0.426898628,2226,763
ZCTA5 93410,0,397,-397,7021,19.3,4636,1497,68,0.00968523,943,6078
ZCTA5 93420,12182,1352,10830,31864,47,25664,1062,367,0.0115177,3369,28495
ZCTA5 93422,13049,1336,11713,33195,41.8,28325,540,311,0.009368881,3049,30146
ZCTA5 93424,570,250,320,1075,63.7,909,31,0,0,605,470
ZCTA5 93426,551,1246,-695,1591,41,1375,18,10,0.006285355,2406,-815
ZCTA5 93427,2191,1349,842,5913,39.8,5225,80,19,0.003213259,3811,2102
ZCTA5 93428,2830,624,2206,5721,60.6,4795,61,12,0.002097535,1377,4344
ZCTA5 93429,37,0,37,55,76.2,46,0,0,0,0,55
ZCTA5 93430,1277,968,309,2624,60.1,2355,61,0,0,2132,492
ZCTA5 93432,424,1052,-628,1039,45.9,991,0,0,0,2235,-1196
ZCTA5 93433,5067,241,4826,12846,39.8,9892,323,250,0.019461311,956,11890
ZCTA5 93434,2051,2066,-15,8138,28.3,3959,396,21,0.002580487,5679,2459
ZCTA5 93436,17701,545,17156,56165,35.4,32265,2188,1618,0.028807976,1222,54943
ZCTA5 93437,1097,659,438,3638,24.2,2316,158,546,0.150082463,1915,1723
ZCTA5 93440,491,2144,-1653,1354,45.2,1009,15,43,0.031757755,6070,-4716
ZCTA5 93441,411,208,203,1059,56.7,966,6,0,0,425,634
ZCTA5 93442,5107,12430,-7323,11250,51.5,9094,574,24,0.002133333,29118,-17868
ZCTA5 93444,7327,15189,-7862,22032,41.8,15802,367,364,0.016521423,37602,-15570
ZCTA5 93445,2843,11910,-9067,7061,45.3,4900,154,142,0.020110466,33163,-26102
ZCTA5 93446,17239,907,16332,46048,39.2,36719,1481,201,0.00436501,2115,43933
ZCTA5 93449,4283,17,4266,8058,58.2,6888,216,99,0.012285927,17,8041
ZCTA5 93450,224,167,57,798,30.7,335,0,0,0,254,544
ZCTA5 93451,1586,5310,-3724,4811,38.4,3549,42,4,0.000831428,12602,-7791
ZCTA5 93452,238,9898,-9660,510,33.1,498,12,0,0,28844,-28334
ZCTA5 93453,1206,128,1078,2449,57.1,2122,0,104,0.042466313,274,2175
ZCTA5 93454,11721,48,11673,41324,31.7,25781,1658,514,0.012438293,153,41171
ZCTA5 93455,15517,456,15061,44091,38.3,31132,1955,1015,0.023020571,762,43329
ZCTA5 93458,13830,9725,4105,59814,26.1,34197,2434,457,0.007640352,23800,36014
ZCTA5 93460,2260,9906,-7646,5933,46.7,4932,89,47,0.007921793,24717,-18784
ZCTA5 93461,479,173,306,1442,37.6,1006,0,5,0.003467406,430,1012
ZCTA5 93463,3588,91,3497,8598,52.9,7356,274,270,0.031402652,187,8411
ZCTA5 93465,3740,7482,-3742,10192,46.9,8526,86,0,0,19135,-8943
ZCTA5 93501,1855,7935,-6080,5128,38.9,2361,112,822,0.160296412,20108,-14980
ZCTA5 93505,4512,810,3702,14914,34,7424,276,3373,0.226163336,2133,12781
ZCTA5 93510,2420,667,1753,7010,46.5,5678,174,72,0.010271041,1768,5242
ZCTA5 93512,100,149,-49,284,63.2,244,0,0,0,410,-126
ZCTA5 93513,660,259,401,1636,42.5,1003,18,34,0.020782396,562,1074
ZCTA5 93514,5980,409,5571,14949,43.8,11150,265,44,0.002943341,1079,13870
ZCTA5 93516,1051,8145,-7094,2548,35.5,1402,153,174,0.068288854,24301,-21753
ZCTA5 93517,235,1212,-977,592,60,330,94,3,0.005067568,3065,-2473
ZCTA5 93518,415,60,355,918,61.8,847,4,20,0.021786492,120,798
ZCTA5 93519,0,4921,-4921,0,-,0,0,0,#DIV/0!,13159,-13159
ZCTA5 93522,36,876,-840,74,64.1,39,0,0,0,2259,-2185
ZCTA5 93523,1210,267,943,3876,25.8,2543,168,303,0.078173375,628,3248
ZCTA5 93524,0,26,-26,108,21.4,54,5,24,0.222222222,61,47
ZCTA5 93526,318,1127,-809,790,42.9,551,1,8,0.010126582,3424,-2634
ZCTA5 93527,859,492,367,1705,58.5,1583,0,20,0.011730205,1244,461
ZCTA5 93528,45,492,-447,90,35.6,30,60,0,0,1658,-1568
ZCTA5 93529,114,353,-239,263,63.9,239,24,0,0,813,-550
ZCTA5 93530,31,87,-56,31,80.1,31,0,0,0,226,-195
ZCTA5 93531,163,671,-508,371,52.2,348,23,0,0,2009,-1638
ZCTA5 93532,992,217,775,2745,35.7,2077,88,93,0.033879781,425,2320
ZCTA5 93534,15438,430,15008,43535,33.2,19324,1210,11201,0.25728724,1073,42462
ZCTA5 93535,22797,214,22583,79522,31.1,39099,2043,16474,0.207162798,476,79046
ZCTA5 93536,22752,142,22610,73417,36.9,42444,4086,9160,0.124766743,335,73082
ZCTA5 93541,202,240,-38,353,38.9,275,0,0,0,649,-296
ZCTA5 93543,3573,146,3427,13793,34.7,6008,142,352,0.025520191,312,13481
ZCTA5 93544,574,127,447,1511,48.1,906,0,217,0.143613501,164,1347
ZCTA5 93545,647,504,143,1629,43.8,1279,3,2,0.001227747,1098,531
ZCTA5 93546,3631,1309,2322,8779,38.2,7278,475,15,0.001708623,3388,5391
ZCTA5 93549,138,270,-132,258,60.6,241,9,0,0,585,-327
ZCTA5 93550,22825,192,22633,82580,30.2,27867,2451,11488,0.139113587,521,82059
ZCTA5 93551,16820,392,16428,54808,37,28860,4312,5544,0.101153116,1038,53770
ZCTA5 93552,10897,799,10098,43118,32.5,19035,1088,5250,0.121758894,1909,41209
ZCTA5 93553,537,53,484,1056,62.1,847,10,5,0.004734848,128,928
ZCTA5 93554,44,116,-72,78,73.1,78,0,0,0,319,-241
ZCTA5 93555,13093,1030,12063,33060,37.5,24719,1558,1297,0.0392317,2103,30957
ZCTA5 93558,8,37,-29,17,-,17,0,0,0,59,-42
ZCTA5 93560,6736,754,5982,21195,31.4,13263,218,2078,0.098041991,1507,19688
ZCTA5 93561,12250,171,12079,31281,40.7,26135,542,393,0.012563537,440,30841
ZCTA5 93562,742,55,687,1757,40.3,1498,17,79,0.044963005,117,1640
ZCTA5 93563,38,514,-476,247,31.1,143,4,50,0.20242915,1127,-880
ZCTA5 93581,0,97,-97,4284,40.9,2311,120,698,0.162931839,176,4108
ZCTA5 93591,2022,80,1942,6914,32.1,3495,189,402,0.058142898,183,6731
ZCTA5 93601,582,6955,-6373,1455,55.8,1298,0,0,0,17687,-16232
ZCTA5 93602,1287,11441,-10154,3089,54.2,2616,18,23,0.007445775,28113,-25024
ZCTA5 93603,133,0,133,268,63.3,268,0,0,0,0,268
ZCTA5 93604,154,4708,-4554,343,62.8,334,0,0,0,13706,-13363
ZCTA5 93605,39,56,-17,126,30.2,115,0,0,0,114,12
ZCTA5 93606,227,153,74,1138,23.6,698,133,0,0,331,807
ZCTA5 93608,336,25097,-24761,1180,26.8,590,0,0,0,60288,-59108
ZCTA5 93609,1439,16666,-15227,5309,31.8,2592,218,212,0.039932191,43805,-38496
ZCTA5 93610,4887,496,4391,23575,34.6,12382,985,1328,0.056330859,1056,22519
ZCTA5 93611,15078,1532,13546,47099,37.5,30372,5038,1769,0.037559184,3972,43127
ZCTA5 93612,13740,251,13489,36833,33.9,21769,3330,1033,0.028045503,1025,35808
ZCTA5 93614,4393,16601,-12208,11951,44.1,9637,164,138,0.011547151,49138,-37187
ZCTA5 93615,1407,9353,-7946,5994,26.5,2424,82,207,0.034534535,26397,-20403
ZCTA5 93616,668,1894,-1226,2379,32.2,1152,94,0,0,5220,-2841
ZCTA5 93618,8228,6877,1351,32044,27.9,19171,256,113,0.003526401,20638,11406
ZCTA5 93619,14936,15899,-963,48320,35.5,33712,6435,1009,0.020881623,40829,7491
ZCTA5 93620,2775,1514,1261,8865,34.7,4429,48,183,0.020642978,3934,4931
ZCTA5 93621,14,18387,-18373,31,62.9,30,1,0,0,59573,-59542
ZCTA5 93622,2699,45,2654,9483,29.8,4309,6,9,0.000949067,192,9291
ZCTA5 93623,0,1869,-1869,9,63.2,2,2,0,0,6050,-6041
ZCTA5 93624,204,1077,-873,1016,28.3,152,22,34,0.033464567,3270,-2254
ZCTA5 93625,2581,15996,-13415,8273,34.7,5504,843,49,0.005922882,39863,-31590
ZCTA5 93626,822,335,487,2255,41.3,1610,179,107,0.047450111,907,1348
ZCTA5 93627,68,24215,-24147,373,21.3,20,0,0,0,71676,-71303
ZCTA5 93628,226,2285,-2059,274,26.9,274,0,0,0,5624,-5350
ZCTA5 93630,5601,9215,-3614,20736,28.9,10023,603,94,0.004533179,29793,-9057
ZCTA5 93631,5430,1356,4074,16738,37.6,11771,1501,98,0.005854941,3442,13296
ZCTA5 93633,0,1174,-1174,0,-,0,0,0,#DIV/0!,3239,-3239
ZCTA5 93634,0,446,-446,22,29.3,6,0,10,0.454545455,1109,-1087
ZCTA5 93635,12686,274,12412,46606,29.1,22345,1097,1012,0.021713942,878,45728
ZCTA5 93636,3991,161,3830,12921,41.3,8889,445,346,0.026778113,605,12316
ZCTA5 93637,11645,705,10940,40996,32.7,20103,854,1308,0.031905552,2213,38783
ZCTA5 93638,12433,74,12359,51669,28.9,21976,981,1463,0.02831485,244,51425
ZCTA5 93640,3033,2521,512,13884,27,5067,39,244,0.017574186,11024,2860
ZCTA5 93641,90,759,-669,188,58.2,139,2,15,0.079787234,1704,-1516
ZCTA5 93643,1180,2886,-1706,2836,51.3,1974,38,2,0.000705219,6736,-3900
ZCTA5 93644,3283,659,2624,7889,50.8,7292,64,38,0.004816834,1716,6173
ZCTA5 93645,132,35,97,494,47.1,360,0,0,0,105,389
ZCTA5 93646,2715,17910,-15195,10425,24.9,5977,7,131,0.012565947,46870,-36445
ZCTA5 93647,2874,4279,-1405,11575,29.1,5632,612,134,0.011576674,11504,71
ZCTA5 93648,3938,184,3754,15507,29,10737,69,40,0.00257948,511,14996
ZCTA5 93650,840,196,644,2646,35.7,960,160,124,0.04686319,776,1870
ZCTA5 93651,606,138,468,1802,31.7,1381,15,32,0.017758047,444,1358
ZCTA5 93652,129,1591,-1462,420,37.2,251,13,0,0,4687,-4267
ZCTA5 93653,572,2577,-2005,1370,48.7,1224,21,0,0,6664,-5294
ZCTA5 93654,8248,245,8003,29697,31.4,17649,954,702,0.023638751,679,29018
ZCTA5 93656,1621,10127,-8506,5777,35,2782,120,5,0.000865501,31443,-25666
ZCTA5 93657,10627,11718,-1091,35854,33.2,22677,1555,86,0.002398617,30373,5481
ZCTA5 93660,868,11816,-10948,3826,25.2,1706,0,37,0.009670674,31672,-27846
ZCTA5 93662,8757,842,7915,30123,32.3,20022,721,366,0.012150184,2749,27374
ZCTA5 93664,184,433,-249,321,67.4,277,2,0,0,1169,-848
ZCTA5 93665,83,2006,-1923,247,28,150,0,97,0.392712551,4392,-4145
ZCTA5 93666,184,2434,-2250,741,21.8,347,0,0,0,5504,-4763
ZCTA5 93667,802,14364,-13562,2005,52.9,1612,0,0,0,36175,-34170
ZCTA5 93668,300,317,-17,1126,37.6,376,0,0,0,908,218
ZCTA5 93669,89,1072,-983,312,57.4,291,0,0,0,2682,-2370
ZCTA5 93670,67,19980,-19913,263,52.1,0,0,0,0,53678,-53415
ZCTA5 93673,121,1827,-1706,551,27.4,393,0,0,0,5390,-4839
ZCTA5 93675,1285,4766,-3481,4062,41.7,3360,287,46,0.011324471,14641,-10579
ZCTA5 93701,3699,284,3415,10123,30.2,4603,619,783,0.077348612,803,9320
ZCTA5 93702,12674,238,12436,45095,29.1,21212,5335,1341,0.029737221,627,44468
ZCTA5 93703,10324,9066,1258,32329,30.1,14499,3922,2529,0.078226979,22928,9401
ZCTA5 93704,11475,15998,-4523,29184,36.9,18969,1416,1328,0.045504386,42135,-12951
ZCTA5 93705,12791,35,12756,37763,32.2,19216,2374,3391,0.089796891,35,37728
ZCTA5 93706,11653,22,11631,41470,30.1,19582,3270,4843,0.116783217,152,41318
ZCTA5 93710,12170,420,11750,33507,30.7,19846,3037,2008,0.059927776,1317,32190
ZCTA5 93711,15949,10781,5168,39085,40,25722,4067,1488,0.038070871,29269,9816
ZCTA5 93720,18500,2579,15921,48148,38.1,30380,8259,1402,0.029118551,6651,41497
ZCTA5 93721,2414,1370,1044,8168,34.6,3913,281,1007,0.123285994,2905,5263
ZCTA5 93722,26424,1963,24461,88116,31.7,37024,14395,9189,0.104282991,4405,83711
ZCTA5 93723,3249,354,2895,13109,32.3,4926,3119,644,0.049126554,1014,12095
ZCTA5 93725,6820,21147,-14327,26620,29.3,12410,4135,1089,0.040909091,65634,-39014
ZCTA5 93726,14643,12447,2196,45330,29.6,22861,3804,2857,0.063026693,34385,10945
ZCTA5 93727,23239,610,22629,79596,31.1,33945,21517,3784,0.047540077,1130,78466
ZCTA5 93728,6116,717,5399,17779,31.7,10862,453,485,0.027279375,2010,15769
ZCTA5 93730,4602,12722,-8120,12810,43.1,8439,2477,243,0.018969555,34676,-21866
ZCTA5 93737,2044,1681,363,7051,35.3,3670,1761,90,0.012764147,4968,2083
ZCTA5 93740,0,2046,-2046,1237,19.4,546,165,104,0.084074373,5616,-4379
ZCTA5 93741,56,3258,-3202,63,31.6,17,0,2,0.031746032,9739,-9676
ZCTA5 93901,10494,13970,-3476,29295,36.1,12806,1823,391,0.013346988,37556,-8261
ZCTA5 93905,13709,157,13552,63949,28.1,11388,1702,573,0.008960265,455,63494
ZCTA5 93906,17729,78,17651,66223,32.7,20274,5059,1114,0.01682195,263,65960
ZCTA5 93907,7157,92,7065,24667,39.9,11045,2083,547,0.022175376,163,24504
ZCTA5 93908,4379,319,4060,12605,43.5,8650,911,23,0.001824673,760,11845
ZCTA5 93920,569,416,153,1701,38.4,1158,0,0,0,1082,619
ZCTA5 93921,1365,2062,-697,2564,63.8,2379,15,1,0.000390016,4905,-2341
ZCTA5 93923,5375,3735,1640,12758,60.4,11056,709,58,0.004546167,9428,3330
ZCTA5 93924,2615,192,2423,6416,57.4,5490,47,103,0.016053616,335,6081
ZCTA5 93925,342,33,309,1513,31.1,292,0,0,0,67,1446
ZCTA5 93926,2418,98,2320,9086,29.3,1516,109,2,0.000220119,234,8852
ZCTA5 93927,4402,54,4348,19665,28,4672,202,178,0.009051615,93,19572
ZCTA5 93928,0,13,-13,904,25,650,93,73,0.080752212,13,891
ZCTA5 93930,4423,1749,2674,16945,31.4,4373,545,24,0.001416347,4417,12528
ZCTA5 93932,215,0,215,477,54.8,452,19,0,0,0,477
ZCTA5 93933,9180,3391,5789,26301,34.6,13351,3943,1673,0.063609749,8769,17532
ZCTA5 93940,14534,212,14322,32273,42.1,23490,2394,1056,0.03272085,352,31921
ZCTA5 93943,0,11,-11,0,-,0,0,0,#DIV/0!,29,-29
ZCTA5 93944,0,36,-36,2017,21.7,1550,141,78,0.038671294,264,1753
ZCTA5 93950,6731,2637,4094,15169,48,12255,1120,113,0.007449403,8141,7028
ZCTA5 93953,1701,7852,-6151,3619,63.9,3125,361,6,0.001657917,23441,-19822
ZCTA5 93954,100,18740,-18640,446,27.8,110,0,0,0,51513,-51067
ZCTA5 93955,10493,10804,-311,32979,33.9,17643,2997,2356,0.071439401,41246,-8267
ZCTA5 93960,4090,20081,-15991,26357,35.1,7921,570,2351,0.089198315,61247,-34890
ZCTA5 93962,121,13409,-13288,203,70.4,138,0,0,0,39749,-39546
ZCTA5 94002,11013,11987,-974,28201,40.3,15389,8410,355,0.012588206,34508,-6307
ZCTA5 94005,1997,6781,-4784,4803,43.8,2442,1516,62,0.012908599,21962,-17159
ZCTA5 94010,16244,4083,12161,43644,41.8,25015,12608,522,0.011960407,7309,36335
ZCTA5 94014,13980,4915,9065,47708,40.7,10044,24600,1352,0.028339063,9242,38466
ZCTA5 94015,20236,8941,11295,64754,40.1,12252,38899,2604,0.040213732,25406,39348
ZCTA5 94018,1392,9326,-7934,3636,48.4,3191,40,0,0,16133,-12497
ZCTA5 94019,5298,5935,-637,15452,45.3,10828,767,91,0.005889205,13978,1474
ZCTA5 94020,845,9584,-8739,2186,52.2,1842,158,0,0,19866,-17680
ZCTA5 94021,90,7553,-7463,263,44.7,263,0,0,0,16805,-16542
ZCTA5 94022,7263,12101,-4838,20069,47.9,11313,7255,60,0.002989686,33412,-13343
ZCTA5 94024,8036,14239,-6203,24203,47.1,14341,7677,227,0.009379003,32558,-8355
ZCTA5 94025,14512,15211,-699,41826,38.6,26753,6773,1232,0.029455363,42185,-359
ZCTA5 94027,2260,23002,-20742,7213,48.1,5294,1333,85,0.011784278,73832,-66619
ZCTA5 94028,2482,9139,-6657,6582,55.1,5534,390,3,0.000455789,30973,-24391
ZCTA5 94030,8108,15193,-7085,23083,44.9,8576,11078,110,0.004765412,31870,-8787
ZCTA5 94037,1040,15083,-14043,2879,55.4,2531,19,0,0,37064,-34185
ZCTA5 94038,1109,7352,-6243,3227,43.3,2551,160,15,0.00464828,20095,-16868
ZCTA5 94040,14975,17584,-2609,35800,35.2,16885,12927,437,0.012206704,59266,-23466
ZCTA5 94041,6310,7574,-1264,14862,34.4,8078,3564,478,0.032162562,26010,-11148
ZCTA5 94043,13429,223,13206,33052,36.1,15437,11261,1488,0.045019969,787,32265
ZCTA5 94044,14000,18248,-4248,38609,43.4,22706,8214,1005,0.0260302,42052,-3443
ZCTA5 94060,367,3085,-2718,1293,41.3,589,22,0,0,12507,-11214
ZCTA5 94061,13256,14020,-764,38255,36.8,20275,4882,776,0.02028493,37746,509
ZCTA5 94062,9668,8829,839,26847,44.5,20942,2146,435,0.016202928,24063,2784
ZCTA5 94063,10907,13092,-2185,35163,33.2,13651,3387,998,0.028382106,38729,-3566
ZCTA5 94065,4731,120,4611,11772,42.5,5015,5245,94,0.007985049,289,11483
ZCTA5 94066,15308,10392,4916,43846,39.1,16221,15050,594,0.013547416,35849,7997
ZCTA5 94070,11611,7402,4209,31477,40.9,21210,5750,231,0.007338692,18216,13261
ZCTA5 94074,58,11321,-11263,140,42.4,60,0,0,0,31965,-31825
ZCTA5 94080,22016,13974,8042,66652,42,20182,28914,1275,0.019129208,46143,20509
ZCTA5 94085,8795,9289,-494,23805,32.9,6576,10062,430,0.018063432,21538,2267
ZCTA5 94086,19461,11101,8360,48482,33.5,17779,22811,557,0.0114888,32278,16204
ZCTA5 94087,20576,489,20087,59771,37.8,21558,30768,709,0.01186194,2039,57732
ZCTA5 94089,8733,44,8689,23492,35.8,7737,10968,347,0.014770986,83,23409
ZCTA5 94102,19213,1534,17679,33856,39.6,11945,10130,3632,0.107277883,4799,29057
ZCTA5 94103,16373,277,16096,32430,36.4,11816,10819,2785,0.085877274,739,31691
ZCTA5 94104,234,48,186,504,51.5,154,274,19,0.037698413,59,445
ZCTA5 94105,7156,533,6623,13810,33.5,5757,7078,199,0.014409848,1210,12600
ZCTA5 94107,14248,1046,13202,28607,34.9,15278,7925,1189,0.041563254,3073,25534
ZCTA5 94108,6583,802,5781,11963,41.8,4214,6378,256,0.021399315,1740,10223
ZCTA5 94109,32183,674,31509,56114,37.2,32345,15050,2367,0.042181987,1595,54519
ZCTA5 94110,26765,101,26664,70859,38.3,35981,10915,2576,0.036353886,381,70478
ZCTA5 94111,2368,304,2064,4707,44.6,2193,2052,162,0.034416826,560,4147
ZCTA5 94112,23480,20,23460,84477,42.5,18002,43023,2795,0.033085929,25,84452
ZCTA5 94114,17121,78,17043,34474,40.9,24366,4777,964,0.027963103,305,34169
ZCTA5 94115,17009,14562,2447,34193,36.7,18358,6742,3687,0.107829088,37613,-3420
ZCTA5 94116,15583,14044,1539,45510,44.1,15281,24568,537,0.011799604,36517,8993
ZCTA5 94117,17650,0,17650,40701,34.4,28656,4957,2120,0.052087172,0,40701
ZCTA5 94118,17485,2815,14670,41456,36.9,22014,13753,681,0.016427055,7795,33661
ZCTA5 94121,18051,106,17945,43964,41.6,20005,18297,763,0.017355109,305,43659
ZCTA5 94122,22649,150,22499,60144,41,23348,27067,1140,0.018954509,322,59822
ZCTA5 94123,12992,140,12852,26002,33.6,20187,2447,242,0.009306976,326,25676
ZCTA5 94124,10665,362,10303,35982,37.7,4381,13055,10438,0.290089489,1160,34822
ZCTA5 94127,7325,1540,5785,20927,45.9,11314,5505,668,0.031920485,4000,16927
ZCTA5 94128,0,151,-151,0,-,0,0,0,#DIV/0!,474,-474
ZCTA5 94129,1340,148,1192,4199,31.8,2611,315,75,0.017861396,410,3789
ZCTA5 94130,650,555,95,3185,27.8,1398,289,586,0.183987441,1398,1787
ZCTA5 94131,12764,317,12447,29437,41,17388,6317,1265,0.042973129,889,28548
ZCTA5 94132,10697,30,10667,29707,36.5,8945,13109,2442,0.082202848,67,29640
ZCTA5 94133,13151,10944,2207,26090,45.1,9402,13629,687,0.026331928,24235,1855
ZCTA5 94134,12660,4540,8120,41977,43,6429,24887,2382,0.056745361,10155,31822
ZCTA5 94158,4827,813,4014,10658,34.5,4288,4322,478,0.04484894,1698,8960
ZCTA5 94188,0,3442,-3442,0,-,0,0,0,#DIV/0!,10501,-10501
ZCTA5 94301,7145,8446,-1301,17243,45.4,10687,4218,438,0.025401612,20810,-3567
ZCTA5 94303,14451,175,14276,48487,36.3,18710,10519,3540,0.07300926,839,47648
ZCTA5 94304,1893,705,1188,4295,39.9,2802,858,69,0.016065192,2654,1641
ZCTA5 94305,3545,3076,469,16469,22.1,9352,4001,638,0.03873945,10447,6022
ZCTA5 94306,10698,5090,5608,28394,40.7,14477,10448,612,0.021553849,12336,16058
ZCTA5 94401,12869,403,12466,35095,35.6,14235,7854,638,0.018179228,1189,33906
ZCTA5 94402,10282,191,10091,27188,40.1,16238,6144,423,0.015558335,421,26767
ZCTA5 94403,16895,330,16565,44244,38.3,21655,12964,975,0.022036886,950,43294
ZCTA5 94404,14137,7387,6750,36571,40.3,13560,18605,916,0.025047169,17697,18874
ZCTA5 94501,25516,380,25136,63588,40.2,29867,18337,4315,0.067858715,929,62659
ZCTA5 94502,4984,7998,-3014,14732,42.6,6314,6184,452,0.03068151,26300,-11568
ZCTA5 94503,5622,477,5145,21874,37.2,6965,7332,1657,0.075752034,1282,20592
ZCTA5 94505,5546,5147,399,15796,43.8,12109,909,594,0.037604457,15302,494
ZCTA5 94506,9286,7161,2125,27375,46.4,15844,7828,942,0.034410959,20709,6666
ZCTA5 94507,4989,11566,-6577,13906,52.4,11389,1478,106,0.007622609,30909,-17003
ZCTA5 94508,1017,480,537,3680,30,2373,498,245,0.066576087,1534,2146
ZCTA5 94509,22921,12331,10590,71669,36.5,28446,6085,12607,0.175905901,27385,44284
ZCTA5 94510,10883,159,10724,27327,45.2,18910,3160,975,0.035678999,402,26925
ZCTA5 94511,864,2586,-1722,2119,51.3,1581,61,0,0,5789,-3670
ZCTA5 94512,0,12410,-12410,0,-,0,0,0,#DIV/0!,32008,-32008
ZCTA5 94513,21326,0,21326,66087,40.9,38282,8014,6067,0.091803229,0,66087
ZCTA5 94514,582,785,-203,2283,31.9,1496,49,51,0.022339028,1914,369
ZCTA5 94515,2730,486,2244,7269,50.1,5374,88,46,0.006328243,1394,5875
ZCTA5 94516,77,27,50,218,61.2,188,0,0,0,27,191
ZCTA5 94517,4359,253,4106,12200,43.8,9230,1302,254,0.020819672,475,11725
ZCTA5 94518,10216,105,10111,28201,40.5,17167,3284,714,0.025318251,180,28021
ZCTA5 94519,7082,1212,5870,20495,38,11329,2870,432,0.021078312,3082,17413
ZCTA5 94520,13095,309,12786,36107,34.4,15129,4616,1622,0.044922037,693,35414
ZCTA5 94521,15676,46,15630,42388,42.2,27293,6327,1770,0.041757101,80,42308
ZCTA5 94523,13969,19,13950,34957,41.6,23559,5156,1368,0.039133793,19,34938
ZCTA5 94525,1529,1638,-109,3434,47.3,2428,113,364,0.105998835,6059,-2625
ZCTA5 94526,12655,3267,9388,33473,47,26974,4157,125,0.003734353,8789,24684
ZCTA5 94528,232,14154,-13922,655,48.2,608,23,0,0,40172,-39517
ZCTA5 94530,10761,11721,-960,26461,41.8,13515,7396,1196,0.045198594,36715,-10254
ZCTA5 94531,12807,13348,-541,43067,38.4,13381,8562,10466,0.243016695,33805,9262
ZCTA5 94533,24343,12402,11941,79665,33.9,31973,12129,13995,0.175673131,33360,46305
ZCTA5 94534,13267,17464,-4197,39318,41.3,18620,9186,4587,0.116664123,45295,-5977
ZCTA5 94535,1009,251,758,3663,22,2295,230,370,0.101010101,582,3081
ZCTA5 94536,24776,8878,15898,72744,38.3,21739,35559,2809,0.038614869,22304,50440
ZCTA5 94538,21726,443,21283,66474,36.2,13941,37136,2233,0.033592081,1196,65278
ZCTA5 94539,16409,194,16215,53762,42.2,8397,40823,911,0.016945054,552,53210
ZCTA5 94541,22134,93,22041,69294,37.3,23487,12482,9047,0.130559644,209,69085
ZCTA5 94542,5029,64,4965,16705,37.9,6845,4003,1486,0.088955403,116,16589
ZCTA5 94544,23037,1557,21480,77692,35.8,16803,21787,6696,0.08618648,3358,74334
ZCTA5 94545,9966,119,9847,33496,40.8,6579,13768,2599,0.077591354,251,33245
ZCTA5 94546,16218,85,16133,46169,42,22549,12819,3174,0.068747428,645,45524
ZCTA5 94547,9068,159,8909,26050,42.7,7071,11122,4599,0.176545106,530,25520
ZCTA5 94548,185,94,91,470,29.9,345,0,0,0,232,238
ZCTA5 94549,10108,3914,6194,28545,45.3,22474,2959,126,0.004414083,10114,18431
ZCTA5 94550,17450,1072,16378,50119,42.9,35778,7054,801,0.015981963,2488,47631
ZCTA5 94551,14391,5341,9050,40552,38.7,24182,6049,834,0.020566187,15932,24620
ZCTA5 94552,5048,6022,-974,15131,48.3,6192,6400,841,0.055581257,17063,-1932
ZCTA5 94553,19163,463,18700,49230,41.2,33628,5077,1830,0.037172456,1190,48040
ZCTA5 94555,11718,501,11217,38522,37.7,5671,28571,630,0.016354291,1190,37332
ZCTA5 94556,5534,1118,4416,15672,44.1,10560,3315,87,0.005551302,2243,13429
ZCTA5 94558,24070,982,23088,66345,43.5,48612,1623,552,0.008320145,2353,63992
ZCTA5 94559,10131,555,9576,27913,38.4,20236,950,198,0.007093469,1552,26361
ZCTA5 94560,14354,57,14297,47815,36.5,13656,18529,1679,0.035114504,130,47685
ZCTA5 94561,12924,71,12853,44088,35.4,25381,3188,3747,0.084989113,169,43919
ZCTA5 94562,0,967,-967,0,-,0,0,0,#DIV/0!,2258,-2258
ZCTA5 94563,7226,173,7053,19454,49,14216,2853,117,0.006014187,402,19052
ZCTA5 94564,6794,156,6638,19065,42.6,7595,5037,2130,0.111723053,300,18765
ZCTA5 94565,29146,1170,27976,100700,34.7,28936,16051,13448,0.133545184,3372,97328
ZCTA5 94566,16088,127,15961,45648,43.5,24376,15670,632,0.013845075,303,45345
ZCTA5 94567,241,237,4,787,45.4,582,6,0,0,478,309
ZCTA5 94568,22946,584,22362,69818,36.5,22853,36974,2618,0.037497493,1279,68539
ZCTA5 94569,169,94,75,247,67.1,216,0,0,0,177,70
ZCTA5 94571,5320,1158,4162,10776,63.3,8326,440,1241,0.115163326,2790,7986
ZCTA5 94572,3234,491,2743,9546,38.3,3564,2122,1486,0.155667295,1122,8424
ZCTA5 94573,34,119,-85,85,30,85,0,0,0,257,-172
ZCTA5 94574,3443,307,3136,7859,49.1,6263,167,43,0.005471434,826,7033
ZCTA5 94575,0,354,-354,1156,20,724,176,58,0.05017301,1078,78
ZCTA5 94576,52,42,10,78,73.6,62,16,0,0,109,-31
ZCTA5 94577,16954,219,16735,49123,40.6,17034,14055,6343,0.12912485,460,48663
ZCTA5 94578,14091,501,13590,42370,37.5,11109,12089,7760,0.183148454,1126,41244
ZCTA5 94579,6607,752,5855,21034,44.1,6159,9926,562,0.026718646,1817,19217
ZCTA5 94580,8938,103,8835,30262,40.2,10644,10352,1113,0.036778798,291,29971
ZCTA5 94582,16025,1725,14300,47319,40.4,13913,27817,2005,0.042371986,4399,42920
ZCTA5 94583,13361,777,12584,39284,40.9,19586,13867,747,0.019015375,1516,37768
ZCTA5 94585,9486,740,8746,29560,36,10841,5527,5798,0.196143437,1543,28017
ZCTA5 94586,299,295,4,844,48.5,721,90,3,0.003554502,760,84
ZCTA5 94587,20800,275,20525,70828,40.8,13256,39306,3388,0.04783419,649,70179
ZCTA5 94588,12169,20,12149,35532,38.6,14261,15911,881,0.024794551,41,35491
ZCTA5 94589,9731,441,9290,31033,39,8313,7574,5749,0.185254407,1247,29786
ZCTA5 94590,15234,90,15144,38012,38.8,14187,3974,8124,0.213721983,193,37819
ZCTA5 94591,19652,1891,17761,58373,41.1,18191,17574,8927,0.152930293,4277,54096
ZCTA5 94592,425,117,308,1096,32.4,403,430,112,0.102189781,330,766
ZCTA5 94595,9514,3302,6212,17455,68.7,13498,2027,307,0.017588084,7152,10303
ZCTA5 94596,10501,56,10445,23046,38.9,16426,3482,554,0.024038879,219,22827
ZCTA5 94597,10839,398,10441,23725,39.1,14790,5433,893,0.037639621,812,22913
ZCTA5 94598,10430,44,10386,26441,46.4,16949,5031,772,0.02919708,88,26353
ZCTA5 94599,1639,1621,18,3421,62.7,2873,124,110,0.032154341,4740,-1319
ZCTA5 94601,15758,46,15712,52950,34.3,9908,10104,8884,0.167780925,247,52703
ZCTA5 94602,12034,139,11895,31451,42.6,14182,5789,4806,0.152809132,355,31096
ZCTA5 94603,10174,52,10122,35996,32.6,4479,1808,9985,0.277391932,147,35849
ZCTA5 94605,16812,11049,5763,45334,38.9,9712,3861,19154,0.422508493,28149,17185
ZCTA5 94606,15712,318,15394,38595,37.5,10847,12728,6001,0.155486462,579,38016
ZCTA5 94607,11678,18,11660,27022,36.2,7783,6998,7698,0.284878987,31,26991
ZCTA5 94608,15442,205,15237,33755,34.8,14477,5645,7992,0.236764924,402,33353
ZCTA5 94609,10321,224,10097,24623,34.9,11339,2887,5636,0.228891687,487,24136
ZCTA5 94610,15656,1918,13738,32144,38.7,17509,5305,4670,0.145283723,4377,27767
ZCTA5 94611,17675,159,17516,40292,44.9,25738,6716,2868,0.071180383,419,39873
ZCTA5 94612,9429,364,9065,16884,37.4,5901,4236,4182,0.247690121,732,16152
ZCTA5 94613,0,128,-128,737,19.6,402,212,28,0.037991859,269,468
ZCTA5 94618,7409,1590,5819,17324,42.4,12042,2225,669,0.038616948,3786,13538
ZCTA5 94619,9457,2746,6711,26514,38.6,9769,4697,5222,0.196952553,6432,20082
ZCTA5 94621,9900,322,9578,35379,30.8,3898,1058,11184,0.316119732,828,34551
ZCTA5 94702,7094,4260,2834,16557,40,8461,2100,3186,0.192426164,10159,6398
ZCTA5 94703,7962,2051,5911,19857,35.7,11498,2937,2208,0.111195045,4928,14929
ZCTA5 94704,7843,657,7186,25124,21.9,11279,8855,1185,0.047166056,1254,23870
ZCTA5 94705,5837,403,5434,14150,44.1,11072,1363,432,0.030530035,768,13382
ZCTA5 94706,7968,203,7765,20962,36.7,10254,5980,881,0.042028432,625,20337
ZCTA5 94707,4932,160,4772,12313,52.5,9200,1537,133,0.010801592,249,12064
ZCTA5 94708,4574,555,4019,11937,49.3,9213,1274,221,0.018513864,1514,10423
ZCTA5 94709,5084,9,5075,12115,30.6,6879,3471,384,0.031696244,19,12096
ZCTA5 94710,3368,352,3016,8056,36.8,4048,1147,1012,0.125620655,701,7355
ZCTA5 94720,154,47,107,6467,19.5,2618,2458,303,0.046853255,100,6367
ZCTA5 94801,9931,36,9895,33178,33.4,7945,2172,4783,0.144161794,53,33125
ZCTA5 94803,9317,82,9235,27133,44.4,11518,5952,3793,0.139792872,151,26982
ZCTA5 94804,15463,391,15072,43346,35.2,12492,5064,9519,0.219605039,2001,41345
ZCTA5 94805,5578,1119,4459,14783,41.9,6498,2792,1646,0.111344111,3226,11557
ZCTA5 94806,20357,127,20230,65072,35.3,18057,12384,8836,0.13578805,238,64834
ZCTA5 94901,15851,98,15753,42307,40.9,26758,2086,381,0.009005602,199,42108
ZCTA5 94903,12591,82,12509,31150,49.1,22620,2602,810,0.02600321,182,30968
ZCTA5 94904,5643,586,5057,13391,49.5,11260,926,89,0.006646255,1500,11891
ZCTA5 94920,5025,33,4992,12803,49.5,10725,928,28,0.002186987,59,12744
ZCTA5 94922,100,351,-251,504,39.6,248,0,0,0,1054,-550
ZCTA5 94923,556,132,424,1283,53.6,977,0,16,0.012470772,274,1009
ZCTA5 94924,557,1746,-1189,1232,62.7,1111,19,0,0,4147,-2915
ZCTA5 94925,3930,9,3921,10145,44.3,7838,583,206,0.020305569,20,10125
ZCTA5 94928,17183,178,17005,45910,34.2,31251,3155,1594,0.034720105,366,45544
ZCTA5 94929,160,122,38,394,38.8,363,0,0,0,318,76
ZCTA5 94930,3803,52,3751,8796,48.3,7669,333,71,0.008071851,128,8668
ZCTA5 94931,3539,202,3337,8966,39.3,7337,182,85,0.009480259,537,8429
ZCTA5 94933,516,70,446,1185,48.3,847,46,0,0,164,1021
ZCTA5 94937,580,6491,-5911,1109,56.2,1034,0,0,0,22317,-21208
ZCTA5 94938,265,13,252,511,66.2,511,0,0,0,29,482
ZCTA5 94939,3416,71,3345,7274,46.8,5848,410,37,0.00508661,110,7164
ZCTA5 94940,100,1082,-982,368,35,309,0,0,0,2798,-2430
ZCTA5 94941,12469,42,12427,32711,46.1,27683,1808,389,0.011892024,78,32633
ZCTA5 94945,7137,46,7091,17482,51.3,13231,1188,293,0.016760096,161,17321
ZCTA5 94946,285,1799,-1514,657,57.5,624,12,3,0.00456621,3554,-2897
ZCTA5 94947,9236,553,8683,25468,46.3,18123,1592,779,0.030587404,1298,24170
ZCTA5 94949,7082,366,6716,18273,48.2,11602,1383,1101,0.060252832,741,17532
ZCTA5 94950,7,308,-301,7,-,0,0,0,0,726,-719
ZCTA5 94951,1483,1492,-9,3393,56.4,2911,183,0,0,3994,-601
ZCTA5 94952,13510,1358,12152,34457,42.9,26998,891,320,0.009286937,3283,31174
ZCTA5 94954,13929,345,13584,38354,42.6,28604,1819,577,0.015044063,879,37475
ZCTA5 94956,623,218,405,1174,62.2,1126,0,0,0,637,537
ZCTA5 94957,671,11447,-10776,1949,45.7,1724,114,31,0.015905593,29024,-27075
ZCTA5 94960,5988,0,5988,15871,45.7,13638,736,214,0.013483712,0,15871
ZCTA5 94963,129,7158,-7029,317,66.6,317,0,0,0,17935,-17618
ZCTA5 94964,127,13564,-13437,2700,40.1,728,222,677,0.250740741,40268,-37568
ZCTA5 94965,6149,733,5416,11821,51.4,8936,896,884,0.074782167,2375,9446
ZCTA5 94970,300,2350,-2050,594,58.4,567,0,0,0,7101,-6507
ZCTA5 94971,121,720,-599,356,63.5,353,3,0,0,2357,-2001
ZCTA5 94972,38,17113,-17075,142,36.2,142,0,0,0,63491,-63349
ZCTA5 94973,643,11174,-10531,1344,61.8,1175,0,0,0,37138,-35794
ZCTA5 95002,575,3820,-3245,2325,33.1,466,293,37,0.015913978,10586,-8261
ZCTA5 95003,10166,130,10036,25244,48.1,20835,837,161,0.006377753,510,24734
ZCTA5 95004,1398,2573,-1175,4280,46.3,3109,150,35,0.00817757,7720,-3440
ZCTA5 95005,2945,587,2358,8020,43.1,7273,122,28,0.003491272,1801,6219
ZCTA5 95006,3534,449,3085,8873,46.7,7785,93,61,0.006874789,968,7905
ZCTA5 95007,214,869,-655,441,39,350,0,8,0.01814059,2982,-2541
ZCTA5 95008,19327,1458,17869,48786,39.7,27741,12187,1205,0.024699709,5129,43657
ZCTA5 95010,4315,598,3717,8808,49.6,7376,582,18,0.002043597,2548,6260
ZCTA5 95012,2517,16591,-14074,10647,28,3292,341,50,0.004696159,47796,-37149
ZCTA5 95013,18,982,-964,27,59.5,18,9,0,0,2604,-2577
ZCTA5 95014,21646,1282,20364,62185,40.8,14902,43005,671,0.010790384,4215,57970
ZCTA5 95017,268,208,60,992,35.9,575,22,0,0,579,413
ZCTA5 95018,2552,1496,1056,5853,45,4973,158,15,0.002562788,5043,810
ZCTA5 95019,2024,215,1809,6912,35.7,2319,152,353,0.051070602,553,6359
ZCTA5 95020,19669,324,19345,67851,36.1,37765,6659,1241,0.018290077,1003,66848
ZCTA5 95023,16566,463,16103,55905,34.9,33967,1865,566,0.010124318,1226,54679
ZCTA5 95030,5355,765,4590,13528,51.2,10649,2206,33,0.002439385,3148,10380
ZCTA5 95032,10275,6626,3649,27149,45.3,19526,5004,257,0.009466279,24808,2341
ZCTA5 95033,3753,15852,-12099,9767,46.5,8387,572,1,0.000102386,52650,-42883
ZCTA5 95035,23749,1473,22276,79769,35.8,11436,53762,2565,0.032155349,3664,76105
ZCTA5 95037,16888,2451,14437,52321,38.8,33451,7901,711,0.01358919,6353,45968
ZCTA5 95039,377,12996,-12619,1360,39.5,339,24,0,0,37265,-35905
ZCTA5 95041,283,1869,-1586,796,38,710,0,0,0,5277,-4481
ZCTA5 95043,272,48,224,641,50.1,576,0,9,0.014040562,66,575
ZCTA5 95045,1421,4089,-2668,4032,47,3085,106,22,0.005456349,11377,-7345
ZCTA5 95046,1847,17371,-15524,6005,50.1,3820,205,29,0.004829309,53095,-47090
ZCTA5 95050,14764,6057,8707,39269,34.6,18946,11878,1159,0.029514375,17465,21804
ZCTA5 95051,22468,220,22248,60582,35.3,19672,31977,1004,0.016572579,794,59788
ZCTA5 95053,0,1678,-1678,3627,19.5,2306,790,64,0.017645437,4284,-657
ZCTA5 95054,8578,5467,3111,24404,33.3,5642,13968,1274,0.052204557,15588,8816
ZCTA5 95060,18841,1279,17562,47594,36.6,35154,3684,806,0.016934908,3627,43967
ZCTA5 95062,15149,70,15079,36278,41.1,28173,1321,465,0.012817686,176,36102
ZCTA5 95064,536,1063,-527,10646,19.6,4775,2732,480,0.045087357,3248,7398
ZCTA5 95065,2930,11207,-8277,8301,40.8,6190,233,62,0.00746898,28097,-19796
ZCTA5 95066,5893,1428,4465,15265,46.6,12666,880,52,0.003406485,4524,10741
ZCTA5 95070,11376,1015,10361,32189,50.1,13275,16921,28,0.000869862,2727,29462
ZCTA5 95073,4175,1983,2192,11359,42.5,9683,327,12,0.001056431,5557,5802
ZCTA5 95075,176,237,-61,589,40.1,461,7,5,0.008488964,836,-247
ZCTA5 95076,24053,151,23902,85739,34.1,40700,2216,669,0.00780275,682,85057
ZCTA5 95110,6665,905,5760,20377,34,7204,3081,645,0.031653335,2453,17924
ZCTA5 95111,15899,7168,8731,60687,36.4,16311,20910,1150,0.018949693,19717,40970
ZCTA5 95112,20778,951,19827,58489,32,19694,14867,2903,0.049633264,5767,52722
ZCTA5 95113,1276,1045,231,2216,34.5,820,884,150,0.067689531,3429,-1213
ZCTA5 95116,13728,247,13481,52245,34.2,11063,14722,1278,0.024461671,844,51401
ZCTA5 95117,10479,187,10292,28832,35.1,12897,7702,2314,0.080258047,413,28419
ZCTA5 95118,11204,4769,6435,32703,39.5,18184,7376,476,0.01455524,16226,16477
ZCTA5 95119,3388,6076,-2688,10354,40.2,4784,3074,185,0.017867491,17687,-7333
ZCTA5 95120,12536,109,12427,38358,46.3,19184,14973,438,0.011418739,323,38035
ZCTA5 95121,9832,276,9556,37663,41.2,7228,22494,1382,0.036693837,686,36977
ZCTA5 95122,12058,2325,9733,54100,35.2,10569,18953,834,0.015415896,6185,47915
ZCTA5 95123,23930,825,23105,71118,37.5,34818,18421,2280,0.032059394,2165,68953
ZCTA5 95124,17553,75,17478,52442,39.3,30714,13896,1052,0.020060257,238,52204
ZCTA5 95125,21083,131,20952,53478,41.8,33319,8044,1243,0.023243203,408,53070
ZCTA5 95126,15021,585,14436,36457,35.4,17713,6090,1886,0.051732178,1987,34470
ZCTA5 95127,15939,437,15502,63103,37.8,18221,16532,829,0.013137252,1333,61770
ZCTA5 95128,13898,4835,9063,35367,37.3,19004,6620,1612,0.045579212,13334,22033
ZCTA5 95129,13835,918,12917,39318,42,9599,25974,1003,0.025509945,2704,36614
ZCTA5 95130,4491,203,4288,13147,37.9,5877,5199,396,0.03012094,711,12436
ZCTA5 95131,9736,634,9102,31566,37.3,4380,22707,792,0.025090287,2140,29426
ZCTA5 95132,12115,11470,645,41337,42.2,7459,26788,717,0.017345236,39561,1776
ZCTA5 95133,8875,688,8187,28902,37.8,3951,17185,864,0.029894125,2066,26836
ZCTA5 95134,13383,1026,12357,31172,30.7,7486,18632,693,0.02223149,2589,28583
ZCTA5 95135,7651,11681,-4030,22010,48,6700,12735,503,0.022853249,39677,-17667
ZCTA5 95136,16114,18258,-2144,48867,36.8,20480,15764,2475,0.050647676,54479,-5612
ZCTA5 95138,5639,3178,2461,19827,38.4,5250,9429,884,0.044585666,8734,11093
ZCTA5 95139,2117,2418,-301,7144,39.5,3511,1863,57,0.007978723,7790,-646
ZCTA5 95140,60,11650,-11590,118,53.3,88,30,0,0,46723,-46605
ZCTA5 95148,12124,9127,2997,47305,39.8,8770,29287,1364,0.028834161,30565,16740
ZCTA5 95202,2920,2448,472,5976,36.9,2230,651,1659,0.277610442,10037,-4061
ZCTA5 95203,5387,584,4803,16255,31.9,8140,1806,1741,0.107105506,1824,14431
ZCTA5 95204,11080,19389,-8309,30135,35,16675,2832,1852,0.061456778,75313,-45178
ZCTA5 95205,10735,9646,1089,39723,30.4,17503,3075,2482,0.062482693,23134,16589
ZCTA5 95206,17279,9585,7694,65966,30.9,22563,9794,7586,0.114998636,18601,47365
ZCTA5 95207,18347,16055,2292,52154,32.6,18739,7590,7538,0.144533497,31274,20880
ZCTA5 95209,13129,17593,-4464,45150,36.1,15101,10755,4054,0.08978959,51067,-5917
ZCTA5 95210,11934,18832,-6898,43009,31.3,10588,13837,5317,0.123625288,56018,-13009
ZCTA5 95211,0,16101,-16101,2304,19.7,1614,468,58,0.025173611,51220,-48916
ZCTA5 95212,7747,11247,-3500,28561,38.1,8030,12024,2302,0.080599419,50175,-21614
ZCTA5 95215,7076,6821,255,26898,38,14462,744,1378,0.051230575,19827,7071
ZCTA5 95219,10856,18210,-7354,30242,36.2,13815,6662,2837,0.093809933,44980,-14738
ZCTA5 95220,2712,10699,-7987,8251,40.2,5806,128,19,0.002302751,29661,-21410
ZCTA5 95221,69,14932,-14863,389,29,83,0,0,0,31619,-31230
ZCTA5 95222,2238,0,2238,5161,58.8,4471,6,43,0.008331719,0,5161
ZCTA5 95223,1305,0,1305,2650,63.9,2422,89,0,0,252,2398
ZCTA5 95224,74,0,74,148,77.7,109,0,0,0,2544,-2396
ZCTA5 95225,322,0,322,1001,64.3,1001,0,0,0,0,1001
ZCTA5 95226,0,20,-20,0,-,0,0,0,#DIV/0!,924,-924
ZCTA5 95227,332,0,332,901,55.4,747,0,0,0,25,876
ZCTA5 95228,1731,59,1672,4571,52.9,3792,85,111,0.024283527,288,4283
ZCTA5 95230,226,2108,-1882,619,34.4,425,7,0,0,5781,-5162
ZCTA5 95231,709,1639,-930,4933,35.5,3074,101,429,0.086965335,4860,73
ZCTA5 95232,29,9852,-9823,145,36.1,145,0,0,0,23745,-23600
ZCTA5 95233,99,24004,-23905,250,56.1,250,0,0,0,64347,-64097
ZCTA5 95236,1708,24549,-22841,4756,40,3059,58,67,0.014087468,69030,-64274
ZCTA5 95237,1522,11976,-10454,4099,41,3132,46,6,0.001463772,29750,-25651
ZCTA5 95240,16235,2960,13275,49623,33.1,24591,6203,563,0.011345545,7998,41625
ZCTA5 95242,10058,288,9770,27448,38.5,18548,1968,618,0.022515302,712,26736
ZCTA5 95245,1003,8033,-7030,2422,59.2,1885,85,141,0.05821635,23219,-20797
ZCTA5 95246,447,471,-24,1305,55.8,1297,8,0,0,1109,196
ZCTA5 95247,1542,7613,-6071,3594,57.5,3251,16,0,0,19894,-16300
ZCTA5 95248,16,2627,-2611,38,-,38,0,0,0,6551,-6513
ZCTA5 95249,1749,858,891,5533,42.3,4726,158,70,0.012651365,2506,3027
ZCTA5 95251,250,753,-503,507,53.1,502,0,0,0,2147,-1640
ZCTA5 95252,4814,1141,3673,14644,45.1,12073,543,67,0.004575253,3168,11476
ZCTA5 95253,124,277,-153,513,14.4,108,0,0,0,692,-179
ZCTA5 95254,279,331,-52,769,45.4,723,0,0,0,758,11
ZCTA5 95255,708,1106,-398,1748,54.5,1181,30,0,0,3241,-1493
ZCTA5 95257,149,3530,-3381,429,60.1,386,0,0,0,10333,-9904
ZCTA5 95258,1538,4189,-2651,4108,46.5,3135,40,39,0.009493671,9907,-5799
ZCTA5 95301,12857,1031,11826,41015,34.8,21330,2638,1956,0.04768987,3952,37063
ZCTA5 95303,291,4854,-4563,860,40.5,525,58,0,0,12455,-11595
ZCTA5 95304,4359,64,4295,15585,37.1,8842,1717,1021,0.06551171,133,15452
ZCTA5 95305,58,127,-69,118,74,89,0,0,0,330,-212
ZCTA5 95306,383,14279,-13896,844,59.5,749,13,0,0,37265,-36421
ZCTA5 95307,13022,6880,6142,47666,32,26387,3293,1366,0.028657743,18674,28992
ZCTA5 95309,0,1515,-1515,0,-,0,0,0,#DIV/0!,4815,-4815
ZCTA5 95310,713,26,687,1431,48,1327,2,0,0,43,1388
ZCTA5 95311,989,7955,-6966,1991,57.9,1778,7,0,0,18891,-16900
ZCTA5 95312,63,10494,-10431,241,28.8,143,0,4,0.01659751,23820,-23579
ZCTA5 95313,424,426,-2,1250,38.9,921,0,0,0,882,368
ZCTA5 95315,3554,5550,-1996,13334,32.5,4147,556,3,0.000224989,15265,-1931
ZCTA5 95316,2627,190,2437,7832,39.5,6184,249,15,0.00191522,411,7421
ZCTA5 95317,260,473,-213,963,28.1,232,0,11,0.011422638,1254,-291
ZCTA5 95318,224,731,-507,410,45.2,410,0,0,0,2522,-2112
ZCTA5 95319,576,1133,-557,1658,37.1,1215,18,35,0.021109771,3448,-1790
ZCTA5 95320,4585,19044,-14459,12481,34.5,9820,220,38,0.003044628,50773,-38292
ZCTA5 95321,1809,2644,-835,3922,59.1,3344,72,0,0,6728,-2806
ZCTA5 95322,3319,886,2433,10012,38,5549,264,0,0,1967,8045
ZCTA5 95323,434,108,326,1489,37.6,1098,28,0,0,262,1227
ZCTA5 95324,2626,5880,-3254,8639,34.4,5437,0,0,0,15904,-7265
ZCTA5 95325,35,1272,-1237,60,-,60,0,0,0,3124,-3064
ZCTA5 95326,3743,506,3237,10254,37.4,7858,312,165,0.016091281,1243,9011
ZCTA5 95327,3012,6262,-3250,9165,41.2,6820,129,652,0.071140207,15957,-6792
ZCTA5 95328,989,4552,-3563,3585,25,2235,37,0,0,11380,-7795
ZCTA5 95329,1172,7,1165,2497,53.4,1825,8,180,0.072086504,13,2484
ZCTA5 95330,6907,7861,-954,28325,32.9,10974,7403,2380,0.084024713,20305,8020
ZCTA5 95333,794,7461,-6667,3031,32.2,1173,49,22,0.007258331,21305,-18274
ZCTA5 95334,4142,10328,-6186,17253,31.4,4771,2984,18,0.001043297,27309,-10056
ZCTA5 95335,73,395,-322,97,60.6,38,59,0,0,842,-745
ZCTA5 95336,15395,1386,14009,47294,38.6,29983,3671,1415,0.029919229,3575,43719
ZCTA5 95337,12551,337,12214,42713,35,21299,7983,2131,0.049891134,819,41894
ZCTA5 95338,4720,850,3870,10726,52,9040,126,52,0.004848033,1835,8891
ZCTA5 95340,12338,10852,1486,37584,31.9,20929,2590,1141,0.030358663,28303,9281
ZCTA5 95341,8787,8350,437,34045,26.8,13211,4040,1304,0.038302247,21114,12931
ZCTA5 95345,332,8955,-8623,664,33.4,640,2,0,0,28716,-28052
ZCTA5 95346,488,13994,-13506,1126,53.7,1106,20,0,0,40102,-38976
ZCTA5 95348,10765,9148,1617,34489,30.1,15407,6108,2096,0.060773,25919,8570
ZCTA5 95350,19358,4009,15349,55097,35,37156,4417,2595,0.047098753,11689,43408
ZCTA5 95351,13453,1323,12130,49149,29.9,27213,2502,1516,0.030844982,4056,45093
ZCTA5 95354,8773,119,8654,25165,34.6,16018,1401,1449,0.057579972,246,24919
ZCTA5 95355,21060,7166,13894,59597,38.4,40321,5539,2851,0.047837978,17036,42561
ZCTA5 95356,11219,1429,9790,33055,38.1,21534,2956,707,0.021388595,4153,28902
ZCTA5 95357,4259,613,3646,13740,36.4,8873,380,911,0.066302766,1395,12345
ZCTA5 95358,8418,236,8182,31938,30.3,20396,1321,696,0.021792222,430,31508
ZCTA5 95360,3956,301,3655,13551,34.4,9930,549,41,0.003025607,744,12807
ZCTA5 95361,12286,485,11801,34725,39.5,26897,718,214,0.006162707,1173,33552
ZCTA5 95363,7948,1075,6873,29364,30.8,17725,811,1017,0.034634246,3064,26300
ZCTA5 95364,0,731,-731,0,-,0,0,0,#DIV/0!,1949,-1949
ZCTA5 95365,1106,4093,-2987,4146,32.7,1606,0,0,0,14134,-9988
ZCTA5 95366,6649,1658,4991,18462,40.5,14421,825,169,0.009153938,4980,13482
ZCTA5 95367,7489,1392,6097,25037,34.5,15346,1436,406,0.016216,3908,21129
ZCTA5 95368,4262,8661,-4399,14674,31.3,8404,1366,237,0.016151015,24440,-9766
ZCTA5 95369,331,174,157,798,48.2,522,2,0,0,407,391
ZCTA5 95370,11988,353,11635,27896,50,24478,376,70,0.00250932,736,27160
ZCTA5 95372,645,1654,-1009,1937,34.4,1786,9,0,0,4486,-2549
ZCTA5 95374,540,654,-114,1702,38.3,954,18,0,0,1469,233
ZCTA5 95375,61,297,-236,65,75.3,64,0,0,0,651,-586
ZCTA5 95376,16697,14133,2564,55314,32.4,26944,6956,2848,0.051487869,44019,11295
ZCTA5 95377,9045,18086,-9041,33630,36.9,13931,9263,1773,0.052720785,48132,-14502
ZCTA5 95379,1705,105,1600,3924,46.4,3288,97,42,0.010703364,217,3707
ZCTA5 95380,15286,997,14289,45576,31.5,28488,1179,571,0.012528524,3709,41867
ZCTA5 95382,12894,12985,-91,37296,37.1,25342,2914,1343,0.036009224,36276,1020
ZCTA5 95383,1870,218,1652,4022,52.4,3764,29,0,0,438,3584
ZCTA5 95385,213,1188,-975,660,29.2,521,0,0,0,2751,-2091
ZCTA5 95386,2934,9546,-6612,10371,34.3,8260,382,225,0.021695111,28162,-17791
ZCTA5 95387,275,1635,-1360,1122,28.7,763,129,0,0,4514,-3392
ZCTA5 95388,3740,52,3688,13270,29.8,4389,481,210,0.01582517,95,13175
ZCTA5 95389,333,354,-21,1380,38.6,1102,30,97,0.070289855,963,417
ZCTA5 95391,5983,794,5189,23235,32.6,8437,10641,1453,0.062534969,1532,21703
ZCTA5 95401,13592,432,13160,36820,39.8,21528,1578,239,0.006491037,1372,35448
ZCTA5 95403,16286,4287,11999,46463,37.9,28046,2020,1225,0.026365065,10019,36444
ZCTA5 95404,15507,8159,7348,38028,41.8,27105,2748,865,0.022746397,23309,14719
ZCTA5 95405,9396,5658,3738,23176,45.8,18827,996,324,0.013979979,13607,9569
ZCTA5 95407,12871,78,12793,41575,33.9,17951,2937,996,0.023956705,194,41381
ZCTA5 95409,11870,165,11705,26179,52.2,20301,1660,254,0.009702433,200,25979
ZCTA5 95410,412,2422,-2010,981,53.3,851,38,0,0,5898,-4917
ZCTA5 95412,161,132,29,341,46,277,5,0,0,273,68
ZCTA5 95415,433,1343,-910,1380,41.1,1119,69,37,0.026811594,3485,-2105
ZCTA5 95417,95,178,-83,299,43.7,277,6,0,0,345,-46
ZCTA5 95419,162,8166,-8004,213,61.5,179,0,0,0,14744,-14531
ZCTA5 95420,85,17536,-17451,225,68.9,223,0,1,0.004444444,38951,-38726
ZCTA5 95421,726,11427,-10701,1743,56,1372,63,0,0,30003,-28260
ZCTA5 95422,6136,557,5579,16759,38.8,10866,126,699,0.041708933,1557,15202
ZCTA5 95423,1528,4678,-3150,3244,55.6,2828,49,53,0.016337855,6526,-3282
ZCTA5 95425,4585,19427,-14842,11337,46.7,8832,191,31,0.002734409,47544,-36207
ZCTA5 95426,644,0,644,1362,54.4,1360,0,1,0.000734214,0,1362
ZCTA5 95427,223,9724,-9501,700,55.3,700,0,0,0,14095,-13395
ZCTA5 95428,973,6064,-5091,2761,37.6,1365,6,30,0.010865628,10836,-8075
ZCTA5 95429,70,12016,-11946,122,61.7,116,6,0,0,30731,-30609
ZCTA5 95430,15,10480,-10465,15,-,15,0,0,0,24565,-24550
ZCTA5 95431,0,13317,-13317,75,41.9,48,7,15,0.2,29940,-29865
ZCTA5 95432,276,12020,-11744,599,58.7,502,24,0,0,24399,-23800
ZCTA5 95435,89,7167,-7078,331,19.8,331,0,0,0,16302,-15971
ZCTA5 95436,2644,6215,-3571,6602,42.1,5153,232,35,0.005301424,15572,-8970
ZCTA5 95437,6438,13342,-6904,15903,46.5,12873,196,83,0.005219141,31170,-15267
ZCTA5 95439,169,5592,-5423,510,57.3,313,0,0,0,15335,-14825
ZCTA5 95441,701,16248,-15547,1802,51,1346,41,24,0.013318535,39061,-37259
ZCTA5 95442,1161,11089,-9928,2521,57.5,2003,0,6,0.002380008,29397,-26876
ZCTA5 95443,36,4937,-4901,129,9.9,129,0,0,0,11853,-11724
ZCTA5 95444,219,14568,-14349,559,50.8,380,0,0,0,34608,-34049
ZCTA5 95445,955,18593,-17638,2134,58.8,1870,0,1,0.000468604,46095,-43961
ZCTA5 95446,2336,13831,-11495,4781,53.1,3960,44,55,0.011503869,31658,-26877
ZCTA5 95448,6724,11575,-4851,16596,48.8,12837,269,19,0.001144854,25684,-9088
ZCTA5 95449,493,1729,-1236,1460,44.6,1014,2,5,0.003424658,4052,-2592
ZCTA5 95450,84,21911,-21827,212,54.3,204,2,0,0,57851,-57639
ZCTA5 95451,4767,14806,-10039,12611,42.2,8596,45,390,0.030925383,41010,-28399
ZCTA5 95452,623,1872,-1249,1360,39.5,1076,186,0,0,4269,-2909
ZCTA5 95453,4638,6222,-1584,11523,49.8,8360,334,144,0.012496746,11404,119
ZCTA5 95454,924,13107,-12183,2076,56.6,1408,37,10,0.004816956,39263,-37187
ZCTA5 95456,419,12369,-11950,780,61.3,767,3,0,0,36217,-35437
ZCTA5 95457,1368,7343,-5975,3178,58.4,2160,34,19,0.005978603,15349,-12171
ZCTA5 95458,1359,11905,-10546,3196,39.4,2377,133,146,0.045682103,33185,-29989
ZCTA5 95459,313,12635,-12322,836,42.5,614,0,0,0,32173,-31337
ZCTA5 95460,1070,18227,-17157,2311,60.1,2006,104,21,0.009086975,53608,-51297
ZCTA5 95461,1322,15769,-14447,3551,46.9,2872,27,21,0.005913827,37725,-34174
ZCTA5 95462,592,14434,-13842,1111,59.4,1010,29,0,0,38480,-37369
ZCTA5 95463,35,10997,-10962,86,29.8,86,0,0,0,28834,-28748
ZCTA5 95464,921,13770,-12849,2587,38.8,1553,60,57,0.022033243,38212,-35625
ZCTA5 95465,603,10942,-10339,1316,55.9,1099,57,20,0.015197568,27611,-26295
ZCTA5 95466,310,7983,-7673,1042,45.4,949,0,6,0.005758157,24888,-23846
ZCTA5 95467,2244,9578,-7334,6109,41.8,5385,49,73,0.011949583,24617,-18508
ZCTA5 95468,547,13096,-12549,1312,47.1,865,4,5,0.003810976,34558,-33246
ZCTA5 95469,615,518,97,1469,50,1117,27,3,0.002042206,1281,188
ZCTA5 95470,2096,2257,-161,5903,43.6,4794,24,0,0,6729,-826
ZCTA5 95471,388,443,-55,809,48.7,783,26,0,0,1012,-203
ZCTA5 95472,11767,1010,10757,29753,50.6,24471,598,311,0.010452727,2875,26878
ZCTA5 95476,15163,52,15111,36578,52.3,28306,818,422,0.011536989,93,36485
ZCTA5 95480,5,17038,-17033,31,19.4,0,0,0,0,41947,-41916
ZCTA5 95482,11329,86,11243,33744,39.2,25209,1196,256,0.007586534,2405,31339
ZCTA5 95485,1199,8794,-7595,3042,44.4,2564,108,17,0.005588429,21144,-18102
ZCTA5 95486,35,7471,-7436,49,65.2,49,0,0,0,19895,-19846
ZCTA5 95488,103,1147,-1044,185,72.3,185,0,0,0,2505,-2320
ZCTA5 95490,5578,74,5504,14256,40.7,11041,271,155,0.010872615,177,14079
ZCTA5 95492,9771,147,9624,28635,41.9,20232,841,304,0.010616379,381,28254
ZCTA5 95493,46,435,-389,79,72.9,44,0,0,0,1276,-1197
ZCTA5 95494,42,146,-104,113,59.4,89,0,0,0,337,-224
ZCTA5 95497,583,432,151,1078,67.3,994,39,0,0,1013,65
ZCTA5 95501,9787,618,9169,24007,39.7,17309,1276,672,0.027991836,1585,22422
ZCTA5 95503,9567,475,9092,23878,43.5,19458,917,187,0.007831477,1518,22360
ZCTA5 95511,57,86,-29,102,68.8,89,0,0,0,285,-183
ZCTA5 95514,59,3315,-3256,74,67.6,74,0,0,0,10014,-9940
ZCTA5 95519,7259,1992,5267,18467,39,14372,735,71,0.003844696,5920,12547
ZCTA5 95521,8351,10746,-2395,22259,28.4,16376,809,462,0.020755649,28206,-5947
ZCTA5 95524,669,80,589,1660,51.1,1525,0,0,0,150,1510
ZCTA5 95525,698,933,-235,1379,56.6,1097,3,0,0,2381,-1002
ZCTA5 95526,210,755,-545,566,54.2,454,4,0,0,2142,-1576
ZCTA5 95527,197,4025,-3828,474,54.5,460,0,0,0,11279,-10805
ZCTA5 95528,578,1548,-970,1548,50.7,1400,4,0,0,4163,-2615
ZCTA5 95531,7688,368,7320,22887,38.7,16007,777,750,0.032769695,847,22040
ZCTA5 95536,1158,4874,-3716,3120,46.6,2475,71,12,0.003846154,10779,-7659
ZCTA5 95537,126,624,-498,632,27.5,570,0,62,0.098101266,1214,-582
ZCTA5 95538,438,4614,-4176,975,55.9,756,0,42,0.043076923,9062,-8087
ZCTA5 95540,5638,1475,4163,14989,39.2,11335,190,122,0.008139302,3604,11385
ZCTA5 95542,1137,147,990,2506,45.7,2361,10,6,0.002394254,325,2181
ZCTA5 95543,232,3076,-2844,536,61,485,0,13,0.024253731,8037,-7501
ZCTA5 95545,84,304,-220,277,44.1,240,0,10,0.036101083,709,-432
ZCTA5 95546,913,0,913,3121,31,193,195,3,0.00096123,199,2922
ZCTA5 95547,486,1973,-1487,1179,56.7,1041,0,0,0,5284,-4105
ZCTA5 95548,383,330,53,1079,44,564,2,18,0.016682113,1026,53
ZCTA5 95549,393,636,-243,1226,36.6,1069,11,1,0.000815661,1266,-40
ZCTA5 95550,64,377,-313,151,28.8,135,0,0,0,1233,-1082
ZCTA5 95551,620,2515,-1895,1794,39.2,1386,20,40,0.022296544,8479,-6685
ZCTA5 95552,240,1046,-806,453,60.3,404,0,0,0,2945,-2492
ZCTA5 95553,359,5549,-5190,762,42.6,597,0,0,0,15365,-14603
ZCTA5 95554,176,3520,-3344,340,34.9,252,0,0,0,9831,-9491
ZCTA5 95555,120,0,120,350,34.7,238,0,0,0,0,350
ZCTA5 95556,271,1258,-987,921,29.7,565,0,0,0,3123,-2202
ZCTA5 95558,135,5477,-5342,266,62.2,220,15,0,0,13639,-13373
ZCTA5 95559,0,424,-424,0,-,0,0,0,#DIV/0!,738,-738
ZCTA5 95560,623,649,-26,1640,37.9,1588,6,6,0.003658537,1694,-54
ZCTA5 95562,1381,308,1073,3395,33.7,2537,53,24,0.007069219,706,2689
ZCTA5 95563,293,2031,-1738,830,65.2,760,6,0,0,5103,-4273
ZCTA5 95564,201,1983,-1782,495,46.9,405,2,0,0,5426,-4931
ZCTA5 95565,274,2032,-1758,669,44.2,510,0,0,0,4012,-3343
ZCTA5 95567,790,1148,-358,2178,39.9,1372,45,0,0,2880,-702
ZCTA5 95568,46,18817,-18771,195,59.7,122,0,25,0.128205128,39955,-39760
ZCTA5 95569,106,20722,-20616,181,50.6,181,0,0,0,50797,-50616
ZCTA5 95570,1071,4039,-2968,2515,45,2158,11,0,0,12481,-9966
ZCTA5 95571,47,12844,-12797,116,58.6,91,0,14,0.120689655,32682,-32566
ZCTA5 95573,581,18706,-18125,1342,39.9,1125,0,4,0.002980626,43685,-42343
ZCTA5 95585,194,26,168,473,51,377,6,22,0.046511628,94,379
ZCTA5 95587,36,4877,-4841,72,-,72,0,0,0,11470,-11398
ZCTA5 95589,654,288,366,1419,45.8,1375,0,44,0.031007752,761,658
ZCTA5 95595,112,3479,-3367,226,60.1,181,0,0,0,6444,-6218
ZCTA5 95601,138,222,-84,310,43.9,270,3,0,0,542,-232
ZCTA5 95602,7290,574,6716,18705,53.9,16498,316,28,0.001496926,1076,17629
ZCTA5 95603,11825,87,11738,28479,48.2,25055,551,146,0.005126585,211,28268
ZCTA5 95604,23,6412,-6389,35,30.4,35,0,0,0,13610,-13575
ZCTA5 95605,4924,307,4617,14328,32.1,8161,839,717,0.050041876,883,13445
ZCTA5 95606,91,965,-874,202,68.2,153,41,0,0,2522,-2320
ZCTA5 95607,94,648,-554,201,68.2,183,0,0,0,1471,-1270
ZCTA5 95608,25840,11301,14539,63730,42.2,47235,5105,3079,0.048313196,27785,35945
ZCTA5 95610,17254,2791,14463,45792,37,35711,1625,1796,0.039220825,7238,38554
ZCTA5 95612,523,6938,-6415,1606,41.8,1486,37,0,0,17068,-15462
ZCTA5 95613,53,3728,-3675,105,-,105,0,0,0,9704,-9599
ZCTA5 95614,1797,250,1547,4580,51.4,4236,52,0,0,581,3999
ZCTA5 95615,342,145,197,1062,54.1,572,63,0,0,294,768
ZCTA5 95616,18126,871,17255,52779,22.8,30371,13871,1318,0.024972053,2373,50406
ZCTA5 95618,9708,309,9399,26478,32.1,17006,5791,564,0.021300702,848,25630
ZCTA5 95619,2513,825,1688,6407,39.4,5669,270,19,0.002965506,2169,4238
ZCTA5 95620,7379,358,7021,21494,35,15610,628,471,0.021913092,870,20624
ZCTA5 95621,16495,977,15518,42838,39.1,32862,1961,1324,0.030907139,2548,40290
ZCTA5 95623,1606,407,1199,4411,49.3,3792,204,27,0.006121061,1126,3285
ZCTA5 95624,20205,7256,12949,68434,37.9,31135,17823,6456,0.094339071,14795,53639
ZCTA5 95625,119,45,74,152,46.1,152,0,0,0,94,58
ZCTA5 95626,1934,888,1046,5978,42.1,4819,354,216,0.036132486,2083,3895
ZCTA5 95627,1209,727,482,4214,30.5,3552,145,0,0,1942,2272
ZCTA5 95628,16594,2317,14277,42434,44,33799,2095,777,0.018310789,5266,37168
ZCTA5 95629,305,1871,-1566,697,59.4,636,0,0,0,5187,-4490
ZCTA5 95630,27236,319,26917,73815,40.2,49339,14121,1427,0.019332114,883,72932
ZCTA5 95631,2552,4587,-2035,6022,51.2,5446,69,0,0,11954,-5932
ZCTA5 95632,10076,815,9261,31509,39.3,20849,1445,621,0.019708655,1760,29749
ZCTA5 95633,1266,343,923,3408,43,3262,69,0,0,749,2659
ZCTA5 95634,1842,219,1623,4001,58.1,3621,107,10,0.002499375,466,3535
ZCTA5 95635,369,552,-183,734,58.2,677,0,20,0.027247956,1399,-665
ZCTA5 95636,497,306,191,1205,45,1078,0,0,0,693,512
ZCTA5 95637,56,570,-514,142,50.7,100,0,0,0,1464,-1322
ZCTA5 95638,828,1001,-173,2196,52.7,1718,82,128,0.058287796,2662,-466
ZCTA5 95639,70,1170,-1100,243,22,211,0,0,0,2944,-2701
ZCTA5 95640,3819,3782,37,12915,42.4,9619,88,842,0.065195509,9916,2999
ZCTA5 95641,741,1873,-1132,1431,53.4,1231,47,12,0.008385744,4206,-2775
ZCTA5 95642,2915,5895,-2980,6913,52.6,5624,190,65,0.009402575,14301,-7388
ZCTA5 95645,467,220,247,1233,40.9,896,0,0,0,607,626
ZCTA5 95646,89,1652,-1563,232,41.1,147,0,9,0.038793103,4013,-3781
ZCTA5 95648,20372,1744,18628,54074,44,43299,3437,511,0.009450013,3809,50265
ZCTA5 95650,5467,1166,4301,14479,47.1,12711,471,3,0.000207197,2542,11937
ZCTA5 95651,201,395,-194,535,48.4,394,70,0,0,1115,-580
ZCTA5 95652,318,2333,-2015,961,23.3,498,73,201,0.209157128,5280,-4319
ZCTA5 95653,166,1062,-896,478,48.9,251,1,1,0.00209205,2498,-2020
ZCTA5 95655,1545,8563,-7018,4806,33.8,2900,641,385,0.080108198,20153,-15347
ZCTA5 95658,2325,12536,-10211,6023,51.3,5117,153,107,0.017765233,30748,-24725
ZCTA5 95659,316,171,145,809,36.3,684,4,4,0.004944376,350,459
ZCTA5 95660,10831,56,10775,35649,32.5,22827,2754,3007,0.084350192,83,35566
ZCTA5 95661,12829,15384,-2555,32880,41,25714,3146,516,0.015693431,36886,-4006
ZCTA5 95662,12767,14411,-1644,33099,41.7,26825,865,456,0.013776851,37798,-4699
ZCTA5 95663,1092,3789,-2697,2771,49.8,2384,38,0,0,9419,-6648
ZCTA5 95664,395,154,241,986,59.3,755,50,9,0.009127789,305,681
ZCTA5 95665,1851,246,1605,4650,52.1,3926,46,14,0.003010753,619,4031
ZCTA5 95666,2441,114,2327,5542,56.4,4936,48,25,0.004511007,266,5276
ZCTA5 95667,14514,238,14276,35343,50.5,32160,312,255,0.007215007,507,34836
ZCTA5 95668,196,3020,-2824,548,44.9,441,0,0,0,8019,-7471
ZCTA5 95669,982,351,631,2296,48,1845,16,0,0,811,1485
ZCTA5 95670,21713,390,21323,59685,36.2,35522,7628,5226,0.087559688,793,58892
ZCTA5 95671,39,138,-99,5386,40.5,1112,128,2264,0.420349053,407,4979
ZCTA5 95672,2084,263,1821,5937,48.9,5379,66,2,0.00033687,694,5243
ZCTA5 95673,5154,160,4994,17332,35.7,12916,1188,224,0.012924071,369,16963
ZCTA5 95674,269,0,269,906,39.8,688,40,20,0.022075055,0,906
ZCTA5 95675,157,561,-404,451,40.4,367,0,31,0.068736142,1032,-581
ZCTA5 95676,41,2572,-2531,164,28.9,154,0,0,0,7147,-6983
ZCTA5 95677,10223,656,9567,28412,37.6,21855,1879,526,0.018513304,2043,26369
ZCTA5 95678,17322,847,16475,45201,36.4,33122,3357,999,0.022101281,1836,43365
ZCTA5 95679,64,840,-776,169,40.9,169,0,0,0,2038,-1869
ZCTA5 95680,0,16739,-16739,0,-,0,0,0,#DIV/0!,42391,-42391
ZCTA5 95681,336,10604,-10268,1269,28.5,884,0,0,0,27797,-26528
ZCTA5 95682,11621,3459,8162,29836,45.6,25776,1070,237,0.007943424,10208,19628
ZCTA5 95683,2564,18703,-16139,6311,55,5080,205,289,0.04579306,44802,-38491
ZCTA5 95684,1309,11133,-9824,2820,60.3,2414,94,7,0.00248227,24541,-21721
ZCTA5 95685,2214,267,1947,4814,54.4,4209,39,19,0.003946822,715,4099
ZCTA5 95686,387,2413,-2026,1155,33.8,516,64,54,0.046753247,5793,-4638
ZCTA5 95687,22424,5055,17369,69825,38.1,41088,6322,8422,0.120615825,13433,56392
ZCTA5 95688,13909,1847,12062,39967,38.9,28978,3289,1804,0.045137238,4186,35781
ZCTA5 95689,562,14649,-14087,1520,51,1376,28,0,0,34808,-33288
ZCTA5 95690,711,13932,-13221,2124,31.7,1339,152,22,0.010357815,33363,-31239
ZCTA5 95691,14086,3224,10862,39361,35.2,23944,5293,1777,0.045146211,7141,32220
ZCTA5 95692,1721,189,1532,5044,39.5,4266,79,4,0.000793021,397,4647
ZCTA5 95693,2475,969,1506,7247,49.8,5237,501,73,0.010073134,2244,5003
ZCTA5 95694,3299,144,3155,9858,39.4,7789,168,61,0.006187868,250,9608
ZCTA5 95695,14578,2363,12215,40479,37.3,28942,1146,540,0.013340251,5388,35091
ZCTA5 95697,105,422,-317,243,45.2,243,0,0,0,1021,-778
ZCTA5 95698,138,3212,-3074,213,60.1,155,0,0,0,7628,-7415
ZCTA5 95699,7,739,-732,13,-,13,0,0,0,1999,-1986
ZCTA5 95701,391,1523,-1132,1049,58.2,981,18,5,0.004766444,3373,-2324
ZCTA5 95703,820,3629,-2809,1993,57.1,1765,14,51,0.025589563,8250,-6257
ZCTA5 95709,2546,409,2137,6495,50.9,6030,119,13,0.00200154,835,5660
ZCTA5 95713,3748,412,3336,9869,46.8,8779,67,140,0.014185834,1177,8692
ZCTA5 95714,157,1051,-894,405,48,380,0,0,0,2466,-2061
ZCTA5 95715,21,9664,-9643,76,46.3,74,0,0,0,22748,-22672
ZCTA5 95717,73,12121,-12048,155,57.1,142,0,0,0,29360,-29205
ZCTA5 95720,47,8,39,106,48.5,72,0,0,0,70,36
ZCTA5 95721,0,37,-37,0,-,0,0,0,#DIV/0!,59,-59
ZCTA5 95722,1873,151,1722,4930,53,4462,106,0,0,323,4607
ZCTA5 95726,3342,241,3101,7754,48.5,7305,84,33,0.004255868,431,7323
ZCTA5 95728,139,942,-803,355,47.6,283,54,0,0,2402,-2047
ZCTA5 95735,24,1367,-1343,50,46.4,50,0,0,0,3093,-3043
ZCTA5 95736,57,73,-16,96,31.9,77,0,0,0,182,-86
ZCTA5 95742,4030,109,3921,13955,36.3,6966,3924,1347,0.096524543,205,13750
ZCTA5 95746,7945,367,7578,22345,48.3,17740,2139,836,0.037413292,852,21493
ZCTA5 95747,25949,2273,23676,72208,40.3,50089,12173,1749,0.024221693,5080,67128
ZCTA5 95757,14578,455,14123,52105,36.8,16634,19704,6104,0.117148066,1333,50772
ZCTA5 95758,22152,487,21665,65416,38.3,26471,17852,7770,0.118778281,1379,64037
ZCTA5 95762,15688,65,15623,45340,44.6,34154,5524,846,0.018659021,265,45075
ZCTA5 95765,13911,182,13729,41799,36.2,29339,5904,710,0.016986052,536,41263
ZCTA5 95776,7977,241,7736,25230,34.7,14162,4115,651,0.025802616,485,24745
ZCTA5 95811,4079,51,4028,7432,31.8,4365,716,758,0.101991389,107,7325
ZCTA5 95814,6777,266,6511,12302,35.9,7059,1268,1785,0.145098358,498,11804
ZCTA5 95815,9634,281,9353,26211,33.5,10064,2026,3142,0.119873336,527,25684
ZCTA5 95816,10574,68,10506,18033,35.1,13861,903,487,0.027006044,133,17900
ZCTA5 95817,6558,488,6070,14109,33.5,7140,1424,1893,0.134169679,1045,13064
ZCTA5 95818,10404,25039,-14635,22423,39.6,14432,2106,1041,0.046425545,59089,-36666
ZCTA5 95819,8112,16139,-8027,20146,37.3,15504,1195,539,0.026754691,41433,-21287
ZCTA5 95820,13625,2499,11126,36224,36.7,17757,3766,4096,0.113074205,5863,30361
ZCTA5 95821,15809,68,15741,37473,38.7,21002,5496,2774,0.074026633,172,37301
ZCTA5 95822,16651,53,16598,46375,38,17697,7697,7301,0.157433962,132,46243
ZCTA5 95823,24311,21,24290,83021,31.5,18764,18324,17032,0.205152913,87,82934
ZCTA5 95824,9144,1959,7185,30783,32.1,8037,8867,2525,0.082025793,4217,26566
ZCTA5 95825,16086,151,15935,37522,31.9,16971,4773,5251,0.139944566,484,37038
ZCTA5 95826,16045,44,16001,40847,32.8,22294,4549,4412,0.108012828,135,40712
ZCTA5 95827,7407,124,7283,21241,34.7,11881,2074,3209,0.15107575,331,20910
ZCTA5 95828,17895,153,17742,61730,35.4,16217,23631,5528,0.089551272,444,61286
ZCTA5 95829,9157,63,9094,30594,36.2,10953,12033,2386,0.077989148,193,30401
ZCTA5 95830,202,319,-117,585,54.6,462,112,0,0,715,-130
ZCTA5 95831,18969,1068,17901,43683,42.6,16449,11849,6736,0.154201863,2976,40707
ZCTA5 95832,3237,71,3166,13446,31.2,1953,5343,2516,0.187118846,155,13291
ZCTA5 95833,15582,51,15531,40853,34.3,15629,5013,5664,0.138643429,111,40742
ZCTA5 95834,11682,178,11504,33102,33.2,11676,9502,5366,0.162105009,293,32809
ZCTA5 95835,14342,750,13592,41051,38.5,16005,11774,5873,0.143065942,1766,39285
ZCTA5 95837,106,4749,-4643,279,50.9,267,0,12,0.043010753,10779,-10500
ZCTA5 95838,11671,4429,7242,41438,32.3,13467,7540,6954,0.16781698,11976,29462
ZCTA5 95841,8225,169,8056,20892,34.4,14404,1841,1796,0.08596592,377,20515
ZCTA5 95842,11884,41,11843,34578,33.2,20246,2873,4877,0.141043438,136,34442
ZCTA5 95843,15020,7,15013,48191,35.5,32353,5924,4165,0.086426926,14,48177
ZCTA5 95864,9891,930,8961,25367,44.6,19102,2095,748,0.029487129,2212,23155
ZCTA5 95901,12615,7683,4932,36176,33.9,24368,3020,1577,0.043592437,18467,17709
ZCTA5 95903,357,13037,-12680,1730,21.6,1251,50,188,0.10867052,34020,-32290
ZCTA5 95910,65,27,38,174,57.9,174,0,0,0,75,99
ZCTA5 95912,1406,2517,-1111,4782,34.5,3194,8,57,0.011919699,6478,-1696
ZCTA5 95913,96,2807,-2711,218,59.1,149,0,0,0,6295,-6077
ZCTA5 95914,254,1007,-753,518,62.8,461,5,6,0.011583012,3912,-3394
ZCTA5 95915,0,7774,-7774,0,-,0,0,0,#DIV/0!,21478,-21478
ZCTA5 95916,486,301,185,1112,56.7,979,57,0,0,780,332
ZCTA5 95917,1293,375,918,4162,32.2,3144,54,0,0,894,3268
ZCTA5 95918,820,477,343,1598,61.5,1235,82,67,0.041927409,1240,358
ZCTA5 95919,529,5370,-4841,1168,54,1131,0,7,0.005993151,12420,-11252
ZCTA5 95920,102,23,79,198,52.3,128,15,0,0,34,164
ZCTA5 95922,265,1141,-876,620,47.4,533,0,0,0,3827,-3207
ZCTA5 95923,39,15,24,56,77.3,56,0,0,0,25,31
ZCTA5 95925,105,468,-363,258,27.9,134,0,54,0.209302326,947,-689
ZCTA5 95926,17314,488,16826,43402,27.1,33220,2440,979,0.022556564,927,42475
ZCTA5 95928,15690,692,14998,38594,33.3,31238,1322,765,0.019821734,2010,36584
ZCTA5 95929,0,138,-138,0,-,0,0,0,#DIV/0!,261,-261
ZCTA5 95930,176,337,-161,546,35.5,495,0,0,0,990,-444
ZCTA5 95932,3002,937,2065,7963,38.9,5138,117,260,0.032651011,2306,5657
ZCTA5 95934,60,1235,-1175,102,68.5,80,0,0,0,2854,-2752
ZCTA5 95935,165,312,-147,344,40.5,339,0,0,0,595,-251
ZCTA5 95936,56,365,-309,113,68.4,109,0,0,0,976,-863
ZCTA5 95937,515,478,37,1125,48.9,914,42,53,0.047111111,981,144
ZCTA5 95938,1408,139,1269,4030,41.9,3269,141,286,0.070967742,423,3607
ZCTA5 95939,180,921,-741,552,40.4,340,0,40,0.072463768,2148,-1596
ZCTA5 95941,119,37,82,290,33.5,93,4,0,0,69,221
ZCTA5 95942,863,9311,-8448,1892,51.1,1737,0,0,0,25511,-23619
ZCTA5 95943,247,185,62,637,32.5,573,0,22,0.034536892,539,98
ZCTA5 95944,64,51,13,64,-,64,0,0,0,95,-31
ZCTA5 95945,11680,156,11524,27188,48.3,24713,247,121,0.004450493,417,26771
ZCTA5 95946,3563,66,3497,9086,57.2,8208,60,7,0.000770416,164,8922
ZCTA5 95947,689,245,444,1464,55.2,1261,49,4,0.00273224,637,827
ZCTA5 95948,3821,1274,2547,12010,34.8,8809,133,26,0.002164863,3859,8151
ZCTA5 95949,7914,1210,6704,21240,51.7,19133,161,112,0.00527307,2767,18473
ZCTA5 95950,205,890,-685,531,53.2,450,0,0,0,1857,-1326
ZCTA5 95951,814,94,720,2498,28.1,1150,164,31,0.012409928,236,2262
ZCTA5 95953,3244,6902,-3658,11247,35.2,6294,1702,170,0.015115142,16708,-5461
ZCTA5 95954,4377,200,4177,11234,48.2,9448,135,0,0,426,10808
ZCTA5 95955,507,191,316,1356,39.2,866,8,0,0,559,797
ZCTA5 95956,196,47,149,429,58.9,402,17,0,0,77,352
ZCTA5 95957,285,4326,-4041,831,34.9,640,3,2,0.002406739,11767,-10936
ZCTA5 95958,0,115,-115,0,-,0,0,0,#DIV/0!,277,-277
ZCTA5 95959,7577,534,7043,18280,55.8,16632,342,139,0.007603939,1068,17212
ZCTA5 95960,276,303,-27,647,35.5,637,3,0,0,898,-251
ZCTA5 95961,9437,742,8695,31402,30.8,20600,2545,953,0.030348385,2027,29375
ZCTA5 95962,454,490,-36,1107,41,1090,0,0,0,1159,-52
ZCTA5 95963,5710,235,5475,16812,36.7,13006,293,35,0.002081846,382,16430
ZCTA5 95965,7704,68,7636,21891,37.7,14254,3306,1046,0.047782194,125,21766
ZCTA5 95966,11923,157,11766,29203,46,22320,1395,391,0.013389035,353,28850
ZCTA5 95968,507,948,-441,1265,45.5,966,19,18,0.014229249,2689,-1424
ZCTA5 95969,4113,398,3715,9032,56.5,8090,89,39,0.004317981,1078,7954
ZCTA5 95970,192,116,76,490,49.1,454,0,12,0.024489796,172,318
ZCTA5 95971,2145,91,2054,6106,42.8,5062,62,322,0.052735015,183,5923
ZCTA5 95972,54,1850,-1796,141,12.6,141,0,0,0,7696,-7555
ZCTA5 95973,15175,949,14226,38490,37.1,30847,1874,443,0.011509483,2428,36062
ZCTA5 95974,51,68,-17,77,81.2,77,0,0,0,124,-47
ZCTA5 95975,730,598,132,1661,46.3,1568,10,0,0,1504,157
ZCTA5 95977,688,482,206,1662,36.5,1251,26,33,0.019855596,1132,530
ZCTA5 95978,36,229,-193,114,41.4,114,0,0,0,612,-498
ZCTA5 95979,163,74,89,362,57.7,293,4,36,0.099447514,137,225
ZCTA5 95981,18,72,-54,67,38.2,0,0,0,0,172,-105
ZCTA5 95982,1115,79,1036,3070,41.5,2706,87,0,0,148,2922
ZCTA5 95983,174,115,59,381,58.6,253,0,0,0,292,89
ZCTA5 95984,94,239,-145,170,62.2,170,0,0,0,552,-382
ZCTA5 95986,35,34,1,99,61.4,99,0,0,0,63,36
ZCTA5 95987,1871,10,1861,6370,32.1,4632,59,9,0.001412873,22,6348
ZCTA5 95988,2805,271,2534,8483,36.1,6721,524,43,0.005068961,717,7766
ZCTA5 95991,14445,31,14414,43028,34,24846,5270,1144,0.026587338,58,42970
ZCTA5 95993,12585,1846,10739,37993,37.7,21124,9096,526,0.013844656,5534,32459
ZCTA5 96001,13369,5961,7408,34253,40.4,29057,1252,467,0.013633842,19234,15019
ZCTA5 96002,12688,1545,11143,34693,37.2,26267,2424,469,0.013518577,4348,30345
ZCTA5 96003,18350,8,18342,44522,41,37769,1596,686,0.015408113,22,44500
ZCTA5 96006,216,11248,-11032,634,58.1,604,1,0,0,32403,-31769
ZCTA5 96007,9531,13148,-3617,24666,39,20629,284,141,0.005716371,32826,-8160
ZCTA5 96008,441,17480,-17039,1188,49.3,1108,0,27,0.022727273,43564,-42376
ZCTA5 96009,143,13624,-13481,281,52.5,274,0,0,0,27978,-27697
ZCTA5 96010,14,7454,-7440,104,39.5,97,0,0,0,16892,-16788
ZCTA5 96011,87,13464,-13377,196,56.1,161,1,4,0.020408163,37858,-37662
ZCTA5 96013,1600,10988,-9388,4519,38.3,3997,7,66,0.014605001,25434,-20915
ZCTA5 96014,66,9120,-9054,114,41.6,89,0,0,0,24544,-24430
ZCTA5 96015,80,1833,-1753,374,77.6,266,58,7,0.018716578,4827,-4453
ZCTA5 96016,133,12422,-12289,357,53,357,0,0,0,30539,-30182
ZCTA5 96017,84,19758,-19674,152,65.3,143,3,0,0,51109,-50957
ZCTA5 96019,4050,2458,1592,10486,40.2,9063,74,43,0.004100706,6851,3635
ZCTA5 96020,1155,3690,-2535,2542,60.6,2432,0,17,0.006687648,10564,-8022
ZCTA5 96021,5379,8219,-2840,15660,35.8,10903,372,17,0.001085568,18678,-3018
ZCTA5 96022,5720,9891,-4171,14793,42.5,12755,399,81,0.005475563,26209,-11416
ZCTA5 96023,502,8492,-7990,1288,40.7,1121,18,7,0.005434783,21335,-20047
ZCTA5 96024,319,17437,-17118,952,54.8,784,117,0,0,48937,-47985
ZCTA5 96025,959,2117,-1158,2192,43.9,1686,47,48,0.02189781,5888,-3696
ZCTA5 96027,844,14424,-13580,2118,56.5,1841,13,31,0.014636449,35426,-33308
ZCTA5 96028,607,10953,-10346,1641,42.2,1120,0,7,0.004265692,27685,-26044
ZCTA5 96029,59,7867,-7808,177,41.8,152,0,0,0,20574,-20397
ZCTA5 96031,29,10047,-10018,51,71.6,31,0,0,0,25583,-25532
ZCTA5 96032,1031,10700,-9669,2618,41.6,1948,4,18,0.006875477,30864,-28246
ZCTA5 96033,174,11188,-11014,420,54.1,368,13,0,0,33874,-33454
ZCTA5 96034,159,12404,-12245,369,50.5,308,0,13,0.035230352,31733,-31364
ZCTA5 96035,1483,14842,-13359,3320,46.1,2773,0,8,0.002409639,34130,-30810
ZCTA5 96037,43,18266,-18223,103,66.4,103,0,0,0,43130,-43027
ZCTA5 96038,259,13803,-13544,687,46.6,618,0,0,0,35336,-34649
ZCTA5 96039,414,10258,-9844,923,55.9,459,10,1,0.001083424,28064,-27141
ZCTA5 96040,38,11362,-11324,86,67.7,80,3,2,0.023255814,31881,-31795
ZCTA5 96041,1095,1007,88,3873,52.9,3068,88,71,0.018332042,2996,877
ZCTA5 96044,453,9335,-8882,1113,50.4,820,29,1,0.000898473,22922,-21809
ZCTA5 96046,54,14983,-14929,135,61.5,135,0,0,0,42368,-42233
ZCTA5 96047,354,8262,-7908,824,55.3,660,6,0,0,20066,-19242
ZCTA5 96048,401,5605,-5204,1235,55.7,1151,6,0,0,13912,-12677
ZCTA5 96050,245,2228,-1983,426,63.5,391,8,0,0,6399,-5973
ZCTA5 96051,575,48,527,1177,59.4,1052,49,13,0.01104503,174,1003
ZCTA5 96052,611,1437,-826,2141,43.2,1794,69,16,0.007473143,3930,-1789
ZCTA5 96054,121,24560,-24439,237,54.2,230,0,0,0,58681,-58444
ZCTA5 96055,1588,7767,-6179,4149,39.8,3379,93,0,0,20872,-16723
ZCTA5 96056,542,8890,-8348,1247,48.5,980,107,0,0,20839,-19592
ZCTA5 96057,495,12698,-12203,1052,57.2,929,0,15,0.014258555,32487,-31435
ZCTA5 96058,200,5314,-5114,644,38.9,405,64,28,0.043478261,10948,-10304
ZCTA5 96059,182,15889,-15707,394,70.5,369,25,0,0,43758,-43364
ZCTA5 96061,0,13097,-13097,0,-,0,0,0,#DIV/0!,35990,-35990
ZCTA5 96062,410,4216,-3806,1006,46.9,896,0,0,0,12502,-11496
ZCTA5 96063,76,183,-107,210,35.7,159,0,0,0,348,-138
ZCTA5 96064,1799,4903,-3104,4442,52.1,3822,74,0,0,10854,-6412
ZCTA5 96065,151,8524,-8373,332,57.7,228,0,0,0,22078,-21746
ZCTA5 96067,3655,8174,-4519,7518,51.6,6916,99,65,0.008645916,24792,-17274
ZCTA5 96068,19,6819,-6800,165,28,110,38,7,0.042424242,21441,-21276
ZCTA5 96069,459,4949,-4490,1112,50,783,13,0,0,14283,-13171
ZCTA5 96071,10,11483,-11473,20,-,20,0,0,0,30525,-30505
ZCTA5 96073,1903,14443,-12540,5377,48.2,4809,51,46,0.008554956,39119,-33742
ZCTA5 96074,33,7239,-7206,137,29.9,96,0,25,0.182481752,9851,-9714
ZCTA5 96075,176,13881,-13705,336,41,250,0,24,0.071428571,21805,-21469
ZCTA5 96076,84,22553,-22469,191,61,120,9,0,0,44766,-44575
ZCTA5 96078,0,6674,-6674,0,-,0,0,0,#DIV/0!,12630,-12630
ZCTA5 96080,12031,15604,-3573,31469,39.6,26486,378,477,0.015157774,45268,-13799
ZCTA5 96084,258,9493,-9235,650,55.8,411,40,0,0,23380,-22730
ZCTA5 96085,7,11450,-11443,25,41.4,7,0,0,0,21793,-21768
ZCTA5 96086,114,7808,-7694,230,61.5,195,3,0,0,23587,-23357
ZCTA5 96087,313,12207,-11894,784,51.3,740,0,0,0,21221,-20437
ZCTA5 96088,2221,9325,-7104,4685,58.3,4209,46,33,0.007043757,22933,-18248
ZCTA5 96090,209,10327,-10118,483,46.8,354,6,0,0,21678,-21195
ZCTA5 96091,338,20347,-20009,705,65.8,645,0,0,0,46336,-45631
ZCTA5 96092,91,11386,-11295,334,39.4,277,0,0,0,23056,-22722
ZCTA5 96093,1695,13478,-11783,4391,44.5,3354,53,1,0.000227739,31391,-27000
ZCTA5 96094,2855,15565,-12710,6846,47.2,5517,199,281,0.041045866,43765,-36919
ZCTA5 96096,333,10855,-10522,808,53.9,738,2,0,0,21971,-21163
ZCTA5 96097,4165,8503,-4338,10169,39,7944,82,215,0.021142689,11914,-1745
ZCTA5 96101,2041,15698,-13657,5343,44.7,4502,6,152,0.028448437,31287,-25944
ZCTA5 96103,681,17461,-16780,1506,64.7,1461,1,0,0,36028,-34522
ZCTA5 96104,398,9240,-8842,885,52.9,773,2,4,0.004519774,20448,-19563
ZCTA5 96105,174,19800,-19626,352,51.2,191,0,0,0,44307,-43955
ZCTA5 96106,203,213,-10,494,32.5,494,0,0,0,915,-421
ZCTA5 96107,341,6897,-6556,714,55,692,3,0,0,14544,-13830
ZCTA5 96108,54,11721,-11667,141,65.2,141,0,0,0,26329,-26188
ZCTA5 96109,414,9326,-8912,1179,41.1,1097,0,0,0,24572,-23393
ZCTA5 96110,13,3972,-3959,33,68.1,33,0,0,0,9504,-9471
ZCTA5 96111,14,0,14,22,76.6,22,0,0,0,0,22
ZCTA5 96112,93,13292,-13199,210,50.8,109,0,1,0.004761905,32805,-32595
ZCTA5 96113,411,0,411,2245,39.6,1387,25,500,0.222717149,0,2245
ZCTA5 96114,1311,21,1290,3200,51.8,2562,35,0,0,29,3171
ZCTA5 96115,67,7815,-7748,107,61.4,99,0,8,0.074766355,18706,-18599
ZCTA5 96116,31,11405,-11374,31,-,31,0,0,0,32677,-32646
ZCTA5 96117,99,0,99,226,58.7,226,0,0,0,57,169
ZCTA5 96118,569,7718,-7149,1494,55.2,1453,0,1,0.000669344,19476,-17982
ZCTA5 96119,12,9157,-9145,22,-,0,0,0,0,24559,-24537
ZCTA5 96120,326,9510,-9184,1061,56.2,597,10,0,0,22916,-21855
ZCTA5 96121,112,0,112,308,32.9,308,0,0,0,12,296
ZCTA5 96122,1728,12744,-11016,4030,42.6,3639,10,0,0,35353,-31323
ZCTA5 96123,25,9472,-9447,65,60.5,59,0,0,0,20308,-20243
ZCTA5 96124,111,12313,-12202,468,37.8,446,0,0,0,28466,-27998
ZCTA5 96125,76,13427,-13351,146,72.1,146,0,0,0,34633,-34487
ZCTA5 96126,66,16369,-16303,301,22.1,65,0,1,0.003322259,40850,-40549
ZCTA5 96128,250,3918,-3668,595,37.8,581,0,2,0.003361345,11353,-10758
ZCTA5 96129,158,0,158,508,50,508,0,0,0,1553,-1045
ZCTA5 96130,4967,18940,-13973,21904,34,15904,353,2315,0.105688459,50834,-28930
ZCTA5 96132,10,258,-248,25,31.4,23,0,0,0,742,-717
ZCTA5 96133,129,8879,-8750,363,50.3,160,0,0,0,20340,-19977
ZCTA5 96134,676,26,650,2144,37.4,1846,0,15,0.006996269,44,2100
ZCTA5 96135,60,15080,-15020,113,-,113,0,0,0,40293,-40180
ZCTA5 96136,17,158,-141,58,62.9,58,0,0,0,280,-222
ZCTA5 96137,1471,19198,-17727,3101,57.6,2819,0,0,0,45783,-42682
ZCTA5 96140,592,16306,-15714,1323,49.1,1082,66,13,0.009826153,41464,-40141
ZCTA5 96141,257,12359,-12102,600,52.6,577,23,0,0,30862,-30262
ZCTA5 96142,374,6669,-6295,818,38.6,782,2,7,0.008557457,16136,-15318
ZCTA5 96143,1467,1496,-29,3480,39.1,2713,44,0,0,3458,22
ZCTA5 96145,1157,5625,-4468,2671,43.6,2332,110,59,0.022089105,14839,-12168
ZCTA5 96146,498,30,468,1165,38.2,1084,0,0,0,97,1068
ZCTA5 96148,293,2723,-2430,706,56.2,581,0,0,0,6244,-5538
ZCTA5 96150,12461,1586,10875,29727,40.2,23693,1353,161,0.005415952,4052,25675
ZCTA5 96155,0,30,-30,0,-,0,0,0,#DIV/0!,70,-70
ZCTA5 96161,7193,3179,4014,19058,42.4,17161,224,46,0.002413685,6758,12300
ZCTA5 96701,14364,1140,13224,41818,43,5164,21407,812,0.019417476,3140,38678
ZCTA5 96703,761,820,-59,2844,40,363,167,0,0,2069,775
ZCTA5 96704,2925,210,2715,8391,48.3,3370,1259,119,0.014181862,370,8021
ZCTA5 96705,684,1208,-524,2382,34.5,356,1267,8,0.003358522,2922,-540
ZCTA5 96706,21944,1815,20129,81658,33.8,12064,36401,2566,0.031423743,3494,78164
ZCTA5 96707,14993,3036,11957,49903,35,10455,14438,1990,0.039877362,9379,40524
ZCTA5 96708,4013,8178,-4165,11213,41.9,6573,1004,22,0.001962008,22117,-10904
ZCTA5 96710,135,2103,-1968,294,61,123,87,0,0,4394,-4100
ZCTA5 96712,2594,4002,-1408,7294,38.8,4190,898,77,0.010556622,8050,-756
ZCTA5 96713,371,1814,-1443,938,51.7,307,0,0,0,5011,-4073
ZCTA5 96714,413,3117,-2704,1289,41.5,558,97,0,0,8233,-6944
ZCTA5 96716,759,985,-226,2488,44.4,256,1303,7,0.002813505,1719,769
ZCTA5 96717,1339,99,1240,5390,32.4,1445,285,58,0.010760668,369,5021
ZCTA5 96719,434,213,221,1252,42.1,508,260,0,0,390,862
ZCTA5 96720,17038,1827,15211,49886,40.1,9731,15372,337,0.006755402,4191,45695
ZCTA5 96722,925,10991,-10066,2093,51,1468,132,0,0,30987,-28894
ZCTA5 96725,1496,2359,-863,4054,47.1,1907,967,7,0.00172669,5085,-1031
ZCTA5 96726,9,1201,-1192,23,-,0,0,0,0,2332,-2309
ZCTA5 96727,1511,524,987,4572,42.4,1324,954,9,0.001968504,1044,3528
ZCTA5 96728,155,36,119,418,48.2,158,77,0,0,70,348
ZCTA5 96729,388,6581,-6193,1330,40.3,5,41,0,0,17963,-16633
ZCTA5 96730,526,1444,-918,1418,34.6,549,123,0,0,4198,-2780
ZCTA5 96731,831,209,622,2893,35.6,651,403,54,0.018665745,415,2478
ZCTA5 96732,7908,16657,-8749,26361,42.4,2437,15589,194,0.007359357,46490,-20129
ZCTA5 96734,16599,9547,7052,52619,36.1,25327,9182,964,0.018320379,26793,25826
ZCTA5 96737,1740,8491,-6751,3851,47.1,1369,176,227,0.058945728,27758,-23907
ZCTA5 96738,2841,10582,-7741,7899,39.3,3332,1495,140,0.017723763,29708,-21809
ZCTA5 96740,14272,6386,7886,40931,42.8,17859,7828,376,0.009186191,16743,24188
ZCTA5 96741,1950,7793,-5843,6150,43.1,2397,1217,0,0,20263,-14113
ZCTA5 96742,31,162,-131,48,57,14,9,2,0.041666667,561,-513
ZCTA5 96743,4662,15423,-10761,13386,43.2,3997,2830,5,0.000373525,37983,-24597
ZCTA5 96744,17150,0,17150,54537,44.4,11058,19705,254,0.004657389,938,53599
ZCTA5 96746,6715,325,6390,20810,45.1,9077,5169,156,0.007496396,653,20157
ZCTA5 96747,284,180,104,1476,39.2,5,1236,0,0,352,1124
ZCTA5 96748,1390,665,725,4251,38.4,780,382,27,0.006351447,1309,2942
ZCTA5 96749,6234,6418,-184,17738,45.7,4872,4839,41,0.002311422,15586,2152
ZCTA5 96750,1246,246,1000,3719,47.2,959,1365,15,0.004033342,605,3114
ZCTA5 96751,44,9107,-9063,133,54.7,94,32,0,0,23475,-23342
ZCTA5 96752,1044,113,931,3214,39.7,416,567,0,0,274,2940
ZCTA5 96753,10853,94,10759,29547,44.4,15416,6124,242,0.008190341,178,29369
ZCTA5 96754,1198,11996,-10798,4111,42.9,2543,824,17,0.004135247,33228,-29117
ZCTA5 96755,1215,7946,-6731,3210,50,740,907,27,0.008411215,21414,-18204
ZCTA5 96756,2033,2306,-273,5939,42.1,2374,1342,28,0.004714598,6579,-640
ZCTA5 96757,241,808,-567,694,48.6,199,168,0,0,2245,-1551
ZCTA5 96759,85,9390,-9305,261,50.9,0,261,0,0,28225,-27964
ZCTA5 96760,1332,47,1285,3788,48.8,1414,940,0,0,104,3684
ZCTA5 96761,7272,423,6849,23473,40.3,9119,6093,58,0.002470924,852,22621
ZCTA5 96762,1072,470,602,6867,23.3,1977,972,28,0.004077472,809,6058
ZCTA5 96763,1183,183,1000,3126,44.8,483,1669,0,0,291,2835
ZCTA5 96764,220,8118,-7898,533,57.5,249,76,0,0,18939,-18406
ZCTA5 96765,212,9930,-9718,689,31.8,274,212,0,0,25970,-25281
ZCTA5 96766,4841,12616,-7775,17420,40.8,2615,8232,168,0.009644087,32040,-14620
ZCTA5 96768,6303,29,6274,18497,43.9,6563,4555,72,0.003892523,1484,17013
ZCTA5 96769,78,1104,-1026,346,24.1,27,115,0,0,5419,-5073
ZCTA5 96770,192,666,-474,435,55.1,143,11,0,0,1264,-829
ZCTA5 96771,2386,5083,-2697,6770,39.9,2535,328,66,0.009748892,14066,-7296
ZCTA5 96772,990,230,760,2576,46.7,908,458,12,0.004658385,742,1834
ZCTA5 96773,80,813,-733,167,56.6,104,20,25,0.149700599,1908,-1741
ZCTA5 96774,85,238,-153,180,66.1,87,11,0,0,1113,-933
ZCTA5 96776,518,3033,-2515,1323,44.8,462,359,0,0,8205,-6882
ZCTA5 96777,605,3588,-2983,2418,28.5,438,661,0,0,9714,-7296
ZCTA5 96778,5838,3816,2022,14777,43.4,6246,1665,42,0.002842255,10176,4601
ZCTA5 96779,877,113,764,2579,41.2,1311,361,0,0,178,2401
ZCTA5 96780,250,2238,-1988,580,47.1,203,192,0,0,6240,-5660
ZCTA5 96781,459,5768,-5309,1200,41,291,432,0,0,15234,-14034
ZCTA5 96782,11909,1260,10649,37992,41.9,4230,19547,724,0.019056644,3366,34626
ZCTA5 96783,594,9702,-9108,1747,39.8,167,475,0,0,25006,-23259
ZCTA5 96785,2132,360,1772,4785,53.5,1953,238,10,0.002089864,858,3927
ZCTA5 96786,13654,2666,10988,43042,28,13633,11193,4380,0.101761071,7220,35822
ZCTA5 96789,18794,8490,10304,55249,41.2,7763,27486,1445,0.02615432,23463,31786
ZCTA5 96790,3206,1522,1684,9375,45.4,4540,1440,8,0.000853333,3302,6073
ZCTA5 96791,2377,1203,1174,7010,41.7,2405,2075,35,0.004992867,2567,4443
ZCTA5 96792,13426,563,12863,52829,32.8,5190,4984,1122,0.021238335,1263,51566
ZCTA5 96793,9722,170,9552,32749,38.9,6318,10739,497,0.015176036,378,32371
ZCTA5 96795,2278,3607,-1329,9815,35.7,935,985,13,0.001324503,9777,38
ZCTA5 96796,727,1699,-972,1863,43.1,394,784,0,0,4281,-2418
ZCTA5 96797,19971,145,19826,72943,39.9,4969,45219,787,0.010789246,539,72404
ZCTA5 96813,11577,536,11041,25292,44.2,4393,11862,564,0.022299541,1216,24076
ZCTA5 96814,11795,0,11795,22880,46.5,3522,13814,271,0.011844406,0,22880
ZCTA5 96815,14584,3006,11578,26608,46.2,10629,10819,425,0.01597264,7114,19494
ZCTA5 96816,17881,277,17604,51526,46,10128,25825,267,0.00518185,580,50946
ZCTA5 96817,19058,764,18294,54183,45.9,5086,33373,497,0.009172619,1888,52295
ZCTA5 96818,18992,480,18512,59703,32.2,18613,21916,4137,0.069293,1444,58259
ZCTA5 96819,11778,447,11331,51712,38.9,3909,30536,624,0.012066832,965,50747
ZCTA5 96820,0,1851,-1851,0,-,0,0,0,#DIV/0!,5338,-5338
ZCTA5 96821,6600,4065,2535,19250,48.9,4303,9997,39,0.002025974,11862,7388
ZCTA5 96822,18842,696,18146,48037,40.8,9755,23787,553,0.01151196,1384,46653
ZCTA5 96825,10759,9756,1003,30621,48.5,8340,13757,282,0.009209366,21515,9106
ZCTA5 96826,14621,5690,8931,30592,42.9,4019,17274,555,0.018141998,14108,16484
ZCTA5 96848,0,0,0,766,23.2,173,393,0,0,0,766
ZCTA5 96850,0,2247,-2247,0,-,0,0,0,#DIV/0!,4636,-4636
ZCTA5 96853,0,13541,-13541,461,22.6,314,22,65,0.140997831,34581,-34120
ZCTA5 96857,0,10165,-10165,4140,22.1,2582,227,729,0.176086957,27096,-22956
ZCTA5 96858,0,7269,-7269,250,23.6,170,6,17,0.068,14395,-14145
ZCTA5 96859,0,11515,-11515,0,-,0,0,0,#DIV/0!,28786,-28786
ZCTA5 96860,0,8408,-8408,3388,22.8,2047,243,592,0.174734357,20519,-17131
ZCTA5 96863,0,9251,-9251,2220,21.4,1576,76,252,0.113513514,22773,-20553
ZCTA5 97001,43,8826,-8783,318,33.3,255,17,16,0.050314465,22517,-22199
ZCTA5 97002,2282,13504,-11222,6558,45,5710,83,90,0.013723696,38487,-31929
ZCTA5 97003,10364,8809,1555,28411,34.6,17820,3362,1340,0.047164831,27510,901
ZCTA5 97004,1683,843,840,3854,53.6,3559,89,0,0,1911,1943
ZCTA5 97005,11355,906,10449,27344,35.7,19101,1623,577,0.021101521,1831,25513
ZCTA5 97006,17945,1689,16256,45165,34.3,28369,9872,1410,0.031218864,4161,41004
ZCTA5 97007,18399,177,18222,48546,40.3,34105,6802,847,0.01744737,616,47930
ZCTA5 97008,12367,12344,23,29880,38.9,23718,1699,518,0.017336011,26966,2914
ZCTA5 97009,3127,8314,-5187,8917,47.2,7538,109,10,0.001121453,20438,-11521
ZCTA5 97011,344,198,146,795,44.7,780,0,0,0,489,306
ZCTA5 97013,8952,14439,-5487,24951,41.6,20369,455,109,0.004368562,44136,-19185
ZCTA5 97014,668,2418,-1750,1584,45.6,1414,55,27,0.017045455,7092,-5508
ZCTA5 97015,9109,4053,5056,23516,38.1,17634,2425,173,0.007356693,10207,13309
ZCTA5 97016,2728,15224,-12496,6728,44.6,5599,39,113,0.016795482,44711,-37983
ZCTA5 97017,1168,1224,-56,3758,41.2,3536,5,58,0.015433741,2930,828
ZCTA5 97018,703,460,243,1782,49.4,1657,27,32,0.017957351,1474,308
ZCTA5 97019,1151,197,954,3261,41.6,2658,31,14,0.004293162,522,2739
ZCTA5 97020,399,3135,-2736,1200,37,948,38,0,0,6745,-5545
ZCTA5 97021,593,4011,-3418,1415,38.6,1253,0,0,0,7209,-5794
ZCTA5 97022,1350,10509,-9159,3309,52.6,2998,0,0,0,32741,-29432
ZCTA5 97023,3983,9395,-5412,10713,44.1,9524,404,2,0.000186689,22838,-12125
ZCTA5 97024,4797,9492,-4695,11195,39.2,8225,13,1188,0.106118803,22178,-10983
ZCTA5 97026,1013,8680,-7667,3620,34.4,2321,20,0,0,20094,-16474
ZCTA5 97027,4870,7264,-2394,12509,39.9,10255,217,223,0.017827164,19653,-7144
ZCTA5 97028,111,9113,-9002,143,74.3,143,0,0,0,23367,-23224
ZCTA5 97029,118,12,106,335,37.3,307,0,3,0.008955224,1361,-1026
ZCTA5 97030,15399,3677,11722,39757,36.3,29029,1516,1480,0.037226149,9755,30002
ZCTA5 97031,7364,25,7339,19464,38.4,15803,172,125,0.006422113,28,19436
ZCTA5 97032,1690,7569,-5879,4991,39.8,4020,157,18,0.003606492,20523,-15532
ZCTA5 97033,31,3900,-3869,83,37.3,83,0,0,0,9967,-9884
ZCTA5 97034,8272,0,8272,20688,49.1,16720,1361,23,0.001111756,0,20688
ZCTA5 97035,10931,3551,7380,26593,41.5,20643,3163,330,0.012409281,17860,8733
ZCTA5 97037,394,11,383,819,54.8,772,10,0,0,274,545
ZCTA5 97038,5979,1847,4132,16429,37.9,15575,113,17,0.001034756,5443,10986
ZCTA5 97039,169,2170,-2001,432,34.7,391,0,0,0,5354,-4922
ZCTA5 97040,614,12580,-11966,1735,36.9,1489,17,0,0,34654,-32919
ZCTA5 97041,947,10815,-9868,2921,43.3,2343,19,12,0.004108182,29799,-26878
ZCTA5 97042,993,3828,-2835,2879,50.5,2655,40,0,0,9767,-6888
ZCTA5 97045,20489,0,20489,56672,40.4,51251,616,306,0.005399492,849,55823
ZCTA5 97048,2839,2875,-36,7530,47.4,6740,38,47,0.0062417,6138,1392
ZCTA5 97049,879,11321,-10442,1866,52.3,1749,41,0,0,26942,-25076
ZCTA5 97050,105,6031,-5926,232,58.3,175,0,0,0,14440,-14208
ZCTA5 97051,6262,11426,-5164,17107,38.4,15470,115,66,0.00385807,28148,-11041
ZCTA5 97053,1433,12861,-11428,3577,55.6,3367,39,0,0,29351,-25774
ZCTA5 97054,622,16617,-15995,1412,54.7,1271,0,0,0,39154,-37742
ZCTA5 97055,6841,12761,-5920,19030,37.6,17473,267,135,0.007094062,30621,-11591
ZCTA5 97056,4529,14824,-10295,11839,42.2,10538,143,18,0.001520399,36469,-24630
ZCTA5 97057,8,7630,-7622,14,35.5,14,0,0,0,17079,-17065
ZCTA5 97058,8123,11135,-3012,20887,39.1,17666,204,56,0.002681094,28330,-7443
ZCTA5 97060,7042,11974,-4932,21882,33.7,17162,873,359,0.016406179,32672,-10790
ZCTA5 97062,11112,8018,3094,28823,38.7,21418,802,509,0.017659508,20666,8157
ZCTA5 97063,412,8419,-8007,830,63,693,0,0,0,24275,-23445
ZCTA5 97064,1304,1139,165,3432,41.9,3285,0,0,0,2689,743
ZCTA5 97065,288,98,190,702,56.6,614,4,0,0,224,478
ZCTA5 97067,882,70,812,1823,53.1,1706,9,0,0,179,1644
ZCTA5 97068,11303,3898,7405,30585,45.2,26541,1453,378,0.012359,10072,20513
ZCTA5 97070,10579,232,10347,25286,37.5,20186,1183,423,0.016728625,580,24706
ZCTA5 97071,10204,9198,1006,31345,38.3,19480,381,290,0.009251874,23486,7859
ZCTA5 97078,8761,8858,-97,24463,36.2,15974,2020,1309,0.053509382,23766,697
ZCTA5 97080,16361,300,16061,46413,38.7,38388,1508,910,0.019606576,718,45695
ZCTA5 97086,11589,224,11365,32037,40.1,22023,4696,523,0.016324874,422,31615
ZCTA5 97089,4795,68,4727,14842,41.7,13092,767,116,0.007815658,114,14728
ZCTA5 97101,1398,831,567,4065,39.8,3601,14,5,0.001230012,2132,1933
ZCTA5 97102,172,106,66,375,63.5,375,0,0,0,273,102
ZCTA5 97103,6989,3731,3258,17787,42.5,15533,93,167,0.00938888,9958,7829
ZCTA5 97106,1791,179,1612,5017,38.3,4245,56,11,0.002192545,609,4408
ZCTA5 97107,959,0,959,2448,43.8,2198,15,0,0,0,2448
ZCTA5 97108,227,1152,-925,600,56.6,583,0,0,0,2931,-2331
ZCTA5 97109,195,692,-497,589,48.9,537,0,0,0,1619,-1030
ZCTA5 97110,595,1150,-555,1225,52.6,892,1,1,0.000816327,2387,-1162
ZCTA5 97111,1340,4818,-3478,3776,46.7,2957,61,18,0.004766949,12064,-8288
ZCTA5 97112,841,185,656,1989,45.4,1886,0,0,0,446,1543
ZCTA5 97113,4869,147,4722,14530,39.4,9496,272,170,0.011699931,282,14248
ZCTA5 97114,1558,1190,368,5027,38.1,4386,11,10,0.001989258,3138,1889
ZCTA5 97115,1324,57,1267,3960,43,3140,30,0,0,158,3802
ZCTA5 97116,10070,0,10070,28835,36.6,22799,515,319,0.011062944,0,28835
ZCTA5 97117,306,65,241,1112,37.6,1078,0,0,0,195,917
ZCTA5 97118,305,99,206,657,57.2,608,7,2,0.00304414,132,525
ZCTA5 97119,1783,3316,-1533,5560,45.3,4664,131,77,0.013848921,8196,-2636
ZCTA5 97121,544,1079,-535,1259,43.7,1216,0,0,0,2584,-1325
ZCTA5 97122,125,171,-46,350,46,306,0,0,0,581,-231
ZCTA5 97123,16404,908,15496,47972,36,31463,3930,1079,0.022492287,2701,45271
ZCTA5 97124,20796,2887,17909,54287,33.9,37070,6586,1645,0.030301914,5759,48528
ZCTA5 97125,24,1565,-1541,77,63.1,49,0,0,0,3801,-3724
ZCTA5 97127,1473,135,1338,4369,35.7,3424,14,0,0,401,3968
ZCTA5 97128,14342,286,14056,38508,39.6,30966,674,219,0.00568713,608,37900
ZCTA5 97130,365,90,275,722,62.6,660,5,0,0,193,529
ZCTA5 97131,1248,1828,-580,2627,57.4,2444,34,0,0,4297,-1670
ZCTA5 97132,11376,2876,8500,30995,36.1,26587,631,191,0.006162284,6880,24115
ZCTA5 97133,2100,4970,-2870,5747,40.6,4542,378,265,0.046111014,13276,-7529
ZCTA5 97134,65,3589,-3524,104,66.1,104,0,0,0,10013,-9909
ZCTA5 97135,538,156,382,1229,64,1154,0,0,0,239,990
ZCTA5 97136,956,343,613,2185,53.5,2115,14,7,0.003203661,716,1469
ZCTA5 97137,376,47,329,1157,39.4,1036,6,0,0,90,1067
ZCTA5 97138,4971,13256,-8285,11304,47.1,10451,178,187,0.016542817,36016,-24712
ZCTA5 97140,9074,216,8858,28282,37.2,23682,1232,280,0.00990029,538,27744
ZCTA5 97141,5261,848,4413,13272,42.7,11464,87,110,0.008288125,1905,11367
ZCTA5 97144,72,257,-185,135,50,135,0,0,0,827,-692
ZCTA5 97145,117,908,-791,165,67,131,7,0,0,2122,-1957
ZCTA5 97146,2891,2662,229,7730,40.9,6489,166,12,0.001552393,7050,680
ZCTA5 97147,208,106,102,392,48.3,371,0,0,0,277,115
ZCTA5 97148,1097,1472,-375,3655,37.9,2829,27,11,0.003009576,3696,-41
ZCTA5 97149,245,753,-508,529,53.1,492,14,0,0,1720,-1191
ZCTA5 97201,9138,316,8822,17015,32.2,12708,2156,380,0.022333235,775,16240
ZCTA5 97202,18265,1085,17180,43507,37.4,35689,2650,1136,0.026110741,2406,41101
ZCTA5 97203,12660,2684,9976,34583,32.4,22852,2054,3898,0.112714339,7741,26842
ZCTA5 97204,431,7707,-7276,1055,35.8,617,59,231,0.218957346,20957,-19902
ZCTA5 97205,5720,957,4763,8309,42.1,6569,369,376,0.045252136,2492,5817
ZCTA5 97206,21338,41,21297,52702,38,41504,5071,962,0.018253577,100,52602
ZCTA5 97208,0,378,-378,0,-,0,0,0,#DIV/0!,827,-827
ZCTA5 97209,13794,11036,2758,19632,39.3,15591,1563,636,0.032396088,33812,-14180
ZCTA5 97210,6647,512,6135,11410,34.9,9238,671,456,0.039964943,1578,9832
ZCTA5 97211,14188,2959,11229,34148,37.5,24719,1504,4108,0.120299871,8902,25246
ZCTA5 97212,11333,9528,1805,28263,40.2,22636,1265,1825,0.064572055,27988,275
ZCTA5 97213,14289,1135,13154,31826,42,26054,2039,819,0.025733677,2746,29080
ZCTA5 97214,14412,3652,10760,28630,36.5,24327,1214,424,0.01480964,9529,19101
ZCTA5 97215,7335,1073,6262,17371,40.6,14189,1213,300,0.017270163,2498,14873
ZCTA5 97216,6986,196,6790,17770,38.6,10917,3391,792,0.044569499,526,17244
ZCTA5 97217,15276,135,15141,35049,37.7,26494,1185,2903,0.082826899,227,34822
ZCTA5 97218,6058,87,5971,15468,34.8,9895,894,1655,0.106995087,157,15311
ZCTA5 97219,18306,477,17829,44374,40.7,35212,2496,1658,0.037364222,1298,43076
ZCTA5 97220,11525,214,11311,28307,40.1,19005,3881,2361,0.083406931,533,27774
ZCTA5 97221,5339,3223,2116,12974,43.7,10647,772,353,0.027208263,7585,5389
ZCTA5 97222,15798,179,15619,36639,39.3,30465,902,329,0.008979503,593,36046
ZCTA5 97223,20306,624,19682,50043,38.9,39576,3531,631,0.012609156,1393,48650
ZCTA5 97224,15509,2406,13103,37059,43.6,30327,2659,886,0.023907823,6197,30862
ZCTA5 97225,11686,9595,2091,26202,38.9,21057,1678,524,0.019998473,24538,1664
ZCTA5 97227,3257,155,3102,5994,34.5,4408,288,627,0.104604605,420,5574
ZCTA5 97229,26324,2939,23385,72974,37.8,45806,19289,1410,0.01932195,8536,64438
ZCTA5 97230,15825,1685,14140,41563,39.5,25484,4611,4238,0.101965691,3549,38014
ZCTA5 97231,1567,19703,-18136,3642,52.7,3292,160,5,0.001372872,49014,-45372
ZCTA5 97232,8245,713,7532,14780,35.4,11613,701,560,0.037889039,1610,13170
ZCTA5 97233,13833,540,13293,38497,35.3,25540,3803,3201,0.083149336,1451,37046
ZCTA5 97236,13284,343,12941,39399,36.6,24945,5255,2604,0.066093048,810,38589
ZCTA5 97239,9239,1947,7292,18620,38.8,15394,945,438,0.023523093,4039,14581
ZCTA5 97258,0,0,0,0,-,0,0,0,#DIV/0!,0,0
ZCTA5 97266,13035,5619,7416,35371,38.2,22232,5915,1840,0.052020016,15420,19951
ZCTA5 97267,12857,229,12628,31841,44.2,27061,772,452,0.014195534,517,31324
ZCTA5 97301,19615,243,19372,56636,33.1,38410,1677,917,0.016191115,524,56112
ZCTA5 97302,16562,549,16013,41371,38.8,34123,730,755,0.018249498,1337,40034
ZCTA5 97303,14709,128,14581,41101,36,31748,442,144,0.003503564,225,40876
ZCTA5 97304,13149,1289,11860,33846,39.2,29008,1088,30,0.000886368,3098,30748
ZCTA5 97305,14299,329,13970,43869,30.9,30022,1222,715,0.016298525,1000,42869
ZCTA5 97306,13032,335,12697,33481,38.9,26611,1550,556,0.016606433,819,32662
ZCTA5 97310,0,318,-318,1194,35.9,752,0,45,0.037688442,869,325
ZCTA5 97317,8339,5331,3008,25635,40.9,18875,627,131,0.005110201,12032,13603
ZCTA5 97321,11009,17143,-6134,29121,40.7,25919,663,76,0.0026098,41954,-12833
ZCTA5 97322,13918,11619,2299,37361,35.4,31534,646,160,0.004282541,32273,5088
ZCTA5 97324,541,5714,-5173,1274,56.8,1174,0,7,0.005494505,13604,-12330
ZCTA5 97325,2212,9101,-6889,6884,38.7,5756,88,0,0,21641,-14757
ZCTA5 97326,356,9363,-9007,941,45.4,865,10,0,0,22923,-21982
ZCTA5 97327,1322,43,1279,3137,48.4,2791,11,0,0,110,3027
ZCTA5 97329,18,7866,-7848,33,-,33,0,0,0,21969,-21936
ZCTA5 97330,18479,2090,16389,43813,33.4,35349,4039,556,0.012690297,5086,38727
ZCTA5 97331,0,198,-198,3656,19,2651,506,31,0.008479212,406,3250
ZCTA5 97333,9974,3781,6193,22938,29.5,19056,1713,269,0.011727265,11559,11379
ZCTA5 97335,44,1880,-1836,45,-,44,0,0,0,6497,-6452
ZCTA5 97336,22,18424,-18402,86,54.8,69,0,0,0,55129,-55043
ZCTA5 97338,8820,12860,-4040,22906,42.8,20569,64,160,0.006985069,30769,-7863
ZCTA5 97341,1779,9693,-7914,3355,60.5,3083,30,2,0.000596125,27179,-23824
ZCTA5 97342,47,9657,-9610,78,63.7,77,0,0,0,26691,-26613
ZCTA5 97343,149,6799,-6650,370,48.4,369,1,0,0,17783,-17413
ZCTA5 97344,653,15323,-14670,1982,34.6,1622,92,0,0,40522,-38540
ZCTA5 97345,230,10603,-10373,759,37.5,758,0,0,0,28477,-27718
ZCTA5 97346,338,37,301,933,50.3,832,8,12,0.012861736,102,831
ZCTA5 97347,548,1147,-599,1407,36.4,614,26,8,0.005685856,4466,-3059
ZCTA5 97348,630,1080,-450,1810,39.1,1543,4,0,0,3479,-1669
ZCTA5 97350,79,199,-120,200,61.2,185,0,0,0,420,-220
ZCTA5 97351,3336,2648,688,10760,30.9,8081,14,51,0.004739777,7432,3328
ZCTA5 97352,2063,2476,-413,6740,37.1,5284,0,41,0.006083086,6867,-127
ZCTA5 97355,12435,224,12211,31643,42,28545,203,71,0.002243782,566,31077
ZCTA5 97357,138,80,58,243,66.4,201,0,0,0,144,99
ZCTA5 97358,1045,186,859,2380,58.4,2087,8,2,0.000840336,566,1814
ZCTA5 97360,882,878,4,2424,43,1985,9,26,0.010726073,2359,65
ZCTA5 97361,4156,3655,501,12879,28,10387,298,294,0.022827859,10423,2456
ZCTA5 97362,1481,102,1379,4174,39.9,3192,17,14,0.003354097,340,3834
ZCTA5 97364,257,2656,-2399,690,31.7,480,1,0,0,6057,-5367
ZCTA5 97365,4749,224,4525,10761,48.5,8726,174,108,0.010036242,572,10189
ZCTA5 97366,873,677,196,2045,57.4,1809,6,0,0,1774,271
ZCTA5 97367,4824,180,4644,10902,55.8,9350,311,29,0.002660062,486,10416
ZCTA5 97368,1318,238,1080,3148,49.2,2725,1,0,0,457,2691
ZCTA5 97369,81,1249,-1168,148,64.4,136,0,0,0,3626,-3478
ZCTA5 97370,3586,57,3529,9378,42.8,7807,156,222,0.023672425,156,9222
ZCTA5 97371,330,88,242,615,54.5,541,26,0,0,208,407
ZCTA5 97373,0,79,-79,191,49.9,118,30,0,0,218,-27
ZCTA5 97374,1936,180,1756,4483,53,4231,0,20,0.004461298,671,3812
ZCTA5 97375,453,14428,-13975,1339,38.7,1216,88,0,0,40860,-39521
ZCTA5 97376,573,1957,-1384,1156,60,1063,45,0,0,4837,-3681
ZCTA5 97377,319,3392,-3073,846,31.4,800,0,0,0,8920,-8074
ZCTA5 97378,2974,440,2534,9225,42.2,8174,124,291,0.031544715,1419,7806
ZCTA5 97380,845,1796,-951,2240,38.6,1616,0,9,0.004017857,4513,-2273
ZCTA5 97381,5799,64,5735,16217,40.2,14072,90,21,0.001294937,173,16044
ZCTA5 97383,3828,416,3412,9977,40.1,8566,74,0,0,1077,8900
ZCTA5 97384,45,551,-506,80,67.1,80,0,0,0,2060,-1980
ZCTA5 97385,1443,3667,-2224,3487,49.1,2838,61,0,0,11980,-8493
ZCTA5 97386,5802,624,5178,14760,46.5,13493,175,132,0.008943089,1551,13209
ZCTA5 97388,373,535,-162,717,63.5,622,36,0,0,1514,-797
ZCTA5 97389,702,1652,-950,1856,43.5,1688,19,0,0,3493,-1637
ZCTA5 97390,372,7,365,557,68.1,418,0,0,0,24,533
ZCTA5 97391,2320,2,2318,6253,39.1,5617,0,6,0.000959539,5,6248
ZCTA5 97392,1953,2568,-615,5753,41.3,5332,61,0,0,6458,-705
ZCTA5 97394,2397,1028,1369,5110,56.4,4702,9,22,0.004305284,2110,3000
ZCTA5 97396,1424,1239,185,3810,40.7,3346,9,5,0.001312336,4135,-325
ZCTA5 97401,22239,702,21537,47867,29.4,37937,3147,478,0.009986003,1841,46026
ZCTA5 97402,22307,139,22168,52725,36,41047,926,972,0.018435277,192,52533
ZCTA5 97403,4491,143,4348,14611,22,12046,768,207,0.014167408,318,14293
ZCTA5 97404,13352,919,12433,34625,40.9,29263,1047,536,0.015480144,2100,32525
ZCTA5 97405,19432,9659,9773,45838,44.9,39860,1583,351,0.007657402,29745,16093
ZCTA5 97406,138,16815,-16677,284,51.1,183,0,0,0,46682,-46398
ZCTA5 97408,6055,5051,1004,14405,44,12415,479,246,0.017077404,14845,-440
ZCTA5 97410,253,13986,-13733,481,61.7,427,0,0,0,35331,-34850
ZCTA5 97411,3437,127,3310,7119,58.3,6476,21,0,0,548,6571
ZCTA5 97412,232,2324,-2092,628,45.8,575,3,0,0,5145,-4517
ZCTA5 97413,455,260,195,873,58.2,811,4,5,0.005727377,969,-96
ZCTA5 97414,58,219,-161,158,51.7,158,0,0,0,524,-366
ZCTA5 97415,6583,12025,-5442,14055,57.3,12359,194,25,0.001778726,30841,-16786
ZCTA5 97416,370,0,370,1151,34.4,1061,0,0,0,0,1151
ZCTA5 97417,1048,4395,-3347,2345,44.9,1945,58,1,0.000426439,16347,-14002
ZCTA5 97419,393,1287,-894,871,59.9,726,38,0,0,4959,-4088
ZCTA5 97420,11988,357,11631,27622,44.1,23568,351,231,0.008362899,1113,26509
ZCTA5 97423,2887,451,2436,6654,48.2,6206,0,17,0.002554854,1149,5505
ZCTA5 97424,7396,935,6461,18423,43.3,16286,162,111,0.006025077,3843,14580
ZCTA5 97426,3999,1772,2227,10442,38.9,9358,90,35,0.003351848,5645,4797
ZCTA5 97429,347,1623,-1276,823,56.7,797,0,0,0,3967,-3144
ZCTA5 97430,169,446,-277,384,55.8,355,0,0,0,1475,-1091
ZCTA5 97431,739,78,661,2231,45.5,2196,0,0,0,235,1996
ZCTA5 97432,17,357,-340,17,-,17,0,0,0,502,-485
ZCTA5 97434,293,421,-128,1085,39.5,883,79,0,0,1019,66
ZCTA5 97435,984,5773,-4789,2403,50.2,2173,25,0,0,16074,-13671
ZCTA5 97436,313,275,38,664,57.3,618,0,0,0,688,-24
ZCTA5 97437,934,6427,-5493,2596,46.2,2392,44,37,0.014252696,22205,-19609
ZCTA5 97438,446,216,230,1245,51.2,1206,9,2,0.001606426,525,720
ZCTA5 97439,7628,990,6638,15419,60.1,14113,165,196,0.01271159,2831,12588
ZCTA5 97441,155,3423,-3268,539,24.2,539,0,0,0,13273,-12734
ZCTA5 97442,1006,69,937,2047,56.5,1802,0,0,0,263,1784
ZCTA5 97443,947,3724,-2777,3052,31.5,2913,0,37,0.012123198,13964,-10912
ZCTA5 97444,2627,615,2012,6166,51.5,5663,16,0,0,2536,3630
ZCTA5 97446,2092,2039,53,5639,35.6,4964,0,11,0.0019507,7078,-1439
ZCTA5 97447,233,1495,-1262,407,42.3,261,0,0,0,6035,-5628
ZCTA5 97448,5817,1937,3880,14228,44.3,12815,20,21,0.001475963,4998,9230
ZCTA5 97449,892,6607,-5715,1885,63.6,1817,0,4,0.002122016,17763,-15878
ZCTA5 97450,273,2810,-2537,679,57.5,650,0,0,0,8435,-7756
ZCTA5 97451,148,4012,-3864,398,62.1,380,0,0,0,10665,-10267
ZCTA5 97452,594,247,347,1508,47.6,1409,30,10,0.0066313,559,949
ZCTA5 97453,342,1667,-1325,840,56.6,765,14,0,0,4732,-3892
ZCTA5 97454,395,823,-428,1124,52.6,1080,0,0,0,3262,-2138
ZCTA5 97455,901,464,437,2594,42.3,2464,19,0,0,1211,1383
ZCTA5 97456,1188,692,496,3253,43.2,2568,34,0,0,1851,1402
ZCTA5 97457,3949,4607,-658,9826,48.7,8836,27,23,0.002340729,12621,-2795
ZCTA5 97458,1997,69,1928,4657,55.5,4009,11,9,0.001932575,197,4460
ZCTA5 97459,5900,85,5815,15218,47,13361,309,140,0.009199632,288,14930
ZCTA5 97461,377,3700,-3323,818,59.2,682,57,0,0,9939,-9121
ZCTA5 97462,1758,82,1676,4217,54.2,3893,20,0,0,104,4113
ZCTA5 97463,1696,3495,-1799,3851,43.2,3732,0,0,0,9160,-5309
ZCTA5 97465,1030,2915,-1885,1778,57.8,1685,2,0,0,8670,-6892
ZCTA5 97466,464,104,360,1301,40.6,1069,0,0,0,407,894
ZCTA5 97467,2430,1613,817,5455,54.8,5021,20,13,0.002383135,4771,684
ZCTA5 97469,1014,3144,-2130,2728,44.2,2319,15,11,0.004032258,8735,-6007
ZCTA5 97470,8396,2484,5912,19019,42.6,17347,70,14,0.000736106,6270,12749
ZCTA5 97471,12587,737,11850,31933,45.7,28357,425,74,0.002317352,1686,30247
ZCTA5 97473,124,441,-317,260,60.5,257,0,0,0,1087,-827
ZCTA5 97476,152,331,-179,300,71.1,278,0,0,0,722,-422
ZCTA5 97477,16180,330,15850,37631,39.6,32137,552,464,0.01233026,667,36964
ZCTA5 97478,14831,339,14492,40217,39.1,33539,589,193,0.004798966,847,39370
ZCTA5 97479,4491,97,4394,10174,51,9613,99,112,0.011008453,208,9966
ZCTA5 97480,145,491,-346,350,58.7,307,0,0,0,1197,-847
ZCTA5 97481,375,4885,-4510,998,41,860,0,17,0.017034068,13306,-12308
ZCTA5 97484,88,47,41,174,56.8,159,0,0,0,78,96
ZCTA5 97486,271,220,51,666,56.6,521,0,12,0.018018018,554,112
ZCTA5 97487,3610,628,2982,8894,48.6,7306,297,60,0.006746121,1685,7209
ZCTA5 97488,447,185,262,1036,61.9,904,21,31,0.02992278,442,594
ZCTA5 97489,439,202,237,1007,49,824,4,0,0,446,561
ZCTA5 97490,148,29,119,443,46.5,406,0,0,0,42,401
ZCTA5 97492,443,2145,-1702,918,66.6,888,0,0,0,4972,-4054
ZCTA5 97493,159,542,-383,329,65.2,308,11,0,0,1596,-1267
ZCTA5 97494,33,1674,-1641,33,-,33,0,0,0,4151,-4118
ZCTA5 97495,858,248,610,1838,59.9,1403,166,6,0.003264418,649,1189
ZCTA5 97496,2720,5152,-2432,7329,41,6719,36,12,0.001637331,12289,-4960
ZCTA5 97497,689,480,209,1276,56.9,1192,9,23,0.018025078,1066,210
ZCTA5 97498,921,675,246,1969,56.3,1675,10,0,0,1859,110
ZCTA5 97499,732,250,482,1717,57.2,1588,0,0,0,523,1194
ZCTA5 97501,18869,323,18546,47229,37.4,38969,324,371,0.007855343,921,46308
ZCTA5 97502,10811,501,10310,28458,42.9,26066,171,2,7.03E-05,1169,27289
ZCTA5 97503,4554,62,4492,13931,35.3,11903,192,6,0.000430694,182,13749
ZCTA5 97504,19779,1514,18265,49370,41,43175,892,457,0.009256634,3742,45628
ZCTA5 97520,12200,549,11651,26633,49.2,23831,459,247,0.009274209,1293,25340
ZCTA5 97522,227,116,111,649,37.6,584,0,0,0,355,294
ZCTA5 97523,2923,275,2648,6443,48,5900,68,120,0.018624864,583,5860
ZCTA5 97524,6006,453,5553,15625,42.9,14358,3,191,0.012224,1194,14431
ZCTA5 97525,2081,168,1913,4740,54.5,4180,27,0,0,468,4272
ZCTA5 97526,15115,318,14797,36166,45.6,32903,171,307,0.008488636,722,35444
ZCTA5 97527,14563,324,14239,36819,46.9,32172,523,115,0.003123387,723,36096
ZCTA5 97530,3405,88,3317,8173,48.9,7653,60,6,0.000734125,175,7998
ZCTA5 97531,99,752,-653,201,71.6,201,0,0,0,1670,-1469
ZCTA5 97532,981,258,723,2359,56.8,2080,0,0,0,565,1794
ZCTA5 97534,358,76,282,623,66.3,623,0,0,0,167,456
ZCTA5 97535,2123,17,2106,4968,50.5,4117,37,42,0.008454106,34,4934
ZCTA5 97536,470,146,324,1116,56.8,952,4,0,0,276,840
ZCTA5 97537,2801,406,2395,6820,52.9,6299,37,0,0,1074,5746
ZCTA5 97538,732,481,251,1989,40,1869,33,0,0,1204,785
ZCTA5 97539,1402,138,1264,3227,58.7,3002,0,13,0.004028509,382,2845
ZCTA5 97540,3689,2179,1510,8401,42.4,7270,446,10,0.001190334,5171,3230
ZCTA5 97541,587,264,323,1505,40.1,1493,0,0,0,574,931
ZCTA5 97543,262,30,232,581,58.8,554,0,0,0,56,525
ZCTA5 97544,889,32,857,2046,49,1991,0,0,0,91,1955
ZCTA5 97601,9737,69,9668,22967,40.3,19810,443,183,0.007967954,124,22843
ZCTA5 97603,12283,991,11292,30950,39.8,24775,298,211,0.006817447,2124,28826
ZCTA5 97604,0,74,-74,0,-,0,0,0,#DIV/0!,153,-153
ZCTA5 97620,27,116,-89,51,43.9,51,0,0,0,266,-215
ZCTA5 97621,110,57,53,199,69.2,153,0,0,0,134,65
ZCTA5 97622,162,101,61,310,54.1,246,0,0,0,211,99
ZCTA5 97623,1142,261,881,2677,54.3,2400,0,15,0.005603287,505,2172
ZCTA5 97624,1653,4,1649,3958,49.3,3010,17,1,0.000252653,8,3950
ZCTA5 97625,62,307,-245,161,47.7,161,0,0,0,957,-796
ZCTA5 97626,82,3475,-3393,112,63.6,112,0,0,0,8058,-7946
ZCTA5 97627,182,323,-141,671,39.7,671,0,0,0,835,-164
ZCTA5 97630,2048,216,1832,5057,46.5,4250,62,13,0.002570694,595,4462
ZCTA5 97632,533,586,-53,1585,36.8,1147,0,20,0.012618297,1306,279
ZCTA5 97633,475,49,426,1287,34.7,1108,0,22,0.017094017,108,1179
ZCTA5 97634,135,524,-389,435,38.8,428,0,0,0,1350,-915
ZCTA5 97635,75,10877,-10802,177,58.2,158,0,0,0,31579,-31402
ZCTA5 97636,186,0,186,431,35.5,419,8,0,0,3,428
ZCTA5 97637,62,1439,-1377,124,43.6,112,0,0,0,3721,-3597
ZCTA5 97638,170,253,-83,562,30.4,560,0,0,0,590,-28
ZCTA5 97639,21,1028,-1007,42,61.3,42,0,0,0,2911,-2869
ZCTA5 97640,54,450,-396,147,46.4,125,0,0,0,1095,-948
ZCTA5 97641,770,472,298,1527,56.3,1450,0,0,0,988,539
ZCTA5 97701,16711,606,16105,40835,36.8,37496,790,375,0.009183299,1601,39234
ZCTA5 97702,20521,38,20483,50767,41.5,45472,539,401,0.007898832,67,50700
ZCTA5 97703,13316,61,13255,32918,43.7,29780,475,31,0.000941734,164,32754
ZCTA5 97707,3066,217,2849,6609,50.9,6143,53,0,0,563,6046
ZCTA5 97709,0,378,-378,0,-,0,0,0,#DIV/0!,1079,-1079
ZCTA5 97710,37,714,-677,70,59.2,70,0,0,0,1749,-1679
ZCTA5 97711,26,555,-529,40,65.5,40,0,0,0,1153,-1113
ZCTA5 97712,22,6444,-6422,71,31.2,71,0,0,0,12945,-12874
ZCTA5 97720,1784,7584,-5800,4395,45.7,3889,0,57,0.012969283,20895,-16500
ZCTA5 97721,81,8859,-8778,170,61.5,170,0,0,0,20324,-20154
ZCTA5 97722,10,3788,-3778,29,52.5,29,0,0,0,6824,-6795
ZCTA5 97730,118,17720,-17602,290,59.5,263,0,0,0,42036,-41746
ZCTA5 97731,196,14216,-14020,453,39.1,440,0,0,0,35821,-35368
ZCTA5 97732,60,12040,-11980,111,62.1,107,0,0,0,29723,-29612
ZCTA5 97733,256,19647,-19391,542,58.2,537,0,0,0,49284,-48742
ZCTA5 97734,1188,7970,-6782,3620,38.6,2973,27,34,0.009392265,19150,-15530
ZCTA5 97735,65,9892,-9827,134,52.4,131,0,0,0,23294,-23160
ZCTA5 97736,23,6811,-6788,85,45.3,72,0,0,0,17173,-17088
ZCTA5 97737,200,5780,-5580,331,57.9,276,0,0,0,15785,-15454
ZCTA5 97738,931,12767,-11836,2278,42,2098,0,0,0,30023,-27745
ZCTA5 97739,5377,7918,-2541,12896,55.5,12356,1,1,7.75E-05,19485,-6589
ZCTA5 97741,4345,20386,-16041,13120,38.5,8832,55,105,0.008003049,69086,-55966
ZCTA5 97750,152,3242,-3090,362,60.8,304,0,0,0,8589,-8227
ZCTA5 97751,31,207,-176,82,30.8,82,0,0,0,919,-837
ZCTA5 97752,0,117,-117,0,-,0,0,0,#DIV/0!,296,-296
ZCTA5 97753,1150,1208,-58,2960,61.2,2858,0,7,0.002364865,3646,-686
ZCTA5 97754,8711,3382,5329,21125,44.5,19280,66,34,0.001609467,8816,12309
ZCTA5 97756,16570,1125,15445,42180,39.7,38278,273,174,0.004125178,5107,37073
ZCTA5 97758,30,1587,-1557,73,29.5,62,0,0,0,3759,-3686
ZCTA5 97759,3305,58,3247,7607,58.3,7324,1,0,0,130,7477
ZCTA5 97760,3166,231,2935,7704,57.3,6874,34,36,0.004672897,568,7136
ZCTA5 97761,908,25,883,3438,29.9,179,0,0,0,42,3396
ZCTA5 97801,7523,162,7361,21526,38.4,17045,138,345,0.01602713,481,21045
ZCTA5 97810,380,18054,-17674,1179,47.1,1028,34,3,0.002544529,48276,-47097
ZCTA5 97812,311,10439,-10128,785,39.9,712,5,0,0,29968,-29183
ZCTA5 97813,584,3878,-3294,1436,44,1360,0,0,0,11701,-10265
ZCTA5 97814,5174,262,4912,12316,44.5,11244,36,178,0.014452744,771,11545
ZCTA5 97817,6,756,-750,41,12.3,41,0,0,0,3000,-2959
ZCTA5 97818,1479,4826,-3347,5034,32.3,3049,44,51,0.010131108,16341,-11307
ZCTA5 97819,17,82,-65,29,64.9,29,0,0,0,281,-252
ZCTA5 97820,462,110,352,1016,56.5,942,7,4,0.003937008,401,615
ZCTA5 97823,583,1037,-454,1140,62.6,1024,6,0,0,2292,-1152
ZCTA5 97824,735,537,198,1866,45.3,1734,18,11,0.005894962,1857,9
ZCTA5 97825,135,1886,-1751,265,55.8,258,0,0,0,7689,-7424
ZCTA5 97826,443,4360,-3917,1319,31.3,909,0,0,0,12962,-11643
ZCTA5 97827,1057,10894,-9837,2504,49.1,2361,40,13,0.005191693,27785,-25281
ZCTA5 97828,1395,4721,-3326,3192,49.6,2956,11,57,0.017857143,13478,-10286
ZCTA5 97830,316,8660,-8344,729,48.1,653,0,0,0,21173,-20444
ZCTA5 97833,289,148,141,696,53.3,626,0,4,0.005747126,392,304
ZCTA5 97834,526,1014,-488,1336,48.2,1204,12,6,0.004491018,3462,-2126
ZCTA5 97835,168,52,116,379,41.5,287,0,0,0,98,281
ZCTA5 97836,877,449,428,2076,45.9,2001,3,17,0.008188825,1250,826
ZCTA5 97837,52,719,-667,76,61.2,72,0,0,0,1764,-1688
ZCTA5 97838,9170,15188,-6018,27318,34.1,21290,426,162,0.005930156,41274,-13956
ZCTA5 97839,125,0,125,303,42.9,244,0,0,0,0,303
ZCTA5 97840,48,118,-70,154,28.7,154,0,0,0,224,-70
ZCTA5 97841,190,125,65,544,40.1,533,1,0,0,231,313
ZCTA5 97842,56,586,-530,82,71.1,82,0,0,0,1619,-1537
ZCTA5 97843,339,8353,-8014,845,48.6,725,0,0,0,19880,-19035
ZCTA5 97844,1254,7567,-6313,3676,36.2,2970,30,0,0,16693,-13017
ZCTA5 97845,1139,8749,-7610,2571,49,2436,28,0,0,24122,-21551
ZCTA5 97846,1018,5983,-4965,2114,56.6,1966,5,5,0.002365184,14242,-12128
ZCTA5 97848,87,14457,-14370,277,45.5,226,0,0,0,40786,-40509
ZCTA5 97850,6837,1245,5592,17029,36.9,15366,174,110,0.006459569,6327,10702
ZCTA5 97856,216,1936,-1720,433,53.8,393,1,0,0,7213,-6780
ZCTA5 97857,229,13846,-13617,538,57.9,528,2,0,0,39010,-38472
ZCTA5 97859,89,12673,-12584,277,45.5,205,0,0,0,35835,-35558
ZCTA5 97862,4359,0,4359,12559,39.7,10303,40,6,0.000477745,257,12302
ZCTA5 97864,150,0,150,244,60.2,189,1,0,0,0,244
ZCTA5 97865,532,7974,-7442,1228,51.4,1165,0,0,0,22097,-20869
ZCTA5 97867,402,6935,-6533,1046,38.8,1014,6,0,0,20818,-19772
ZCTA5 97868,660,6714,-6054,1579,49.4,1485,0,0,0,15527,-13948
ZCTA5 97869,415,4222,-3807,905,49.3,821,3,0,0,10804,-9899
ZCTA5 97870,294,0,294,639,58.3,541,4,0,0,745,-106
ZCTA5 97873,108,152,-44,206,54.3,187,0,0,0,324,-118
ZCTA5 97874,159,47,112,380,53.8,343,9,0,0,127,253
ZCTA5 97875,1047,21,1026,2783,36.8,2247,2,0,0,87,2696
ZCTA5 97876,350,24,326,996,44,822,24,0,0,66,930
ZCTA5 97877,163,31,132,287,70.5,286,0,0,0,70,217
ZCTA5 97880,151,107,44,358,48.5,331,15,1,0.002793296,259,99
ZCTA5 97882,2112,138,1974,7879,34.6,5923,11,246,0.031222236,638,7241
ZCTA5 97883,1007,94,913,2395,41.7,2173,33,63,0.026304802,364,2031
ZCTA5 97884,72,20,52,127,67.5,126,0,0,0,932,-805
ZCTA5 97885,571,149,422,1404,46.6,1249,0,4,0.002849003,570,834
ZCTA5 97886,338,60,278,963,36.3,836,10,0,0,208,755
ZCTA5 97901,260,1225,-965,768,43.9,604,6,2,0.002604167,2694,-1926
ZCTA5 97902,6,227,-221,23,17.8,23,0,0,0,701,-678
ZCTA5 97903,16,35,-19,41,51.9,41,0,0,0,94,-53
ZCTA5 97904,120,2072,-1952,243,50.4,202,0,0,0,7693,-7450
ZCTA5 97905,63,77,-14,131,60,131,0,0,0,489,-358
ZCTA5 97906,89,184,-95,270,27.8,270,0,0,0,953,-683
ZCTA5 97907,274,36,238,699,49.7,661,3,0,0,116,583
ZCTA5 97908,10,31,-21,19,58.9,19,0,0,0,76,-57
ZCTA5 97909,7,108,-101,16,-,16,0,0,0,248,-232
ZCTA5 97910,179,3168,-2989,609,42.7,603,0,0,0,9256,-8647
ZCTA5 97911,32,108,-76,57,63.1,57,0,0,0,198,-141
ZCTA5 97913,1610,23,1587,5139,25.6,4205,7,0,0,72,5067
ZCTA5 97914,5927,33,5894,19500,37.2,14783,272,301,0.015435897,82,19418
ZCTA5 97917,14,129,-115,41,30.9,41,0,0,0,315,-274
ZCTA5 97918,1602,342,1260,4763,37.3,4237,53,0,0,798,3965
ZCTA5 97920,13,906,-893,29,53.8,23,0,0,0,2548,-2519
ZCTA5 98001,11820,33,11787,35297,40.4,20148,6092,2236,0.06334816,152,35145
ZCTA5 98002,14012,800,13212,35915,35.4,20311,2361,3350,0.09327579,2471,33444
ZCTA5 98003,18988,8943,10045,50501,35.9,20911,6425,9707,0.192214016,26446,24055
ZCTA5 98004,18125,75,18050,38632,37,20160,14417,750,0.019413957,281,38351
ZCTA5 98005,8732,17,8715,21603,36.2,9479,9987,305,0.014118409,47,21556
ZCTA5 98006,13782,46,13736,39595,43.1,19560,15655,870,0.021972471,119,39476
ZCTA5 98007,11770,191,11579,28576,33.3,12518,12039,1640,0.057390817,847,27729
ZCTA5 98008,9233,12,9221,26091,43.8,16649,6550,426,0.016327469,18,26073
ZCTA5 98010,2280,91,2189,5963,40.7,4986,347,48,0.008049639,365,5598
ZCTA5 98011,11133,290,10843,27396,37.7,18305,5017,289,0.010548985,644,26752
ZCTA5 98012,26731,953,25778,75045,35.5,44581,19946,1860,0.024785129,1975,73070
ZCTA5 98014,2842,392,2450,7736,46,7053,314,27,0.003490176,980,6756
ZCTA5 98019,3903,83,3820,11290,37.5,9503,770,50,0.004428698,353,10937
ZCTA5 98020,8762,49,8713,18594,51.4,16100,1259,72,0.003872217,186,18408
ZCTA5 98021,11809,33,11776,34359,37.8,22010,8634,385,0.011205216,88,34271
ZCTA5 98022,8697,62,8635,22007,43,18779,543,80,0.003635207,183,21824
ZCTA5 98023,17896,3971,13925,51811,37.7,25016,7535,7613,0.146937909,9518,42293
ZCTA5 98024,1976,246,1730,5503,48.1,4395,238,85,0.01544612,1195,4308
ZCTA5 98025,0,52,-52,0,-,0,0,0,#DIV/0!,98,-98
ZCTA5 98026,15357,137,15220,39340,42.1,28093,4675,1081,0.027478393,401,38939
ZCTA5 98027,11294,53,11241,27808,41.2,20690,4105,348,0.012514384,228,27580
ZCTA5 98028,9266,108,9158,23556,39.6,17066,3438,753,0.031966378,557,22999
ZCTA5 98029,12362,895,11467,31480,36,18085,9707,812,0.025794155,2240,29240
ZCTA5 98030,13134,5944,7190,39526,34.5,18231,8043,4775,0.120806558,15671,23855
ZCTA5 98031,13716,127,13589,41464,35.6,16336,11971,4828,0.116438356,892,40572
ZCTA5 98032,14195,161,14034,38985,32.9,15939,6528,5364,0.137591381,360,38625
ZCTA5 98033,16773,149,16624,39726,38.7,28471,6839,689,0.017343805,626,39100
ZCTA5 98034,20706,4116,16590,52841,37.2,37675,7958,841,0.015915672,12770,40071
ZCTA5 98036,15091,138,14953,41132,38.7,26749,6222,3094,0.075221239,565,40567
ZCTA5 98037,10705,146,10559,28938,40,15997,6902,1714,0.059230078,705,28233
ZCTA5 98038,12733,54,12679,37624,38.3,30008,3185,638,0.016957261,252,37372
ZCTA5 98039,1054,44,1010,2928,46.7,1772,783,18,0.006147541,95,2833
ZCTA5 98040,9758,34,9724,25506,45.5,17418,5492,231,0.009056693,112,25394
ZCTA5 98042,16602,62,16540,48639,40.8,33405,5846,2439,0.050144945,267,48372
ZCTA5 98043,8616,152,8464,21265,37.7,14444,2106,1028,0.048342347,416,20849
ZCTA5 98045,5704,99,5605,15611,39.4,12760,654,30,0.001921722,475,15136
ZCTA5 98047,2293,89,2204,7024,31.6,3541,810,692,0.098519362,173,6851
ZCTA5 98050,0,134,-134,0,-,0,0,0,#DIV/0!,348,-348
ZCTA5 98051,1560,170,1390,4272,45,3657,94,0,0,768,3504
ZCTA5 98052,30181,223,29958,75765,34.9,40330,28142,1379,0.018201016,578,75187
ZCTA5 98053,8458,92,8366,22857,43.7,15047,5980,152,0.006650042,340,22517
ZCTA5 98055,9351,99,9252,24668,33.4,10159,6313,2912,0.118047673,521,24147
ZCTA5 98056,14449,133,14316,36950,37.8,19205,9819,1507,0.040784844,650,36300
ZCTA5 98057,5951,18,5933,12351,37.5,6053,2014,2128,0.172293741,30,12321
ZCTA5 98058,15449,371,15078,42366,38.3,25389,6315,3395,0.080135014,863,41503
ZCTA5 98059,14319,53,14266,41076,39,23681,10335,823,0.020036031,208,40868
ZCTA5 98065,5200,96,5104,15779,37.6,13054,1655,61,0.003865898,403,15376
ZCTA5 98068,295,84,211,551,53.1,527,8,4,0.007259528,243,308
ZCTA5 98070,4579,117,4462,10886,49.7,9846,109,5,0.000459306,343,10543
ZCTA5 98072,9748,8366,1382,24931,43.1,20416,2333,190,0.007621034,24992,-61
ZCTA5 98074,9811,15,9796,30370,38.4,17719,10501,154,0.005070794,26,30344
ZCTA5 98075,8241,37,8204,25762,41.1,14779,8525,582,0.022591414,98,25664
ZCTA5 98077,4636,34,4602,13862,44.5,11236,1121,64,0.004616938,71,13791
ZCTA5 98087,15403,115,15288,41958,33,21690,8165,2668,0.063587397,510,41448
ZCTA5 98092,17170,17,17153,50845,35.9,30927,6651,2471,0.048598682,53,50792
ZCTA5 98101,10127,1496,8631,14528,35.1,8296,4037,1182,0.081360132,4071,10457
ZCTA5 98102,15755,60,15695,25396,33.3,18373,3253,662,0.026067097,158,25238
ZCTA5 98103,25283,17975,7308,52210,33.7,40302,4983,1141,0.021854051,52551,-341
ZCTA5 98104,8299,143,8156,14469,36,7231,3958,1448,0.100076025,635,13834
ZCTA5 98105,16760,7,16753,49448,24.1,31201,11387,1315,0.026593593,27,49421
ZCTA5 98106,11227,73,11154,27489,35.4,13348,4255,3489,0.126923497,402,27087
ZCTA5 98107,14647,209,14438,27116,34.1,20810,3534,90,0.003319074,704,26412
ZCTA5 98108,8367,89,8278,23759,37.1,6665,8858,4549,0.191464287,393,23366
ZCTA5 98109,18072,151,17921,29376,32.2,19021,7081,1046,0.035607298,643,28733
ZCTA5 98110,9824,202,9622,24557,49.2,22084,753,21,0.000855153,1190,23367
ZCTA5 98112,10938,102,10836,24412,39.2,19445,2164,765,0.031337047,534,23878
ZCTA5 98115,22557,223,22334,53729,37.1,41021,6840,971,0.018072177,449,53280
ZCTA5 98116,12698,1683,11015,27190,39.1,22281,1392,891,0.032769401,5014,22176
ZCTA5 98117,14802,22,14780,36365,39.9,29658,2411,530,0.014574453,64,36301
ZCTA5 98118,17853,36,17817,48937,38.4,18254,13087,9916,0.202627868,143,48794
ZCTA5 98119,13726,25,13701,26094,34,18847,3206,697,0.026711121,35,26059
ZCTA5 98121,13659,35,13624,21010,34.2,11309,6539,837,0.039838172,77,20933
ZCTA5 98122,21383,5635,15748,41541,30.9,25123,5550,4408,0.106112034,14178,27363
ZCTA5 98125,19336,31,19305,43386,37.6,28694,6714,3640,0.083898032,57,43329
ZCTA5 98126,9928,109,9819,22030,38.5,14069,2584,2873,0.130413073,576,21454
ZCTA5 98133,22365,1446,20919,50153,40.2,31163,7538,5006,0.099814567,3423,46730
ZCTA5 98134,246,538,-292,808,41.2,512,101,86,0.106435644,1315,-507
ZCTA5 98136,7829,624,7205,17245,40.5,14214,647,347,0.020121774,1329,15916
ZCTA5 98144,14195,23,14172,31648,38.1,15339,6521,4794,0.151478766,47,31601
ZCTA5 98146,10306,207,10099,27879,39.4,14418,5132,1702,0.061049535,1021,26858
ZCTA5 98148,4117,86,4031,11068,35.9,4732,1289,1575,0.142302132,433,10635
ZCTA5 98154,0,87,-87,0,-,0,0,0,#DIV/0!,409,-409
ZCTA5 98155,13790,77,13713,36081,40.1,25069,5133,1520,0.042127435,312,35769
ZCTA5 98158,0,148,-148,0,-,0,0,0,#DIV/0!,465,-465
ZCTA5 98164,157,214,-57,250,36.9,142,38,0,0,604,-354
ZCTA5 98166,9131,220,8911,22599,43.3,16969,1397,769,0.034028054,743,21856
ZCTA5 98168,12220,696,11524,34614,37.6,14932,7183,4325,0.124949442,4167,30447
ZCTA5 98174,0,1464,-1464,0,-,0,0,0,#DIV/0!,3976,-3976
ZCTA5 98177,7994,1069,6925,20561,46.2,16471,1791,445,0.021642916,2834,17727
ZCTA5 98178,9531,259,9272,26282,40,8140,7577,6392,0.243208279,570,25712
ZCTA5 98188,10873,61,10812,27524,37.3,9098,4440,6852,0.248946374,343,27181
ZCTA5 98195,0,22,-22,2259,19.2,1062,733,119,0.052678176,47,2212
ZCTA5 98198,14376,25,14351,38919,37,19249,4418,4633,0.119042113,95,38824
ZCTA5 98199,10186,124,10062,22890,38.9,17705,2760,344,0.015028397,222,22668
ZCTA5 98201,13316,549,12767,30669,39.3,23981,1009,964,0.031432391,1438,29231
ZCTA5 98203,13876,0,13876,36164,39.3,25699,2854,2381,0.065838956,0,36164
ZCTA5 98204,16975,8051,8924,42496,32.9,22984,6532,4076,0.09591491,18748,23748
ZCTA5 98207,0,676,-676,1376,23.6,683,243,261,0.189680233,2628,-1252
ZCTA5 98208,21887,1627,20260,60087,36.9,39300,9030,2986,0.049694609,6968,53119
ZCTA5 98220,191,0,191,578,41.4,578,0,0,0,37,541
ZCTA5 98221,10075,8054,2021,22707,50.4,20304,494,238,0.010481349,23904,-1197
ZCTA5 98222,60,0,60,108,65.3,108,0,0,0,0,108
ZCTA5 98223,16673,12216,4457,45253,42.2,37375,1471,377,0.008330939,31235,14018
ZCTA5 98224,102,4476,-4374,203,53.3,201,0,0,0,11798,-11595
ZCTA5 98225,21943,493,21450,50046,30.7,41587,2334,698,0.013947169,1164,48882
ZCTA5 98226,18890,48,18842,45373,39.4,34494,2785,535,0.011791153,126,45247
ZCTA5 98229,13483,86,13397,34182,39.6,28034,1222,319,0.009332397,344,33838
ZCTA5 98230,7902,50,7852,18413,45.8,15001,596,191,0.010373106,104,18309
ZCTA5 98232,1590,1218,372,4030,46,3894,13,39,0.009677419,4224,-194
ZCTA5 98233,6532,34,6498,16615,39.3,12507,340,119,0.007162203,88,16527
ZCTA5 98235,144,40,104,368,24.9,325,0,23,0.0625,64,304
ZCTA5 98236,2478,96,2382,6184,52.3,5700,123,70,0.011319534,527,5657
ZCTA5 98237,1778,88,1690,4474,39.3,3808,48,19,0.004246759,180,4294
ZCTA5 98238,45,65,-20,45,-,45,0,0,0,122,-77
ZCTA5 98239,3368,0,3368,7409,60.5,6647,183,45,0.006073694,0,7409
ZCTA5 98240,1199,28,1171,3328,41.4,2951,0,0,0,74,3254
ZCTA5 98241,849,0,849,1854,48.1,1668,0,6,0.003236246,831,1023
ZCTA5 98243,145,30,115,270,50.6,256,2,0,0,87,183
ZCTA5 98244,1294,1595,-301,3244,50.1,2615,42,2,0.000616523,5012,-1768
ZCTA5 98245,1978,73,1905,4122,54.7,3691,62,37,0.008976225,155,3967
ZCTA5 98247,2948,93,2855,8068,39,6032,65,29,0.003594447,354,7714
ZCTA5 98248,9069,246,8823,26404,36.8,21758,1776,122,0.004620512,517,25887
ZCTA5 98249,2051,189,1862,4229,59.6,3884,28,109,0.025774415,559,3670
ZCTA5 98250,3946,162,3784,8568,54,7665,109,93,0.010854342,719,7849
ZCTA5 98251,1929,425,1504,4706,45.4,3990,31,104,0.022099448,1013,3693
ZCTA5 98252,3879,89,3790,10246,39.9,9383,188,26,0.002537576,208,10038
ZCTA5 98253,1192,24,1168,2275,59.2,2092,0,0,0,80,2195
ZCTA5 98255,127,96,31,262,54.2,212,11,0,0,352,-90
ZCTA5 98256,137,71,66,328,47.9,322,6,0,0,258,70
ZCTA5 98257,2107,61,2046,4513,58.3,3297,62,41,0.009084866,193,4320
ZCTA5 98258,17359,98,17261,51374,35.6,42330,2231,1006,0.01958189,348,51026
ZCTA5 98260,2784,94,2690,5979,63.1,5617,141,4,0.000669008,453,5526
ZCTA5 98261,1454,23,1431,3034,59.7,2783,34,24,0.007910349,121,2913
ZCTA5 98262,486,943,-457,887,63.3,826,0,0,0,3596,-2709
ZCTA5 98263,69,79,-10,196,41.8,188,0,0,0,340,-144
ZCTA5 98264,7946,51,7895,22005,35.9,17785,563,187,0.008498069,112,21893
ZCTA5 98266,1497,115,1382,4373,35.7,3858,69,0,0,359,4014
ZCTA5 98267,133,27,106,250,55,250,0,0,0,92,158
ZCTA5 98270,18949,7,18942,52756,37.8,39493,3876,1347,0.025532641,16,52740
ZCTA5 98271,10858,69,10789,29120,39.5,21015,1416,397,0.013633242,239,28881
ZCTA5 98272,9667,64,9603,31517,35.8,24696,854,895,0.028397373,301,31216
ZCTA5 98273,11556,308,11248,30924,35.4,22507,586,78,0.002522313,976,29948
ZCTA5 98274,6850,106,6744,18052,42,13405,611,134,0.007423,465,17587
ZCTA5 98275,8304,1429,6875,21409,44.6,13791,4566,282,0.01317203,3980,17429
ZCTA5 98276,517,155,362,1397,33,1220,0,0,0,708,689
ZCTA5 98277,15943,120,15823,40112,34.2,29684,2982,1549,0.038616873,322,39790
ZCTA5 98278,0,87,-87,2515,22.2,1180,53,340,0.135188867,289,2226
ZCTA5 98279,364,214,150,689,58.2,658,10,0,0,894,-205
ZCTA5 98280,199,9,190,394,61.7,371,13,0,0,20,374
ZCTA5 98281,636,75,561,1210,58.3,1130,11,0,0,224,986
ZCTA5 98282,7286,132,7154,17235,54.7,15626,439,245,0.01421526,726,16509
ZCTA5 98283,179,163,16,499,44.8,441,0,0,0,688,-189
ZCTA5 98284,10158,61,10097,27159,38.6,22601,316,337,0.01240841,233,26926
ZCTA5 98286,87,148,-61,188,63.1,169,3,10,0.053191489,633,-445
ZCTA5 98288,91,68,23,254,41.8,238,0,5,0.019685039,368,-114
ZCTA5 98290,14045,18,14027,38516,42.8,33513,935,203,0.005270537,61,38455
ZCTA5 98292,8700,127,8573,24141,41.9,21450,434,58,0.002402552,1008,23133
ZCTA5 98294,2556,49,2507,6936,36.3,5566,38,41,0.005911188,132,6804
ZCTA5 98295,1020,103,917,2927,37.1,2661,31,8,0.002733174,252,2675
ZCTA5 98296,9172,75,9097,27032,41.2,22417,2042,289,0.010691033,274,26758
ZCTA5 98297,42,607,-565,59,68.7,59,0,0,0,1569,-1510
ZCTA5 98303,811,64,747,1564,61.1,1366,44,17,0.010869565,160,1404
ZCTA5 98304,440,164,276,1114,53.9,1008,13,0,0,645,469
ZCTA5 98305,141,38,103,298,57.8,284,0,0,0,108,190
ZCTA5 98310,9048,54,8994,21635,36.6,14287,1582,1134,0.052415068,164,21471
ZCTA5 98311,10021,83,9938,27170,36,19892,2634,1028,0.037835848,337,26833
ZCTA5 98312,12812,54,12758,31762,36.5,23729,1351,1748,0.055034318,240,31522
ZCTA5 98314,28,20,8,1773,22.5,1289,12,116,0.065425832,59,1714
ZCTA5 98315,1074,108,966,6407,22.4,4403,215,392,0.061183081,487,5920
ZCTA5 98320,678,20,658,1456,60.6,1278,8,0,0,58,1398
ZCTA5 98321,6056,66,5990,16749,40.4,15012,160,105,0.006269031,290,16459
ZCTA5 98323,242,11296,-11054,644,43.7,635,2,0,0,29356,-28712
ZCTA5 98325,712,183,529,1737,57.4,1622,2,5,0.002878526,427,1310
ZCTA5 98326,369,1027,-658,931,39.9,637,0,0,0,2263,-1332
ZCTA5 98327,4108,28,4080,9974,34.1,6618,879,716,0.071786645,67,9907
ZCTA5 98328,3710,260,3450,10505,40.7,8843,90,149,0.014183722,511,9994
ZCTA5 98329,4087,1192,2895,11175,42.7,9853,147,160,0.014317673,2629,8546
ZCTA5 98330,11,331,-320,22,-,22,0,0,0,760,-738
ZCTA5 98331,2176,191,1985,5951,36.7,4292,101,149,0.025037809,413,5538
ZCTA5 98332,7198,50,7148,19722,46.6,16131,1186,276,0.013994524,110,19612
ZCTA5 98333,1371,1472,-101,3534,48.3,3274,37,0,0,3380,154
ZCTA5 98335,10785,3623,7162,28128,44.2,23530,845,149,0.005297213,8909,19219
ZCTA5 98336,257,8,249,693,39,632,0,0,0,29,664
ZCTA5 98337,3530,395,3135,8582,31.9,6470,545,324,0.037753437,1050,7532
ZCTA5 98338,10802,86,10716,31996,38.5,24915,1144,1124,0.035129391,138,31858
ZCTA5 98339,1426,5367,-3941,3304,49.7,2742,51,8,0.002421308,13577,-10273
ZCTA5 98340,1545,2,1543,3017,68.6,2791,55,0,0,7,3010
ZCTA5 98342,611,73,538,1331,53.7,1164,22,15,0.011269722,102,1229
ZCTA5 98345,162,276,-114,270,57.2,270,0,0,0,558,-288
ZCTA5 98346,3865,819,3046,9371,52.2,7759,224,34,0.003628215,2031,7340
ZCTA5 98349,2084,160,1924,5272,38.5,4497,172,0,0,411,4861
ZCTA5 98350,92,49,43,336,31.6,24,0,2,0.005952381,77,259
ZCTA5 98351,596,309,287,1375,60.3,1082,17,37,0.026909091,673,702
ZCTA5 98353,17,554,-537,17,-,17,0,0,0,1624,-1607
ZCTA5 98354,3212,51,3161,8185,37.3,6493,572,123,0.015027489,75,8110
ZCTA5 98355,297,1158,-861,792,31.6,491,124,0,0,2361,-1569
ZCTA5 98356,911,0,911,2350,50.3,1974,0,0,0,0,2350
ZCTA5 98357,517,0,517,1547,30.3,215,0,0,0,0,1547
ZCTA5 98358,439,0,439,924,58.3,918,0,0,0,0,924
ZCTA5 98359,1868,0,1868,4991,45.9,4566,37,31,0.00621118,0,4991
ZCTA5 98360,5045,0,5045,14591,38.3,12883,264,74,0.005071619,0,14591
ZCTA5 98361,316,0,316,469,64.6,429,0,0,0,0,469
ZCTA5 98362,10731,0,10731,24462,47,21385,352,198,0.008094187,0,24462
ZCTA5 98363,5961,0,5961,14245,45.1,11878,128,150,0.010530011,0,14245
ZCTA5 98364,20,0,20,67,17.5,67,0,0,0,0,67
ZCTA5 98365,2432,0,2432,4779,65,4373,118,0,0,0,4779
ZCTA5 98366,14047,0,14047,36620,38.7,28837,1799,834,0.02277444,0,36620
ZCTA5 98367,11448,0,11448,30710,41.8,25930,952,300,0.009768805,0,30710
ZCTA5 98368,8363,0,8363,16702,59.3,15431,163,146,0.008741468,0,16702
ZCTA5 98370,12893,0,12893,33071,43.5,27512,954,368,0.011127574,0,33071
ZCTA5 98371,8840,0,8840,22741,39.4,18439,1535,621,0.027307506,0,22741
ZCTA5 98372,10544,0,10544,27127,37.4,21806,1625,575,0.021196594,0,27127
ZCTA5 98373,10504,0,10504,29283,34.7,20961,2173,1398,0.04774101,0,29283
ZCTA5 98374,14501,0,14501,42974,37.3,32049,2149,919,0.021385024,0,42974
ZCTA5 98375,10017,0,10017,31973,32.3,20458,2270,2436,0.076189285,0,31973
ZCTA5 98376,891,0,891,2044,54.6,1779,96,0,0,0,2044
ZCTA5 98377,965,0,965,2057,52.6,1980,0,0,0,0,2057
ZCTA5 98380,1935,0,1935,5753,39.2,5199,159,13,0.002259691,0,5753
ZCTA5 98381,96,0,96,235,43.9,197,0,0,0,0,235
ZCTA5 98382,14109,0,14109,30366,60.4,27079,660,331,0.010900349,0,30366
ZCTA5 98383,8798,0,8798,22541,37.1,16212,2228,1207,0.05354687,0,22541
ZCTA5 98385,191,0,191,462,55.5,445,7,0,0,0,462
ZCTA5 98387,16364,0,16364,52017,32.2,32804,2897,4826,0.092777361,0,52017
ZCTA5 98388,2712,0,2712,6975,41.3,5161,339,433,0.062078853,0,6975
ZCTA5 98390,4575,0,4575,11413,36.5,9671,145,101,0.008849558,0,11413
ZCTA5 98391,19173,0,19173,55662,37.3,47336,1652,490,0.008803133,0,55662
ZCTA5 98392,1370,0,1370,3231,44.6,2327,43,26,0.008047044,0,3231
ZCTA5 98394,418,0,418,1186,49.6,1168,0,0,0,0,1186
ZCTA5 98396,244,0,244,620,36.8,610,0,4,0.006451613,0,620
ZCTA5 98402,3897,0,3897,6805,36.3,4733,458,506,0.07435709,0,6805
ZCTA5 98403,4292,0,4292,8441,35.8,6883,294,228,0.027011018,0,8441
ZCTA5 98404,12254,0,12254,35357,34.6,15954,5933,5066,0.143281387,0,35357
ZCTA5 98405,10106,0,10106,24053,38.4,15925,1081,2764,0.114912901,0,24053
ZCTA5 98406,9918,0,9918,22708,41.1,18227,807,1296,0.057072397,0,22708
ZCTA5 98407,9559,0,9559,20993,45.6,17013,958,662,0.031534321,0,20993
ZCTA5 98408,8121,0,8121,22016,37.9,12683,1791,2378,0.108012355,0,22016
ZCTA5 98409,11351,0,11351,28403,31,15785,2646,4641,0.163398233,0,28403
ZCTA5 98416,0,0,0,1057,19.2,750,98,38,0.035950804,0,1057
ZCTA5 98418,4055,0,4055,9813,37.3,6167,738,549,0.055946194,0,9813
ZCTA5 98421,12,0,12,950,35.2,574,212,117,0.123157895,0,950
ZCTA5 98422,7903,0,7903,22002,39,14218,2496,1868,0.084901373,0,22002
ZCTA5 98424,4395,0,4395,12019,31.7,6248,1736,1329,0.110574923,0,12019
ZCTA5 98430,0,0,0,0,-,0,0,0,#DIV/0!,0,0
ZCTA5 98433,4268,0,4268,19771,23,12193,877,2788,0.141014617,0,19771
ZCTA5 98438,12,0,12,576,22.2,377,39,59,0.102430556,0,576
ZCTA5 98439,2128,0,2128,6095,25.6,3643,79,540,0.088597211,0,6095
ZCTA5 98443,2155,0,2155,5688,46.9,4377,334,85,0.014943741,0,5688
ZCTA5 98444,12964,0,12964,35083,35,16416,3712,6269,0.178690534,0,35083
ZCTA5 98445,11689,0,11689,32304,38.1,19824,2241,3159,0.097789747,0,32304
ZCTA5 98446,4489,0,4489,13068,37.6,9992,594,320,0.024487297,0,13068
ZCTA5 98447,0,0,0,1303,19.6,864,218,41,0.031465848,0,1303
ZCTA5 98465,3498,0,3498,7092,41.8,4963,224,784,0.110547095,0,7092
ZCTA5 98466,11868,0,11868,29989,37.1,20850,2025,2227,0.074260562,0,29989
ZCTA5 98467,6147,0,6147,15382,39.5,9561,2235,1141,0.07417761,0,15382
ZCTA5 98498,11362,0,11362,29062,38.9,17899,2264,2912,0.100199573,0,29062
ZCTA5 98499,13635,0,13635,33589,34.5,16730,3147,5669,0.168775492,0,33589
ZCTA5 98501,18315,0,18315,46170,38.9,37108,2803,1223,0.026489062,0,46170
ZCTA5 98502,14483,0,14483,35954,37.7,27734,2321,1050,0.029203983,0,35954
ZCTA5 98503,17195,0,17195,42023,38.4,30825,2510,2010,0.04783095,0,42023
ZCTA5 98505,0,0,0,145,20.8,93,9,9,0.062068966,0,145
ZCTA5 98506,8561,0,8561,18232,47.7,15426,903,403,0.022103993,0,18232
ZCTA5 98512,12356,0,12356,30251,39.8,23863,1201,745,0.024627285,0,30251
ZCTA5 98513,13284,0,13284,36117,38.1,25850,3262,1169,0.032367029,0,36117
ZCTA5 98516,10502,0,10502,26336,39.9,18719,2925,1149,0.043628493,0,26336
ZCTA5 98520,8304,0,8304,25064,38.5,20082,244,832,0.033195021,0,25064
ZCTA5 98524,1691,0,1691,4326,41.8,3964,40,0,0,0,4326
ZCTA5 98526,76,0,76,206,31.1,144,4,0,0,0,206
ZCTA5 98527,131,0,131,237,64.5,210,0,0,0,0,237
ZCTA5 98528,4856,0,4856,13082,40.9,10098,283,182,0.013912246,0,13082
ZCTA5 98530,183,0,183,551,38.3,506,3,0,0,0,551
ZCTA5 98531,10499,0,10499,26501,38.4,22314,240,231,0.008716652,0,26501
ZCTA5 98532,9578,0,9578,26100,41.3,22636,383,205,0.007854406,0,26100
ZCTA5 98533,255,0,255,524,64.3,493,0,0,0,0,524
ZCTA5 98535,314,0,314,598,51.5,474,0,28,0.046822742,0,598
ZCTA5 98536,0,0,0,0,-,0,0,0,#DIV/0!,0,0
ZCTA5 98537,966,0,966,2688,39.9,2360,110,0,0,0,2688
ZCTA5 98538,164,0,164,417,52.6,364,0,0,0,0,417
ZCTA5 98539,65,0,65,136,33.4,128,0,0,0,0,136
ZCTA5 98541,4076,0,4076,10343,45.5,9545,16,4,0.000386735,0,10343
ZCTA5 98542,210,0,210,669,50.1,669,0,0,0,0,669
ZCTA5 98544,16,0,16,55,16.8,55,0,0,0,0,55
ZCTA5 98546,1326,0,1326,2920,50.9,2639,19,0,0,0,2920
ZCTA5 98547,692,0,692,1317,62.1,1317,0,0,0,0,1317
ZCTA5 98548,1125,0,1125,2197,66.9,1955,0,0,0,0,2197
ZCTA5 98550,4893,0,4893,11691,43.2,10197,184,85,0.00727055,0,11691
ZCTA5 98552,85,0,85,240,37.9,202,0,0,0,0,240
ZCTA5 98555,267,0,267,350,70.5,294,19,0,0,0,350
ZCTA5 98556,0,0,0,592,34.8,306,27,120,0.202702703,0,592
ZCTA5 98557,1357,0,1357,3650,42.3,3318,85,37,0.010136986,0,3650
ZCTA5 98558,0,0,0,51,68.6,40,0,10,0.196078431,0,51
ZCTA5 98559,0,0,0,0,-,0,0,0,#DIV/0!,0,0
ZCTA5 98560,45,0,45,98,37.6,98,0,0,0,0,98
ZCTA5 98562,43,0,43,43,-,43,0,0,0,0,43
ZCTA5 98563,3082,0,3082,7636,46.1,7149,130,1,0.000130959,0,7636
ZCTA5 98564,1130,0,1130,2684,45.8,2037,0,63,0.023472429,0,2684
ZCTA5 98565,93,0,93,303,26.5,273,1,0,0,0,303
ZCTA5 98566,108,0,108,302,38.7,270,0,0,0,0,302
ZCTA5 98568,1102,0,1102,2549,52.1,1916,21,7,0.002746175,0,2549
ZCTA5 98569,3619,0,3619,6826,62.9,5898,202,2,0.000292997,0,6826
ZCTA5 98570,1691,0,1691,4674,42.7,3905,13,1,0.00021395,0,4674
ZCTA5 98571,77,0,77,77,-,0,0,0,0,0,77
ZCTA5 98572,338,0,338,884,38.8,765,6,0,0,0,884
ZCTA5 98575,47,0,47,117,60.2,93,5,0,0,0,117
ZCTA5 98576,1848,0,1848,5277,42.4,4854,51,17,0.003221527,0,5277
ZCTA5 98577,2813,0,2813,7121,45.3,5669,183,37,0.005195899,0,7121
ZCTA5 98579,5010,0,5010,13440,41.5,11228,97,43,0.003199405,0,13440
ZCTA5 98580,4267,0,4267,11358,43.5,9751,120,241,0.021218524,0,11358
ZCTA5 98581,246,0,246,402,72.9,383,0,0,0,0,402
ZCTA5 98582,78,0,78,177,47.8,177,0,0,0,0,177
ZCTA5 98583,42,0,42,120,43.6,120,0,0,0,0,120
ZCTA5 98584,13675,0,13675,37360,41.3,29413,238,204,0.005460385,0,37360
ZCTA5 98585,325,0,325,610,56.3,581,0,0,0,0,610
ZCTA5 98586,707,0,707,1863,44.3,1207,81,61,0.032742888,0,1863
ZCTA5 98587,287,0,287,810,41.8,87,0,0,0,0,810
ZCTA5 98588,716,0,716,1490,60.9,1354,7,34,0.022818792,0,1490
ZCTA5 98589,2922,0,2922,7699,42.7,6717,69,188,0.024418756,0,7699
ZCTA5 98590,242,0,242,539,50.2,385,0,0,0,0,539
ZCTA5 98591,1551,0,1551,3582,51.7,3352,44,9,0.002512563,0,3582
ZCTA5 98592,690,0,690,1543,59.7,1300,0,0,0,0,1543
ZCTA5 98593,475,0,475,1247,49.5,971,0,13,0.01042502,0,1247
ZCTA5 98595,1189,0,1189,2698,53.6,2552,25,8,0.002965159,0,2698
ZCTA5 98596,2525,0,2525,7856,41.2,6515,161,2,0.000254582,0,7856
ZCTA5 98597,9342,0,9342,26222,36.7,21615,523,431,0.01643658,0,26222
ZCTA5 98601,1070,0,1070,3237,36,2968,0,0,0,0,3237
ZCTA5 98602,82,0,82,126,64.4,102,0,0,0,0,126
ZCTA5 98603,532,0,532,1307,40.6,1093,0,0,0,0,1307
ZCTA5 98604,12706,0,12706,37041,38.5,34339,496,174,0.004697497,0,37041
ZCTA5 98605,503,0,503,1245,42.4,1139,9,0,0,0,1245
ZCTA5 98606,3399,0,3399,9551,48.8,8939,166,3,0.000314103,0,9551
ZCTA5 98607,11902,0,11902,34674,41.6,26971,3407,694,0.020014997,0,34674
ZCTA5 98609,0,0,0,0,-,0,0,0,#DIV/0!,0,0
ZCTA5 98610,1154,0,1154,2932,46.7,2699,22,3,0.001023192,0,2932
ZCTA5 98611,3309,0,3309,9478,42.1,8420,29,46,0.004853345,0,9478
ZCTA5 98612,1346,0,1346,3209,57,2777,53,32,0.009971954,0,3209
ZCTA5 98613,200,0,200,560,44.5,511,8,15,0.026785714,0,560
ZCTA5 98614,200,0,200,364,58.8,364,0,0,0,0,364
ZCTA5 98616,56,0,56,117,57.6,115,0,0,0,0,117
ZCTA5 98617,459,0,459,1100,45,898,0,0,0,0,1100
ZCTA5 98619,257,0,257,609,53.9,530,0,0,0,0,609
ZCTA5 98620,3360,0,3360,7711,52.5,7096,0,53,0.006873298,0,7711
ZCTA5 98621,104,0,104,228,68.9,216,9,0,0,0,228
ZCTA5 98623,22,0,22,42,-,42,0,0,0,0,42
ZCTA5 98624,580,0,580,1994,40.6,1780,0,0,0,0,1994
ZCTA5 98625,2725,0,2725,6397,50.8,5724,32,0,0,0,6397
ZCTA5 98626,10199,0,10199,26579,40.2,23669,367,255,0.00959404,0,26579
ZCTA5 98628,126,0,126,306,50.8,306,0,0,0,0,306
ZCTA5 98629,2929,0,2929,8872,42.6,8142,388,0,0,0,8872
ZCTA5 98631,1564,0,1564,3458,54.4,3188,17,0,0,0,3458
ZCTA5 98632,20667,0,20667,50944,39.6,43266,812,564,0.01107098,0,50944
ZCTA5 98635,772,0,772,1877,45.1,1717,29,1,0.000532765,0,1877
ZCTA5 98638,631,0,631,1560,40.2,1319,23,40,0.025641026,0,1560
ZCTA5 98639,445,0,445,1177,37.4,1040,33,0,0,0,1177
ZCTA5 98640,2359,0,2359,4694,63.8,4030,91,0,0,0,4694
ZCTA5 98641,68,0,68,114,66.5,114,0,0,0,0,114
ZCTA5 98642,8069,0,8069,22934,40.4,20078,379,262,0.011424087,0,22934
ZCTA5 98643,147,0,147,414,35.8,303,9,25,0.060386473,0,414
ZCTA5 98644,385,0,385,628,71.4,495,0,0,0,0,628
ZCTA5 98645,812,0,812,2137,50.7,1846,0,0,0,0,2137
ZCTA5 98647,142,0,142,236,64.2,186,0,0,0,0,236
ZCTA5 98648,1282,0,1282,3283,49.1,2928,46,4,0.001218398,0,3283
ZCTA5 98649,281,0,281,726,40.3,503,0,36,0.049586777,0,726
ZCTA5 98650,485,0,485,1133,54.4,1017,9,0,0,0,1133
ZCTA5 98651,460,0,460,1035,52.5,998,0,0,0,0,1035
ZCTA5 98660,5849,0,5849,12917,38.8,10702,190,368,0.028489587,0,12917
ZCTA5 98661,20398,0,20398,49822,35.2,37045,1837,1491,0.029926538,0,49822
ZCTA5 98662,13308,0,13308,36573,37.5,29550,2077,898,0.024553632,0,36573
ZCTA5 98663,6251,0,6251,15263,37.7,11745,270,197,0.01290703,0,15263
ZCTA5 98664,9053,0,9053,23141,40,19194,953,660,0.028520807,0,23141
ZCTA5 98665,10962,0,10962,27175,39.2,21638,792,740,0.027230911,0,27175
ZCTA5 98670,25,0,25,48,50.3,44,4,0,0,0,48
ZCTA5 98671,8598,0,8598,23782,40.8,21481,457,151,0.00634934,0,23782
ZCTA5 98672,2815,0,2815,7062,43.4,6216,32,87,0.012319456,0,7062
ZCTA5 98673,185,0,185,489,48,459,2,0,0,0,489
ZCTA5 98674,5195,0,5195,15426,35.9,13792,122,98,0.006352911,0,15426
ZCTA5 98675,2106,0,2106,7083,36.7,6538,38,184,0.025977693,0,7083
ZCTA5 98682,22605,0,22605,66229,34.9,51057,4027,1279,0.019311782,0,66229
ZCTA5 98683,13332,0,13332,31969,43.2,24223,3355,616,0.019268667,0,31969
ZCTA5 98684,12451,0,12451,34394,36.1,25657,2130,612,0.017793801,0,34394
ZCTA5 98685,11530,0,11530,30199,44.2,25408,1417,555,0.018378092,0,30199
ZCTA5 98686,7541,0,7541,20547,41.5,17135,1048,322,0.015671388,0,20547
ZCTA5 98801,16710,0,16710,44861,35.6,29555,272,280,0.006241502,0,44861
ZCTA5 98802,11389,0,11389,31480,38,22058,294,197,0.006257942,0,31480
ZCTA5 98811,45,0,45,120,51.5,64,56,0,0,0,120
ZCTA5 98812,1672,0,1672,5403,28.3,2422,11,21,0.00388673,0,5403
ZCTA5 98813,807,0,807,2642,28,435,0,0,0,0,2642
ZCTA5 98814,338,0,338,690,56,649,15,0,0,0,690
ZCTA5 98815,2648,0,2648,7451,44.2,6344,56,0,0,0,7451
ZCTA5 98816,2437,0,2437,6219,46,4995,83,0,0,0,6219
ZCTA5 98817,63,0,63,131,59.1,131,0,0,0,0,131
ZCTA5 98819,100,0,100,190,58.8,159,3,0,0,0,190
ZCTA5 98821,377,0,377,1131,54.6,567,0,0,0,0,1131
ZCTA5 98822,682,0,682,1831,42.8,1482,16,15,0.008192245,0,1831
ZCTA5 98823,4529,0,4529,12514,34.4,8894,40,122,0.009749081,0,12514
ZCTA5 98824,46,0,46,161,24.6,30,0,0,0,0,161
ZCTA5 98826,3266,0,3266,7505,55.6,6979,134,26,0.003464357,0,7505
ZCTA5 98827,150,0,150,339,26.9,196,0,0,0,0,339
ZCTA5 98828,760,0,760,2002,42.5,1439,0,0,0,0,2002
ZCTA5 98829,242,0,242,647,55.4,265,42,7,0.010819165,0,647
ZCTA5 98830,246,0,246,482,53.5,434,1,0,0,0,482
ZCTA5 98831,1355,0,1355,3691,47.2,2176,0,18,0.004876727,0,3691
ZCTA5 98832,62,0,62,155,47.2,148,0,0,0,0,155
ZCTA5 98833,73,0,73,149,46.2,137,0,0,0,0,149
ZCTA5 98834,110,0,110,278,49,258,0,0,0,0,278
ZCTA5 98836,258,0,258,796,50.1,399,18,0,0,0,796
ZCTA5 98837,16166,0,16166,45729,35.2,33424,715,878,0.01920007,0,45729
ZCTA5 98840,1890,0,1890,4895,42,3729,27,37,0.007558733,0,4895
ZCTA5 98841,3416,0,3416,9135,41.1,6578,23,0,0,0,9135
ZCTA5 98843,789,0,789,2066,44.4,1253,0,7,0.00338819,0,2066
ZCTA5 98844,2110,0,2110,4736,53.6,4009,4,0,0,0,4736
ZCTA5 98845,104,0,104,270,48.4,208,0,0,0,0,270
ZCTA5 98846,418,0,418,1277,33.1,706,29,0,0,0,1277
ZCTA5 98847,886,0,886,2780,35.5,2668,0,0,0,0,2780
ZCTA5 98848,3557,0,3557,12782,27.3,6113,55,0,0,0,12782
ZCTA5 98849,525,0,525,1164,41.3,707,2,1,0.000859107,0,1164
ZCTA5 98850,594,0,594,1924,31.8,1102,0,25,0.012993763,0,1924
ZCTA5 98851,1743,0,1743,5212,36.8,4041,100,4,0.00076746,0,5212
ZCTA5 98852,10,0,10,20,65.2,20,0,0,0,0,20
ZCTA5 98853,59,0,59,116,44,116,0,0,0,0,116
ZCTA5 98855,2347,0,2347,5870,42.6,4334,23,26,0.004429302,0,5870
ZCTA5 98856,1057,0,1057,2595,45.5,2169,28,0,0,0,2595
ZCTA5 98857,1203,0,1203,3431,38.4,1791,34,0,0,0,3431
ZCTA5 98858,765,0,765,1747,52.5,1495,0,4,0.002289639,0,1747
ZCTA5 98859,37,0,37,78,62.6,78,0,0,0,0,78
ZCTA5 98860,127,0,127,257,57.9,230,0,0,0,0,257
ZCTA5 98862,1241,0,1241,2546,58.9,2387,0,10,0.00392773,0,2546
ZCTA5 98901,10890,0,10890,31873,30.6,21230,277,679,0.021303297,0,31873
ZCTA5 98902,16394,0,16394,45913,34,27366,493,654,0.014244332,0,45913
ZCTA5 98903,6046,0,6046,17577,35.5,11732,468,77,0.004380725,0,17577
ZCTA5 98908,14662,0,14662,38936,39.6,31002,366,291,0.007473803,0,38936
ZCTA5 98921,0,0,0,0,-,0,0,0,#DIV/0!,0,0
ZCTA5 98922,3209,0,3209,7162,50.8,6233,36,0,0,0,7162
ZCTA5 98923,410,0,410,760,54.1,383,0,0,0,0,760
ZCTA5 98925,267,0,267,547,57.4,495,0,0,0,0,547
ZCTA5 98926,13441,0,13441,32559,29.3,27263,539,425,0.013053226,0,32559
ZCTA5 98930,4484,0,4484,14952,29.3,9919,30,16,0.001070091,0,14952
ZCTA5 98932,1362,0,1362,5109,23.4,3340,4,8,0.001565864,0,5109
ZCTA5 98933,398,0,398,1188,37.8,697,19,1,0.000841751,0,1188
ZCTA5 98934,518,0,518,1046,35,817,0,10,0.009560229,0,1046
ZCTA5 98935,1126,0,1126,4347,27.3,2626,55,0,0,0,4347
ZCTA5 98936,2160,0,2160,7589,32.8,4864,50,237,0.031229411,0,7589
ZCTA5 98937,1855,0,1855,4483,41.1,3909,21,31,0.006915012,0,4483
ZCTA5 98938,761,0,761,2401,27.8,1854,0,0,0,0,2401
ZCTA5 98939,31,0,31,105,46.5,51,0,0,0,0,105
ZCTA5 98940,228,0,228,445,49.7,445,0,0,0,0,445
ZCTA5 98941,332,0,332,703,43.1,595,28,0,0,0,703
ZCTA5 98942,7017,0,7017,17949,37.3,13195,159,197,0.010975542,0,17949
ZCTA5 98943,360,0,360,792,32.7,736,0,0,0,0,792
ZCTA5 98944,6578,0,6578,25194,27.1,16974,29,245,0.009724538,0,25194
ZCTA5 98946,143,0,143,310,61.9,286,0,0,0,0,310
ZCTA5 98947,905,0,905,3172,26.1,1551,11,63,0.019861286,0,3172
ZCTA5 98948,3610,0,3610,12972,28.8,6032,142,29,0.002235584,0,12972
ZCTA5 98950,0,0,0,29,39.7,29,0,0,0,0,29
ZCTA5 98951,3604,0,3604,13061,30.3,5288,359,8,0.000612511,0,13061
ZCTA5 98952,529,0,529,1956,28.3,420,0,8,0.00408998,0,1956
ZCTA5 98953,2184,0,2184,6684,34.6,4580,36,0,0,0,6684
ZCTA5 99001,2035,0,2035,8400,33.9,5410,497,550,0.06547619,0,8400
ZCTA5 99003,1691,0,1691,4147,50.9,3916,26,0,0,0,4147
ZCTA5 99004,8272,0,8272,21836,28.5,18225,424,483,0.022119436,0,21836
ZCTA5 99005,3686,0,3686,11159,39,10058,139,0,0,0,11159
ZCTA5 99006,5100,0,5100,13649,42.3,12776,31,28,0.002051432,0,13649
ZCTA5 99008,164,0,164,401,60.7,389,0,0,0,0,401
ZCTA5 99009,1668,0,1668,4677,40.5,3758,8,0,0,0,4677
ZCTA5 99011,814,0,814,3343,23.3,2308,66,316,0.094525875,0,3343
ZCTA5 99012,332,0,332,1081,37.5,1036,0,0,0,0,1081
ZCTA5 99013,512,0,512,1436,34.5,736,9,11,0.007660167,0,1436
ZCTA5 99014,31,0,31,31,-,31,0,0,0,0,31
ZCTA5 99016,7122,0,7122,17913,39,15825,399,398,0.022218501,0,17913
ZCTA5 99017,94,0,94,167,45.6,140,0,0,0,0,167
ZCTA5 99018,117,0,117,277,54.6,254,0,3,0.010830325,0,277
ZCTA5 99019,4375,0,4375,12261,36.6,11311,215,32,0.002609901,0,12261
ZCTA5 99020,0,0,0,0,-,0,0,0,#DIV/0!,0,0
ZCTA5 99021,3533,0,3533,10139,43.2,9579,26,32,0.00315613,0,10139
ZCTA5 99022,3064,0,3064,8740,39.8,7691,201,155,0.017734554,0,8740
ZCTA5 99023,277,0,277,883,42.6,846,0,0,0,0,883
ZCTA5 99025,2090,0,2090,5910,45.8,5159,82,0,0,0,5910
ZCTA5 99026,3166,0,3166,8521,50.2,7967,48,0,0,0,8521
ZCTA5 99027,2399,0,2399,5832,52.7,5446,33,0,0,0,5832
ZCTA5 99029,545,0,545,1240,38.3,1218,0,0,0,0,1240
ZCTA5 99030,306,0,306,633,55.1,547,4,0,0,0,633
ZCTA5 99031,485,0,485,1313,47.1,1235,0,0,0,0,1313
ZCTA5 99032,317,0,317,826,50.3,776,17,0,0,0,826
ZCTA5 99033,366,0,366,882,49.7,841,0,0,0,0,882
ZCTA5 99034,121,0,121,231,34,215,0,1,0.004329004,0,231
ZCTA5 99036,631,0,631,1549,50.3,1548,0,0,0,0,1549
ZCTA5 99037,5648,0,5648,15647,39,13759,292,153,0.009778232,0,15647
ZCTA5 99039,65,0,65,181,42.5,159,0,0,0,0,181
ZCTA5 99040,335,0,335,778,42.3,118,0,13,0.016709512,0,778
ZCTA5 99101,611,0,611,1612,48.5,1548,16,0,0,0,1612
ZCTA5 99102,267,0,267,580,35.5,554,4,0,0,0,580
ZCTA5 99103,200,0,200,543,40.8,539,1,0,0,0,543
ZCTA5 99105,13,0,13,27,55.8,27,0,0,0,0,27
ZCTA5 99109,2073,0,2073,4743,57.8,4277,13,3,0.000632511,0,4743
ZCTA5 99110,659,0,659,1656,40.8,1545,0,0,0,0,1656
ZCTA5 99111,1594,0,1594,4057,43.9,3665,14,14,0.003450826,0,4057
ZCTA5 99113,231,0,231,559,47.1,516,0,0,0,0,559
ZCTA5 99114,5009,0,5009,13134,42.9,11735,121,19,0.001446627,0,13134
ZCTA5 99115,510,0,510,1261,42.2,1084,7,32,0.025376685,0,1261
ZCTA5 99116,721,0,721,1706,43.4,803,9,0,0,0,1706
ZCTA5 99117,200,0,200,516,41.3,492,0,0,0,0,516
ZCTA5 99118,349,0,349,811,48.7,697,0,0,0,0,811
ZCTA5 99119,696,0,696,1491,57.4,1158,0,1,0.000670691,0,1491
ZCTA5 99121,88,0,88,272,52,224,6,0,0,0,272
ZCTA5 99122,1615,0,1615,4269,42.8,3899,35,30,0.007027407,0,4269
ZCTA5 99123,449,0,449,1031,60.3,890,0,0,0,0,1031
ZCTA5 99124,117,0,117,258,48.5,121,0,0,0,0,258
ZCTA5 99125,247,0,247,647,42.3,623,0,2,0.00309119,0,647
ZCTA5 99126,271,0,271,765,41.2,617,0,0,0,0,765
ZCTA5 99128,128,0,128,291,47.7,278,6,0,0,0,291
ZCTA5 99129,294,0,294,625,44.2,305,18,0,0,0,625
ZCTA5 99130,309,0,309,791,41.1,701,0,0,0,0,791
ZCTA5 99131,80,0,80,132,70.1,130,0,0,0,0,132
ZCTA5 99133,720,0,720,1440,52.1,1023,12,0,0,0,1440
ZCTA5 99134,253,0,253,572,47,482,0,15,0.026223776,0,572
ZCTA5 99135,167,0,167,406,34.8,396,0,0,0,0,406
ZCTA5 99136,11,0,11,21,60.9,21,0,0,0,0,21
ZCTA5 99137,194,0,194,413,43,376,12,0,0,0,413
ZCTA5 99138,406,0,406,1152,39.6,264,0,3,0.002604167,0,1152
ZCTA5 99139,351,0,351,806,43.2,655,0,0,0,0,806
ZCTA5 99140,220,0,220,494,51.4,129,0,3,0.006072874,0,494
ZCTA5 99141,2512,0,2512,5902,46.8,5442,60,31,0.005252457,0,5902
ZCTA5 99143,346,0,346,640,57.3,529,0,0,0,0,640
ZCTA5 99144,9,0,9,15,63.5,15,0,0,0,0,15
ZCTA5 99146,27,0,27,42,70.5,34,0,0,0,0,42
ZCTA5 99147,84,0,84,161,65.5,151,0,0,0,0,161
ZCTA5 99148,1012,0,1012,2318,56.7,2158,22,0,0,0,2318
ZCTA5 99149,72,0,72,197,42.5,190,0,0,0,0,197
ZCTA5 99150,111,0,111,256,65.6,244,2,0,0,0,256
ZCTA5 99151,76,0,76,158,53.5,143,0,0,0,0,158
ZCTA5 99152,70,0,70,148,46.3,126,0,0,0,0,148
ZCTA5 99153,253,0,253,424,57.3,395,0,0,0,0,424
ZCTA5 99154,12,0,12,41,32.5,41,0,0,0,0,41
ZCTA5 99155,415,0,415,1245,33.3,93,7,0,0,0,1245
ZCTA5 99156,3739,0,3739,8901,49.7,8007,28,40,0.004493877,0,8901
ZCTA5 99157,325,0,325,633,56,595,2,0,0,0,633
ZCTA5 99158,225,0,225,579,51.4,544,0,12,0.020725389,0,579
ZCTA5 99159,587,0,587,1341,55.2,1252,10,25,0.018642804,0,1341
ZCTA5 99160,48,0,48,88,59.4,60,0,0,0,0,88
ZCTA5 99161,606,0,606,1373,49.1,1232,29,0,0,0,1373
ZCTA5 99163,12449,0,12449,34815,22.6,26476,3955,961,0.027603045,0,34815
ZCTA5 99166,1225,0,1225,2934,55.1,2530,4,15,0.005112474,0,2934
ZCTA5 99167,333,0,333,732,62.6,620,0,16,0.021857923,0,732
ZCTA5 99169,1108,0,1108,2643,42.8,2393,15,50,0.018917896,0,2643
ZCTA5 99170,393,0,393,980,43.9,892,5,0,0,0,980
ZCTA5 99171,402,0,402,941,55.4,891,1,27,0.02869288,0,941
ZCTA5 99173,582,0,582,1638,43.5,1407,0,62,0.037851038,0,1638
ZCTA5 99174,17,0,17,33,54.5,32,1,0,0,0,33
ZCTA5 99176,96,0,96,207,56.2,187,0,0,0,0,207
ZCTA5 99179,184,0,184,500,35.7,495,0,0,0,0,500
ZCTA5 99180,314,0,314,791,41.6,652,31,0,0,0,791
ZCTA5 99181,927,0,927,2143,50.8,2047,0,10,0.004666356,0,2143
ZCTA5 99185,534,0,534,1235,48.8,1058,19,13,0.010526316,0,1235
ZCTA5 99201,7643,0,7643,14147,40.3,11215,382,445,0.031455432,0,14147
ZCTA5 99202,7623,0,7623,20526,31.1,16191,900,564,0.027477346,0,20526
ZCTA5 99203,9138,0,9138,21500,43.5,19332,359,303,0.014093023,0,21500
ZCTA5 99204,3928,0,3928,7375,33.1,5958,392,448,0.060745763,0,7375
ZCTA5 99205,17730,0,17730,43901,37.1,37949,655,583,0.01327988,0,43901
ZCTA5 99206,16578,0,16578,42139,38.4,36275,605,569,0.013502931,0,42139
ZCTA5 99207,12814,0,12814,32732,31.9,25403,1371,1404,0.042893804,0,32732
ZCTA5 99208,22536,0,22536,57606,40.2,50066,1296,1351,0.023452418,0,57606
ZCTA5 99212,8507,0,8507,20395,40.6,18168,285,172,0.00843344,0,20395
ZCTA5 99216,11536,0,11536,27597,35.6,24418,278,437,0.015835055,0,27597
ZCTA5 99217,7519,0,7519,19226,38.7,15492,740,78,0.004057006,0,19226
ZCTA5 99218,5889,0,5889,15233,34.4,13424,498,126,0.008271516,0,15233
ZCTA5 99223,14353,0,14353,34013,41.2,29074,829,627,0.018434128,0,34013
ZCTA5 99224,9760,0,9760,23705,39.2,20701,605,232,0.009786965,0,23705
ZCTA5 99251,0,0,0,1258,19.2,907,89,117,0.093004769,0,1258
ZCTA5 99258,0,0,0,486,19.5,362,34,0,0,0,486
ZCTA5 99301,25147,0,25147,84124,30.1,51484,1730,2115,0.025141458,0,84124
ZCTA5 99320,3445,0,3445,9756,35.9,7662,49,0,0,0,9756
ZCTA5 99321,118,0,118,736,20.4,253,0,0,0,0,736
ZCTA5 99322,214,0,214,380,54.8,373,0,0,0,0,380
ZCTA5 99323,1339,0,1339,4494,32.6,3155,0,198,0.044058745,0,4494
ZCTA5 99324,3591,0,3591,10045,34.4,8547,187,43,0.004280737,0,10045
ZCTA5 99326,1300,0,1300,6116,38.5,3777,133,272,0.044473512,0,6116
ZCTA5 99328,1673,0,1673,3616,50,3084,2,37,0.010232301,0,3616
ZCTA5 99329,68,0,68,175,38.5,170,0,0,0,0,175
ZCTA5 99330,275,0,275,1183,35.2,868,22,0,0,0,1183
ZCTA5 99333,32,0,32,81,58.3,81,0,0,0,0,81
ZCTA5 99335,56,0,56,164,49.6,135,0,0,0,0,164
ZCTA5 99336,19474,0,19474,51839,34,36809,1099,1291,0.02490403,0,51839
ZCTA5 99337,11034,0,11034,32393,38.7,26202,727,493,0.015219338,0,32393
ZCTA5 99338,5857,0,5857,17266,38.8,15004,259,380,0.022008572,0,17266
ZCTA5 99341,238,0,238,639,46.2,556,0,0,0,0,639
ZCTA5 99343,690,0,690,2660,23.1,1976,17,0,0,0,2660
ZCTA5 99344,5338,0,5338,19198,25.8,9154,120,12,0.000625065,0,19198
ZCTA5 99345,67,0,67,140,52.3,105,0,0,0,0,140
ZCTA5 99346,132,0,132,337,43,142,0,0,0,0,337
ZCTA5 99347,1039,0,1039,2367,50.2,2208,58,0,0,0,2367
ZCTA5 99348,520,0,520,1657,31.3,1154,0,7,0.004224502,0,1657
ZCTA5 99349,2148,0,2148,7856,29.1,2003,31,0,0,0,7856
ZCTA5 99350,4834,0,4834,14101,33.9,9700,304,155,0.010992128,0,14101
ZCTA5 99352,13688,0,13688,34772,38.8,28311,2272,489,0.014063039,0,34772
ZCTA5 99353,5615,0,5615,17685,36.3,14385,177,261,0.01475827,0,17685
ZCTA5 99354,9836,0,9836,25433,33.3,20912,1301,425,0.016710573,0,25433
ZCTA5 99356,80,0,80,252,33.4,166,0,0,0,0,252
ZCTA5 99357,1033,0,1033,4047,25.4,1599,0,0,0,0,4047
ZCTA5 99359,87,0,87,159,60.2,115,0,21,0.132075472,0,159
ZCTA5 99360,491,0,491,1460,35.9,1160,0,0,0,0,1460
ZCTA5 99361,723,0,723,1680,42.7,1474,8,0,0,0,1680
ZCTA5 99362,16124,0,16124,42706,39.2,34084,808,889,0.020816747,0,42706
ZCTA5 99363,32,0,32,46,72.3,46,0,0,0,0,46
ZCTA5 99371,125,0,125,314,45.5,288,3,0,0,0,314
ZCTA5 99401,155,0,155,386,36.1,386,0,0,0,0,386
ZCTA5 99402,601,0,601,1449,47.5,1316,7,29,0.020013803,0,1449
ZCTA5 99403,8555,0,8555,20492,44.9,18631,255,173,0.008442319,0,20492
ZCTA5 99501,7348,0,7348,16267,38,9293,1075,1272,0.078195119,0,16267
ZCTA5 99502,9077,0,9077,26288,33.3,15915,2271,608,0.023128424,0,26288
ZCTA5 99503,5854,0,5854,12360,36.2,5889,1668,1129,0.091343042,0,12360
ZCTA5 99504,15580,0,15580,40872,34,21106,4746,3948,0.096594245,0,40872
ZCTA5 99505,1006,0,1006,6085,21.1,3722,128,688,0.113064914,0,6085
ZCTA5 99506,2019,0,2019,7167,22.8,4979,212,805,0.112320357,0,7167
ZCTA5 99507,13213,0,13213,35916,35.3,19393,6598,1389,0.038673572,0,35916
ZCTA5 99508,12970,0,12970,39926,30.9,15656,5417,3092,0.07744327,0,39926
ZCTA5 99513,0,0,0,0,-,0,0,0,#DIV/0!,0,0
ZCTA5 99515,7494,0,7494,21596,37.9,14604,1981,406,0.018799778,0,21596
ZCTA5 99516,7327,0,7327,21428,41.4,16502,738,612,0.028560762,0,21428
ZCTA5 99517,6610,0,6610,16014,39.2,10667,1812,467,0.029161983,0,16014
ZCTA5 99518,4172,0,4172,10180,32.9,6258,849,429,0.042141454,0,10180
ZCTA5 99519,0,0,0,1501,48.9,1231,72,0,0,0,1501
ZCTA5 99530,0,0,0,0,-,0,0,0,#DIV/0!,0,0
ZCTA5 99540,195,0,195,346,52.5,333,0,9,0.026011561,0,346
ZCTA5 99546,68,0,68,190,50.3,97,50,16,0.084210526,0,190
ZCTA5 99547,8,0,8,38,21.3,0,0,0,0,0,38
ZCTA5 99548,17,0,17,40,37,1,0,0,0,0,40
ZCTA5 99549,24,0,24,65,32.8,16,0,0,0,0,65
ZCTA5 99550,70,0,70,128,56.6,44,0,0,0,0,128
ZCTA5 99551,104,0,104,469,23.3,11,0,0,0,0,469
ZCTA5 99552,51,0,51,293,26.1,3,0,0,0,0,293
ZCTA5 99553,57,0,57,700,44.3,102,186,62,0.088571429,0,700
ZCTA5 99554,238,0,238,1065,22.3,0,0,0,0,0,1065
ZCTA5 99555,41,0,41,125,33.6,6,0,0,0,0,125
ZCTA5 99556,1189,0,1189,2786,50.7,2417,29,0,0,0,2786
ZCTA5 99557,211,0,211,722,36.8,120,10,11,0.015235457,0,722
ZCTA5 99558,32,0,32,93,24.5,1,0,0,0,0,93
ZCTA5 99559,2268,0,2268,7702,30.3,1463,242,151,0.019605297,0,7702
ZCTA5 99561,67,0,67,375,24.3,0,0,0,0,0,375
ZCTA5 99563,134,0,134,777,34.2,157,0,0,0,0,777
ZCTA5 99564,18,0,18,44,39.5,6,11,0,0,0,44
ZCTA5 99565,11,0,11,31,32.3,4,0,0,0,0,31
ZCTA5 99566,36,0,36,81,35.5,34,0,0,0,0,81
ZCTA5 99567,2783,0,2783,7819,41.6,6759,108,60,0.007673616,0,7819
ZCTA5 99568,182,0,182,471,54.6,457,0,0,0,0,471
ZCTA5 99569,18,0,18,42,39.5,1,0,0,0,0,42
ZCTA5 99571,90,0,90,201,48.6,43,42,2,0.009950249,0,201
ZCTA5 99572,85,0,85,226,42.7,224,2,0,0,0,226
ZCTA5 99573,299,0,299,855,44,541,2,3,0.003508772,0,855
ZCTA5 99574,840,0,840,2671,33.7,1801,334,16,0.005990266,0,2671
ZCTA5 99575,20,0,20,65,45.3,0,0,0,0,0,65
ZCTA5 99576,799,0,799,2536,30.8,614,6,24,0.009463722,0,2536
ZCTA5 99577,10122,0,10122,28264,34.5,23409,699,754,0.026677045,0,28264
ZCTA5 99578,137,0,137,624,25.3,0,0,0,0,0,624
ZCTA5 99579,8,0,8,47,45.9,28,6,0,0,0,47
ZCTA5 99580,18,0,18,53,30.3,1,0,0,0,0,53
ZCTA5 99581,272,0,272,1005,26,6,3,0,0,0,1005
ZCTA5 99583,28,0,28,106,40.5,14,0,0,0,0,106
ZCTA5 99585,46,0,46,253,22.5,0,0,0,0,0,253
ZCTA5 99586,163,0,163,350,57.8,205,0,0,0,0,350
ZCTA5 99587,925,0,925,2029,42.9,1806,37,0,0,0,2029
ZCTA5 99588,390,0,390,1168,39.4,732,13,0,0,0,1168
ZCTA5 99589,24,0,24,73,30.9,8,0,0,0,0,73
ZCTA5 99590,70,0,70,236,30.5,12,0,0,0,0,236
ZCTA5 99591,26,0,26,95,39.4,0,0,0,0,0,95
ZCTA5 99602,94,0,94,290,35,10,0,0,0,0,290
ZCTA5 99603,4346,0,4346,10852,39.9,8961,181,21,0.001935127,0,10852
ZCTA5 99604,174,0,174,961,28.9,66,0,0,0,0,961
ZCTA5 99605,61,0,61,119,48.1,96,0,0,0,0,119
ZCTA5 99606,89,0,89,244,30.5,35,0,0,0,0,244
ZCTA5 99607,52,0,52,225,18.7,13,0,1,0.004444444,0,225
ZCTA5 99608,8,0,8,21,22.8,0,0,0,0,0,21
ZCTA5 99609,75,0,75,448,26.4,8,0,0,0,0,448
ZCTA5 99610,793,0,793,2064,44.7,1663,27,0,0,0,2064
ZCTA5 99611,5405,0,5405,14594,36.7,10707,440,153,0.01048376,0,14594
ZCTA5 99612,342,0,342,1238,38,164,256,0,0,0,1238
ZCTA5 99613,160,0,160,459,38.3,232,12,5,0.010893246,0,459
ZCTA5 99614,114,0,114,467,25.8,3,0,4,0.00856531,0,467
ZCTA5 99615,4190,0,4190,12750,35.1,6838,2913,138,0.010823529,0,12750
ZCTA5 99620,236,0,236,1247,18.6,1,0,0,0,0,1247
ZCTA5 99621,84,0,84,425,25.8,7,4,0,0,0,425
ZCTA5 99622,97,0,97,470,24.5,8,0,0,0,0,470
ZCTA5 99623,7213,0,7213,21510,34.8,17310,525,214,0.009948861,0,21510
ZCTA5 99624,17,0,17,24,58.2,7,0,0,0,0,24
ZCTA5 99625,23,0,23,34,40.3,4,0,0,0,0,34
ZCTA5 99626,59,0,59,304,19.3,6,0,0,0,0,304
ZCTA5 99627,89,0,89,226,42.5,58,0,2,0.008849558,0,226
ZCTA5 99628,159,0,159,705,30,90,0,0,0,0,705
ZCTA5 99630,108,0,108,327,38,0,0,0,0,0,327
ZCTA5 99631,111,0,111,285,46.7,254,0,0,0,0,285
ZCTA5 99632,195,0,195,845,25.8,11,0,0,0,0,845
ZCTA5 99633,141,0,141,394,40,142,23,0,0,0,394
ZCTA5 99634,181,0,181,724,22.2,5,0,0,0,0,724
ZCTA5 99635,0,0,0,107,30.5,104,0,0,0,0,107
ZCTA5 99636,117,0,117,572,30.8,9,2,41,0.071678322,0,572
ZCTA5 99637,177,0,177,874,23.6,14,0,2,0.00228833,0,874
ZCTA5 99638,5,0,5,17,15.5,0,0,0,0,0,17
ZCTA5 99639,504,0,504,1170,54.1,967,13,0,0,0,1170
ZCTA5 99640,34,0,34,79,50.5,7,0,2,0.025316456,0,79
ZCTA5 99641,147,0,147,999,24.8,0,0,0,0,0,999
ZCTA5 99643,80,0,80,174,30.5,25,0,0,0,0,174
ZCTA5 99644,51,0,51,121,53.6,10,0,1,0.008264463,0,121
ZCTA5 99645,10623,0,10623,30706,35.2,24623,383,493,0.016055494,0,30706
ZCTA5 99647,9,0,9,18,57,0,0,0,0,0,18
ZCTA5 99648,23,0,23,74,20.8,1,0,0,0,0,74
ZCTA5 99649,24,0,24,89,26.8,27,0,0,0,0,89
ZCTA5 99650,104,0,104,467,23.2,3,2,0,0,0,467
ZCTA5 99651,3,0,3,8,70.3,0,0,0,0,0,8
ZCTA5 99652,1551,0,1551,3579,43,2963,61,29,0.008102822,0,3579
ZCTA5 99653,23,0,23,116,21.4,80,0,20,0.172413793,0,116
ZCTA5 99654,15472,0,15472,43671,35.1,34762,752,658,0.015067207,0,43671
ZCTA5 99655,210,0,210,989,24.1,20,2,0,0,0,989
ZCTA5 99656,4,0,4,10,42.5,0,0,0,0,0,10
ZCTA5 99657,19,0,19,118,18.7,1,0,0,0,0,118
ZCTA5 99658,258,0,258,1002,24.7,24,0,0,0,0,1002
ZCTA5 99659,55,0,55,312,18.6,0,0,0,0,0,312
ZCTA5 99660,86,0,86,351,44.5,17,3,8,0.022792023,0,351
ZCTA5 99661,397,0,397,1164,48.4,174,228,7,0.006013746,0,1164
ZCTA5 99662,109,0,109,459,21.5,3,0,0,0,0,459
ZCTA5 99663,199,0,199,404,54.9,240,0,0,0,0,404
ZCTA5 99664,1611,0,1611,4383,44.1,3411,53,71,0.01619895,0,4383
ZCTA5 99665,11,0,11,42,36.5,8,2,0,0,0,42
ZCTA5 99666,30,0,30,142,21.3,0,0,0,0,0,142
ZCTA5 99667,58,0,58,125,61,104,0,0,0,0,125
ZCTA5 99668,25,0,25,81,27.3,8,0,0,0,0,81
ZCTA5 99669,6669,0,6669,17725,41.6,14984,303,164,0.009252468,0,17725
ZCTA5 99670,30,0,30,56,56,11,0,0,0,0,56
ZCTA5 99671,151,0,151,646,27,30,2,21,0.03250774,0,646
ZCTA5 99672,1475,0,1475,3191,50.6,2885,0,0,0,0,3191
ZCTA5 99674,593,0,593,1296,56.4,1083,35,0,0,0,1296
ZCTA5 99675,11,0,11,58,11.5,24,0,0,0,0,58
ZCTA5 99676,664,0,664,1569,40.2,1493,2,11,0.007010835,0,1569
ZCTA5 99677,13,0,13,34,55.5,5,0,0,0,0,34
ZCTA5 99678,220,0,220,866,26.6,72,2,1,0.001154734,0,866
ZCTA5 99679,61,0,61,278,26.5,37,3,0,0,0,278
ZCTA5 99680,159,0,159,1072,29.1,12,0,0,0,0,1072
ZCTA5 99681,52,0,52,309,21.3,2,0,0,0,0,309
ZCTA5 99682,138,0,138,334,40.3,8,12,0,0,0,334
ZCTA5 99683,184,0,184,362,57,322,0,0,0,0,362
ZCTA5 99684,169,0,169,737,41.5,224,6,0,0,0,737
ZCTA5 99685,674,0,674,3626,37,927,1849,138,0.038058467,0,3626
ZCTA5 99686,1615,0,1615,3978,40.5,3183,0,98,0.024635495,0,3978
ZCTA5 99688,1100,0,1100,2509,48.9,2178,10,4,0.001594261,0,2509
ZCTA5 99689,216,0,216,562,37.2,176,80,18,0.03202847,0,562
ZCTA5 99690,29,0,29,145,28.3,0,0,0,0,0,145
ZCTA5 99691,63,0,63,108,44.5,4,0,2,0.018518519,0,108
ZCTA5 99692,137,0,137,713,45.4,79,504,6,0.008415147,0,713
ZCTA5 99693,124,0,124,332,47.5,117,106,2,0.006024096,0,332
ZCTA5 99694,598,0,598,1480,43.3,1237,19,17,0.011486486,0,1480
ZCTA5 99695,0,0,0,0,-,0,0,0,#DIV/0!,0,0
ZCTA5 99701,7199,0,7199,17781,33.9,11754,906,826,0.04645408,0,17781
ZCTA5 99702,965,0,965,3273,22.8,2411,44,160,0.048884815,0,3273
ZCTA5 99703,2093,0,2093,9593,22.1,6570,321,1553,0.161888877,0,9593
ZCTA5 99704,0,0,0,61,21.5,44,0,11,0.180327869,0,61
ZCTA5 99705,7775,0,7775,22925,32.1,17623,262,731,0.031886587,0,22925
ZCTA5 99706,10,0,10,23,52.5,0,0,0,0,0,23
ZCTA5 99707,0,0,0,0,-,0,0,0,#DIV/0!,0,0
ZCTA5 99709,11538,0,11538,27880,35.9,19835,1159,1027,0.036836442,0,27880
ZCTA5 99712,4829,0,4829,13260,39.7,10787,312,88,0.006636501,0,13260
ZCTA5 99714,437,0,437,1016,45.9,875,8,0,0,0,1016
ZCTA5 99720,65,0,65,254,27.3,42,6,0,0,0,254
ZCTA5 99721,73,0,73,261,25.3,8,0,0,0,0,261
ZCTA5 99722,69,0,69,225,21.8,2,0,0,0,0,225
ZCTA5 99723,1425,0,1425,5126,28.9,669,467,79,0.015411627,0,5126
ZCTA5 99724,43,0,43,93,40.5,0,0,0,0,0,93
ZCTA5 99725,314,0,314,611,50.1,611,0,0,0,0,611
ZCTA5 99726,15,0,15,19,59.5,12,0,0,0,0,19
ZCTA5 99727,124,0,124,677,23.4,19,0,0,0,0,677
ZCTA5 99729,78,0,78,136,53.5,105,0,0,0,0,136
ZCTA5 99730,49,0,49,54,60.9,51,0,0,0,0,54
ZCTA5 99732,8,0,8,21,55.2,21,0,0,0,0,21
ZCTA5 99733,17,0,17,29,45.1,4,0,0,0,0,29
ZCTA5 99734,0,0,0,1074,41.7,886,48,7,0.006517691,0,1074
ZCTA5 99736,35,0,35,163,27.5,2,7,0,0,0,163
ZCTA5 99737,1347,0,1347,4502,34.5,3851,60,67,0.014882275,0,4502
ZCTA5 99738,67,0,67,147,60.8,123,0,0,0,0,147
ZCTA5 99739,63,0,63,279,18.6,1,0,0,0,0,279
ZCTA5 99740,235,0,235,520,43,63,10,1,0.001923077,0,520
ZCTA5 99741,196,0,196,519,32.6,164,2,0,0,0,519
ZCTA5 99742,114,0,114,419,25.8,9,0,0,0,0,419
ZCTA5 99743,334,0,334,880,48.5,619,26,6,0.006818182,0,880
ZCTA5 99744,50,0,50,130,36.5,120,0,0,0,0,130
ZCTA5 99745,25,0,25,41,56.3,0,0,0,0,0,41
ZCTA5 99746,68,0,68,230,20.3,7,0,0,0,0,230
ZCTA5 99747,61,0,61,241,30.5,8,0,1,0.004149378,0,241
ZCTA5 99748,69,0,69,216,43.7,35,0,0,0,0,216
ZCTA5 99749,78,0,78,376,24.2,23,0,0,0,0,376
ZCTA5 99750,157,0,157,905,26.3,62,0,0,0,0,905
ZCTA5 99751,35,0,35,156,18.8,13,0,0,0,0,156
ZCTA5 99752,874,0,874,3273,31,653,50,85,0.025970058,0,3273
ZCTA5 99753,91,0,91,276,25,3,0,0,0,0,276
ZCTA5 99754,35,0,35,57,47.8,0,0,0,0,0,57
ZCTA5 99755,44,0,44,896,45.3,776,22,9,0.010044643,0,896
ZCTA5 99756,19,0,19,35,50.3,22,0,0,0,0,35
ZCTA5 99757,13,0,13,15,72.6,15,0,0,0,0,15
ZCTA5 99758,50,0,50,151,28.2,5,0,0,0,0,151
ZCTA5 99759,45,0,45,229,23.3,14,0,1,0.004366812,0,229
ZCTA5 99760,245,0,245,737,37,504,0,0,0,0,737
ZCTA5 99761,94,0,94,488,26.3,9,0,2,0.004098361,0,488
ZCTA5 99762,1322,0,1322,4137,31.2,1064,118,61,0.014744984,0,4137
ZCTA5 99763,97,0,97,602,27.2,10,42,0,0,0,602
ZCTA5 99764,73,0,73,474,19.1,80,131,0,0,0,474
ZCTA5 99765,89,0,89,296,41.3,15,0,0,0,0,296
ZCTA5 99766,203,0,203,925,22.9,43,0,4,0.004324324,0,925
ZCTA5 99767,20,0,20,67,14.8,0,0,0,0,0,67
ZCTA5 99768,66,0,66,200,27.4,31,0,0,0,0,200
ZCTA5 99769,181,0,181,946,23.8,32,0,3,0.003171247,0,946
ZCTA5 99770,142,0,142,659,24.4,29,0,0,0,0,659
ZCTA5 99771,70,0,70,330,27,3,0,0,0,0,330
ZCTA5 99772,148,0,148,560,30.5,30,0,3,0.005357143,0,560
ZCTA5 99773,43,0,43,204,29,0,0,0,0,0,204
ZCTA5 99774,4,0,4,9,52.8,0,0,0,0,0,9
ZCTA5 99775,152,0,152,1046,21.1,550,272,43,0.041108987,0,1046
ZCTA5 99776,23,0,23,107,37.9,5,0,7,0.065420561,0,107
ZCTA5 99777,70,0,70,190,42,25,0,0,0,0,190
ZCTA5 99778,75,0,75,250,29,1,0,2,0.008,0,250
ZCTA5 99780,657,0,657,1756,45.2,1056,12,0,0,0,1756
ZCTA5 99781,35,0,35,109,23.8,0,0,0,0,0,109
ZCTA5 99782,138,0,138,556,28.9,40,0,0,0,0,556
ZCTA5 99783,75,0,75,267,23.9,0,0,0,0,0,267
ZCTA5 99784,63,0,63,192,32.5,8,0,0,0,0,192
ZCTA5 99785,137,0,137,673,21.7,16,0,0,0,0,673
ZCTA5 99786,77,0,77,273,29.9,50,0,0,0,0,273
ZCTA5 99788,36,0,36,110,34.6,25,0,0,0,0,110
ZCTA5 99789,125,0,125,751,24.7,185,0,0,0,0,751
ZCTA5 99790,17,0,17,23,50.5,19,0,0,0,0,23
ZCTA5 99791,33,0,33,181,21.5,4,0,0,0,0,181
ZCTA5 99801,11880,0,11880,29976,38.7,19321,2086,269,0.008973846,0,29976
ZCTA5 99820,157,0,157,504,45.9,106,0,41,0.081349206,0,504
ZCTA5 99824,1042,0,1042,2264,36,1552,67,53,0.023409894,0,2264
ZCTA5 99825,13,0,13,19,73.1,19,0,0,0,0,19
ZCTA5 99826,195,0,195,603,50.3,563,0,0,0,0,603
ZCTA5 99827,802,0,802,2169,42.2,1819,39,0,0,0,2169
ZCTA5 99829,275,0,275,913,46.5,253,30,4,0.004381161,0,913
ZCTA5 99830,146,0,146,447,34.4,74,22,1,0.002237136,0,447
ZCTA5 99832,37,0,37,61,64.1,44,0,0,0,0,61
ZCTA5 99833,1211,0,1211,3368,49,2175,560,34,0.010095012,0,3368
ZCTA5 99835,3439,0,3439,8514,39.2,5413,621,51,0.005990134,0,8514
ZCTA5 99836,19,0,19,38,57,38,0,0,0,0,38
ZCTA5 99840,390,0,390,1329,40.5,1017,35,39,0.029345372,0,1329
ZCTA5 99841,105,0,105,156,65,140,0,0,0,0,156
ZCTA5 99850,0,0,0,0,-,0,0,0,#DIV/0!,0,0
ZCTA5 99901,5487,0,5487,13942,40.3,8970,1182,114,0.008176732,0,13942
ZCTA5 99903,1,0,1,1,-,1,0,0,0,0,1
ZCTA5 99918,113,0,113,263,40.7,250,0,0,0,0,263
ZCTA5 99919,263,0,263,562,54.6,492,11,0,0,0,562
ZCTA5 99921,822,0,822,1868,46.3,1285,41,7,0.003747323,0,1868
ZCTA5 99922,121,0,121,319,37.9,52,0,1,0.003134796,0,319
ZCTA5 99923,13,0,13,13,-,13,0,0,0,0,13
ZCTA5 99925,345,0,345,917,43.3,411,7,4,0.00436205,0,917
ZCTA5 99926,457,0,457,1445,38,92,6,0,0,0,1445
ZCTA5 99927,11,0,11,11,-,11,0,0,0,0,11
ZCTA5 99929,841,0,841,2161,45.1,1274,41,3,0.001388246,0,2161
